,onset,offset,label,onset_sample,offset_sample,length,corrcoeff
0,61.0962,61.103267,1,1832886,1833098,212,0.586480333972178
1,61.7701,61.794,1,1853103,1853820,717,0.7627303214104678
2,70.039367,70.0483,1,2101181,2101449,268,0.28832732404960204
3,70.056333,70.072033,1,2101689,2102160,471,0.5277437650139446
4,70.076333,70.081967,1,2102289,2102459,170,0.056722140312611455
5,70.0854,70.089867,1,2102562,2102696,134,-0.4183756159247677
6,70.093267,70.1032,1,2102798,2103096,298,0.1628882337951914
7,70.107067,70.120733,1,2103212,2103621,409,0.42774397438498213
8,70.1223,70.133967,1,2103669,2104019,350,0.040184742987330935
9,70.135133,70.150167,1,2104053,2104505,452,0.6011366499369848
10,70.1559,70.1597,1,2104677,2104791,114,
11,70.162367,70.175767,1,2104871,2105273,402,0.5390597736895983
12,72.542067,72.550067,1,2176262,2176502,240,0.2911133586740358
13,72.916433,72.926267,1,2187492,2187788,296,0.3705353124264179
14,73.0435,73.047467,1,2191305,2191424,119,0.6330393097890471
15,78.362333,78.365667,1,2350869,2350970,101,
16,78.3808,78.384167,1,2351424,2351525,101,0.6982239624821361
17,78.385467,78.3885,1,2351564,2351655,91,
18,78.399067,78.402733,1,2351972,2352081,109,0.4767522302904463
19,78.4038,78.407167,1,2352114,2352215,101,0.6744305104687759
20,78.409733,78.4136,1,2352291,2352408,117,
21,78.570867,78.695667,1,2357126,2360870,3744,0.7042133386134326
22,80.9522,80.961067,1,2428566,2428832,266,0.49418860010888543
23,80.986233,80.9949,1,2429586,2429847,261,0.24834894739597027
24,81.1598,81.1668,1,2434794,2435004,210,0.4413086726040898
25,81.519467,81.524033,1,2445584,2445720,136,0.37600738063021855
26,85.198233,85.206267,1,2555946,2556188,242,0.20806886602250996
27,85.211067,85.262867,1,2556332,2557886,1554,0.8357575984998967
28,85.2652,85.318033,1,2557956,2559540,1584,0.8258837952204917
29,86.2165,86.222833,1,2586495,2586684,189,0.4555494786151295
30,86.2377,86.241667,1,2587131,2587250,119,
31,86.264467,86.2692,1,2587934,2588076,142,0.066106382668961
32,86.624133,86.635133,1,2598723,2599053,330,0.22352992865693747
33,86.644433,86.659233,1,2599332,2599776,444,0.35546529405757477
34,86.662867,86.684667,1,2599886,2600540,654,0.08028287972343758
35,86.685933,86.702533,1,2600577,2601075,498,-0.03173798232048269
36,86.812833,86.819033,1,2604384,2604570,186,-0.021699188803056668
37,86.820967,86.845867,1,2604629,2605376,747,0.17187089877650522
38,86.849633,86.8565,1,2605488,2605695,207,0.1621699096552011
39,86.862833,86.888933,1,2605884,2606667,783,0.06155765556952828
40,86.890633,86.8982,1,2606718,2606946,228,0.16053751883428252
41,86.899367,86.966267,1,2606981,2608988,2007,0.044848837729663395
42,87.025033,87.036967,1,2610750,2611109,359,0.33325047072126174
43,87.0407,87.055333,1,2611221,2611659,438,0.02301494686235868
44,87.056367,87.069267,1,2611691,2612078,387,0.0153375402056842
45,87.071833,87.076967,1,2612154,2612309,155,0.3367928785239678
46,87.111733,87.122133,1,2613351,2613663,312,0.1076448232872564
47,87.138967,87.1468,1,2614169,2614404,235,
48,87.150367,87.176967,1,2614511,2615309,798,0.0783625352021334
49,87.197567,87.201833,1,2615927,2616054,127,
50,87.206733,87.216367,1,2616201,2616491,290,0.3897885482030246
51,87.224533,87.228067,1,2616735,2616842,107,0.2739676286404378
52,87.266433,87.2798,1,2617992,2618394,402,0.40520679557831135
53,87.3215,87.3486,1,2619645,2620458,813,0.044838595257792026
54,87.397267,87.402033,1,2621918,2622060,142,
55,87.416733,87.4277,1,2622501,2622831,330,0.3659563993307223
56,87.4906,87.5131,1,2624718,2625393,675,-0.013705188362529857
57,87.525833,87.528833,1,2625774,2625864,90,-0.07238382665733194
58,87.574767,87.578233,1,2627243,2627346,103,
59,87.582667,87.5858,1,2627480,2627574,94,-0.25700360000589356
60,87.5879,87.594767,1,2627637,2627843,206,-0.05042207522933924
61,87.6283,87.6533,1,2628849,2629599,750,0.016353915099020653
62,87.675533,87.681467,1,2630265,2630444,179,0.33406311663088206
63,87.773567,87.7769,1,2633207,2633307,100,
64,87.798967,87.802667,1,2633969,2634080,111,
65,87.8555,87.8605,1,2635665,2635815,150,
66,87.882267,87.889433,1,2636468,2636682,214,0.3017300794809127
67,87.986433,87.993767,1,2639592,2639813,221,0.3250070065321019
68,87.997133,88.001133,1,2639913,2640033,120,0.005317789666080201
69,88.020367,88.0302,1,2640611,2640906,295,0.4785470729962979
70,88.042567,88.0481,1,2641277,2641443,166,0.18956520290490342
71,88.064567,88.094467,1,2641937,2642834,897,0.04934174806537273
72,88.135067,88.141767,1,2644052,2644253,201,-0.1927684113298612
73,88.142933,88.160967,1,2644287,2644829,542,0.4731084238487289
74,88.534333,88.5405,1,2656029,2656215,186,0.2503539962694039
75,88.7421,88.7561,1,2662263,2662683,420,0.45352534707805314
76,88.7584,88.859833,1,2662752,2665794,3042,0.7820059177615801
77,92.236567,92.240633,1,2767097,2767218,121,0.6566823358958916
78,92.241833,92.246367,1,2767254,2767391,137,0.2797709844511733
79,92.2686,92.284733,1,2768058,2768541,483,0.4022368250534066
80,92.287733,92.303567,1,2768631,2769107,476,0.12554135957027687
81,92.304833,92.314067,1,2769144,2769422,278,0.10849253478366738
82,92.3187,92.370833,1,2769561,2771124,1563,0.11411586555222474
83,92.3719,92.4077,1,2771157,2772231,1074,0.2134908120939942
84,92.428167,92.4345,1,2772845,2773035,190,-0.18118240727274523
85,93.564833,93.578867,1,2806944,2807366,422,0.896810195136514
86,93.5812,93.669133,1,2807436,2810073,2637,0.8380415069878653
87,95.7603,95.771833,1,2872809,2873154,345,-0.0014849456459304895
88,95.776833,95.8779,1,2873304,2876337,3033,0.7846526724635808
89,96.8457,96.848867,1,2905371,2905466,95,
90,96.8555,96.955267,1,2905665,2908658,2993,0.8549339375794512
91,96.966433,96.970033,1,2908992,2909100,108,-0.38149974719484975
92,97.0066,97.014,1,2910198,2910420,222,0.15270226058390451
93,97.341833,97.345967,1,2920254,2920379,125,
94,97.4283,97.4387,1,2922849,2923161,312,-0.15057008784696957
95,100.194333,100.206333,1,3005829,3006189,360,0.34343764944765387
96,100.213367,100.316033,1,3006401,3009480,3079,0.7497541119587514
97,103.197,103.2015,1,3095910,3096045,135,0.17386658211436906
98,103.210133,103.244967,1,3096303,3097349,1046,0.2811526948045026
99,103.474667,103.488433,1,3104240,3104652,412,0.43504861568842007
100,103.493667,103.4994,1,3104810,3104982,172,0.3943188714051699
101,103.504767,103.518833,1,3105143,3105564,421,-0.015623183117730232
102,103.520633,103.5248,1,3105618,3105744,126,0.05130952214274824
103,103.527867,103.539067,1,3105836,3106172,336,-0.0677466299840171
104,103.7041,103.709767,1,3111123,3111293,170,0.3740925156391252
105,103.710933,103.9578,1,3111327,3118734,7407,0.813580657843481
106,103.978033,103.9858,1,3119340,3119574,234,-0.017638329448264663
107,104.005433,104.009433,1,3120162,3120282,120,
108,104.438367,104.542733,1,3133151,3136281,3130,0.7691994072898403
109,104.866967,104.876767,1,3146009,3146303,294,0.6778121419387736
110,104.8937,104.902567,1,3146811,3147077,266,0.6670220951932964
111,104.9274,104.949933,1,3147822,3148497,675,0.7425152904679219
112,104.976567,105.036367,1,3149297,3151091,1794,0.6655852718395061
113,105.055733,105.059567,1,3151671,3151787,116,0.6093728675010767
114,105.061267,105.090633,1,3151838,3152718,880,0.6802220111260331
115,105.109467,105.1541,1,3153284,3154623,1339,0.64083436339635
116,105.174667,105.179733,1,3155240,3155391,151,0.6617762100261262
117,105.181967,105.197167,1,3155459,3155915,456,0.6997372443883063
118,105.2129,105.224367,1,3156387,3156731,344,0.7710252347954671
119,105.232033,105.2517,1,3156960,3157551,591,0.763985528273094
120,105.613833,105.6215,1,3168414,3168645,231,0.707937927532971
121,105.625533,105.802933,1,3168765,3174087,5322,0.8304587767582062
122,105.819267,105.940133,1,3174578,3178203,3625,0.7735629278119174
123,105.9823,105.988333,1,3179469,3179649,180,0.4853511568479074
124,106.397933,106.403267,1,3191937,3192098,161,0.6170956414066261
125,106.405,106.5613,1,3192150,3196839,4689,0.7610990461365502
126,106.5785,106.606033,1,3197355,3198180,825,0.87073524262772
127,106.6083,106.669633,1,3198249,3200088,1839,0.823281596781574
128,106.6709,106.685133,1,3200127,3200553,426,0.5297293616497746
129,107.061067,107.211467,1,3211832,3216344,4512,0.756157103098227
130,107.213167,107.252033,1,3216395,3217560,1165,0.7222212057712011
131,107.255033,107.3812,1,3217650,3221436,3786,0.7736059683691185
132,107.433933,107.5167,1,3223017,3225501,2484,0.7864346274541424
133,108.0985,108.1823,1,3242955,3245469,2514,0.8266304403631337
134,108.2171,108.224533,1,3246513,3246735,222,0.5371031307244786
135,108.325067,108.3459,1,3249752,3250377,625,0.6072055731264495
136,108.3586,108.4512,1,3250758,3253536,2778,0.8280761105995464
137,108.806467,108.977133,1,3264194,3269313,5119,0.830525201647847
138,108.987667,108.9925,1,3269630,3269775,145,-0.1384644154593571
139,109.4194,109.425133,1,3282582,3282753,171,0.6938037509349978
140,109.445833,109.4531,1,3283374,3283593,219,0.5491751893120501
141,109.454133,109.486067,1,3283623,3284582,959,0.7124324539668985
142,109.520267,109.5383,1,3285608,3286149,541,0.6251043394262508
143,109.5402,109.548833,1,3286206,3286464,258,0.6110785047767945
144,109.550033,109.591233,1,3286500,3287736,1236,0.6931492297752065
145,109.598667,109.6027,1,3287960,3288081,121,0.6247960525957997
146,109.6139,109.6367,1,3288417,3289101,684,0.5761789757506772
147,109.6735,109.676667,1,3290205,3290300,95,-0.05523113598200396
148,109.677967,109.688167,1,3290339,3290645,306,0.3823263833863526
149,109.743733,109.748567,1,3292311,3292457,146,0.8235517021068729
150,109.755233,109.806533,1,3292656,3294195,1539,0.7569951326764175
151,109.808633,109.892167,1,3294258,3296765,2507,0.7249070410176475
152,110.313933,110.370967,1,3309417,3311129,1712,0.8192736915986191
153,110.373467,110.3859,1,3311204,3311577,373,0.6763439731059587
154,110.391033,110.409033,1,3311730,3312270,540,0.757336326954747
155,110.6728,110.678633,1,3320184,3320358,174,0.3967107671370747
156,110.729933,110.786433,1,3321897,3323592,1695,0.7377039399057103
157,110.7879,110.808233,1,3323637,3324246,609,0.6338651329137207
158,110.813067,110.836767,1,3324392,3325103,711,0.7215647598562647
159,110.873633,110.903467,1,3326208,3327104,896,0.5134811629225472
160,110.9103,110.9916,1,3327309,3329748,2439,0.7184121443621098
161,110.9949,111.009767,1,3329847,3330293,446,0.39026070916232586
162,111.2858,111.452033,1,3338574,3343560,4986,0.8149543424109262
163,111.459833,111.523267,1,3343794,3345698,1904,0.7290893820791605
164,112.034767,112.039067,1,3361043,3361172,129,0.1321011187022053
165,112.040167,112.096367,1,3361205,3362891,1686,0.7848281254303907
166,112.103067,112.1426,1,3363092,3364278,1186,0.8796638617790853
167,112.173333,112.177633,1,3365199,3365328,129,-0.08601773116408974
168,112.178933,112.184767,1,3365367,3365543,176,0.2112419843812177
169,112.1918,112.229667,1,3365754,3366890,1136,0.713505284216987
170,112.2311,112.244633,1,3366933,3367338,405,0.6643276593661015
171,112.246233,112.268467,1,3367386,3368054,668,0.5531460036914305
172,112.295967,112.2993,1,3368879,3368979,100,
173,112.325667,112.335933,1,3369770,3370077,307,-0.0012569556839488719
174,112.6678,112.684367,1,3380034,3380531,497,0.7301637507888766
175,112.6854,112.773467,1,3380562,3383204,2642,0.7759000146214483
176,112.7792,112.791467,1,3383376,3383744,368,0.6971888922361326
177,112.792733,112.799433,1,3383781,3383982,201,0.4005014554986011
178,112.811667,112.8944,1,3384350,3386832,2482,0.8364658049440381
179,112.9032,112.907733,1,3387096,3387231,135,0.10696296317523803
180,113.311333,113.3195,1,3399339,3399585,246,0.23287735134406054
181,113.3249,113.328167,1,3399747,3399845,98,
182,113.3296,113.3337,1,3399888,3400011,123,
183,113.3398,113.346633,1,3400194,3400398,204,-0.06974505745494258
184,113.572567,113.6036,1,3407177,3408108,931,0.38004309381896795
185,113.605567,113.6268,1,3408167,3408804,637,0.8379725290006126
186,113.65,113.706633,1,3409500,3411198,1698,0.802990001070712
187,113.7079,113.751467,1,3411237,3412544,1307,0.814731232480162
188,113.768267,113.771267,1,3413048,3413138,90,0.7855724869378252
189,113.773067,113.802033,1,3413192,3414060,868,0.6784068826342512
190,113.813167,113.816267,1,3414395,3414488,93,
191,113.818667,113.8225,1,3414560,3414675,115,0.41449589201146153
192,113.827933,113.8332,1,3414837,3414996,159,
193,113.846167,113.856333,1,3415385,3415689,304,-0.03218393582153146
194,113.8588,113.8659,1,3415764,3415977,213,0.3969498706944283
195,113.867,113.8732,1,3416010,3416196,186,0.1289737684130903
196,114.032933,114.1456,1,3420987,3424368,3381,0.8706995047902145
197,114.5121,114.528567,1,3435363,3435857,494,0.060640572131794405
198,114.5296,114.613133,1,3435888,3438393,2505,0.8147070902276488
199,114.6391,114.653133,1,3439173,3439593,420,0.26357710016023095
200,114.6542,114.668567,1,3439626,3440057,431,0.11400211186444965
201,114.6783,114.682367,1,3440349,3440471,122,
202,114.748967,114.7535,1,3442469,3442605,136,0.22225267493218426
203,114.7644,114.788033,1,3442932,3443640,708,0.4862719472439393
204,114.789433,114.847533,1,3443682,3445425,1743,0.10123964050078957
205,114.8619,114.972767,1,3445857,3449183,3326,0.746750236772217
206,115.1277,115.1387,1,3453831,3454161,330,0.6819094082993699
207,115.143067,115.1591,1,3454292,3454773,481,0.07891985932427978
208,115.178,115.244433,1,3455340,3457332,1992,0.08477937108129237
209,115.253733,115.421567,1,3457611,3462647,5036,0.7545223406477849
210,115.4284,115.4483,1,3462852,3463449,597,0.8546349727263821
211,115.4588,115.4786,1,3463764,3464358,594,0.7867177832891824
212,115.489967,115.5023,1,3464699,3465069,370,0.3521920377008983
213,115.657367,115.723333,1,3469721,3471699,1978,0.6068499924968047
214,115.732267,115.7444,1,3471968,3472332,364,0.13669920999521853
215,115.941633,115.989,1,3478248,3479670,1422,0.7471229721997733
216,115.990067,115.993067,1,3479702,3479792,90,
217,115.9945,115.9999,1,3479835,3479997,162,-0.3357397041705707
218,116.0017,116.0389,1,3480051,3481167,1116,0.6230797658078076
219,116.048633,116.062333,1,3481458,3481869,411,0.14646705956952444
220,116.0682,116.072967,1,3482046,3482189,143,
221,116.074167,116.095533,1,3482225,3482865,640,0.0586316241020916
222,116.0975,116.100633,1,3482925,3483018,93,
223,116.102667,116.1073,1,3483080,3483219,139,
224,116.258467,116.3083,1,3487754,3489249,1495,0.5533908652317998
225,116.3145,116.3316,1,3489435,3489948,513,-0.08494292296753413
226,116.516567,116.528967,1,3495497,3495869,372,0.5661298867350207
227,116.539167,116.5912,1,3496175,3497736,1561,0.7670906594764912
228,116.593933,116.621233,1,3497817,3498636,819,0.6342017524039886
229,116.638733,116.763633,1,3499161,3502908,3747,0.6740785727539012
230,116.7675,116.843667,1,3503025,3505310,2285,0.6693196246563302
231,116.8477,116.8963,1,3505431,3506889,1458,0.7224622025909638
232,116.9033,116.906733,1,3507099,3507201,102,0.20835648146579577
233,116.9113,116.9457,1,3507339,3508371,1032,0.007641642281448453
234,116.953267,116.964933,1,3508598,3508947,349,0.17220751963692008
235,116.972333,116.976167,1,3509169,3509285,116,
236,117.019333,117.0908,1,3510579,3512724,2145,0.14144470659664887
237,117.092167,117.0959,1,3512765,3512877,112,0.5385395701609523
238,117.097033,117.102067,1,3512910,3513062,152,0.4995794519217476
239,117.121033,117.270567,1,3513630,3518117,4487,0.32747800065805555
240,117.2756,117.285633,1,3518268,3518568,300,0.15945122037782172
241,117.288967,117.316533,1,3518669,3519495,826,0.36410848048367356
242,117.6983,117.709067,1,3530949,3531272,323,0.5144342125000818
243,117.7124,117.729967,1,3531372,3531899,527,0.2700678763838539
244,117.738467,117.788467,1,3532154,3533654,1500,0.4816014357801298
245,117.8042,117.8292,1,3534126,3534876,750,0.4403641492989357
246,117.8501,117.869433,1,3535503,3536082,579,0.4269080546236517
247,117.870533,117.890833,1,3536115,3536724,609,0.490861044867435
248,117.901233,117.912533,1,3537036,3537375,339,0.3775770109537995
249,117.927233,117.946,1,3537816,3538380,564,0.4997189312492347
250,117.948767,117.999367,1,3538463,3539981,1518,0.12798954419761094
251,118.000633,118.012133,1,3540018,3540363,345,-0.009948469661980978
252,118.038567,118.153233,1,3541157,3544596,3439,0.7856123548222483
253,118.159233,118.180733,1,3544776,3545421,645,0.4554969636791472
254,118.1904,118.210633,1,3545712,3546318,606,0.020420481143811064
255,118.221733,118.2262,1,3546651,3546786,135,-0.030780841082908465
256,118.238967,118.247267,1,3547169,3547418,249,-0.1402870293255384
257,118.274,118.2968,1,3548220,3548904,684,0.5358867428914788
258,118.298133,118.3103,1,3548943,3549309,366,0.31080712791883175
259,118.312933,118.346733,1,3549387,3550401,1014,0.020700059050503435
260,118.349267,118.353233,1,3550478,3550596,118,-0.37744870925129503
261,118.3543,118.358767,1,3550629,3550763,134,0.24466261471324105
262,118.372867,118.377067,1,3551186,3551312,126,
263,118.406033,118.412767,1,3552180,3552383,203,0.33684441011405064
264,118.418333,118.4341,1,3552549,3553023,474,0.5686585100874272
265,118.435133,118.515867,1,3553053,3555476,2423,0.5387543934541971
266,118.518133,118.5505,1,3555543,3556515,972,0.6534810129792386
267,118.554367,118.567667,1,3556631,3557030,399,0.5435423471627197
268,118.585467,118.616133,1,3557564,3558483,919,0.4854581148910128
269,118.617167,118.670667,1,3558515,3560120,1605,0.4425180419279085
270,118.680533,118.688567,1,3560415,3560657,242,0.11622500321777822
271,118.6946,118.867633,1,3560838,3566028,5190,0.3046547351127965
272,118.870433,118.8833,1,3566112,3566499,387,0.34378702603830197
273,118.884533,118.922633,1,3566535,3567678,1143,0.4041450045059599
274,118.931333,118.9673,1,3567939,3569019,1080,0.43270258284398844
275,118.974933,119.299333,1,3569247,3578979,9732,0.3428086993352129
276,119.3115,119.3624,1,3579345,3580872,1527,0.20112598152033523
277,119.363633,119.366833,1,3580908,3581004,96,0.0032639748375888037
278,119.368067,119.375867,1,3581042,3581276,234,0.5996080920365217
279,119.381833,119.394133,1,3581454,3581823,369,0.22128175487569324
280,119.4605,119.466867,1,3583815,3584006,191,0.053851511880935135
281,119.6758,119.7745,1,3590274,3593235,2961,0.7370677487755393
282,119.787933,119.825333,1,3593637,3594759,1122,0.6830671844438538
283,119.838567,119.874967,1,3595157,3596249,1092,0.735467112662108
284,119.883433,119.9158,1,3596502,3597474,972,-0.011448066852047608
285,119.918867,119.960333,1,3597566,3598809,1243,0.17047979316107098
286,119.961333,120.131867,1,3598839,3603956,5117,0.6846752686057022
287,120.140233,120.227233,1,3604206,3606816,2610,0.7568515650270675
288,120.261733,120.314033,1,3607851,3609420,1569,0.5551039269365056
289,120.3161,120.320333,1,3609483,3609609,126,-0.1441756476913093
290,120.6001,120.605367,1,3618003,3618161,158,0.2746490030930098
291,120.6307,120.6355,1,3618921,3619065,144,0.5029777151032908
292,120.639567,120.664767,1,3619187,3619943,756,0.7871323768827221
293,120.6697,120.6951,1,3620091,3620853,762,0.6792244990981463
294,120.6977,120.706167,1,3620931,3621185,254,0.5936805543731198
295,120.7266,120.824167,1,3621798,3624725,2927,0.7654884764805077
296,120.841467,120.873433,1,3625244,3626202,958,0.6795377158933353
297,120.897433,120.914833,1,3626922,3627444,522,0.3538034549358697
298,120.9659,121.011233,1,3628977,3630336,1359,0.5688304098940217
299,121.126833,121.130133,1,3633804,3633903,99,
300,121.138133,121.2107,1,3634143,3636321,2178,0.664886597288599
301,121.2124,121.242367,1,3636372,3637271,899,0.6316465189591682
302,121.5744,121.601833,1,3647232,3648054,822,0.550538341830439
303,121.602967,121.622467,1,3648089,3648674,585,0.6653379756189297
304,121.634567,121.641667,1,3649037,3649250,213,0.5700536961214984
305,121.6429,121.6882,1,3649287,3650646,1359,0.7315737793871316
306,121.698733,121.704467,1,3650961,3651134,173,0.08281229555109877
307,121.7586,121.7623,1,3652758,3652869,111,0.16997116382657612
308,121.763333,121.8732,1,3652899,3656196,3297,0.7631688709129552
309,121.879867,121.887233,1,3656396,3656616,220,-0.1677188276922486
310,121.9687,122.1025,1,3659061,3663075,4014,0.812983750401863
311,122.117133,122.155367,1,3663513,3664661,1148,0.7404442458134664
312,122.173733,122.195,1,3665211,3665850,639,0.08183125928843767
313,122.204067,122.2114,1,3666122,3666342,220,-0.018406186644452895
314,122.2586,122.263167,1,3667758,3667895,137,0.41587146802000113
315,122.2699,122.397967,1,3668097,3671939,3842,0.7838445260606753
316,122.437567,122.463767,1,3673127,3673913,786,0.17126196443386185
317,122.466167,122.4998,1,3673985,3674994,1009,-0.0051403837348202724
318,122.5063,122.511433,1,3675189,3675342,153,-0.1548046521611655
319,122.512567,122.519533,1,3675377,3675585,208,0.2857943591013349
320,122.5298,122.535,1,3675894,3676050,156,-0.056478580159671735
321,122.560167,122.662567,1,3676805,3679877,3072,0.8845487808332415
322,122.686567,122.777767,1,3680597,3683333,2736,0.751564137921482
323,122.778967,122.800767,1,3683369,3684023,654,0.6852673933587389
324,123.2803,123.3585,1,3698409,3700755,2346,0.7028327659526945
325,123.359933,123.387833,1,3700797,3701634,837,0.707141541185691
326,126.868333,126.8718,1,3806049,3806154,105,
327,131.178767,131.183767,1,3935363,3935513,150,0.4624321785474579
328,132.8227,132.8258,1,3984681,3984773,92,
329,132.827967,132.834667,1,3984839,3985040,201,-0.1687651010736346
330,133.542167,133.566733,1,4006265,4007001,736,0.016490852055107783
331,133.576467,133.598,1,4007294,4007940,646,0.14281350521410638
332,133.608767,133.631333,1,4008263,4008939,676,0.12647672136807733
333,133.640867,133.646333,1,4009226,4009389,163,0.05532593989163957
334,133.6505,133.6803,1,4009515,4010408,893,0.17394934243277665
335,133.684267,133.7196,1,4010528,4011588,1060,0.20134496386027614
336,133.725133,133.747267,1,4011753,4012418,665,0.10487320315315633
337,133.7726,133.778333,1,4013178,4013349,171,0.03547931192059597
338,133.785967,133.842,1,4013579,4015260,1681,0.044201465716908674
339,133.875767,133.881133,1,4016273,4016433,160,-0.05059759057108781
340,133.883867,133.931433,1,4016516,4017942,1426,0.08230084116793986
341,133.9331,133.9536,1,4017993,4018608,615,-0.0535248156503264
342,133.958267,133.963267,1,4018748,4018898,150,0.26639981448699845
343,133.973767,133.981367,1,4019213,4019441,228,0.2665354320546463
344,133.9879,134.013967,1,4019637,4020419,782,-0.026502299491661
345,134.0153,134.018633,1,4020459,4020558,99,-0.411846684275872
346,134.032,134.036233,1,4020960,4021086,126,0.034404731039180944
347,134.048733,134.052833,1,4021461,4021584,123,0.08809540872074273
348,134.0583,134.068367,1,4021749,4022051,302,0.039490282072710624
349,135.1183,135.1224,1,4053549,4053672,123,
350,135.1237,135.126867,1,4053711,4053806,95,
351,135.535967,135.5477,1,4066079,4066430,351,0.4008306374143824
352,136.128133,136.131133,1,4083843,4083933,90,-0.37548832522960823
353,137.647133,137.650233,1,4129413,4129506,93,0.22844663993429493
354,137.6513,137.6563,1,4129538,4129688,150,0.1294308634346823
355,137.661367,137.6781,1,4129841,4130343,502,0.7726547496082564
356,137.679167,137.77,1,4130375,4133100,2725,0.8680178137886613
357,139.0871,139.093767,1,4172613,4172813,200,0.11514187165623033
358,139.094833,139.205833,1,4172844,4176174,3330,0.8680548716386377
359,139.7158,139.724833,1,4191474,4191744,270,0.7232590976119011
360,139.731167,139.740267,1,4191935,4192208,273,0.472479252425775
361,139.757133,139.8174,1,4192713,4194522,1809,0.677115852256298
362,139.8372,139.8705,1,4195116,4196115,999,0.5997968421440301
363,139.8975,139.905167,1,4196925,4197155,230,0.6002874951971459
364,139.914,139.930067,1,4197420,4197902,482,0.5701014157303196
365,139.9451,139.9611,1,4198353,4198833,480,0.46154066012902834
366,139.9807,139.9849,1,4199421,4199547,126,0.6861542376322297
367,140.0102,140.014967,1,4200306,4200449,143,0.6879186954437643
368,140.0183,140.027833,1,4200549,4200834,285,0.662435991897954
369,140.059533,140.063567,1,4201785,4201907,122,0.6246071034692955
370,140.252933,140.410433,1,4207587,4212312,4725,0.8393870958411794
371,140.4233,140.4669,1,4212699,4214007,1308,0.8104265766883711
372,140.470333,140.5511,1,4214109,4216533,2424,0.7912636781019867
373,141.088033,141.0936,1,4232640,4232808,168,0.6395912252816462
374,141.115767,141.1346,1,4233473,4234038,565,0.846230092015229
375,141.162,141.181633,1,4234860,4235448,588,0.8950356642013158
376,141.187533,141.215967,1,4235625,4236479,854,0.7293743726761188
377,141.2186,141.251833,1,4236558,4237554,996,0.6753321018397813
378,141.276233,141.354167,1,4238286,4240625,2339,0.7385976009925606
379,141.365667,141.4099,1,4240970,4242297,1327,0.8102423934002692
380,141.414433,141.426933,1,4242432,4242807,375,0.7007081712917721
381,141.429533,141.435333,1,4242885,4243059,174,0.5151380919665423
382,141.436333,141.476167,1,4243089,4244285,1196,0.6562949528716064
383,141.496733,141.500067,1,4244901,4245002,101,0.8194035401641737
384,141.5013,141.512367,1,4245039,4245371,332,0.809662493537443
385,141.513633,141.536167,1,4245408,4246085,677,0.741681450320812
386,141.542167,141.546867,1,4246265,4246406,141,0.5483714830885962
387,141.549467,141.5994,1,4246484,4247982,1498,0.72182396330594
388,141.618833,141.640267,1,4248564,4249208,644,0.7489917340021363
389,141.656167,141.669,1,4249685,4250070,385,0.7996524565764208
390,141.6759,141.695967,1,4250277,4250879,602,0.7294199772560248
391,142.0912,142.238333,1,4262736,4267149,4413,0.8432529521364615
392,142.239567,142.244033,1,4267187,4267320,133,0.6381606218362995
393,142.245933,142.249067,1,4267377,4267472,95,0.07812929570655175
394,142.2501,142.297433,1,4267503,4268922,1419,0.8269725868933997
395,142.323233,142.349833,1,4269696,4270494,798,0.8274319312581198
396,142.353167,142.4144,1,4270595,4272432,1837,0.7898245489900942
397,142.4184,142.430333,1,4272552,4272909,357,0.7197989832537237
398,142.437733,142.519367,1,4273131,4275581,2450,0.7932428213069551
399,142.876967,142.9352,1,4286309,4288056,1747,0.8138799842403743
400,142.946833,142.953667,1,4288404,4288610,206,0.12709548202282367
401,143.4243,143.5257,1,4302729,4305771,3042,0.823963942471199
402,143.531867,143.543,1,4305956,4306290,334,0.10748103879617109
403,143.595933,143.600133,1,4307877,4308003,126,0.18139464192887333
404,143.6078,143.720633,1,4308234,4311618,3384,0.799599106899628
405,143.7279,143.741033,1,4311837,4312230,393,0.559974262003133
406,143.781467,143.784967,1,4313444,4313549,105,
407,144.1579,144.276067,1,4324737,4328282,3545,0.8085362446992287
408,144.288133,144.294033,1,4328643,4328820,177,0.27204314596240853
409,144.361967,144.467067,1,4330859,4334012,3153,0.8080440871203602
410,144.489567,144.494133,1,4334687,4334823,136,0.3145107487727496
411,144.496533,144.505867,1,4334895,4335176,281,0.06492639384601617
412,144.552867,144.558267,1,4336586,4336748,162,-0.0047997820205991585
413,144.561167,144.663933,1,4336835,4339917,3082,0.8146832944778659
414,144.6795,144.686633,1,4340385,4340598,213,-0.01674290165541912
415,145.0889,145.103033,1,4352667,4353090,423,0.5986367239317115
416,145.1079,145.112567,1,4353237,4353377,140,0.11548712062851549
417,145.1188,145.214767,1,4353564,4356443,2879,0.7989583405545392
418,145.2439,145.251867,1,4357317,4357556,239,-0.02096464049839938
419,145.602933,145.606533,1,4368087,4368195,108,0.5610975056381874
420,145.613767,145.6335,1,4368413,4369005,592,0.6320014670230053
421,145.6358,145.6444,1,4369074,4369332,258,0.7590174773683144
422,145.648967,145.655133,1,4369469,4369653,184,0.668263672677451
423,145.658467,145.667567,1,4369754,4370027,273,0.6794234266022725
424,145.6771,145.701067,1,4370313,4371032,719,0.7473623210111305
425,145.729867,145.788367,1,4371896,4373651,1755,0.6210727817683874
426,145.810633,145.8196,1,4374318,4374588,270,0.7274064325539047
427,145.822333,145.8429,1,4374669,4375287,618,0.7405842631927886
428,145.858,145.903733,1,4375740,4377111,1371,0.715687745047353
429,145.925133,145.966733,1,4377753,4379001,1248,0.7727096807502233
430,145.979067,146.0172,1,4379372,4380516,1144,0.7775041492046212
431,146.028967,146.070933,1,4380869,4382127,1258,0.08993047093388748
432,146.0731,146.080133,1,4382193,4382403,210,-0.03132062189865612
433,146.1093,146.1261,1,4383279,4383783,504,0.5830998762825959
434,146.128433,146.133567,1,4383852,4384007,155,0.3112377424505652
435,146.1353,146.2133,1,4384059,4386399,2340,0.802655301104739
436,146.434633,146.602833,1,4393038,4398084,5046,0.82231385852693
437,146.6041,146.705933,1,4398123,4401177,3054,0.7488087004939914
438,146.756333,146.760167,1,4402689,4402805,116,0.279674891092923
439,146.972367,147.227533,1,4409171,4416825,7654,0.7546898940108017
440,147.258233,147.264767,1,4417746,4417943,197,0.10530414263006721
441,147.685033,147.7063,1,4430550,4431189,639,0.5685879553997747
442,147.715833,147.719233,1,4431474,4431576,102,
443,147.7205,147.750633,1,4431615,4432518,903,0.8028223180300922
444,147.753367,147.802567,1,4432601,4434077,1476,0.7486043054637823
445,147.812333,147.841833,1,4434369,4435254,885,0.830572229639542
446,147.8535,147.886967,1,4435605,4436609,1004,0.809930632410734
447,147.888467,147.9177,1,4436654,4437531,877,0.8167091206463519
448,147.920667,147.993633,1,4437620,4439808,2188,0.7676923280323094
449,147.999233,148.0051,1,4439976,4440153,177,0.7666625975011347
450,148.011633,148.038867,1,4440348,4441166,818,0.7018601288446453
451,148.079433,148.087667,1,4442382,4442630,248,-0.11964389502224955
452,148.102533,148.1147,1,4443075,4443441,366,0.2429540913660033
453,148.281567,148.326133,1,4448447,4449783,1336,0.64207374642658
454,148.328567,148.3511,1,4449857,4450533,676,0.6525365624835824
455,148.382367,148.4628,1,4451471,4453884,2413,0.6762237164862186
456,148.4797,148.5294,1,4454391,4455882,1491,0.7942929903148409
457,148.5456,148.550567,1,4456368,4456517,149,0.5049522776511701
458,148.559733,148.5796,1,4456791,4457388,597,0.5550506278536087
459,148.6171,148.661167,1,4458513,4459835,1322,0.08232180353554565
460,148.6786,148.6837,1,4460358,4460511,153,-0.2714212330321967
461,148.684867,148.688333,1,4460546,4460649,103,0.49198669855691546
462,148.792133,148.798467,1,4463763,4463954,191,0.6389418872632514
463,148.842933,148.859633,1,4465287,4465788,501,0.7987273480945891
464,148.8618,148.9613,1,4465854,4468839,2985,0.8287326825828223
465,148.977233,149.063533,1,4469316,4471905,2589,0.7518599015934667
466,149.080233,149.085767,1,4472406,4472573,167,-0.02110022471656795
467,149.1068,149.1109,1,4473204,4473327,123,0.33118832194309367
468,149.355233,149.408,1,4480656,4482240,1584,0.8294566749529094
469,149.413067,149.491333,1,4482392,4484739,2347,0.8400601983965059
470,149.5101,149.6042,1,4485303,4488126,2823,0.7947906847261947
471,149.606367,149.703933,1,4488191,4491117,2926,0.8347082381042091
472,149.724067,149.7281,1,4491722,4491843,121,-0.09823576845491183
473,149.730133,149.734133,1,4491903,4492023,120,-0.06880777715521182
474,149.952967,149.964533,1,4498589,4498935,346,0.683590684992657
475,149.967033,150.0863,1,4499010,4502589,3579,0.6884167989428769
476,150.091833,150.112667,1,4502754,4503380,626,0.5943918230951339
477,150.1142,150.173533,1,4503426,4505205,1779,0.6171240383880869
478,150.1758,150.221833,1,4505274,4506654,1380,0.5810980451607164
479,150.238867,150.277367,1,4507166,4508321,1155,0.5929410565642725
480,150.290533,150.303433,1,4508715,4509102,387,0.5786491191833506
481,150.313033,150.319933,1,4509390,4509597,207,-0.05451610872052106
482,150.322933,150.3273,1,4509687,4509819,132,0.14770172791329605
483,150.330567,150.380567,1,4509917,4511417,1500,0.6183032858395735
484,150.4002,150.509833,1,4512006,4515294,3288,0.8251591714571309
485,150.543867,150.554033,1,4516316,4516620,304,-0.08129576723874132
486,150.569533,150.573667,1,4517085,4517210,125,-0.04698472769587865
487,150.602633,150.6066,1,4518078,4518198,120,
488,150.779967,150.9371,1,4523399,4528113,4714,0.8114665769794838
489,150.957,151.104067,1,4528710,4533122,4412,0.753384772720433
490,151.122533,151.127733,1,4533675,4533831,156,-0.11456346620836709
491,151.1509,151.1583,1,4534527,4534749,222,-0.08703852314827
492,151.383267,151.541333,1,4541498,4546239,4741,0.7610508060591747
493,151.546333,151.568267,1,4546389,4547048,659,0.40341332319933687
494,151.579067,151.597967,1,4547372,4547939,567,0.08700817208165397
495,151.600733,151.6039,1,4548021,4548117,96,0.10540643735072124
496,151.605467,151.617133,1,4548164,4548513,349,0.14429385823727145
497,151.6705,151.6905,1,4550115,4550715,600,0.6378588274003264
498,151.704233,151.790233,1,4551126,4553706,2580,0.7667083395557972
499,151.791867,151.7981,1,4553756,4553943,187,0.4040970388779267
500,151.842833,151.8473,1,4555284,4555419,135,0.2686705958380708
501,152.0062,152.0105,1,4560186,4560315,129,
502,152.011567,152.1259,1,4560347,4563777,3430,0.8048099287278238
503,152.142533,152.287933,1,4564275,4568637,4362,0.7810753585019956
504,152.307733,152.316067,1,4569231,4569482,251,-0.10634582135862634
505,152.341333,152.3459,1,4570239,4570377,138,0.5518230689721155
506,152.670833,152.713733,1,4580124,4581411,1287,0.6181064784274174
507,152.728067,152.7512,1,4581842,4582536,694,0.6680318296661873
508,152.773067,152.781333,1,4583192,4583439,247,0.7891105885323297
509,152.795167,152.812233,1,4583855,4584366,511,0.7876988265653054
510,152.828367,152.84,1,4584851,4585200,349,0.4953758729905531
511,152.854833,152.877433,1,4585644,4586322,678,-0.027372475263464473
512,152.878467,152.883333,1,4586354,4586499,145,-0.07595016976631007
513,152.884667,152.889967,1,4586540,4586699,159,0.2692312936257406
514,152.8985,152.907667,1,4586955,4587230,275,0.036274832127834604
515,152.9405,152.993967,1,4588215,4589819,1604,0.7496203290937619
516,152.9954,153.0561,1,4589862,4591683,1821,0.75644711483625
517,153.3243,153.376967,1,4599729,4601309,1580,0.8100587303206103
518,153.388767,153.4357,1,4601663,4603071,1408,0.8817013686453802
519,153.453033,153.4618,1,4603590,4603854,264,-0.07783930625292476
520,153.466433,153.474133,1,4603992,4604223,231,-0.08327718053462867
521,153.696967,153.717133,1,4610909,4611513,604,0.7592598226338401
522,153.719533,153.746633,1,4611585,4612398,813,0.8246176695309053
523,153.7479,153.883867,1,4612437,4616516,4079,0.7884675897999508
524,153.886467,153.932467,1,4616594,4617974,1380,0.7257708567576495
525,153.956833,154.0167,1,4618704,4620501,1797,0.8542241671810722
526,154.022333,154.0381,1,4620669,4621143,474,0.7608150682207323
527,154.0404,154.0566,1,4621212,4621698,486,0.48047513046652385
528,154.063233,154.066267,1,4621896,4621988,92,-0.14823713379130765
529,154.075,154.088333,1,4622250,4622649,399,-0.014877045049718266
530,154.091167,154.115133,1,4622735,4623453,718,0.1450763516536576
531,154.1216,154.1258,1,4623648,4623774,126,
532,154.1528,154.178233,1,4624584,4625346,762,0.7207468705068888
533,154.192333,154.312433,1,4625769,4629372,3603,0.8055377050452841
534,154.314467,154.411667,1,4629434,4632350,2916,0.7666017942875015
535,154.426233,154.444833,1,4632786,4633344,558,-0.04901172171443049
536,154.445933,154.452467,1,4633377,4633574,197,0.11902851696385941
537,154.4585,154.466133,1,4633755,4633983,228,0.16322049389955795
538,154.5406,154.567967,1,4636218,4637039,821,0.20750888093491604
539,154.5691,154.613333,1,4637073,4638399,1326,0.06128279819983756
540,154.614833,154.6282,1,4638444,4638846,402,0.26261721254286624
541,154.629733,154.6353,1,4638891,4639059,168,-0.10311343999503082
542,154.647833,154.9568,1,4639434,4648704,9270,0.7457494499322895
543,154.958133,154.967233,1,4648743,4649016,273,0.330170527967492
544,154.975833,154.982533,1,4649274,4649475,201,0.059206566317435275
545,155.0037,155.0165,1,4650111,4650495,384,0.33951714127258315
546,155.2735,155.2799,1,4658205,4658397,192,0.7726515394009519
547,155.283167,155.290433,1,4658495,4658712,217,0.6119015199388265
548,155.296933,155.3164,1,4658907,4659492,585,0.5600335928364044
549,155.3378,155.364033,1,4660134,4660920,786,0.8329746269630708
550,155.370067,155.394067,1,4661102,4661822,720,0.7173577481459609
551,155.400133,155.414967,1,4662003,4662449,446,0.7458702120133617
552,155.428533,155.532267,1,4662855,4665968,3113,0.7399603047777636
553,155.536867,155.545833,1,4666106,4666374,268,0.2594835655465122
554,155.5583,155.5677,1,4666749,4667031,282,0.5509434458051056
555,155.572533,155.602433,1,4667175,4668072,897,0.6805344399229837
556,155.608367,155.6132,1,4668251,4668396,145,0.6459139487999893
557,155.6202,155.6702,1,4668606,4670106,1500,0.014428382876117196
558,155.683867,155.688667,1,4670516,4670660,144,0.20160513904630709
559,155.692267,155.857,1,4670768,4675710,4942,0.778793644685459
560,155.859167,155.903867,1,4675775,4677116,1341,0.827389974762976
561,155.922567,155.956833,1,4677677,4678704,1027,0.814600862462644
562,155.976967,155.9953,1,4679309,4679859,550,-0.028435622568584975
563,155.999,156.004,1,4679970,4680120,150,0.27603973275439075
564,156.009233,156.026433,1,4680276,4680792,516,0.24892891575898382
565,156.037967,156.0429,1,4681139,4681287,148,-0.10107207854403273
566,156.0455,156.061633,1,4681365,4681848,483,0.5681377171857586
567,156.064333,156.1552,1,4681929,4684656,2727,0.8350918363853981
568,156.172833,156.175867,1,4685184,4685276,92,
569,156.177033,156.217267,1,4685310,4686518,1208,0.07818965307844478
570,156.2197,156.223533,1,4686591,4686705,114,0.10645134513387157
571,156.2336,156.2976,1,4687008,4688928,1920,0.75949859593319
572,156.298867,156.384833,1,4688966,4691544,2578,0.7704332049469197
573,156.3931,156.405667,1,4691793,4692170,377,0.29420360977572263
574,156.4948,156.5094,1,4694844,4695282,438,0.7592847662328719
575,156.511133,156.634733,1,4695333,4699041,3708,0.8351218138467066
576,156.643933,156.6678,1,4699317,4700034,717,-0.02532899969019893
577,156.6767,156.686667,1,4700301,4700600,299,0.3548842553650328
578,156.6923,156.698,1,4700769,4700940,171,0.04512345029479528
579,156.7233,156.882667,1,4701699,4706480,4781,0.8413777963061908
580,156.888767,156.895133,1,4706663,4706853,190,-0.15914550935647473
581,156.907067,156.922833,1,4707212,4707684,472,-0.028338089537651778
582,156.923967,156.927933,1,4707719,4707837,118,
583,156.9313,156.938867,1,4707939,4708166,227,0.031375755625902245
584,156.947333,156.9529,1,4708419,4708587,168,0.6071410372665674
585,157.3382,157.342133,1,4720146,4720263,117,0.6469869866827921
586,157.3484,157.355467,1,4720452,4720664,212,0.5357995768628966
587,157.366033,157.424333,1,4720980,4722729,1749,0.6577834024281133
588,157.435633,157.44,1,4723068,4723200,132,0.15379581234994125
589,157.453067,157.471,1,4723592,4724130,538,0.6108407004248703
590,157.4834,157.533333,1,4724502,4725999,1497,0.4202653010606565
591,157.5423,157.546067,1,4726269,4726382,113,-0.2048482059139582
592,157.5526,157.5806,1,4726578,4727418,840,0.6075551547048682
593,157.643067,157.6486,1,4729292,4729458,166,0.11779339791245207
594,157.750833,157.872933,1,4732524,4736187,3663,0.8445263494720274
595,157.893133,157.9052,1,4736793,4737156,363,0.023804259055474657
596,158.2991,158.3257,1,4748973,4749771,798,0.8005159781922296
597,158.329133,158.358767,1,4749873,4750763,890,0.7984151507955538
598,158.372767,158.387,1,4751183,4751610,427,0.8175458296972524
599,158.4042,158.446967,1,4752126,4753409,1283,0.778177273952913
600,158.466467,158.529533,1,4753994,4755885,1891,0.8031195087348638
601,158.542567,158.550133,1,4756277,4756503,226,0.6854063264146861
602,158.551367,158.5864,1,4756541,4757592,1051,0.7421548346293803
603,159.223833,159.227867,1,4776714,4776836,122,
604,159.2292,159.2327,1,4776876,4776981,105,
605,160.894533,160.897533,1,4826835,4826925,90,
606,161.394467,161.3976,1,4841834,4841928,94,-0.25887905776526915
607,162.9821,162.985533,1,4889463,4889565,102,
608,163.207267,163.211733,1,4896218,4896351,133,0.32218208233576595
609,163.225133,163.228267,1,4896753,4896848,95,
610,170.828,170.862633,1,5124840,5125878,1038,0.6191364112525932
611,170.9081,170.9269,1,5127243,5127807,564,0.775416590411629
612,170.956467,171.0048,1,5128694,5130144,1450,0.5827709986669424
613,171.028733,171.048667,1,5130861,5131460,599,0.7068765965853773
614,171.066767,171.080233,1,5132003,5132406,403,0.7117895692511861
615,171.084667,171.1014,1,5132540,5133042,502,0.6395091637695051
616,173.6077,173.6272,1,5208231,5208816,585,-0.19184067937518104
617,174.741233,174.7455,1,5242236,5242365,129,0.6390298671327986
618,174.746533,174.7582,1,5242395,5242746,351,0.053355478857712905
619,174.875633,174.880633,1,5246268,5246418,150,
620,176.702133,176.709233,1,5301063,5301276,213,-0.065209579070762
621,176.789233,176.8139,1,5303676,5304417,741,-0.05672971528994041
622,176.816933,176.853233,1,5304507,5305596,1089,-0.03199933551375076
623,176.855233,176.888633,1,5305656,5306658,1002,0.06786875777444328
624,176.8939,176.936067,1,5306817,5308082,1265,0.0017143769936157822
625,176.941267,176.952467,1,5308238,5308574,336,0.07463663068633651
626,176.9597,177.0053,1,5308791,5310159,1368,0.3786536346212729
627,177.008233,177.165433,1,5310246,5314962,4716,0.20354300551375576
628,177.1675,177.197533,1,5315025,5315925,900,-0.004881518977006452
629,177.262367,177.268,1,5317871,5318040,169,-0.14028654032545862
630,177.3063,177.335033,1,5319189,5320050,861,0.021042412325657456
631,177.337833,177.341833,1,5320134,5320254,120,0.5677170414402781
632,177.349767,177.3994,1,5320493,5321982,1489,0.01185742811575863
633,177.744467,177.754633,1,5332334,5332638,304,0.19309666687059784
634,177.7588,177.767533,1,5332764,5333025,261,0.4781303146116348
635,177.7875,177.7998,1,5333625,5333994,369,0.0790792658987677
636,177.8107,177.825933,1,5334321,5334777,456,0.08118863800500167
637,177.832467,177.8391,1,5334974,5335173,199,-0.05810561020108037
638,178.126333,178.1676,1,5343789,5345028,1239,0.05217756113691826
639,178.1736,178.1831,1,5345208,5345493,285,0.30687358708935114
640,178.2081,178.2137,1,5346243,5346411,168,-0.23606815615251867
641,178.216667,178.224567,1,5346500,5346737,237,0.44497163852167015
642,178.2257,178.234933,1,5346771,5347047,276,-0.08318165828302695
643,178.240967,178.2479,1,5347229,5347437,208,-0.054725530068284005
644,178.2687,178.3879,1,5348061,5351637,3576,-0.0006428445526343027
645,178.399433,178.403367,1,5351982,5352101,119,
646,178.405333,178.4124,1,5352159,5352372,213,-0.02297038441694396
647,178.415,178.4657,1,5352450,5353971,1521,0.07578252526395304
648,178.492567,178.532567,1,5354777,5355977,1200,0.05600657433209518
649,178.535267,178.549367,1,5356058,5356481,423,0.03945327815658355
650,178.551767,178.5665,1,5356553,5356995,442,-0.11307913255323286
651,178.570333,178.5811,1,5357109,5357433,324,0.06811054059158497
652,178.603667,178.693467,1,5358110,5360804,2694,0.4388672090492946
653,178.694533,178.7911,1,5360835,5363733,2898,0.024002130835859455
654,178.794233,178.813033,1,5363826,5364390,564,0.027871913866163382
655,178.814867,178.851033,1,5364446,5365530,1084,0.09769862356749058
656,178.855133,178.864667,1,5365653,5365940,287,-0.1016609785684716
657,178.867067,178.8841,1,5366012,5366523,511,0.02923761042966379
658,178.885633,178.897567,1,5366568,5366927,359,-0.024675215472913188
659,178.8991,178.904767,1,5366973,5367143,170,
660,178.973133,178.979867,1,5369193,5369396,203,0.502805950486556
661,178.981767,178.985267,1,5369453,5369558,105,
662,179.059733,179.069267,1,5371791,5372078,287,-0.03126710531772085
663,179.110133,179.116533,1,5373303,5373495,192,0.24236786391394055
664,179.1189,179.165067,1,5373567,5374952,1385,0.014841327100333009
665,179.173733,179.221667,1,5375211,5376650,1439,0.03341182187775837
666,179.225133,179.228167,1,5376753,5376845,92,
667,179.2375,179.289833,1,5377125,5378694,1569,0.1765436452198057
668,179.293233,179.3004,1,5378796,5379012,216,0.047388322308948023
669,179.321,179.334667,1,5379630,5380040,410,0.33016749684254276
670,179.336,179.3416,1,5380080,5380248,168,0.07805933062808469
671,179.3448,179.355433,1,5380344,5380662,318,0.08079532788510861
672,179.367333,179.384267,1,5381019,5381528,509,0.16925219415993809
673,179.390467,179.404533,1,5381714,5382135,421,0.3796358827614116
674,179.5098,179.531467,1,5385294,5385944,650,0.11643886549141404
675,179.5507,179.565467,1,5386521,5386964,443,0.22337822097781748
676,179.5767,179.585433,1,5387301,5387562,261,0.2998625690673206
677,179.6756,179.682267,1,5390268,5390468,200,
678,179.7074,179.712867,1,5391222,5391386,164,0.2024201342819966
679,179.742267,179.764333,1,5392268,5392929,661,-0.0568403680062416
680,179.779533,179.787333,1,5393385,5393619,234,0.22156575449158153
681,179.788733,179.802367,1,5393661,5394071,410,0.22356544113370838
682,179.806033,179.8146,1,5394180,5394438,258,0.15272989963240607
683,179.8472,179.859933,1,5395416,5395797,381,0.19636483989733874
684,179.8687,179.874833,1,5396061,5396244,183,0.45975021126880405
685,179.8759,179.880467,1,5396277,5396414,137,0.5098138251783552
686,180.002933,180.009267,1,5400087,5400278,191,0.6851502969409461
687,180.063433,180.0668,1,5401902,5402004,102,-0.06928437433381807
688,180.068067,180.097067,1,5402042,5402912,870,-0.07182042281828581
689,180.101633,180.121533,1,5403048,5403645,597,0.1588481522229472
690,180.1254,180.1612,1,5403762,5404836,1074,0.14948201881180043
691,180.1671,180.180933,1,5405013,5405427,414,0.05774548235087749
692,180.183333,180.193533,1,5405499,5405805,306,0.0544922026606994
693,180.200933,180.208233,1,5406027,5406246,219,0.16764307794322897
694,180.209367,180.217,1,5406281,5406510,229,0.822568739958915
695,180.277767,180.314467,1,5408333,5409434,1101,-0.030037286620145837
696,180.3207,180.384933,1,5409621,5411547,1926,-0.05148838695234371
697,180.3915,180.431,1,5411745,5412930,1185,0.054376376212507564
698,180.4324,180.441033,1,5412972,5413230,258,-0.023565771396950937
699,180.444233,180.4552,1,5413326,5413656,330,0.18544097261736459
700,180.4572,180.464467,1,5413716,5413934,218,0.1553550023567648
701,180.481,180.552433,1,5414430,5416572,2142,0.44464809149406975
702,180.555033,180.638667,1,5416650,5419160,2510,0.3033112538319793
703,180.642133,180.715567,1,5419263,5421467,2204,0.30632551910052386
704,180.716667,180.7207,1,5421500,5421621,121,-0.03416024323576871
705,180.729333,180.752,1,5421879,5422560,681,0.023008504550884514
706,180.754567,180.767367,1,5422637,5423021,384,0.054556137002109074
707,180.811467,180.821767,1,5424344,5424653,309,0.010359578287390835
708,180.826467,180.831467,1,5424794,5424944,150,-0.3287347528683093
709,180.841033,180.886933,1,5425230,5426607,1377,0.020174899989856738
710,180.894067,180.953133,1,5426822,5428593,1771,0.013520806754091636
711,181.560133,181.566267,1,5446803,5446988,185,-0.18352923147701644
712,181.570767,181.579767,1,5447123,5447393,270,-0.11614931996563914
713,182.132533,182.1423,1,5463975,5464269,294,-0.1097507564760925
714,182.173533,182.181233,1,5465205,5465436,231,-0.19409489554314774
715,182.219567,182.223133,1,5466587,5466693,106,
716,182.2246,182.306767,1,5466738,5469203,2465,-0.04413725934479263
717,182.310633,182.315533,1,5469318,5469465,147,0.021328584842690807
718,182.324,182.346533,1,5469720,5470395,675,-0.010781983819486933
719,182.4858,182.494233,1,5474574,5474826,252,-0.08167452430258078
720,182.537733,182.578667,1,5476131,5477360,1229,0.0044864911213709675
721,182.5799,182.617733,1,5477397,5478531,1134,-0.02526839458858057
722,182.619667,182.628467,1,5478590,5478854,264,-0.06686495436602691
723,182.634667,182.638233,1,5479040,5479146,106,
724,182.644267,182.674167,1,5479328,5480225,897,-0.01896161320968756
725,182.676967,182.681367,1,5480309,5480441,132,
726,182.687867,182.6957,1,5480636,5480871,235,0.08544038615430039
727,182.702333,182.7632,1,5481069,5482896,1827,0.01844516328713994
728,182.7642,182.8316,1,5482926,5484948,2022,0.11705173597650204
729,182.833,182.8394,1,5484990,5485182,192,
730,182.857,182.865433,1,5485710,5485962,252,0.20173529881961288
731,182.8674,182.8982,1,5486022,5486946,924,0.26606685517004347
732,182.8999,182.9057,1,5486997,5487171,174,0.38232546208443335
733,182.9068,182.933233,1,5487204,5487996,792,0.3984245172509224
734,182.9392,182.943733,1,5488176,5488311,135,0.05646214680919939
735,182.949367,183.023167,1,5488481,5490695,2214,0.1613868908863362
736,183.024167,183.050933,1,5490725,5491527,802,0.08980931826055277
737,183.056167,183.0807,1,5491685,5492421,736,0.03291716016809052
738,183.099733,183.102867,1,5492991,5493086,95,
739,183.106433,183.120567,1,5493192,5493617,425,-0.0687669752321778
740,183.127833,183.152733,1,5493834,5494581,747,0.012252148933797913
741,183.235467,183.241,1,5497064,5497230,166,0.2264762748085181
742,183.245433,183.248867,1,5497362,5497466,104,0.7619655445765872
743,183.256167,183.265667,1,5497685,5497970,285,0.28650080600407046
744,183.268767,183.3089,1,5498063,5499267,1204,-0.022941573158579368
745,183.411133,183.4187,1,5502333,5502561,228,-0.0750410250337391
746,183.421633,183.427333,1,5502648,5502819,171,-0.0680149285530606
747,183.434733,183.438733,1,5503041,5503161,120,0.8075358466820306
748,183.698,183.723667,1,5510940,5511710,770,0.08872347626275581
749,183.724767,183.727833,1,5511743,5511834,91,
750,183.7337,183.751933,1,5512011,5512557,546,0.1924515581452282
751,183.831933,183.844533,1,5514957,5515335,378,0.3014134532918004
752,183.890433,183.9285,1,5516712,5517855,1143,-0.12060073022067459
753,183.943233,183.947567,1,5518296,5518427,131,-0.12036477681261164
754,183.9605,183.9678,1,5518815,5519034,219,-0.08361806054222697
755,183.9777,184.0356,1,5519331,5521068,1737,0.10420173048340575
756,184.0376,184.116033,1,5521128,5523480,2352,0.5338669627583067
757,184.117133,184.1229,1,5523513,5523687,174,-0.14744656139432247
758,184.1239,184.1469,1,5523717,5524407,690,-0.024313712864964847
759,184.1481,184.204367,1,5524443,5526131,1688,0.06601293011773494
760,184.205833,184.240467,1,5526174,5527214,1040,0.0032114949164643368
761,184.25,184.259567,1,5527500,5527787,287,0.0062296740635212145
762,184.261367,184.2791,1,5527841,5528373,532,0.07759481534795044
763,184.295333,184.332967,1,5528859,5529989,1130,0.044249710808980186
764,184.531267,184.534467,1,5535938,5536034,96,
765,184.642633,184.6431,1,5539278,5539293,15,
766,184.703267,184.725833,1,5541098,5541774,676,-0.03318012877158126
767,184.731233,184.7471,1,5541936,5542413,477,0.1229501022178198
768,184.8061,184.811033,1,5544183,5544330,147,0.22635740994435607
769,184.825533,184.8428,1,5544765,5545284,519,0.16169386144764686
770,184.853967,184.863167,1,5545619,5545895,276,0.2663672240559635
771,185.027167,185.0316,1,5550815,5550948,133,0.3538595470679709
772,185.071,185.080267,1,5552130,5552408,278,-0.012675881702618873
773,185.081267,185.085667,1,5552438,5552570,132,-0.12007694727728019
774,185.0877,185.099933,1,5552631,5552997,366,0.09684103603705879
775,185.105567,185.125467,1,5553167,5553764,597,-0.07539945272794103
776,185.126633,185.136433,1,5553798,5554092,294,-0.03835350913679752
777,185.145,185.156433,1,5554350,5554692,342,0.002224575779279074
778,185.1591,185.171767,1,5554773,5555153,380,-0.08997036677230925
779,185.215533,185.226133,1,5556465,5556783,318,0.10982144940761406
780,185.232,185.250633,1,5556960,5557518,558,0.31236143591369636
781,185.3792,185.4351,1,5561376,5563053,1677,-0.02948135381661378
782,185.436333,185.441967,1,5563089,5563259,170,-0.11663278410711558
783,185.707833,185.771033,1,5571234,5573130,1896,-0.03589916605952602
784,185.784333,185.810167,1,5573529,5574305,776,0.020289189791707893
785,185.816433,185.832067,1,5574492,5574962,470,-0.036044327497535944
786,185.833433,185.8426,1,5575002,5575278,276,-0.15769855386310222
787,185.854067,185.869633,1,5575622,5576088,466,0.05106355956595596
788,185.872233,185.885667,1,5576166,5576570,404,0.16239932289544234
789,185.886767,185.9007,1,5576603,5577021,418,-0.05945622376376484
790,185.902167,185.929867,1,5577065,5577896,831,0.02312891166993266
791,185.951067,185.960933,1,5578532,5578827,295,0.14883039158988798
792,186.006467,186.045867,1,5580194,5581376,1182,0.10386702980742311
793,186.055467,186.071833,1,5581664,5582154,490,0.015186466631952352
794,186.1873,186.191767,1,5585619,5585753,134,0.754509017496531
795,186.285067,186.301233,1,5588552,5589036,484,-0.054381529549581815
796,186.304467,186.3166,1,5589134,5589498,364,0.06661170065649737
797,186.329567,186.373067,1,5589887,5591192,1305,0.1675068734317393
798,186.378867,186.3843,1,5591366,5591529,163,-0.08093781617340297
799,186.3891,186.407233,1,5591673,5592216,543,0.11225839449290702
800,186.414167,186.448033,1,5592425,5593440,1015,0.15288979402327746
801,186.4493,186.466833,1,5593479,5594004,525,0.02940381176165845
802,186.4708,186.500267,1,5594124,5595008,884,0.024412597230587717
803,186.5036,186.512333,1,5595108,5595369,261,0.004520481285330435
804,186.517033,186.543967,1,5595510,5596319,809,0.014523730014670439
805,186.548067,186.5558,1,5596442,5596674,232,0.1018330281943919
806,186.561967,186.6468,1,5596859,5599404,2545,0.24293263945365615
807,186.653167,186.692867,1,5599595,5600786,1191,0.045168888543297446
808,186.696033,186.748533,1,5600880,5602455,1575,0.06435271644756235
809,186.753167,186.7569,1,5602595,5602707,112,-0.21033628722448736
810,186.771233,186.786267,1,5603136,5603588,452,-0.09541082359498769
811,186.834367,186.8396,1,5605031,5605188,157,-0.07548695686613843
812,186.845467,186.896033,1,5605364,5606880,1516,0.20408332847574193
813,186.903067,186.908167,1,5607092,5607245,153,-0.14858823931536688
814,187.1821,187.1897,1,5615463,5615691,228,0.08144977702658279
815,187.315667,187.320167,1,5619470,5619605,135,-0.5085548082236432
816,187.326867,187.348033,1,5619806,5620440,634,-0.014349841032268489
817,187.3666,187.3829,1,5620998,5621487,489,0.19800942456567014
818,187.3897,187.398867,1,5621691,5621966,275,0.30926745013313206
819,187.6715,187.6753,1,5630145,5630259,114,
820,187.7033,187.721533,1,5631099,5631645,546,-0.08266462577406476
821,187.723067,187.729467,1,5631692,5631884,192,-0.08653832301937489
822,187.7344,187.738133,1,5632032,5632143,111,
823,187.7403,187.763467,1,5632209,5632904,695,0.10047554709407867
824,187.7686,187.787167,1,5633058,5633615,557,0.03344977162044964
825,187.793933,187.801167,1,5633817,5634035,218,0.09272898724178182
826,187.808733,187.833867,1,5634261,5635016,755,0.019463478485115353
827,187.845,187.886133,1,5635350,5636583,1233,0.291076039130539
828,187.8879,187.8987,1,5636637,5636961,324,0.09463380988248324
829,187.901967,187.926767,1,5637059,5637803,744,0.1508972747047343
830,187.9289,187.953933,1,5637867,5638617,750,0.06513954065880136
831,187.954967,188.028033,1,5638649,5640840,2191,0.1317275083332912
832,188.0295,188.040833,1,5640885,5641224,339,0.009047531166790608
833,188.043533,188.0491,1,5641305,5641473,168,0.07648091758998346
834,188.057333,188.063433,1,5641719,5641902,183,0.072345300866539
835,188.0645,188.088767,1,5641935,5642663,728,2.4235289749839062e-05
836,188.0977,188.102733,1,5642931,5643081,150,0.3419748974577681
837,188.1074,188.118467,1,5643222,5643554,332,0.17309925589036493
838,188.125567,188.145167,1,5643767,5644355,588,0.2822257903135241
839,188.1479,188.153333,1,5644437,5644599,162,0.14114548862673904
840,188.179367,188.194267,1,5645381,5645828,447,-0.04738806591457534
841,188.1981,188.2133,1,5645943,5646399,456,-0.14967477511605415
842,188.222867,188.2269,1,5646686,5646807,121,-0.07885778663955902
843,188.229367,188.246167,1,5646881,5647385,504,-0.04035155126463716
844,188.253267,188.306267,1,5647598,5649188,1590,0.09563586051594491
845,188.3684,188.373867,1,5651052,5651216,164,0.28496256536195785
846,188.4012,188.4317,1,5652036,5652951,915,0.02629858185983298
847,188.5543,188.5654,1,5656629,5656962,333,0.13616706470899267
848,188.5692,188.583933,1,5657076,5657517,441,0.48712159515663606
849,188.5871,188.600233,1,5657613,5658006,393,-0.05294831713496791
850,188.605733,188.614267,1,5658171,5658428,257,-0.07667434517894983
851,188.615767,188.622633,1,5658473,5658678,205,-0.2688217089942392
852,188.688067,188.6939,1,5660642,5660817,175,0.29920927619116283
853,188.695,188.700967,1,5660850,5661029,179,0.5124303837517608
854,188.7021,188.712567,1,5661063,5661377,314,0.17574603741868583
855,188.724033,188.732033,1,5661720,5661960,240,0.07384521538313707
856,188.796967,188.800467,1,5663909,5664014,105,0.3442484344418718
857,188.802567,188.808367,1,5664077,5664251,174,0.41558634233167857
858,188.810233,188.816867,1,5664306,5664506,200,-0.13015176348257293
859,188.8204,188.837933,1,5664612,5665137,525,-0.021897313895699586
860,188.839133,188.869867,1,5665173,5666096,923,0.04878900924948703
861,188.870867,188.901133,1,5666126,5667033,907,0.016597457064827216
862,188.9111,188.919,1,5667333,5667570,237,0.623299115015528
863,188.9229,188.9264,1,5667687,5667792,105,
864,189.132433,189.1503,1,5673972,5674509,537,-0.06977917823597461
865,189.1545,189.160033,1,5674635,5674800,165,
866,189.190133,189.194033,1,5675703,5675820,117,
867,189.198767,189.224267,1,5675963,5676728,765,-0.1038295679440181
868,189.250533,189.2539,1,5677515,5677617,102,
869,189.293033,189.333267,1,5678790,5679998,1208,0.23263308730036175
870,189.399467,189.405267,1,5681984,5682158,174,0.49348525923588377
871,189.411067,189.4341,1,5682332,5683023,691,-0.0920890140528352
872,189.442833,189.458867,1,5683284,5683766,482,-0.036655323429440965
873,189.462267,189.492467,1,5683868,5684774,906,0.09277809436614173
874,189.494033,189.498133,1,5684820,5684943,123,0.15596360906740186
875,189.533067,189.541267,1,5685992,5686238,246,-0.13235722017165463
876,189.546433,189.5627,1,5686392,5686881,489,0.09951809952204484
877,189.5688,189.574967,1,5687064,5687249,185,
878,189.577667,189.593967,1,5687330,5687819,489,0.1715805591951187
879,189.5955,189.628367,1,5687865,5688851,986,0.30725143533042637
880,189.632533,189.639533,1,5688975,5689185,210,-0.01624705483890116
881,189.6406,189.689167,1,5689218,5690675,1457,0.22006359741213302
882,189.691067,189.716433,1,5690732,5691492,760,0.06563254473395728
883,189.719633,189.769433,1,5691588,5693082,1494,0.04646905945383216
884,189.770767,189.784967,1,5693123,5693549,426,0.36359850527627174
885,189.791267,189.816167,1,5693738,5694485,747,-0.05675190618330689
886,189.827167,189.8408,1,5694815,5695224,409,0.18560837765594754
887,189.853933,189.8573,1,5695617,5695719,102,
888,189.861267,189.883667,1,5695838,5696510,672,0.10742184233038228
889,189.8943,189.897933,1,5696829,5696937,108,-0.07355940243568887
890,189.979533,189.984767,1,5699385,5699543,158,
891,189.9903,189.998,1,5699709,5699940,231,
892,190.008433,190.027833,1,5700252,5700834,582,-0.043246033308584515
893,190.033433,190.0392,1,5701002,5701176,174,-0.10197224979366976
894,190.110767,190.118967,1,5703323,5703569,246,0.26053570342329513
895,190.120067,190.126567,1,5703602,5703797,195,0.38072486544056994
896,190.1392,190.152367,1,5704176,5704571,395,0.1445976138848778
897,190.227133,190.236167,1,5706813,5707085,272,0.23822477391727936
898,190.4127,190.416233,1,5712381,5712486,105,0.3774189827105076
899,190.453067,190.485,1,5713592,5714550,958,0.0525301130615258
900,190.490733,190.4944,1,5714721,5714832,111,
901,190.497333,190.516367,1,5714919,5715491,572,-0.06429851731487027
902,190.522233,190.554733,1,5715666,5716641,975,-0.003355314131276927
903,190.555833,190.565333,1,5716674,5716959,285,-0.001366774542343043
904,190.570967,190.579767,1,5717129,5717393,264,0.13098631667887192
905,190.581967,190.589667,1,5717459,5717690,231,0.12393692040024959
906,190.6523,190.659,1,5719569,5719770,201,0.4645272768293544
907,190.708933,190.733867,1,5721267,5722016,749,0.05564425673451055
908,190.754933,190.7988,1,5722647,5723964,1317,0.012654677442198002
909,190.821667,190.841533,1,5724650,5725245,595,0.04364403122021853
910,190.844333,190.865367,1,5725329,5725961,632,-0.013739560786742776
911,190.874533,190.8853,1,5726235,5726559,324,-0.12202040249069832
912,190.894567,190.915533,1,5726837,5727465,628,0.19943618640944558
913,190.9218,190.9627,1,5727654,5728881,1227,-0.04428984018474984
914,190.964033,190.9679,1,5728920,5729037,117,-0.02079692159322607
915,190.976133,191.003733,1,5729283,5730111,828,0.009667472139726895
916,191.005033,191.008033,1,5730150,5730240,90,
917,191.009833,191.0329,1,5730294,5730987,693,0.11305125946792283
918,191.0408,191.0493,1,5731224,5731479,255,0.0494417898723538
919,191.055433,191.063167,1,5731662,5731895,233,-0.08698935666964198
920,191.064533,191.0724,1,5731935,5732172,237,-0.03736033276031919
921,191.0774,191.090033,1,5732322,5732700,378,0.042165497314331085
922,191.094667,191.1565,1,5732840,5734695,1855,0.28945359911273705
923,191.1612,191.1945,1,5734836,5735835,999,0.15239817993441837
924,191.199,191.203633,1,5735970,5736108,138,0.3084730145892439
925,191.213833,191.275567,1,5736414,5738267,1853,0.2652329750117596
926,191.2773,191.306,1,5738319,5739180,861,0.06231939430500808
927,191.307333,191.3946,1,5739219,5741838,2619,0.045972362216584725
928,191.4024,191.429933,1,5742072,5742897,825,0.0612622261970557
929,191.434967,191.4426,1,5743049,5743278,229,-0.11958482881344733
930,191.519867,191.525067,1,5745596,5745752,156,0.015238999426592797
931,191.5515,191.597267,1,5746545,5747918,1373,0.033148806830013776
932,191.598533,191.605067,1,5747955,5748152,197,0.06683329320840015
933,191.6937,191.7006,1,5750811,5751018,207,0.04348921289395585
934,191.727367,191.734633,1,5751821,5752038,217,
935,191.7379,191.746267,1,5752137,5752388,251,0.11637285293685945
936,191.990767,191.993933,1,5759723,5759817,94,
937,192.015667,192.049433,1,5760470,5761482,1012,0.12741716457278465
938,192.053033,192.087267,1,5761590,5762618,1028,0.267697919155829
939,192.088367,192.091567,1,5762651,5762747,96,
940,192.129233,192.1862,1,5763876,5765586,1710,0.04636535551677538
941,192.200033,192.203967,1,5766000,5766119,119,-0.03502551121380161
942,192.361767,192.365967,1,5770853,5770979,126,
943,192.416133,192.4214,1,5772483,5772642,159,-0.07722331921503073
944,192.426167,192.451367,1,5772785,5773541,756,0.014210246872975951
945,192.462433,192.497433,1,5773872,5774922,1050,0.19077387617972957
946,192.5001,192.543667,1,5775003,5776310,1307,0.08679738793248504
947,192.5471,192.583233,1,5776413,5777496,1083,0.18329421949116811
948,192.585367,192.592867,1,5777561,5777786,225,0.06709339830842716
949,192.595633,192.645233,1,5777868,5779356,1488,0.3378315359072715
950,192.6478,192.651767,1,5779434,5779553,119,-0.09565605107325563
951,192.652967,192.669733,1,5779589,5780091,502,0.11548962115488477
952,192.671267,192.7617,1,5780138,5782851,2713,0.05660817809454639
953,192.762933,192.8433,1,5782887,5785299,2412,0.06654188765375468
954,192.874233,192.896533,1,5786226,5786895,669,-0.08312156689343184
955,192.899767,192.906433,1,5786993,5787192,199,-0.07511455696268926
956,192.915533,192.9189,1,5787465,5787567,102,-0.21354761933753444
957,192.944567,192.971733,1,5788337,5789151,814,0.016244024490598113
958,192.974133,192.9797,1,5789223,5789391,168,0.2703111652939722
959,192.980733,192.987867,1,5789421,5789636,215,-0.09591139148878905
960,193.048767,193.052133,1,5791463,5791563,100,0.15535144330892053
961,193.059367,193.062433,1,5791781,5791872,91,
962,193.069333,193.074333,1,5792079,5792229,150,0.0654586228357651
963,193.084,193.111467,1,5792520,5793344,824,0.03567244143558923
964,193.113267,193.119733,1,5793398,5793591,193,0.1173488900674024
965,193.164333,193.172333,1,5794929,5795169,240,0.3245485180730622
966,193.175667,193.184,1,5795270,5795520,250,0.01824644783815116
967,193.1892,193.203233,1,5795676,5796096,420,0.34377511137321687
968,193.2083,193.212367,1,5796249,5796371,122,
969,193.213667,193.220333,1,5796410,5796609,199,-0.1219496680971696
970,193.305467,193.316467,1,5799164,5799494,330,0.3362255661220942
971,193.456167,193.465467,1,5803685,5803964,279,-0.1054784273520357
972,193.5051,193.537567,1,5805153,5806127,974,-0.028775490529644173
973,193.5442,193.587633,1,5806326,5807628,1302,0.10054042307500914
974,193.588933,193.597933,1,5807667,5807937,270,0.15703365539544775
975,193.602233,193.607633,1,5808066,5808228,162,0.18549909741331097
976,193.609667,193.614967,1,5808290,5808449,159,0.42956365505304556
977,193.617833,193.653633,1,5808534,5809608,1074,0.01701483647913594
978,193.661667,193.6794,1,5809850,5810382,532,0.20746676711620296
979,193.6852,193.6929,1,5810556,5810787,231,0.2536354090256628
980,193.694533,193.6985,1,5810835,5810955,120,-0.143973857751055
981,193.699867,193.721367,1,5810996,5811641,645,0.2798536322306854
982,193.7289,193.7424,1,5811867,5812272,405,0.11824390846401714
983,193.744,193.793833,1,5812320,5813814,1494,0.1884150493994599
984,193.802033,193.832067,1,5814060,5814962,902,-0.015484745608683513
985,193.866033,193.875433,1,5815980,5816262,282,0.2125716864649091
986,193.8894,193.900133,1,5816682,5817003,321,0.27483929348706476
987,193.903967,193.940433,1,5817119,5818212,1093,0.4860513418631865
988,193.9415,194.0263,1,5818245,5820789,2544,0.11556005165808654
989,194.027533,194.0415,1,5820825,5821245,420,0.17202466512390502
990,194.0425,194.057633,1,5821275,5821728,453,0.014014819184313479
991,194.058633,194.089567,1,5821758,5822687,929,0.004966758413078162
992,194.091833,194.096467,1,5822754,5822894,140,
993,194.104533,194.1232,1,5823135,5823696,561,-0.11700887811939922
994,194.124433,194.129367,1,5823732,5823881,149,
995,194.1873,194.1915,1,5825619,5825745,126,-0.03865327028080507
996,194.2018,194.209667,1,5826054,5826290,236,0.21105207138383092
997,194.294967,194.298167,1,5828849,5828945,96,0.7394717483233034
998,194.3152,194.346833,1,5829456,5830404,948,0.051313573309092614
999,194.3515,194.364267,1,5830545,5830928,383,-0.06685512331255031
1000,194.370567,194.3791,1,5831117,5831373,256,-0.0882121695307389
1001,194.390733,194.397533,1,5831721,5831925,204,-0.2009213967488579
1002,194.398667,194.416667,1,5831960,5832500,540,-0.07199944709758907
1003,194.428667,194.451133,1,5832860,5833533,673,0.1944118447452583
1004,194.452533,194.460667,1,5833575,5833820,245,0.2677289941514451
1005,194.5338,194.537633,1,5836014,5836128,114,
1006,194.5563,194.567067,1,5836689,5837012,323,0.4410334811565342
1007,194.5701,194.5776,1,5837103,5837328,225,0.3775250186534968
1008,194.943633,194.950067,1,5848308,5848502,194,0.4127822600767532
1009,194.996533,195.000433,1,5849895,5850012,117,
1010,195.057533,195.069067,1,5851725,5852072,347,-0.05367026699617449
1011,195.075367,195.086067,1,5852261,5852582,321,-0.061886869354384505
1012,195.0877,195.1101,1,5852631,5853303,672,-0.08070497223800352
1013,195.125033,195.1307,1,5853750,5853921,171,0.019521030359479892
1014,195.1411,195.174067,1,5854233,5855222,989,0.027846902958395488
1015,195.182,195.185533,1,5855460,5855565,105,
1016,195.204867,195.208933,1,5856146,5856267,121,0.6035014537451363
1017,195.2291,195.3095,1,5856873,5859285,2412,0.08627661849887831
1018,195.342,195.359967,1,5860260,5860799,539,0.14286234735009612
1019,195.380733,195.406933,1,5861421,5862207,786,0.12325485197973127
1020,195.408033,195.4117,1,5862240,5862351,111,
1021,195.416833,195.42,1,5862504,5862600,96,
1022,195.434433,195.437433,1,5863032,5863122,90,
1023,195.4386,195.445533,1,5863158,5863365,207,
1024,195.4505,195.456267,1,5863515,5863688,173,-0.0864270327548174
1025,195.466133,195.486167,1,5863983,5864585,602,0.05121327909969196
1026,195.498467,195.502033,1,5864954,5865060,106,0.22669337392064387
1027,195.503167,195.5142,1,5865095,5865426,331,0.3298607040116641
1028,195.517133,195.5221,1,5865513,5865663,150,0.2430970428305893
1029,195.523767,195.539833,1,5865713,5866194,481,-0.14954826949484679
1030,195.5441,195.5581,1,5866323,5866743,420,0.1156979710897356
1031,195.560667,195.5795,1,5866820,5867385,565,0.09076389542879372
1032,195.5821,195.588267,1,5867463,5867648,185,-0.05669816218155925
1033,195.590133,195.6008,1,5867703,5868024,321,-0.04065485565497039
1034,195.605833,195.647833,1,5868174,5869434,1260,0.42588282575346126
1035,195.655433,195.742033,1,5869662,5872260,2598,0.2060401503797581
1036,195.744433,195.763967,1,5872332,5872919,587,0.023254813390358717
1037,195.772,195.776067,1,5873160,5873282,122,-0.17651975706413867
1038,195.7819,195.790833,1,5873457,5873724,267,-0.007452110630326365
1039,195.791833,195.819133,1,5873754,5874573,819,0.03598893024923841
1040,195.823033,195.829667,1,5874690,5874890,200,-0.10089675197571535
1041,195.844233,195.874367,1,5875326,5876231,905,-0.1394878945531146
1042,195.9291,195.975367,1,5877873,5879261,1388,0.07543226739426606
1043,195.979133,195.985433,1,5879373,5879562,189,0.30376206746372814
1044,196.0675,196.070867,1,5882025,5882126,101,
1045,196.099567,196.130833,1,5882987,5883924,937,0.03691435011219073
1046,196.207267,196.212133,1,5886218,5886363,145,
1047,196.236667,196.280933,1,5887100,5888427,1327,0.0361064189833621
1048,196.3489,196.353533,1,5890467,5890605,138,-0.19043924076601365
1049,196.384767,196.402867,1,5891543,5892086,543,0.006396116813015605
1050,196.405467,196.4128,1,5892164,5892384,220,0.0018013369401610848
1051,196.4916,196.501333,1,5894748,5895039,291,0.3570366007417198
1052,196.524667,196.527967,1,5895740,5895839,99,0.7781129803829878
1053,196.5357,196.5469,1,5896071,5896407,336,0.12710352473915065
1054,196.651567,196.6674,1,5899547,5900022,475,0.1529175993971412
1055,196.668867,196.6721,1,5900066,5900163,97,
1056,196.685767,196.699467,1,5900573,5900984,411,0.3983268566111476
1057,196.767267,196.7766,1,5903018,5903298,280,-0.13932294470275217
1058,196.778033,196.823067,1,5903340,5904692,1352,-0.06376687126206342
1059,196.824167,196.831533,1,5904725,5904945,220,0.054380201937980106
1060,196.837433,196.848667,1,5905122,5905460,338,0.43242029664664294
1061,196.878667,196.887767,1,5906360,5906633,273,-0.07398492484103388
1062,197.0105,197.020967,1,5910315,5910629,314,0.01613171464395816
1063,197.405333,197.414633,1,5922159,5922438,279,0.03396916202396172
1064,197.420467,197.433133,1,5922614,5922993,379,-0.08924619464125752
1065,197.437733,197.441433,1,5923131,5923242,111,
1066,197.443767,197.446767,1,5923313,5923403,90,
1067,197.464167,197.468333,1,5923925,5924049,124,-0.09085551954670607
1068,197.478933,197.4927,1,5924367,5924781,414,0.30305956249853366
1069,197.5072,197.5133,1,5925216,5925399,183,-0.05834308579745624
1070,197.518633,197.524233,1,5925558,5925726,168,
1071,197.608633,197.613867,1,5928258,5928416,158,0.13812300463966187
1072,197.6551,197.6769,1,5929653,5930307,654,0.059830573617534286
1073,197.691733,197.696733,1,5930751,5930901,150,-0.076482726956678
1074,197.700333,197.7071,1,5931009,5931213,204,
1075,197.7086,197.713133,1,5931258,5931393,135,-0.14790944422248006
1076,197.728967,197.7359,1,5931869,5932077,208,0.3824768057910881
1077,197.7444,197.7482,1,5932332,5932446,114,-0.25312738107252314
1078,197.807833,197.817967,1,5934234,5934539,305,-0.08311844631065468
1079,197.823267,197.829667,1,5934698,5934890,192,
1080,197.838567,197.8538,1,5935157,5935614,457,-0.04333227270278553
1081,197.855133,197.880667,1,5935653,5936420,767,-0.09622849024429737
1082,197.9096,197.913833,1,5937288,5937414,126,0.40417953533701084
1083,197.916533,197.931033,1,5937495,5937930,435,-0.037656185095948626
1084,197.946467,197.998967,1,5938394,5939969,1575,0.09485529117114967
1085,198.002433,198.058033,1,5940072,5941740,1668,0.09603161991397857
1086,198.064667,198.093667,1,5941940,5942810,870,0.08037728233409218
1087,198.099467,198.1044,1,5942984,5943132,148,0.4404530942856076
1088,198.110333,198.114267,1,5943309,5943428,119,-0.4309468962172615
1089,198.1216,198.1304,1,5943648,5943912,264,0.17390068106333323
1090,198.140033,198.161933,1,5944200,5944857,657,0.25341606589011245
1091,198.1666,198.171233,1,5944998,5945136,138,0.5976074123459127
1092,198.1813,198.204,1,5945439,5946120,681,0.19479621772179384
1093,198.216,198.2284,1,5946480,5946852,372,0.15631718955126134
1094,198.235533,198.238533,1,5947065,5947155,90,
1095,198.247767,198.267933,1,5947433,5948037,604,0.20968808268311784
1096,198.268933,198.391867,1,5948067,5951756,3689,0.03309828079951016
1097,198.3952,198.449033,1,5951856,5953470,1614,0.06180298720701987
1098,198.4553,198.459033,1,5953659,5953770,111,
1099,198.532767,198.536033,1,5955983,5956080,97,
1100,198.570133,198.587767,1,5957103,5957633,530,-0.04826837802914412
1101,198.590933,198.597533,1,5957727,5957925,198,
1102,198.603333,198.612333,1,5958099,5958369,270,0.014905012316389667
1103,198.6359,198.6389,1,5959077,5959167,90,
1104,198.642333,198.649067,1,5959269,5959472,203,0.1660850903787299
1105,198.652933,198.6627,1,5959587,5959881,294,0.2624559273765366
1106,198.667567,198.681233,1,5960027,5960436,409,0.19564455014378848
1107,198.686033,198.7061,1,5960580,5961183,603,0.02294522083641715
1108,198.7881,198.795733,1,5963643,5963871,228,0.5054740150974256
1109,198.805867,198.9067,1,5964176,5967201,3025,0.07525994611917723
1110,198.9197,198.931533,1,5967591,5967945,354,0.03762929843614777
1111,198.945033,198.955233,1,5968350,5968656,306,0.0018745668767015256
1112,199.070867,199.077033,1,5972126,5972310,184,-0.05948363183605591
1113,199.122667,199.141167,1,5973680,5974235,555,0.0029458567333585954
1114,199.142867,199.163833,1,5974286,5974914,628,-0.04826299512751891
1115,199.2016,199.2329,1,5976048,5976987,939,0.09013650700512235
1116,199.262767,199.307233,1,5977883,5979216,1333,-0.05407692660112393
1117,199.308467,199.330867,1,5979254,5979926,672,0.07319214889985372
1118,199.332267,199.371,1,5979968,5981130,1162,-0.012817459810512737
1119,199.375767,199.383967,1,5981273,5981519,246,0.04323498964452955
1120,199.386267,199.423367,1,5981588,5982701,1113,0.06107706896682171
1121,199.424633,199.4376,1,5982738,5983128,390,-0.0010825266964654885
1122,199.439667,199.450233,1,5983190,5983506,316,0.14201038381551292
1123,199.4658,199.468833,1,5983974,5984064,90,
1124,199.4917,199.500433,1,5984751,5985012,261,-0.07685293542018647
1125,199.5386,199.594733,1,5986158,5987841,1683,-0.014456970788435953
1126,199.6007,199.609367,1,5988021,5988281,260,0.2015229721420522
1127,199.622867,199.6679,1,5988686,5990037,1351,0.05096692732790214
1128,199.669267,199.688667,1,5990078,5990660,582,0.10114508726569695
1129,199.690767,199.728533,1,5990723,5991855,1132,0.08680505044889714
1130,199.736867,199.746767,1,5992106,5992403,297,0.039297901364119224
1131,199.7522,199.765167,1,5992566,5992955,389,0.454887719275465
1132,199.770333,199.776933,1,5993109,5993307,198,0.28667345193235916
1133,199.780967,199.791433,1,5993429,5993742,313,0.2839361352515683
1134,199.800067,199.914233,1,5994002,5997426,3424,0.3795293034337022
1135,199.9252,199.9335,1,5997756,5998005,249,-0.04533209295526553
1136,199.938233,199.9569,1,5998146,5998707,561,0.06928044085575423
1137,199.957967,199.977,1,5998739,5999310,571,-0.05252896655033319
1138,199.981567,200.023567,1,5999447,6000707,1260,0.12064843578871444
1139,200.024633,200.036833,1,6000738,6001104,366,-0.04023130360961133
1140,200.069833,200.0752,1,6002094,6002256,162,0.14346288756583678
1141,200.100767,200.1057,1,6003023,6003171,148,-0.17334462716199758
1142,200.108,200.114667,1,6003240,6003440,200,0.6787393226088922
1143,200.121333,200.1252,1,6003639,6003756,117,-0.1038615627230571
1144,200.129567,200.133167,1,6003887,6003995,108,-0.28958544026826694
1145,200.269933,200.2787,1,6008097,6008361,264,-0.13432799973924994
1146,200.3013,200.348333,1,6009039,6010449,1410,-0.05583000183658486
1147,200.351067,200.3937,1,6010532,6011811,1279,0.04808010705827205
1148,200.4129,200.4425,1,6012387,6013275,888,0.2181554709087757
1149,200.5388,200.5607,1,6016164,6016821,657,0.2597956789005925
1150,200.570367,200.595167,1,6017111,6017855,744,0.21651198664566695
1151,200.639233,200.642767,1,6019176,6019283,107,-0.2256005348606928
1152,200.678533,200.692833,1,6020355,6020784,429,0.04792889099541218
1153,200.6944,200.7137,1,6020832,6021411,579,0.13920887291362435
1154,200.724267,200.734767,1,6021728,6022043,315,0.1899239444668215
1155,200.737867,200.756133,1,6022136,6022683,547,0.2488725053755145
1156,200.7603,200.773233,1,6022809,6023196,387,0.29686294596653623
1157,200.7772,200.817567,1,6023316,6024527,1211,0.017663450698546142
1158,200.8316,200.866767,1,6024948,6026003,1055,0.3255549235132338
1159,200.868733,200.8996,1,6026061,6026988,927,0.01443000065880236
1160,200.9227,201.039167,1,6027681,6031175,3494,0.08289318878233949
1161,201.045833,201.070567,1,6031374,6032117,743,-0.03183289286258295
1162,201.072067,201.0802,1,6032162,6032406,244,0.10333784191537283
1163,201.0852,201.1255,1,6032556,6033765,1209,0.003411949214466201
1164,201.150633,201.1562,1,6034518,6034686,168,0.6049016438066663
1165,201.157233,201.166833,1,6034716,6035004,288,-0.11825552141217614
1166,201.168,201.196,1,6035040,6035880,840,0.01927435204056159
1167,201.2077,201.2111,1,6036231,6036333,102,
1168,201.224933,201.269233,1,6036747,6038076,1329,0.04787610453761463
1169,201.360367,201.368433,1,6040811,6041052,241,0.4327624765153422
1170,201.396167,201.427867,1,6041885,6042836,951,0.036803746875433654
1171,201.5016,201.512333,1,6045048,6045369,321,0.2224795820717559
1172,201.5388,201.578533,1,6046164,6047355,1191,0.0665691315550865
1173,201.626167,201.6352,1,6048785,6049056,271,-0.09740162966217374
1174,201.6454,201.657367,1,6049362,6049721,359,0.32015317148612343
1175,201.658767,201.6629,1,6049763,6049887,124,0.12420986452538214
1176,201.665367,201.673733,1,6049961,6050211,250,0.025100148617318987
1177,201.6831,201.6882,1,6050493,6050646,153,-0.07081408850797151
1178,201.734233,201.738267,1,6052026,6052148,122,
1179,201.7483,201.752333,1,6052449,6052569,120,0.0495004945999879
1180,201.782167,201.7885,1,6053465,6053655,190,0.3564736074272876
1181,201.798067,201.807867,1,6053942,6054236,294,-0.008207320911892772
1182,201.809467,201.825967,1,6054284,6054779,495,-0.04090780680608637
1183,201.827567,201.850267,1,6054827,6055508,681,0.06728882747476563
1184,201.851367,201.9288,1,6055541,6057864,2323,0.4103295985377435
1185,201.930967,201.9342,1,6057929,6058026,97,0.00213294309995723
1186,201.951967,201.9803,1,6058559,6059409,850,0.4584210995721922
1187,201.9864,202.0921,1,6059592,6062763,3171,0.47896461919040717
1188,202.094633,202.150133,1,6062838,6064503,1665,0.4803711423434731
1189,202.1526,202.156,1,6064578,6064680,102,-0.140935785025071
1190,202.1647,202.2785,1,6064941,6068355,3414,0.5480379785685229
1191,202.281,202.3338,1,6068430,6070014,1584,0.15693531524747176
1192,202.3363,202.378533,1,6070089,6071355,1266,0.08005829488632565
1193,202.379833,202.3913,1,6071394,6071739,345,-0.10744084721514263
1194,202.394833,202.411267,1,6071844,6072338,494,0.08021194259860116
1195,202.4144,202.4322,1,6072432,6072966,534,0.059865868272745544
1196,202.434,202.4431,1,6073020,6073293,273,0.09714607894011612
1197,202.449867,202.456767,1,6073496,6073703,207,0.06715592394702095
1198,202.4642,202.4681,1,6073926,6074043,117,0.37383440503504917
1199,202.4752,202.4852,1,6074256,6074556,300,-0.014646036069362729
1200,202.487067,202.503933,1,6074612,6075117,505,-0.0031134741832438712
1201,202.527067,202.532667,1,6075812,6075980,168,0.3472703751183773
1202,202.5669,202.571667,1,6077007,6077150,143,-0.04850780880074876
1203,202.581933,202.5997,1,6077457,6077991,534,-0.06109444894394582
1204,202.602833,202.6073,1,6078084,6078219,135,0.09232792451101014
1205,202.618967,202.625667,1,6078569,6078770,201,-0.06933652669662826
1206,202.637867,202.644833,1,6079136,6079344,208,-0.04294875014554141
1207,202.646633,202.671467,1,6079398,6080144,746,0.2007380164473262
1208,202.6747,202.6943,1,6080241,6080829,588,0.24797213800232024
1209,202.703533,202.711033,1,6081105,6081330,225,0.37974986328634697
1210,202.725067,202.7292,1,6081752,6081876,124,0.2030413663864808
1211,202.748767,202.7629,1,6082463,6082887,424,0.3856118162799094
1212,202.763933,202.769433,1,6082917,6083082,165,-0.12087371593829441
1213,202.783233,202.803333,1,6083496,6084099,603,0.19435093903283224
1214,202.888433,202.893033,1,6086652,6086790,138,
1215,202.932667,202.9419,1,6087980,6088257,277,-0.05860124556219147
1216,202.942967,202.946767,1,6088289,6088403,114,0.6294277879795835
1217,202.950867,202.954967,1,6088526,6088649,123,-0.09539178408498461
1218,202.964133,202.987367,1,6088923,6089621,698,0.10283136096472888
1219,202.989467,203.0174,1,6089684,6090522,838,0.10166376289726008
1220,203.030233,203.049233,1,6090906,6091476,570,-0.042459064772844585
1221,203.0524,203.063733,1,6091572,6091911,339,0.6167612970898618
1222,203.068733,203.116167,1,6092061,6093485,1424,0.17935609969801153
1223,203.1173,203.190667,1,6093519,6095720,2201,0.42277496318232344
1224,203.1939,203.220033,1,6095817,6096600,783,0.08049601395105792
1225,203.221833,203.3315,1,6096654,6099945,3291,0.21024645561020702
1226,203.336467,203.361967,1,6100094,6100859,765,0.02326142692310398
1227,203.366067,203.391733,1,6100982,6101751,769,0.08406189193177026
1228,203.395833,203.405767,1,6101874,6102173,299,-0.0917683016857469
1229,203.4075,203.416567,1,6102225,6102497,272,0.04849408608635331
1230,203.418167,203.433967,1,6102545,6103019,474,0.26570047199251134
1231,203.441733,203.445133,1,6103251,6103353,102,-0.2552728716293759
1232,203.446167,203.4533,1,6103385,6103599,214,-0.001936049936085041
1233,203.4664,203.4724,1,6103992,6104172,180,-0.05578012128985794
1234,203.473633,203.501633,1,6104208,6105048,840,-0.03763655312447017
1235,203.525933,203.529933,1,6105777,6105897,120,
1236,203.5361,203.5399,1,6106083,6106197,114,
1237,203.6037,203.626,1,6108111,6108780,669,-0.002085124706478653
1238,203.6424,203.693267,1,6109272,6110798,1526,0.10458067490224213
1239,203.760067,203.765067,1,6112802,6112952,150,0.3139746516563628
1240,203.791267,203.828433,1,6113738,6114852,1114,-0.02495697551534974
1241,203.895433,203.899467,1,6116862,6116984,122,0.3273646975647533
1242,203.935933,203.9736,1,6118077,6119208,1131,0.12610522850358627
1243,204.0343,204.039133,1,6121029,6121173,144,-0.1543424974702651
1244,204.083667,204.0877,1,6122510,6122631,121,
1245,204.0936,204.099667,1,6122808,6122990,182,-0.07112964279883216
1246,204.1586,204.1618,1,6124758,6124854,96,-0.35452557240687765
1247,204.1644,204.169333,1,6124932,6125079,147,0.0980698814986149
1248,204.177367,204.185767,1,6125321,6125573,252,0.35726786044484565
1249,204.194233,204.197533,1,6125826,6125925,99,0.6640311036328636
1250,204.198767,204.205,1,6125963,6126150,187,0.7268954246657815
1251,204.2608,204.265033,1,6127824,6127950,126,0.024021373543886188
1252,204.3235,204.328833,1,6129705,6129864,159,-0.03747125065268781
1253,204.339967,204.344267,1,6130199,6130328,129,
1254,204.389033,204.3927,1,6131670,6131781,111,-0.18842608764826074
1255,204.401933,204.411667,1,6132057,6132350,293,0.1252314385178162
1256,204.6468,204.650233,1,6139404,6139506,102,
1257,204.706867,204.711533,1,6141206,6141345,139,-0.07433457645866864
1258,204.713067,204.728567,1,6141392,6141857,465,-0.07537335426713598
1259,204.7412,204.744467,1,6142236,6142334,98,
1260,204.7515,204.779033,1,6142545,6143370,825,0.07759470184514329
1261,204.9069,204.9187,1,6147207,6147561,354,0.15152070307224375
1262,205.004967,205.012,1,6150149,6150360,211,0.21351639840631537
1263,205.021767,205.033633,1,6150653,6151008,355,-0.06006094246667315
1264,205.0398,205.051667,1,6151194,6151550,356,0.05673813634037355
1265,205.059933,205.0706,1,6151797,6152118,321,0.3252389209337652
1266,205.077567,205.089433,1,6152327,6152682,355,0.11406571178024377
1267,205.090433,205.095667,1,6152712,6152870,158,-0.15659737356462236
1268,205.1038,205.113067,1,6153114,6153392,278,-0.08535683105591878
1269,205.1174,205.1204,1,6153522,6153612,90,
1270,205.146067,205.195167,1,6154382,6155855,1473,0.5331482613669435
1271,205.199167,205.232467,1,6155975,6156974,999,0.17943649509659282
1272,205.233667,205.383767,1,6157010,6161513,4503,0.062458499358041555
1273,205.384933,205.4074,1,6161547,6162222,675,-0.03746046342540248
1274,205.409467,205.419667,1,6162284,6162590,306,-0.10567593749080123
1275,205.486433,205.490567,1,6164592,6164717,125,0.12202456013656807
1276,205.514,205.550767,1,6165420,6166523,1103,0.03824030794449897
1277,205.618933,205.623333,1,6168567,6168699,132,-0.24272507678918742
1278,205.656533,205.694633,1,6169695,6170838,1143,0.11892507100755292
1279,205.758633,205.764167,1,6172758,6172925,167,0.0810674743321783
1280,205.776567,205.788,1,6173297,6173640,343,0.12855908025596935
1281,205.790133,205.8407,1,6173703,6175221,1518,0.0787827384905621
1282,205.910933,205.916567,1,6177327,6177497,170,-0.15025490574410377
1283,205.9426,205.977467,1,6178278,6179324,1046,0.11344377134466081
1284,206.0464,206.057933,1,6181392,6181737,345,0.04509180814301216
1285,206.070933,206.079133,1,6182127,6182373,246,0.015502870737335129
1286,206.086467,206.1237,1,6182594,6183711,1117,0.018068107340021365
1287,206.126733,206.130233,1,6183801,6183906,105,-0.007814811782974645
1288,206.1315,206.144867,1,6183945,6184346,401,0.2508981242532133
1289,206.1596,206.164067,1,6184788,6184922,134,-0.10795440873355
1290,206.232767,206.2391,1,6186983,6187173,190,0.5622107719090201
1291,206.365,206.372867,1,6190950,6191186,236,0.13952852413692157
1292,206.374233,206.394267,1,6191226,6191828,602,0.09758608322796472
1293,206.3961,206.421233,1,6191883,6192636,753,0.35095092861391897
1294,206.430867,206.464133,1,6192926,6193923,997,0.06760048648229953
1295,206.471067,206.476367,1,6194132,6194291,159,0.1387255740714889
1296,206.575733,206.588167,1,6197271,6197645,374,0.22921611374643075
1297,206.594167,206.5988,1,6197825,6197964,139,0.04959496604356427
1298,206.621367,206.6248,1,6198641,6198744,103,0.15658515129889702
1299,206.693,206.713967,1,6200790,6201419,629,0.1790878397629754
1300,206.715167,206.719833,1,6201455,6201594,139,-0.18544600115270937
1301,206.733433,206.7385,1,6202002,6202155,153,-0.05103628350795833
1302,206.7429,206.779567,1,6202287,6203387,1100,0.04392789522676515
1303,206.790933,206.801833,1,6203727,6204054,327,0.3013294453602853
1304,206.8048,206.828533,1,6204144,6204855,711,0.06200508034513121
1305,206.8392,206.852967,1,6205176,6205589,413,0.36381504475412
1306,206.854367,206.871667,1,6205631,6206150,519,0.2595145684280493
1307,206.9033,206.917733,1,6207099,6207531,432,0.2740379308921111
1308,206.934,206.958,1,6208020,6208740,720,-0.041675657407774284
1309,206.972767,206.9767,1,6209183,6209301,118,0.4939193834274347
1310,206.977767,206.981167,1,6209333,6209435,102,0.857316981911634
1311,206.984167,207.0236,1,6209525,6210708,1183,0.351277003639783
1312,207.025433,207.029267,1,6210762,6210878,116,-0.18862539574339127
1313,207.0338,207.0505,1,6211014,6211515,501,0.16864363017124115
1314,207.0518,207.070367,1,6211554,6212111,557,0.3633645477847202
1315,207.071767,207.078867,1,6212153,6212366,213,0.03626102506706613
1316,207.088567,207.1011,1,6212657,6213033,376,0.06901319354199423
1317,207.102867,207.111133,1,6213086,6213333,247,-0.04030391770782497
1318,207.115633,207.1491,1,6213468,6214473,1005,0.22418003694418598
1319,207.159167,207.229933,1,6214775,6216897,2122,0.27026070985297396
1320,207.2311,207.240233,1,6216933,6217206,273,0.21252866652374316
1321,207.2454,207.268033,1,6217362,6218040,678,-0.06895777699701401
1322,207.282767,207.286667,1,6218483,6218600,117,
1323,207.288767,207.329833,1,6218663,6219894,1231,0.07726689258174521
1324,207.414433,207.422867,1,6222432,6222686,254,0.2799718353936899
1325,207.448067,207.452133,1,6223442,6223563,121,-0.22950121554256572
1326,207.465467,207.475667,1,6223964,6224270,306,-0.06364568345984213
1327,207.4963,207.4999,1,6224889,6224997,108,
1328,207.5097,207.513733,1,6225291,6225411,120,
1329,207.527067,207.532,1,6225812,6225960,148,0.49292397054776493
1330,207.538933,207.542333,1,6226167,6226269,102,0.42866890562668064
1331,207.551167,207.5724,1,6226535,6227172,637,0.051360639169219645
1332,207.575033,207.596833,1,6227250,6227904,654,0.48068554651215933
1333,207.650067,207.654667,1,6229502,6229640,138,0.10234345554412179
1334,207.676033,207.681033,1,6230280,6230430,150,0.10373736871194889
1335,207.730033,207.743167,1,6231900,6232295,395,0.08303123502693666
1336,207.759767,207.768867,1,6232793,6233066,273,-0.11006384496796007
1337,207.7893,207.792433,1,6233679,6233772,93,
1338,207.7961,207.8124,1,6233883,6234372,489,0.11210446980092503
1339,207.822067,207.842267,1,6234662,6235268,606,-0.0379552370957217
1340,207.849133,207.886933,1,6235473,6236607,1134,0.1303099278934793
1341,207.9006,207.955667,1,6237018,6238670,1652,0.12518324273728418
1342,207.963567,207.983967,1,6238907,6239519,612,0.0815540098840205
1343,207.992867,207.999567,1,6239786,6239987,201,0.05051728089579278
1344,208.0073,208.0111,1,6240219,6240333,114,
1345,208.023667,208.046333,1,6240710,6241389,679,0.047609990886545876
1346,208.048333,208.062,1,6241449,6241860,411,0.12264923283013372
1347,208.077467,208.1353,1,6242324,6244059,1735,0.5133765867101472
1348,208.1379,208.1775,1,6244137,6245325,1188,0.08764727183417421
1349,208.178567,208.241333,1,6245357,6247239,1882,0.05301240026618814
1350,208.250267,208.376167,1,6247508,6251285,3777,0.15331633027025676
1351,208.377467,208.387833,1,6251324,6251634,310,-0.015340171292201174
1352,208.3899,208.396267,1,6251697,6251888,191,-0.09530014422551415
1353,208.446133,208.4515,1,6253383,6253545,162,0.6181558076356887
1354,208.452867,208.470867,1,6253586,6254126,540,0.005159312096309601
1355,208.4743,208.4797,1,6254229,6254391,162,-0.061449545699848424
1356,208.484467,208.535033,1,6254534,6256050,1516,0.09124173695170577
1357,208.539167,208.561467,1,6256175,6256844,669,-0.005486117862340085
1358,208.563467,208.583933,1,6256904,6257517,613,0.004543164454170287
1359,208.6067,208.663567,1,6258201,6259907,1706,0.11418067665598275
1360,209.220467,209.223467,1,6276614,6276704,90,
1361,209.2359,209.2442,1,6277077,6277326,249,0.18932524833703845
1362,209.252033,209.264133,1,6277560,6277923,363,0.05100876589763586
1363,209.2835,209.294733,1,6278505,6278841,336,0.20326198179599644
1364,209.874733,209.878567,1,6296241,6296357,116,
1365,210.0008,210.0038,1,6300024,6300114,90,-0.19345811301312105
1366,210.006367,210.037833,1,6300191,6301134,943,-0.09837952050842123
1367,210.047333,210.066067,1,6301419,6301982,563,0.16753473797699697
1368,210.067233,210.0914,1,6302016,6302742,726,0.0481346135661225
1369,210.093267,210.103033,1,6302798,6303090,292,0.04667810753700319
1370,210.105433,210.157067,1,6303162,6304712,1550,0.2698083519302472
1371,210.1684,210.192467,1,6305052,6305774,722,0.11290588455435888
1372,210.201567,210.207533,1,6306047,6306225,178,
1373,210.211,210.225433,1,6306330,6306762,432,0.019665949824042912
1374,210.2265,210.232867,1,6306795,6306986,191,0.3652225828346068
1375,210.244633,210.253033,1,6307338,6307590,252,-0.06272338538112233
1376,210.2738,210.277833,1,6308214,6308334,120,
1377,210.2977,210.3093,1,6308931,6309279,348,0.3010676264072322
1378,210.3167,210.322533,1,6309501,6309675,174,
1379,210.339333,210.343233,1,6310179,6310296,117,
1380,210.351,210.354733,1,6310530,6310641,111,
1381,210.3595,210.412167,1,6310785,6312365,1580,0.4554609322373544
1382,210.4174,210.4242,1,6312522,6312726,204,0.5200943685659529
1383,210.428633,210.473433,1,6312858,6314202,1344,0.16793631344774984
1384,210.476333,210.506433,1,6314289,6315192,903,0.020066590103889993
1385,210.5088,210.5119,1,6315264,6315357,93,
1386,210.5161,210.547233,1,6315483,6316416,933,0.17367501778157476
1387,210.5485,210.554033,1,6316455,6316620,165,0.17349758024907969
1388,210.556333,210.575533,1,6316689,6317265,576,0.11949532659429286
1389,210.576567,210.605333,1,6317297,6318159,862,0.021235790977240696
1390,210.607333,210.6153,1,6318219,6318459,240,0.10241986268419885
1391,210.621867,210.665167,1,6318656,6319955,1299,0.05552928063871888
1392,210.6744,210.6833,1,6320232,6320499,267,0.1427138439384345
1393,210.690367,210.701,1,6320711,6321030,319,-0.001758280483703856
1394,210.705167,210.708467,1,6321155,6321254,99,
1395,210.771733,210.775133,1,6323151,6323253,102,-0.08327038810933299
1396,210.8302,210.839867,1,6324906,6325196,290,0.05272920137751213
1397,210.9273,210.9314,1,6327819,6327942,123,-0.09037640891681795
1398,210.993267,211.0403,1,6329798,6331209,1411,0.09278588723259648
1399,211.137967,211.1577,1,6334139,6334731,592,0.23872170678724733
1400,211.1674,211.186833,1,6335022,6335604,582,0.14799990342190356
1401,211.193367,211.200767,1,6335801,6336023,222,-0.16729134125151324
1402,211.238067,211.2451,1,6337142,6337353,211,
1403,211.299767,211.306033,1,6338993,6339180,187,-0.040287901075668216
1404,211.310833,211.317867,1,6339324,6339536,212,0.1452888545872394
1405,211.328967,211.336767,1,6339869,6340103,234,-0.03741920709983275
1406,211.3431,211.3547,1,6340293,6340641,348,0.21793020563461746
1407,211.3564,211.373567,1,6340692,6341207,515,0.09109383231951718
1408,211.406033,211.411767,1,6342180,6342353,173,0.12521302428247857
1409,211.424967,211.4321,1,6342749,6342963,214,0.0732088692597198
1410,211.448033,211.4514,1,6343440,6343542,102,
1411,211.5248,211.5292,1,6345744,6345876,132,0.5896858693338892
1412,211.765533,211.779833,1,6352965,6353394,429,-0.01862292065085513
1413,211.787633,211.8138,1,6353628,6354414,786,-0.10423660568321287
1414,211.816567,211.834667,1,6354497,6355040,543,0.006739981854351281
1415,211.836267,211.893467,1,6355088,6356804,1716,0.24660368038313404
1416,211.898733,212.040333,1,6356961,6361209,4248,0.5303125910643124
1417,212.043833,212.1456,1,6361314,6364368,3054,0.21588675561622414
1418,212.147733,212.1671,1,6364431,6365013,582,0.00809290276858893
1419,212.1686,212.1836,1,6365058,6365508,450,-0.056432716446465
1420,212.191333,212.214933,1,6365739,6366447,708,0.030138374093173565
1421,212.2185,212.222667,1,6366555,6366680,125,-0.05756662343257344
1422,212.296033,212.3069,1,6368880,6369207,327,-0.13050016973155013
1423,212.3404,212.3438,1,6370212,6370314,102,
1424,212.463367,212.474267,1,6373901,6374228,327,0.05159111937755016
1425,212.475633,212.480967,1,6374268,6374429,161,0.37909236814197866
1426,212.499767,212.503667,1,6374993,6375110,117,-0.22861731065864702
1427,212.598367,212.6134,1,6377951,6378402,451,0.33554609717538597
1428,212.614533,212.632,1,6378435,6378960,525,0.47025601255662663
1429,212.708267,212.711833,1,6381248,6381354,106,-0.03565474854747792
1430,212.714067,212.733067,1,6381422,6381992,570,0.08383981919947625
1431,212.769067,212.789833,1,6383072,6383694,622,0.29639392348882554
1432,212.791567,212.797633,1,6383747,6383928,181,0.05238227091507959
1433,212.8034,212.819567,1,6384102,6384587,485,0.23418395188238667
1434,212.826067,212.8495,1,6384782,6385485,703,0.043709238802932995
1435,212.852467,212.900233,1,6385574,6387006,1432,0.01912151857182802
1436,212.906,212.917533,1,6387180,6387525,345,-0.07022834464980474
1437,212.919133,212.925167,1,6387573,6387755,182,0.24662419304172947
1438,212.940367,213.018567,1,6388211,6390557,2346,0.6542999551271192
1439,213.024467,213.111433,1,6390734,6393342,2608,0.16731809217369226
1440,213.114833,213.120067,1,6393444,6393602,158,-0.0493230554848948
1441,213.1211,213.131233,1,6393633,6393936,303,-0.07539730624470292
1442,213.162433,213.165733,1,6394872,6394971,99,0.093929229637998
1443,213.184633,213.192933,1,6395538,6395787,249,0.03743997096398915
1444,213.2136,213.244233,1,6396408,6397326,918,0.11742202580428948
1445,213.2628,213.2796,1,6397884,6398388,504,-0.029864924016362055
1446,213.280967,213.290733,1,6398429,6398721,292,-0.0626838478634034
1447,213.291867,213.320433,1,6398756,6399612,856,0.011395385186130765
1448,213.325833,213.345767,1,6399774,6400373,599,0.07601336982039061
1449,213.391333,213.398467,1,6401739,6401954,215,0.5333714191715927
1450,213.454833,213.457833,1,6403644,6403734,90,
1451,213.463,213.466167,1,6403890,6403985,95,-0.11248340610825981
1452,213.5014,213.505867,1,6405042,6405176,134,0.5236920726269959
1453,213.507,213.519533,1,6405210,6405585,375,0.36267625279373794
1454,213.573167,213.584033,1,6407195,6407520,325,0.2988782067287562
1455,213.6022,213.611133,1,6408066,6408333,267,0.3938309192091148
1456,213.704533,213.7389,1,6411135,6412167,1032,-0.06237156067833305
1457,213.741733,213.778667,1,6412251,6413360,1109,-0.009430592636376214
1458,213.78,213.825133,1,6413400,6414753,1353,0.049160669470043224
1459,213.8306,213.838467,1,6414918,6415154,236,0.1270545012511734
1460,213.8477,214.1415,1,6415431,6424245,8814,0.5146164031975531
1461,214.1521,214.155633,1,6424563,6424668,105,-0.33550573037316783
1462,214.2248,214.2306,1,6426744,6426918,174,-0.15552031569387903
1463,214.2546,214.3551,1,6427638,6430653,3015,0.08213982929124015
1464,214.359067,214.367533,1,6430772,6431025,253,0.13749354787924273
1465,214.4722,214.4894,1,6434166,6434682,516,0.4213171798379117
1466,214.685867,214.6958,1,6440576,6440874,298,0.22132141176216463
1467,214.767267,214.770833,1,6443018,6443124,106,
1468,214.772733,214.7802,1,6443181,6443406,225,-0.018653492243340876
1469,214.7832,214.8498,1,6443496,6445494,1998,0.12865673270818437
1470,214.853533,214.875233,1,6445605,6446256,651,0.1273290636871636
1471,214.9267,214.932033,1,6447801,6447960,159,0.6900240421108628
1472,214.970767,214.9772,1,6449123,6449316,193,-0.07869826900082051
1473,214.984767,214.988267,1,6449543,6449648,105,0.061008513416948996
1474,215.048967,215.065033,1,6451469,6451950,481,0.0854582311083735
1475,215.0908,215.098933,1,6452724,6452967,243,-0.05428384306706605
1476,215.1011,215.114967,1,6453033,6453449,416,0.11899191877369923
1477,215.143767,215.1571,1,6454313,6454713,400,-0.052806331518901246
1478,215.1757,215.186,1,6455271,6455580,309,0.3809652000556492
1479,215.187033,215.193367,1,6455610,6455801,191,0.2794021630356063
1480,215.194567,215.203133,1,6455837,6456093,256,-0.13393634605407162
1481,215.208467,215.261733,1,6456254,6457851,1597,0.00031278908304733437
1482,215.264333,215.5186,1,6457929,6465558,7629,0.5134750081236664
1483,215.522733,215.558,1,6465681,6466740,1059,0.13485672233319687
1484,215.569033,215.574633,1,6467070,6467238,168,
1485,215.6168,215.621333,1,6468504,6468639,135,-0.10904414182611794
1486,215.6403,215.679433,1,6469209,6470382,1173,0.002394258249320708
1487,215.6818,215.7372,1,6470454,6472116,1662,0.08093065202886748
1488,215.740233,215.744267,1,6472206,6472328,122,
1489,215.7709,215.775,1,6473127,6473250,123,-0.11921720232586744
1490,215.8183,215.825233,1,6474549,6474756,207,0.42273216878311437
1491,215.834033,215.8376,1,6475020,6475128,108,-0.12027857504656495
1492,215.867967,215.873967,1,6476039,6476219,180,0.3044850730779469
1493,216.351767,216.357267,1,6490553,6490718,165,0.18100702923928766
1494,216.364467,216.369133,1,6490934,6491073,139,0.07193072980878702
1495,216.3882,216.3946,1,6491646,6491838,192,-0.289691244420836
1496,216.3961,216.403933,1,6491883,6492117,234,0.44141402292945425
1497,216.4202,216.435267,1,6492606,6493058,452,0.3201426708412034
1498,217.007267,217.0112,1,6510218,6510336,118,0.20590203382677383
1499,217.1244,217.2359,1,6513732,6517077,3345,0.05336303038390704
1500,217.2511,217.260633,1,6517533,6517818,285,-0.015056954134842176
1501,217.265833,217.279467,1,6517974,6518384,410,-0.07454617621887226
1502,217.2856,217.289833,1,6518568,6518694,126,
1503,217.292633,217.304867,1,6518778,6519146,368,-0.06213525138058955
1504,217.3097,217.3142,1,6519291,6519426,135,
1505,217.3181,217.329833,1,6519543,6519894,351,-0.07756947900106492
1506,217.341267,217.344833,1,6520238,6520344,106,-0.06478899616329044
1507,217.605633,217.6401,1,6528168,6529203,1035,-0.022182573731829535
1508,217.641767,217.662567,1,6529253,6529877,624,0.021992275403537532
1509,217.668367,217.675833,1,6530051,6530274,223,0.014274679226423921
1510,217.680833,217.690967,1,6530424,6530729,305,0.06433276892937195
1511,217.6924,217.695467,1,6530772,6530864,92,0.488902466409096
1512,217.701167,217.825833,1,6531035,6534774,3739,0.3159473323093387
1513,217.826933,217.830267,1,6534807,6534908,101,0.3968807910461013
1514,217.8324,217.8537,1,6534972,6535611,639,0.0005601625582945547
1515,217.856733,217.975767,1,6535701,6539273,3572,0.11704277133878924
1516,217.9796,217.983667,1,6539388,6539510,122,0.3845706709933464
1517,218.074367,218.108933,1,6542231,6543267,1036,0.11256480743613023
1518,218.1185,218.125933,1,6543555,6543777,222,0.6427210671580715
1519,218.130467,218.163833,1,6543914,6544914,1000,0.07835194309553384
1520,218.305367,218.313933,1,6549161,6549417,256,0.059831259917630504
1521,218.3186,218.323567,1,6549558,6549707,149,
1522,218.696233,218.710633,1,6560886,6561318,432,0.5629075778003606
1523,218.755567,218.760533,1,6562667,6562815,148,-0.10115716146592242
1524,218.959933,218.969433,1,6568797,6569082,285,0.44380763211867497
1525,218.9804,218.987933,1,6569412,6569637,225,0.17245987685302658
1526,219.055533,219.070767,1,6571665,6572123,458,-0.09141351387609964
1527,219.076033,219.0867,1,6572280,6572601,321,0.0007509273231637745
1528,219.110367,219.114067,1,6573311,6573422,111,
1529,219.115633,219.150567,1,6573468,6574517,1049,-0.11604614125682262
1530,219.154233,219.157833,1,6574626,6574734,108,
1531,219.158867,219.1664,1,6574766,6574992,226,0.16907671810560573
1532,219.1704,219.191533,1,6575112,6575745,633,-0.05822546346140316
1533,219.194233,219.206967,1,6575826,6576209,383,0.08093466244968521
1534,219.2088,219.2232,1,6576264,6576696,432,0.4827431740563842
1535,219.226333,219.248567,1,6576789,6577457,668,0.05822465508877776
1536,219.2502,219.264233,1,6577506,6577926,420,0.09525630634635912
1537,219.2663,219.303067,1,6577989,6579092,1103,-0.0490871426873107
1538,219.304433,219.3176,1,6579132,6579528,396,0.20832822881419163
1539,219.318767,219.332367,1,6579563,6579971,408,-0.009021270425370573
1540,219.335833,219.341867,1,6580074,6580256,182,0.05698450121058048
1541,219.347167,219.3945,1,6580415,6581835,1420,0.6339460518211683
1542,219.402167,219.417367,1,6582065,6582521,456,0.02844861217716668
1543,219.4257,219.434133,1,6582771,6583023,252,0.06450895272962169
1544,219.440067,219.468333,1,6583202,6584049,847,0.09742261362812041
1545,219.553967,219.5591,1,6586619,6586773,154,0.6083821425723103
1546,219.5775,219.632867,1,6587325,6588986,1661,0.4458568350123338
1547,219.643167,219.656867,1,6589295,6589706,411,0.06498121546176239
1548,219.6598,219.663767,1,6589794,6589913,119,0.04516372006139099
1549,219.670933,219.6796,1,6590127,6590388,261,-0.12625993726386753
1550,219.6836,219.703967,1,6590508,6591119,611,-0.041251732948316355
1551,219.721667,219.738167,1,6591650,6592145,495,0.007046898081374167
1552,219.7462,219.751233,1,6592386,6592536,150,-0.009787280570767255
1553,219.7577,219.772667,1,6592731,6593180,449,0.016793616592982955
1554,220.0341,220.0445,1,6601023,6601335,312,0.34770005596668097
1555,220.055267,220.060533,1,6601658,6601815,157,
1556,220.064433,220.0765,1,6601932,6602295,363,0.26212929748925773
1557,220.0784,220.083333,1,6602352,6602499,147,
1558,220.123267,220.137733,1,6603698,6604131,433,0.3094836710909382
1559,220.177733,220.182333,1,6605331,6605469,138,
1560,220.2025,220.208933,1,6606075,6606267,192,
1561,220.2383,220.242633,1,6607149,6607278,129,
1562,220.2463,220.251667,1,6607389,6607550,161,
1563,220.3192,220.326333,1,6609576,6609789,213,0.3031581689167741
1564,220.362967,220.369967,1,6610889,6611099,210,0.009344378975251234
1565,220.3769,220.393633,1,6611307,6611808,501,-0.007619672722299797
1566,220.433633,220.4531,1,6613008,6613593,585,-0.06696640124114361
1567,220.455867,220.506433,1,6613676,6615192,1516,0.03601402808516531
1568,220.5092,220.521933,1,6615276,6615657,381,-0.0021051838214946597
1569,220.5241,220.527867,1,6615723,6615836,113,
1570,220.5291,220.562133,1,6615873,6616863,990,0.10511411922119378
1571,220.564033,220.578233,1,6616920,6617346,426,-0.014187663970022024
1572,220.589033,220.5992,1,6617670,6617976,306,0.09509261936630964
1573,220.6758,220.683067,1,6620274,6620492,218,0.10909802908154087
1574,220.738767,220.7422,1,6622163,6622266,103,
1575,220.764667,220.809267,1,6622940,6624278,1338,-0.04141390352348741
1576,220.815067,220.850633,1,6624452,6625518,1066,-0.006888213085656971
1577,220.8523,220.8644,1,6625569,6625932,363,0.25245272852375156
1578,220.865833,220.8727,1,6625974,6626181,207,-0.07377718004585695
1579,220.884733,220.937467,1,6626541,6628124,1583,0.12919251701107443
1580,220.955367,221.084967,1,6628661,6632549,3888,0.26991310636498655
1581,221.086,221.103367,1,6632580,6633101,521,-0.05944059469625222
1582,221.106167,221.110867,1,6633185,6633326,141,-0.08342015260759802
1583,221.1346,221.1454,1,6634038,6634362,324,-0.04794814885243108
1584,221.146433,221.180933,1,6634392,6635427,1035,0.005155440194608658
1585,221.1839,221.187533,1,6635517,6635625,108,-0.13302291365936117
1586,221.188533,221.232367,1,6635655,6636971,1316,0.00035265617974038633
1587,221.250967,221.3057,1,6637529,6639171,1642,0.1252946585129062
1588,221.3088,221.422,1,6639264,6642660,3396,0.09060999624138408
1589,221.4595,221.466033,1,6643785,6643980,195,0.30585451380946593
1590,221.468833,221.4742,1,6644064,6644226,162,0.47916680085861313
1591,221.504867,221.508767,1,6645146,6645263,117,-0.060970297061125577
1592,221.5248,221.553967,1,6645744,6646619,875,-0.08713719853195201
1593,221.5634,221.580067,1,6646902,6647402,500,0.27989401464663355
1594,221.5844,221.592633,1,6647532,6647778,246,-0.07156038323363138
1595,221.606333,221.6241,1,6648189,6648723,534,0.08788011288687278
1596,221.6294,221.638733,1,6648882,6649161,279,0.011074494734720249
1597,221.641333,221.645567,1,6649239,6649367,128,0.07532694742049281
1598,221.6541,221.666267,1,6649623,6649988,365,0.26515351687302596
1599,221.9534,221.956433,1,6658602,6658692,90,0.2787959114411251
1600,221.971733,221.984,1,6659151,6659520,369,
1601,221.985367,221.999433,1,6659561,6659982,421,0.3667777343433819
1602,222.004033,222.032033,1,6660120,6660960,840,-0.08245149067230681
1603,222.038867,222.0461,1,6661166,6661383,217,-0.07633278851092759
1604,222.091867,222.107533,1,6662756,6663225,469,-0.05702891003434095
1605,222.125033,222.134267,1,6663750,6664028,278,-0.020887138041100574
1606,222.195333,222.2218,1,6665859,6666654,795,-0.07103544228236802
1607,222.235667,222.2399,1,6667070,6667197,127,
1608,222.247033,222.257833,1,6667410,6667734,324,-0.11418519027956932
1609,222.259367,222.2828,1,6667781,6668484,703,0.052763193826147275
1610,222.2909,222.303433,1,6668727,6669102,375,-0.06399784439073083
1611,222.310133,222.315233,1,6669303,6669456,153,-0.11833352260447183
1612,222.3506,222.424567,1,6670518,6672737,2219,0.0909339758995022
1613,222.432267,222.455567,1,6672968,6673667,699,0.022001895855231674
1614,222.4764,222.481067,1,6674292,6674432,140,0.2877182745682512
1615,222.825267,222.8316,1,6684758,6684948,190,0.016562032177982623
1616,222.860733,222.865033,1,6685821,6685950,129,
1617,222.903,222.919767,1,6687090,6687593,503,0.0299495269364642
1618,222.9556,223.018033,1,6688668,6690540,1872,-0.07781318364266819
1619,223.021033,223.044,1,6690630,6691320,690,0.0028555713846983226
1620,223.046467,223.059467,1,6691394,6691784,390,-0.052738848616168704
1621,223.0605,223.094333,1,6691815,6692829,1014,0.11372821769935978
1622,223.101733,223.108333,1,6693051,6693249,198,0.26723824126791823
1623,223.1094,223.164967,1,6693282,6694949,1667,0.48210710020011277
1624,223.1662,223.2952,1,6694986,6698856,3870,0.21801189634000512
1625,223.296467,223.3294,1,6698894,6699882,988,-0.05133337489816538
1626,223.3341,223.339867,1,6700023,6700196,173,0.14444675063970078
1627,223.355133,223.359367,1,6700653,6700781,128,-0.048125163613878405
1628,223.560033,223.5648,1,6706800,6706944,144,0.3753793500849167
1629,223.5658,223.572567,1,6706974,6707177,203,-0.225995902355533
1630,223.573733,223.588633,1,6707211,6707658,447,0.18772309750673324
1631,223.684967,223.7037,1,6710549,6711111,562,0.3432074211894899
1632,223.716933,223.744467,1,6711507,6712334,827,0.12450158144466346
1633,223.745467,223.7511,1,6712364,6712533,169,0.5978426528331839
1634,223.792733,223.795733,1,6713781,6713871,90,
1635,223.912167,223.923267,1,6717365,6717698,333,0.1461903531915423
1636,223.9327,223.935733,1,6717981,6718071,90,
1637,223.9369,223.9407,1,6718107,6718221,114,
1638,223.9424,223.9593,1,6718272,6718779,507,-0.12114520930725543
1639,223.964067,223.972233,1,6718922,6719166,244,-0.047810965274156826
1640,223.974167,223.982667,1,6719225,6719480,255,-0.10073769112742496
1641,224.002833,224.0105,1,6720084,6720315,231,-0.10333973750250451
1642,224.016833,224.034567,1,6720504,6721037,533,-0.023343975507544867
1643,224.036567,224.048933,1,6721097,6721467,370,0.05545420488547353
1644,224.061,224.0642,1,6721830,6721926,96,
1645,224.123,224.128233,1,6723690,6723846,156,-0.10054608582616273
1646,224.168233,224.190667,1,6725046,6725720,674,0.0006245664896558323
1647,224.192033,224.195133,1,6725760,6725853,93,
1648,224.2014,224.224,1,6726042,6726720,678,0.03435711148712696
1649,224.2251,224.2309,1,6726753,6726927,174,0.3198233421076141
1650,224.234933,224.286667,1,6727047,6728600,1553,0.06796617712072535
1651,224.289233,224.324233,1,6728676,6729726,1050,-0.07706144009571711
1652,224.337167,224.4874,1,6730115,6734622,4507,0.39593825125791055
1653,224.489,224.596433,1,6734670,6737892,3222,0.12926654585979797
1654,224.668733,224.6731,1,6740061,6740193,132,-0.281436266692715
1655,224.682833,224.728133,1,6740484,6741843,1359,0.07991198762897468
1656,224.7383,224.777367,1,6742149,6743321,1172,-0.028357331539846122
1657,224.778667,224.830933,1,6743360,6744927,1567,0.13490516494101704
1658,224.832033,224.8377,1,6744960,6745131,171,-0.06924398377454398
1659,225.0576,225.061167,1,6751728,6751835,107,
1660,225.095367,225.111533,1,6752861,6753345,484,0.1403666729922528
1661,225.259733,225.274167,1,6757791,6758225,434,0.35996140885996386
1662,225.2752,225.279933,1,6758256,6758397,141,0.6111628910409629
1663,225.285367,225.2971,1,6758561,6758913,352,0.09398590945445971
1664,225.298367,225.316067,1,6758951,6759482,531,0.33231064891186324
1665,225.318033,225.324467,1,6759540,6759734,194,-0.10352737005807222
1666,225.3257,225.331333,1,6759771,6759939,168,0.2483721168539184
1667,225.597567,225.602867,1,6767927,6768086,159,
1668,225.615133,225.618533,1,6768453,6768555,102,
1669,225.686267,225.691767,1,6770588,6770753,165,0.21531939609869374
1670,225.7727,225.830267,1,6773181,6774908,1727,0.08382537991201483
1671,225.8313,225.886833,1,6774939,6776604,1665,0.06600335568356634
1672,225.9622,225.972667,1,6778866,6779180,314,-0.09190953245959733
1673,225.977333,225.996767,1,6779319,6779903,584,0.07524420334282084
1674,226.0025,226.0068,1,6780075,6780204,129,0.21410018376533177
1675,226.0088,226.029767,1,6780264,6780893,629,0.16171720903024206
1676,226.034267,226.0409,1,6781028,6781227,199,-0.2514358944520191
1677,226.049467,226.059233,1,6781484,6781776,292,-0.03457659215329047
1678,226.062233,226.0764,1,6781866,6782292,426,0.032646480019336316
1679,226.078933,226.097467,1,6782367,6782924,557,0.033328698840154665
1680,226.099133,226.123933,1,6782973,6783717,744,0.016303690461230085
1681,226.128467,226.131933,1,6783854,6783957,103,
1682,226.140867,226.21,1,6784226,6786300,2074,0.4532023461769293
1683,226.212767,226.312933,1,6786383,6789387,3004,0.18473968236899158
1684,226.3201,226.324533,1,6789603,6789735,132,0.10916327085680994
1685,226.404933,226.408933,1,6792147,6792267,120,
1686,226.430233,226.479467,1,6792906,6794384,1478,0.026159588527696762
1687,226.484567,226.511,1,6794537,6795330,793,0.11367786467551484
1688,226.514833,226.535033,1,6795444,6796050,606,0.050335714435526396
1689,226.542367,226.550833,1,6796271,6796524,253,-0.04765780930386327
1690,226.6164,226.619567,1,6798492,6798587,95,
1691,226.9631,227.002567,1,6808893,6810077,1184,0.3577380813201579
1692,227.009533,227.0265,1,6810285,6810795,510,0.2882123454244785
1693,227.228233,227.237333,1,6816846,6817119,273,0.27301604820724706
1694,227.543433,227.5466,1,6826302,6826398,96,
1695,227.5923,227.598667,1,6827769,6827960,191,0.23519753204396343
1696,227.602433,227.611633,1,6828072,6828348,276,0.12681911397886816
1697,227.642933,227.6599,1,6829287,6829797,510,0.25519550592222773
1698,227.672667,227.6788,1,6830180,6830364,184,-0.12160235373168607
1699,227.6976,227.7027,1,6830928,6831081,153,0.875292668135811
1700,227.775133,227.7787,1,6833253,6833361,108,-0.1871464629013696
1701,228.237867,228.249467,1,6847136,6847484,348,0.3049250734386528
1702,228.264333,228.2674,1,6847929,6848022,93,
1703,228.379533,228.4305,1,6851385,6852915,1530,-0.04748202463255442
1704,228.4321,228.440567,1,6852963,6853217,254,0.4117776850810113
1705,228.455633,228.472033,1,6853668,6854160,492,0.1302361845920253
1706,228.482333,228.502133,1,6854469,6855063,594,0.05301040561120409
1707,228.506467,228.5108,1,6855194,6855324,130,-0.05461095437729145
1708,228.520667,228.648933,1,6855620,6859467,3847,0.3524227823727944
1709,228.650433,228.680167,1,6859512,6860405,893,0.1850022625531373
1710,228.696133,228.835367,1,6860883,6865061,4178,0.3937660325584334
1711,228.8389,228.8456,1,6865167,6865368,201,-0.05423578179671847
1712,228.9367,228.949033,1,6868101,6868470,369,-0.0907346440336468
1713,228.952333,228.988133,1,6868569,6869643,1074,0.030872942186501755
1714,229.003367,229.012,1,6870101,6870360,259,0.15127222042591829
1715,229.0185,229.0526,1,6870555,6871578,1023,0.14699071278525574
1716,229.398633,229.401733,1,6881958,6882051,93,-0.22171864746952785
1717,229.705167,229.709333,1,6891155,6891279,124,-0.2548621143642134
1718,229.721567,229.728233,1,6891647,6891846,199,-0.30238580747632715
1719,229.9005,229.905333,1,6897015,6897159,144,
1720,229.996367,230.0007,1,6899891,6900021,130,
1721,230.0909,230.0957,1,6902727,6902871,144,0.22278803018929733
1722,230.139333,230.1473,1,6904179,6904419,240,0.18807543264853224
1723,230.1505,230.305467,1,6904515,6909164,4649,0.012980736070124512
1724,230.308167,230.3361,1,6909245,6910083,838,0.006454130292607245
1725,230.3385,230.343,1,6910155,6910290,135,-0.21346889323307208
1726,230.360167,230.527333,1,6910805,6915819,5014,0.16899075304106925
1727,230.5287,230.539233,1,6915861,6916176,315,0.05492378862717259
1728,230.5448,230.5748,1,6916344,6917244,900,-0.027976836186514635
1729,230.671467,230.6878,1,6920144,6920634,490,-0.010788469901433369
1730,230.692233,230.7231,1,6920766,6921693,927,-0.07208451971824976
1731,230.732567,230.7891,1,6921977,6923673,1696,0.03762813222052658
1732,230.81,230.8145,1,6924300,6924435,135,0.4121700167818336
1733,230.906033,230.9108,1,6927180,6927324,144,0.3348434290435978
1734,230.914367,230.917667,1,6927431,6927530,99,
1735,230.9246,230.928567,1,6927738,6927857,119,
1736,231.125633,231.139467,1,6933768,6934184,416,0.08747243278931725
1737,231.215333,231.2316,1,6936459,6936948,489,-0.066581596147319
1738,231.303533,231.310333,1,6939105,6939309,204,0.03806184913609634
1739,231.312467,231.3157,1,6939374,6939471,97,
1740,231.317233,231.334767,1,6939516,6940043,527,-0.09293144838173617
1741,231.3438,231.353567,1,6940314,6940607,293,0.015215620541373518
1742,231.3723,231.376133,1,6941169,6941283,114,-0.18703517737085576
1743,231.382667,231.3884,1,6941480,6941652,172,-0.03185836674421715
1744,231.3953,231.4069,1,6941859,6942207,348,0.21530935952897315
1745,231.408433,231.4148,1,6942252,6942444,192,0.12118323743868158
1746,231.432033,231.435267,1,6942960,6943058,98,
1747,231.4381,231.4598,1,6943143,6943794,651,-0.07743979124845764
1748,231.478267,231.4935,1,6944348,6944805,457,0.2891877723808025
1749,231.495033,231.5085,1,6944850,6945255,405,0.033106632219462966
1750,231.5316,231.535267,1,6945948,6946058,110,0.31529402425072856
1751,231.5832,231.586833,1,6947496,6947604,108,
1752,231.595033,231.610733,1,6947850,6948321,471,-0.013800794573434938
1753,231.884833,231.894867,1,6956544,6956846,302,0.09289983564880937
1754,231.9497,231.9593,1,6958491,6958779,288,-0.021268332900107337
1755,231.973033,231.988867,1,6959190,6959666,476,-0.09422873513802045
1756,231.990367,232.0073,1,6959711,6960219,508,-0.021256014591702132
1757,232.0097,232.0174,1,6960291,6960522,231,0.3966204149680438
1758,232.018533,232.044533,1,6960555,6961335,780,0.07965346104548647
1759,232.050033,232.060733,1,6961500,6961821,321,0.07099855431560592
1760,232.061933,232.119733,1,6961857,6963591,1734,0.12498349130401151
1761,232.121433,232.144933,1,6963642,6964347,705,0.09308686845738337
1762,232.1517,232.317433,1,6964551,6969522,4971,0.5780248505488069
1763,232.320267,232.337133,1,6969608,6970113,505,-0.03766610505196616
1764,232.338767,232.367933,1,6970163,6971037,874,-0.02015997583708326
1765,232.370533,232.388067,1,6971115,6971642,527,0.007511061640412428
1766,232.417167,232.438533,1,6972515,6973155,640,0.012458122955946171
1767,232.447133,232.4502,1,6973413,6973506,93,
1768,232.458567,232.4635,1,6973757,6973905,148,-0.1202360747235413
1769,232.4656,232.472233,1,6973968,6974166,198,-0.00023649041081594906
1770,232.509067,232.534033,1,6975272,6976020,748,0.1702136387560681
1771,232.537433,232.549767,1,6976122,6976493,371,-0.05206870505057283
1772,232.5508,232.555867,1,6976524,6976676,152,
1773,232.560233,232.573233,1,6976806,6977196,390,-0.011259261298478901
1774,232.576967,232.5934,1,6977309,6977802,493,0.16840352733860914
1775,232.5949,232.610933,1,6977847,6978327,480,0.10514934594491264
1776,232.712633,232.717733,1,6981378,6981531,153,0.1931243994103545
1777,232.8843,232.889767,1,6986529,6986693,164,0.023854566379787046
1778,232.891067,232.903,1,6986732,6987090,358,0.07550738186719949
1779,232.914967,232.923933,1,6987449,6987717,268,-0.1464778172092034
1780,232.924967,232.9318,1,6987749,6987954,205,-0.03757456871493025
1781,233.5662,233.5739,1,7006986,7007217,231,0.1254084776054646
1782,233.5916,233.603533,1,7007748,7008105,357,0.30663752015760337
1783,234.1314,234.165867,1,7023942,7024976,1034,-0.13161417530222752
1784,234.170633,234.189967,1,7025118,7025699,581,-0.06015811182416016
1785,234.2344,234.355733,1,7027032,7030671,3639,-0.03658403625429796
1786,234.358867,234.368167,1,7030766,7031045,279,-0.005947212908977835
1787,234.3727,234.376633,1,7031181,7031298,117,-0.4277688226390079
1788,234.386167,234.403267,1,7031585,7032098,513,0.08913940920462159
1789,234.407333,234.418067,1,7032219,7032542,323,-0.11138290406538062
1790,234.4209,234.440967,1,7032627,7033229,602,0.012920402101694206
1791,234.456467,234.501733,1,7033694,7035051,1357,0.06801330415913523
1792,234.517767,234.5309,1,7035533,7035927,394,0.055581068359784505
1793,234.561733,234.634867,1,7036851,7039046,2195,0.4397723265224102
1794,234.6359,234.712267,1,7039077,7041368,2291,-0.034017598013636775
1795,234.713533,234.726167,1,7041405,7041785,380,-0.05042592941272815
1796,234.7533,234.759133,1,7042599,7042773,174,-0.07765547649789321
1797,234.7604,234.7638,1,7042812,7042914,102,-0.04589049436809353
1798,234.7651,234.822467,1,7042953,7044674,1721,0.018476784862720898
1799,234.8402,234.8439,1,7045206,7045317,111,
1800,234.863833,234.914567,1,7045914,7047437,1523,-0.025660441031314263
1801,234.915967,234.936067,1,7047479,7048082,603,0.06795617760316415
1802,234.939433,234.955767,1,7048182,7048673,491,0.18691877903079746
1803,234.970833,234.976433,1,7049124,7049292,168,-0.08994008703451431
1804,234.980267,235.0511,1,7049408,7051533,2125,0.006147120040719498
1805,235.056067,235.066467,1,7051682,7051994,312,-0.014005973651642186
1806,235.0675,235.0865,1,7052025,7052595,570,0.07858678971002597
1807,235.091033,235.094333,1,7052730,7052829,99,
1808,235.102233,235.164767,1,7053066,7054943,1877,-0.023033091102580516
1809,235.166167,235.216467,1,7054985,7056494,1509,0.05919680510300084
1810,235.219533,235.244533,1,7056585,7057335,750,-0.05074065932717606
1811,235.248233,235.256533,1,7057446,7057695,249,0.4329551572638915
1812,235.272733,235.305433,1,7058181,7059162,981,0.08875460225176401
1813,235.467133,235.472667,1,7064013,7064180,167,0.17598209065293055
1814,235.559367,235.568467,1,7066781,7067054,273,0.07454402757990247
1815,235.571667,235.575933,1,7067150,7067277,127,
1816,235.592833,235.596667,1,7067784,7067900,116,0.5239160149322546
1817,235.597667,235.6062,1,7067930,7068186,256,0.23664241037824377
1818,235.617633,235.626267,1,7068528,7068788,260,-0.028757882838084038
1819,235.702667,235.705733,1,7071080,7071171,91,
1820,235.718367,235.731267,1,7071551,7071938,387,0.4264916959584236
1821,235.801033,235.805533,1,7074030,7074165,135,-0.059047155434386364
1822,235.807467,235.818333,1,7074224,7074549,325,0.19206815729997778
1823,235.9025,235.9063,1,7077075,7077189,114,
1824,235.910433,235.9143,1,7077312,7077429,117,
1825,235.916367,235.934567,1,7077491,7078037,546,0.1884825890117041
1826,235.9381,235.951167,1,7078143,7078535,392,-0.05197339568682248
1827,235.976767,235.979933,1,7079303,7079397,94,
1828,236.2571,236.260833,1,7087713,7087824,111,0.5638517587903362
1829,236.487333,236.494333,1,7094619,7094829,210,0.17963989259388724
1830,236.5113,236.533333,1,7095339,7095999,660,0.04547118574503958
1831,236.535533,236.539067,1,7096065,7096172,107,
1832,236.5464,236.5558,1,7096392,7096674,282,0.14960851340960515
1833,236.581567,236.593267,1,7097447,7097798,351,0.11738929473012177
1834,236.5997,236.604267,1,7097991,7098128,137,0.19643440877559118
1835,236.6093,236.6314,1,7098279,7098942,663,0.2739269505719931
1836,236.671667,236.676533,1,7100150,7100295,145,0.06904973831421501
1837,236.6968,236.7012,1,7100904,7101036,132,0.3490650653905406
1838,236.7084,236.717333,1,7101252,7101519,267,0.024653340862338145
1839,236.7187,236.734567,1,7101561,7102037,476,0.030040102655752084
1840,236.736767,236.757233,1,7102103,7102716,613,0.09247990160254266
1841,236.767533,236.775367,1,7103025,7103261,236,-0.12630488369617524
1842,236.857367,236.896133,1,7105721,7106883,1162,-0.05215037311030709
1843,236.897933,236.912767,1,7106937,7107383,446,0.020984363065467068
1844,236.916433,236.947833,1,7107492,7108434,942,0.11195906269826478
1845,236.949867,236.9687,1,7108496,7109061,565,0.09419714986382738
1846,236.981933,237.013567,1,7109457,7110407,950,0.2156420001518475
1847,237.023967,237.027533,1,7110719,7110825,106,0.06240779135050836
1848,237.157,237.197933,1,7114710,7115937,1227,-0.03435157191550832
1849,237.199833,237.2117,1,7115994,7116351,357,-0.026123112979878328
1850,237.2173,237.229033,1,7116519,7116870,351,-0.09075569569941405
1851,237.235433,237.2645,1,7117062,7117935,873,0.09536135430577257
1852,237.271867,237.296567,1,7118156,7118897,741,0.076974749245702
1853,237.297967,237.334233,1,7118939,7120026,1087,0.2351903260642377
1854,237.350067,237.401567,1,7120502,7122047,1545,0.4301021499267417
1855,237.4042,237.417167,1,7122126,7122515,389,0.037981168060448725
1856,237.7473,237.754667,1,7132419,7132640,221,0.09525831405463105
1857,237.776,237.783467,1,7133280,7133504,224,-0.21850687583253423
1858,237.785367,237.795133,1,7133561,7133853,292,-0.1380707796694167
1859,237.796133,237.8135,1,7133883,7134405,522,-0.090305249066613
1860,237.8414,237.845833,1,7135242,7135374,132,0.29514620363078886
1861,237.8638,237.869667,1,7135914,7136090,176,
1862,237.872767,237.883833,1,7136183,7136514,331,
1863,237.884933,237.888533,1,7136547,7136655,108,-0.13332401560444695
1864,237.9646,237.968767,1,7138938,7139063,125,
1865,237.9699,237.980133,1,7139097,7139403,306,-0.09277420450754323
1866,238.007333,238.041867,1,7140219,7141256,1037,-0.04001452624123018
1867,238.047833,238.0692,1,7141434,7142076,642,0.02071216088464051
1868,238.073433,238.077867,1,7142202,7142336,134,-0.014780310562301469
1869,238.081833,238.110333,1,7142454,7143309,855,0.025082920011437672
1870,238.1115,238.194833,1,7143345,7145844,2499,0.07788940963454744
1871,238.203333,238.207133,1,7146099,7146213,114,0.29219648836125395
1872,238.209867,238.274567,1,7146296,7148237,1941,0.26844261749125153
1873,238.275567,238.361333,1,7148267,7150839,2572,-0.018235081093939648
1874,238.3634,238.4157,1,7150902,7152471,1569,-0.010721285419447066
1875,238.455133,238.458233,1,7153653,7153746,93,
1876,238.4745,238.4807,1,7154235,7154421,186,
1877,238.490567,238.516767,1,7154717,7155503,786,-0.030046931055429375
1878,238.5195,238.525433,1,7155585,7155762,177,-0.10209379216474104
1879,238.542067,238.6036,1,7156262,7158108,1846,-0.0001093632376754094
1880,238.606667,238.623533,1,7158200,7158705,505,0.035729933642252
1881,238.633167,238.6392,1,7158995,7159176,181,0.21601814122878688
1882,238.726267,238.752133,1,7161788,7162563,775,0.07203422542987302
1883,238.758367,238.765433,1,7162751,7162962,211,0.010223883096358534
1884,238.767633,238.771867,1,7163028,7163156,128,-0.10950112591922577
1885,238.773267,238.8227,1,7163198,7164681,1483,0.02635791797706346
1886,238.8302,238.833267,1,7164906,7164998,92,
1887,238.859633,238.8666,1,7165788,7165998,210,0.5222335028338763
1888,238.878433,238.881633,1,7166352,7166448,96,0.11149610834045076
1889,238.8865,238.896433,1,7166595,7166892,297,0.03698074396288895
1890,238.9147,238.923567,1,7167441,7167707,266,0.02330250716544617
1891,238.9256,238.928967,1,7167768,7167869,101,-0.09858177177657099
1892,238.9522,238.959467,1,7168566,7168784,218,0.25982532932457914
1893,239.0157,239.03,1,7170471,7170900,429,-0.05202122591329748
1894,239.0424,239.047667,1,7171272,7171430,158,0.09838485505904451
1895,239.092167,239.102833,1,7172765,7173084,319,-0.05908856291207689
1896,239.199933,239.209933,1,7175997,7176297,300,0.12391829437440936
1897,239.2533,239.265067,1,7177599,7177952,353,0.2846219496018741
1898,239.291333,239.3016,1,7178739,7179048,309,0.4495152486577942
1899,239.348333,239.3514,1,7180449,7180542,93,
1900,239.498167,239.501833,1,7184945,7185054,109,
1901,239.511867,239.516433,1,7185356,7185492,136,
1902,239.525,239.5348,1,7185750,7186044,294,-0.05430287897609777
1903,239.58,239.5831,1,7187400,7187493,93,
1904,239.592567,239.596033,1,7187777,7187880,103,0.5715503477969363
1905,239.9114,239.917233,1,7197342,7197516,174,-0.13128405268459994
1906,239.923633,239.9365,1,7197708,7198095,387,0.21859771870404202
1907,239.945767,239.959567,1,7198373,7198787,414,0.23884330786389443
1908,240.069267,240.073267,1,7202078,7202198,120,
1909,240.113,240.131633,1,7203390,7203948,558,-0.07619096119881717
1910,240.1363,240.153433,1,7204089,7204602,513,-0.05693178369570723
1911,240.156467,240.191533,1,7204694,7205745,1051,0.03172213652272982
1912,240.199833,240.203933,1,7205994,7206117,123,0.37571993006603804
1913,240.206333,240.221233,1,7206189,7206636,447,0.2005380787067325
1914,240.222967,240.239033,1,7206689,7207170,481,0.10570296837762456
1915,240.2406,240.247067,1,7207218,7207412,194,0.3947543680477812
1916,240.249033,240.2666,1,7207470,7207998,528,0.09585986602436615
1917,240.2753,240.281667,1,7208259,7208450,191,0.0757214684272298
1918,240.2946,240.315567,1,7208838,7209467,629,0.09153767401924352
1919,240.323833,240.355067,1,7209714,7210652,938,0.3002870191556145
1920,240.3624,240.401667,1,7210872,7212050,1178,0.26736484537625127
1921,240.405633,240.4623,1,7212168,7213869,1701,0.435726340256796
1922,240.470733,240.5988,1,7214121,7217964,3843,0.12962831327769014
1923,240.602467,240.6548,1,7218074,7219644,1570,-0.022796824197387155
1924,240.6569,240.716,1,7219707,7221480,1773,0.053465963405670475
1925,240.776667,240.780333,1,7223300,7223409,109,0.09170298898862925
1926,240.782233,240.787633,1,7223466,7223628,162,-0.3648728319807536
1927,240.803833,240.8365,1,7224114,7225095,981,-0.02903590018765414
1928,240.844367,240.8636,1,7225331,7225908,577,0.08340691342191164
1929,240.866033,240.901,1,7225980,7227030,1050,0.0027516275728719937
1930,241.016033,241.020367,1,7230480,7230611,131,
1931,241.0538,241.061167,1,7231614,7231835,221,0.3538732704881928
1932,241.254733,241.275033,1,7237641,7238250,609,0.20491565113640128
1933,241.2849,241.303467,1,7238547,7239104,557,0.2877280601239804
1934,241.3046,241.3115,1,7239138,7239345,207,
1935,241.312733,241.316,1,7239381,7239480,99,
1936,241.561033,241.568167,1,7246830,7247045,215,0.468117937145973
1937,241.6245,241.647833,1,7248735,7249434,699,-0.0497970560857148
1938,241.648867,241.698233,1,7249466,7250946,1480,-0.04262579463470524
1939,241.699867,241.712033,1,7250996,7251360,364,-0.033586072348874764
1940,241.741767,241.748267,1,7252253,7252448,195,-0.09395108896011492
1941,241.7697,241.773467,1,7253091,7253204,113,-0.17716822545828154
1942,241.781067,241.791233,1,7253432,7253736,304,-0.057245649649150535
1943,241.805,241.8151,1,7254150,7254453,303,-0.09242890299797041
1944,241.832267,241.847167,1,7254968,7255415,447,0.0417756717761044
1945,241.8543,241.858633,1,7255629,7255758,129,
1946,241.954533,241.962967,1,7258635,7258889,254,0.43091989904861666
1947,242.2461,242.295467,1,7267383,7268864,1481,-0.06709497774918115
1948,242.300233,242.322267,1,7269006,7269668,662,0.23696317219934496
1949,242.3239,242.3429,1,7269717,7270287,570,0.0014136592115821512
1950,242.348167,242.367433,1,7270445,7271022,577,0.19258462653194378
1951,242.3955,242.437767,1,7271865,7273133,1268,0.026486908967375256
1952,242.439733,242.459567,1,7273191,7273787,596,-0.04754202650605455
1953,242.681767,242.6878,1,7280453,7280634,181,-0.03495119842016085
1954,242.716633,242.719933,1,7281498,7281597,99,
1955,242.722667,242.7286,1,7281680,7281858,178,-0.12021001981383671
1956,242.729833,242.768733,1,7281894,7283061,1167,-0.08789069690700037
1957,242.7707,242.7934,1,7283121,7283802,681,-0.02327145576161604
1958,242.7952,242.8059,1,7283856,7284177,321,-0.03468945337270189
1959,242.806933,242.819767,1,7284207,7284593,386,0.13858680814087135
1960,242.8346,242.8402,1,7285038,7285206,168,0.0138494009804125
1961,242.857467,242.8717,1,7285724,7286151,427,0.2224912570851564
1962,242.902133,242.9134,1,7287063,7287402,339,-0.021423162532904046
1963,242.9146,242.986933,1,7287438,7289607,2169,0.49179402323948196
1964,242.988033,243.1287,1,7289640,7293861,4221,0.21174211357488884
1965,243.1307,243.146233,1,7293921,7294386,465,-0.018746668852667007
1966,243.154167,243.1612,1,7294625,7294836,211,-0.0762633958128221
1967,243.175433,243.2164,1,7295262,7296492,1230,-0.06172836808309757
1968,243.217533,243.2755,1,7296525,7298265,1740,0.04009393734928281
1969,243.387067,243.424133,1,7301612,7302723,1111,-0.04360846296792502
1970,243.425167,243.4345,1,7302755,7303035,280,0.30868159440631143
1971,243.435933,243.489567,1,7303077,7304687,1610,-0.1529043190119915
1972,243.491233,243.4947,1,7304736,7304841,105,0.3594018248683105
1973,243.5753,243.581167,1,7307259,7307435,176,0.1769588985116987
1974,243.582267,243.586467,1,7307468,7307594,126,-0.05855165026070824
1975,243.6034,243.650633,1,7308102,7309518,1416,-0.1031890942949738
1976,243.657467,243.675767,1,7309724,7310273,549,0.12518994014404541
1977,243.677133,243.687733,1,7310313,7310631,318,0.30204711739255313
1978,243.6928,243.729267,1,7310784,7311878,1094,0.061366040226417215
1979,243.828167,243.831733,1,7314845,7314951,106,0.2333405097483058
1980,243.838,243.842533,1,7315140,7315275,135,
1981,243.870267,243.873867,1,7316108,7316216,108,-0.24072295883582698
1982,243.8785,243.881767,1,7316355,7316453,98,
1983,243.9037,243.914567,1,7317111,7317437,326,0.21981849003182222
1984,243.918267,243.924833,1,7317548,7317744,196,
1985,244.002633,244.0064,1,7320078,7320192,114,-0.3081047334183703
1986,244.0321,244.0421,1,7320963,7321263,300,-0.47923470691545356
1987,244.054867,244.064033,1,7321646,7321920,274,-0.30870702444075176
1988,244.1444,244.153367,1,7324332,7324601,269,-0.2548771402466318
1989,244.162233,244.1675,1,7324866,7325025,159,0.22381285700579348
1990,244.7757,244.794567,1,7343271,7343837,566,0.2712336207711782
1991,244.841133,244.8451,1,7345233,7345353,120,0.3809383623654499
1992,245.062733,245.067267,1,7351881,7352018,137,-0.2195775356719944
1993,245.4624,245.4697,1,7363872,7364091,219,0.4884227489800726
1994,245.6595,245.663133,1,7369785,7369893,108,0.13412137855791312
1995,245.674967,245.6859,1,7370249,7370577,328,0.2955955083992352
1996,245.863767,245.868133,1,7375913,7376043,130,0.3634358177226317
1997,245.920967,245.925567,1,7377629,7377767,138,0.753953259136532
1998,246.006833,246.0105,1,7380204,7380315,111,0.3570285362353722
1999,246.0682,246.078967,1,7382046,7382369,323,0.0030505139290293018
2000,246.1179,246.1216,1,7383537,7383648,111,
2001,246.157733,246.186467,1,7384731,7385594,863,0.24201719260311327
2002,246.1889,246.192633,1,7385667,7385778,111,0.4005201936343182
2003,246.258567,246.2635,1,7387757,7387905,148,0.2554961013507587
2004,246.267133,246.284,1,7388013,7388520,507,0.010157457429074255
2005,246.285067,246.2911,1,7388552,7388733,181,0.61241357480451
2006,246.382867,246.390733,1,7391486,7391721,235,0.4599666695304674
2007,246.396267,246.401267,1,7391888,7392038,150,
2008,246.402633,246.409,1,7392078,7392270,192,0.5368208346025879
2009,246.453533,246.457467,1,7393605,7393724,119,0.04374371518257125
2010,246.4627,246.474533,1,7393881,7394235,354,0.0297050985720567
2011,246.475533,246.488567,1,7394265,7394657,392,0.30590020160311565
2012,246.531833,246.553867,1,7395954,7396616,662,-0.01380231540703529
2013,246.594433,246.606267,1,7397832,7398188,356,0.058217049549634206
2014,246.6074,246.610633,1,7398222,7398318,96,-0.14115474092527916
2015,246.611867,246.615,1,7398356,7398450,94,0.37217231379089005
2016,246.6732,246.681433,1,7400196,7400442,246,0.20590612497622765
2017,246.740833,246.750333,1,7402224,7402509,285,0.3770000018781508
2018,246.811467,246.8215,1,7404344,7404645,301,0.21031953803013242
2019,246.831133,246.835233,1,7404933,7405056,123,
2020,246.886033,246.894367,1,7406580,7406831,251,-0.08454670719669247
2021,246.8959,246.902367,1,7406877,7407071,194,0.4360204772085054
2022,246.968,246.980367,1,7409040,7409411,371,0.07100386054056529
2023,246.9992,247.0024,1,7409976,7410072,96,0.5107096258359062
2024,247.172133,247.175933,1,7415163,7415277,114,0.03510902620813625
2025,247.318733,247.331067,1,7419561,7419932,371,0.3085814015612255
2026,247.332667,247.3364,1,7419980,7420092,112,
2027,247.437633,247.441633,1,7423128,7423248,120,0.3038442482852761
2028,247.445733,247.4558,1,7423371,7423674,303,-0.04585490150887816
2029,247.466167,247.4699,1,7423985,7424097,112,
2030,247.573567,247.5859,1,7427207,7427577,370,0.22996865398025132
2031,247.589,247.595867,1,7427670,7427876,206,0.2091231338043334
2032,247.597,247.6062,1,7427910,7428186,276,0.5006905670989567
2033,247.645133,247.649333,1,7429353,7429479,126,-0.08217613334475814
2034,247.7286,247.737833,1,7431858,7432134,276,0.434234996457168
2035,247.7411,247.750533,1,7432233,7432515,282,-0.11603574761800908
2036,247.7548,247.765933,1,7432644,7432977,333,0.18535166242283452
2037,247.9677,247.975567,1,7439031,7439267,236,0.3292566872420922
2038,247.987367,247.996867,1,7439621,7439906,285,-0.05796757629860379
2039,248.057067,248.060067,1,7441712,7441802,90,
2040,248.179933,248.189333,1,7445397,7445679,282,0.6170561308612599
2041,248.190533,248.217267,1,7445715,7446518,803,-0.045132934937390616
2042,248.2739,248.279033,1,7448217,7448370,153,-0.12925839363427136
2043,248.2838,248.287967,1,7448514,7448639,125,-0.06322247487176474
2044,248.296633,248.318333,1,7448898,7449549,651,0.05944558636559239
2045,248.341367,248.355467,1,7450241,7450664,423,0.4900802466184093
2046,248.375667,248.381267,1,7451270,7451438,168,-0.13310848278364065
2047,249.740133,249.758267,1,7492203,7492748,545,0.28148157189575834
2048,249.759333,249.766,1,7492779,7492980,201,0.5509647287991184
2049,249.771,249.774933,1,7493130,7493247,117,0.48306373054779483
2050,249.787667,249.796367,1,7493630,7493891,261,0.3551314699081166
2051,249.803667,249.816033,1,7494110,7494480,370,0.21200065138190208
2052,249.820733,249.8263,1,7494621,7494789,168,-0.11030902277195936
2053,250.211633,250.2181,1,7506348,7506543,195,-0.11048048842233375
2054,250.227667,250.233033,1,7506830,7506990,160,-0.15527005106047723
2055,250.381867,250.388067,1,7511456,7511642,186,-0.4012969818940055
2056,250.389967,250.426033,1,7511699,7512780,1081,0.41296046514769197
2057,250.8016,250.804667,1,7524048,7524140,92,0.2549684522246128
2058,250.843567,250.848267,1,7525307,7525448,141,
2059,250.855567,250.859067,1,7525667,7525772,105,0.10273290466008553
2060,250.872267,250.887767,1,7526168,7526633,465,0.10412958453826444
2061,250.9067,250.923467,1,7527201,7527704,503,0.20970347892328917
2062,250.925233,250.9337,1,7527756,7528011,255,-0.11363597441992723
2063,250.992167,251.012933,1,7529765,7530387,622,-0.0014982347985576824
2064,251.019633,251.042367,1,7530588,7531271,683,0.14906948050134253
2065,251.052433,251.0667,1,7531572,7532001,429,-0.06753066098125525
2066,251.068067,251.084867,1,7532042,7532546,504,0.4495419771364438
2067,251.087433,251.092633,1,7532622,7532778,156,0.40643329019555147
2068,251.097767,251.107667,1,7532933,7533230,297,0.301125187260577
2069,251.112867,251.117667,1,7533386,7533530,144,0.43340912636000767
2070,251.1586,251.183833,1,7534758,7535514,756,0.06351768056949843
2071,251.188433,251.191733,1,7535652,7535751,99,
2072,251.192733,251.214233,1,7535781,7536426,645,0.4362052172373365
2073,251.222433,251.234833,1,7536672,7537044,372,0.023127872799840833
2074,251.246667,251.250567,1,7537400,7537517,117,0.31909140135754305
2075,251.251867,251.255867,1,7537556,7537676,120,-0.16411980556283826
2076,251.394233,251.3973,1,7541826,7541919,93,0.4713509834974919
2077,251.398667,251.417967,1,7541960,7542539,579,0.16812881132928853
2078,251.4193,251.426733,1,7542579,7542801,222,0.6253504959644303
2079,251.440167,251.456733,1,7543205,7543701,496,0.3333626117842253
2080,251.467533,251.4783,1,7544025,7544349,324,0.29454406890885043
2081,251.501533,251.5116,1,7545045,7545348,303,0.30975861521406256
2082,251.554367,251.562367,1,7546631,7546871,240,-0.1602865477693727
2083,251.604,251.622033,1,7548120,7548660,540,0.009562555093301395
2084,251.6231,251.627967,1,7548693,7548839,146,0.47990836013268917
2085,251.640167,251.658867,1,7549205,7549766,561,0.4222115391792972
2086,251.670167,251.6786,1,7550105,7550358,253,0.2768560343592373
2087,251.6942,251.698067,1,7550826,7550942,116,
2088,251.7017,251.711233,1,7551051,7551336,285,0.37757270183941816
2089,251.873367,251.8767,1,7556201,7556301,100,
2090,251.9071,251.910433,1,7557213,7557312,99,0.08069703600845658
2091,251.984867,251.9916,1,7559546,7559748,202,0.6413727823460859
2092,251.993967,251.9978,1,7559819,7559934,115,0.44280657966655845
2093,252.004,252.0111,1,7560120,7560333,213,0.10760102199898966
2094,252.058067,252.068,1,7561742,7562040,298,0.19641308755299824
2095,252.0713,252.0789,1,7562139,7562367,228,0.040536532574941435
2096,252.085833,252.107733,1,7562574,7563231,657,0.11887409128199576
2097,252.118133,252.136567,1,7563543,7564097,554,0.01668962857302272
2098,252.1379,252.1494,1,7564137,7564482,345,0.1977369100286329
2099,252.158967,252.1688,1,7564769,7565064,295,-0.09766159736262427
2100,252.1815,252.185467,1,7565445,7565564,119,-0.08139371239462607
2101,252.250833,252.2545,1,7567524,7567635,111,0.2532729545465802
2102,252.476033,252.479233,1,7574280,7574376,96,
2103,252.495533,252.5006,1,7574865,7575018,153,0.0986448609268942
2104,252.507033,252.560633,1,7575210,7576818,1608,0.18911485702698766
2105,252.5618,252.5659,1,7576854,7576977,123,-0.3224521290388862
2106,252.568933,252.6541,1,7577067,7579623,2556,0.3708471805023175
2107,252.6588,252.669233,1,7579764,7580076,312,0.5713495402719861
2108,253.4204,253.425267,1,7602612,7602758,146,
2109,253.7894,253.810933,1,7613682,7614327,645,0.13028567454330517
2110,253.817567,253.843767,1,7614527,7615313,786,0.06922732953219084
2111,253.848867,253.853433,1,7615466,7615602,136,0.14655171143643178
2112,253.854633,253.862733,1,7615638,7615881,243,-0.05944426007391601
2113,253.868633,253.876,1,7616058,7616280,222,0.4874019263737456
2114,253.8801,253.906967,1,7616403,7617209,806,0.14896843448071465
2115,253.909867,253.9278,1,7617296,7617834,538,0.4037694168459054
2116,253.9339,253.944133,1,7618017,7618323,306,0.04569475221684987
2117,253.947,253.952267,1,7618410,7618568,158,0.16794839636947598
2118,253.9559,253.959233,1,7618677,7618776,99,
2119,253.962967,253.967233,1,7618889,7619016,127,
2120,253.984067,253.9871,1,7619522,7619613,91,0.08722493161615742
2121,253.989433,253.994833,1,7619682,7619844,162,0.34642679972310125
2122,255.440267,255.4451,1,7663208,7663353,145,
2123,255.4551,255.4645,1,7663653,7663935,282,0.4298887139076993
2124,255.465733,255.4837,1,7663971,7664511,540,-0.004030806164668978
2125,255.485167,255.4883,1,7664555,7664649,94,0.3539636627068751
2126,255.499267,255.5071,1,7664978,7665213,235,0.441625306749986
2127,255.5119,255.520567,1,7665357,7665617,260,0.12632350049374028
2128,255.542467,255.547133,1,7666274,7666413,139,-0.09414859709207855
2129,255.549533,255.560833,1,7666485,7666824,339,0.10520254537368284
2130,255.571367,255.594967,1,7667141,7667849,708,0.24786283012870614
2131,255.599333,255.613867,1,7667979,7668416,437,0.00029953516985392706
2132,255.619633,255.625933,1,7668588,7668777,189,0.10082355724184433
2133,255.631933,255.643633,1,7668957,7669308,351,-0.027614526095895594
2134,255.649533,255.653033,1,7669485,7669590,105,
2135,255.942633,255.945767,1,7678278,7678373,95,
2136,256.585267,256.599767,1,7697558,7697993,435,-0.04371633631635481
2137,256.6244,256.6362,1,7698731,7699085,354,-0.01840106560192713
2138,256.6698,256.721467,1,7700094,7701644,1550,0.16910684112437693
2139,256.723167,256.726467,1,7701695,7701794,99,
2140,256.729367,256.737933,1,7701881,7702137,256,-0.013322940231881795
2141,256.7728,256.7773,1,7703184,7703319,135,0.05381218211252281
2142,256.8182,256.821233,1,7704546,7704636,90,
2143,256.824133,256.831867,1,7704723,7704956,233,-0.23622173243776728
2144,256.970667,256.974333,1,7709120,7709229,109,
2145,257.417,257.4201,1,7722509,7722603,94,0.14819714990685015
2146,257.461567,257.473533,1,7723847,7724205,358,-0.06056682749401463
2147,257.4799,257.4896,1,7724397,7724688,291,0.09092089212851079
2148,257.492567,257.5028,1,7724777,7725083,306,-0.10511971207875923
2149,257.510233,257.529733,1,7725306,7725891,585,0.03062352676580591
2150,257.531,257.540033,1,7725930,7726200,270,0.04626770518345447
2151,257.594667,257.608167,1,7727840,7728245,405,0.3864040506209245
2152,257.624267,257.6347,1,7728728,7729041,313,0.08862655611169415
2153,257.644333,257.650533,1,7729329,7729515,186,0.729111665475285
2154,257.6697,257.681067,1,7730090,7730432,342,-0.05232344990848734
2155,257.682333,257.686667,1,7730469,7730600,131,-0.19595273188225296
2156,257.688533,257.692533,1,7730655,7730775,120,0.4451772955190911
2157,258.281667,258.284733,1,7748450,7748541,91,0.2414218596245993
2158,258.413367,258.420033,1,7752401,7752600,199,0.07208313013962143
2159,258.437967,258.454667,1,7753139,7753640,501,0.1711886805555697
2160,258.478233,258.4866,1,7754346,7754598,252,0.16238207528530385
2161,258.4947,258.5089,1,7754841,7755266,425,-0.08035868205311214
2162,258.5173,258.529367,1,7755518,7755881,363,0.15066080237234417
2163,258.573033,258.5785,1,7757190,7757355,165,0.4927080321711013
2164,258.580233,258.587967,1,7757406,7757639,233,0.36706934069745817
2165,258.613933,258.628967,1,7758417,7758869,452,0.09819251337151952
2166,258.636933,258.6497,1,7759107,7759491,384,-0.0953807602559376
2167,258.653767,258.6662,1,7759613,7759986,373,0.22057085689543868
2168,258.671267,258.678333,1,7760138,7760349,211,-0.056761133074297844
2169,258.743967,258.747933,1,7762319,7762437,118,
2170,259.028067,259.032967,1,7770842,7770989,147,-0.1688921482477143
2171,259.218,259.238867,1,7776540,7777166,626,0.05155236367385213
2172,259.251767,259.257333,1,7777553,7777719,166,
2173,259.347233,259.365567,1,7780416,7780967,551,0.04474190386248104
2174,259.374633,259.3814,1,7781238,7781442,204,-0.046684707149161765
2175,259.387333,259.395033,1,7781619,7781850,231,-0.013204345887326956
2176,259.3973,259.401767,1,7781918,7782053,135,-0.27515168138940577
2177,259.409833,259.413733,1,7782294,7782411,117,
2178,259.4161,259.443,1,7782482,7783289,807,0.0924418176851533
2179,259.445367,259.4545,1,7783361,7783635,274,0.0796187668479083
2180,259.4648,259.4846,1,7783944,7784538,594,0.09472388190895911
2181,259.491533,259.537967,1,7784745,7786139,1394,0.0383735134880784
2182,259.540533,259.5439,1,7786215,7786317,102,0.7520396012137232
2183,259.545,259.5727,1,7786350,7787181,831,0.07154937677297868
2184,259.593133,259.604767,1,7787793,7788143,350,0.23456419149856758
2185,259.607267,259.622767,1,7788218,7788683,465,0.209889276862309
2186,259.623867,259.628133,1,7788716,7788843,127,0.012172441616481853
2187,259.6295,259.632833,1,7788885,7788984,99,-0.08610299636830776
2188,259.644167,259.6515,1,7789325,7789545,220,0.04886207533299108
2189,259.6534,259.665467,1,7789601,7789964,363,0.008729889311721873
2190,259.672167,259.6783,1,7790165,7790348,183,-0.0722072261917949
2191,259.681,259.684267,1,7790429,7790528,99,
2192,259.692767,259.715433,1,7790783,7791462,679,0.2511712331059945
2193,259.717833,259.7364,1,7791534,7792092,558,0.03257872584876056
2194,259.747433,259.756367,1,7792422,7792691,269,0.3517625352685329
2195,259.7609,259.7663,1,7792827,7792989,162,0.3779958192259041
2196,259.790367,259.794033,1,7793711,7793820,109,-0.1971819972512317
2197,259.797767,259.8008,1,7793933,7794023,90,
2198,259.824567,259.8447,1,7794737,7795341,604,0.14357936913069771
2199,259.869133,259.8896,1,7796073,7796687,614,0.06332029167449182
2200,259.898867,259.9491,1,7796966,7798473,1507,0.008142423364366656
2201,259.950367,259.957433,1,7798511,7798722,211,0.05883913116206436
2202,259.969333,259.977833,1,7799079,7799334,255,0.3719447940851682
2203,260.002567,260.0092,1,7800077,7800276,199,0.20276461844512841
2204,260.014733,260.026,1,7800441,7800780,339,0.1554416259454891
2205,260.0323,260.047867,1,7800969,7801436,467,0.2833820707335512
2206,260.0659,260.072,1,7801977,7802160,183,0.23053749566570148
2207,260.074067,260.082933,1,7802222,7802487,265,0.36149426115200134
2208,260.205567,260.213633,1,7806167,7806408,241,0.20833083564540952
2209,260.444767,260.447833,1,7813343,7813434,91,-0.22582363925689306
2210,260.479367,260.499033,1,7814381,7814970,589,0.1780594384498578
2211,260.652133,260.675267,1,7819563,7820258,695,0.21322965760339008
2212,260.685733,260.6935,1,7820571,7820804,233,0.6103460693115886
2213,260.694533,260.708167,1,7820835,7821245,410,0.13882914619990488
2214,260.7208,260.730933,1,7821624,7821927,303,0.21709402976150804
2215,260.752,260.759233,1,7822560,7822776,216,0.0746519873173739
2216,260.761533,260.768867,1,7822845,7823066,221,0.2170375061121753
2217,260.777767,260.782133,1,7823333,7823463,130,0.22734022040717422
2218,260.787733,260.799833,1,7823631,7823994,363,0.10511420582507987
2219,260.801133,260.805733,1,7824033,7824171,138,-0.03871557806642629
2220,261.3462,261.351533,1,7840386,7840545,159,0.37995602185494437
2221,261.3729,261.380067,1,7841187,7841402,215,0.28452417942437186
2222,261.431933,261.4532,1,7842957,7843595,638,0.10377198510420609
2223,261.462,261.477433,1,7843860,7844322,462,0.3335509252871956
2224,261.482267,261.489933,1,7844468,7844697,229,-0.026564606373699312
2225,261.5041,261.509667,1,7845123,7845290,167,0.011744382022513824
2226,261.5282,261.574833,1,7845846,7847244,1398,0.056129925747985074
2227,261.592733,261.6021,1,7847781,7848063,282,0.10313964683087379
2228,261.6035,261.6077,1,7848105,7848231,126,0.2404792543046525
2229,261.610633,261.62,1,7848318,7848600,282,0.057276248080474525
2230,261.6362,261.642667,1,7849085,7849280,195,-0.1157384819733052
2231,261.645333,261.6572,1,7849359,7849716,357,0.060242125470171604
2232,261.660333,261.6823,1,7849809,7850469,660,0.10645744900045163
2233,261.6866,261.6994,1,7850598,7850982,384,-0.02940083398213573
2234,261.7038,261.711333,1,7851114,7851339,225,0.5122917021882952
2235,261.7169,261.72,1,7851507,7851600,93,0.15764368250650293
2236,261.773467,261.785567,1,7853204,7853567,363,0.10557234774970717
2237,261.804433,261.810533,1,7854132,7854315,183,0.2910004344402944
2238,261.989733,261.9939,1,7859691,7859817,126,0.1260799034101386
2239,262.2217,262.2254,1,7866651,7866761,110,0.06981367102545534
2240,262.2357,262.2452,1,7867071,7867356,285,0.008605258881964173
2241,262.272467,262.2795,1,7868174,7868385,211,-0.08364369313177315
2242,262.285467,262.3008,1,7868564,7869023,459,-0.03748689785659065
2243,262.3499,262.360033,1,7870497,7870800,303,-0.12509967833584323
2244,262.362633,262.3814,1,7870878,7871442,564,0.05096434870582359
2245,262.3868,262.407933,1,7871604,7872237,633,0.08634437153791014
2246,262.422333,262.428333,1,7872669,7872849,180,0.058192341779440514
2247,262.444333,262.4607,1,7873329,7873820,491,0.03172733231071588
2248,262.474767,262.484233,1,7874243,7874526,283,0.16068428577299892
2249,262.493233,262.5064,1,7874796,7875192,396,0.12578001443686412
2250,262.508067,262.5189,1,7875242,7875566,324,0.42602194269792387
2251,262.536133,262.540767,1,7876083,7876223,140,0.18635000690898665
2252,262.550533,262.5593,1,7876515,7876779,264,-0.11069545433620183
2253,262.5614,262.575633,1,7876842,7877268,426,0.21635014225772561
2254,262.576767,262.579967,1,7877303,7877399,96,
2255,262.592,262.603367,1,7877760,7878101,341,0.29576297812154106
2256,262.6104,262.6159,1,7878312,7878477,165,
2257,262.639267,262.652967,1,7879178,7879589,411,0.1987670846850463
2258,262.654933,262.659,1,7879647,7879770,123,0.14400647867387775
2259,262.665867,262.668867,1,7879976,7880066,90,
2260,262.671833,262.683633,1,7880154,7880508,354,-0.23799611904671342
2261,262.697967,262.720533,1,7880939,7881615,676,0.28354459992780995
2262,262.725867,262.7476,1,7881776,7882427,651,0.05903402546835405
2263,262.750533,262.7558,1,7882515,7882674,159,-0.06593076973562124
2264,262.919867,262.9237,1,7887596,7887711,115,0.25973408806872766
2265,263.370567,263.3804,1,7901117,7901412,295,0.044599122559757474
2266,263.414267,263.466133,1,7902428,7903983,1555,0.1844739083197436
2267,263.491,263.496267,1,7904730,7904888,158,0.44963780088000543
2268,263.500733,263.520667,1,7905021,7905620,599,0.16250702051175575
2269,263.521667,263.588,1,7905650,7907640,1990,0.028220593925986914
2270,263.592567,263.6172,1,7907777,7908516,739,0.3086920447882986
2271,263.618933,263.7649,1,7908567,7912947,4380,0.3207215351140908
2272,263.769167,263.7848,1,7913075,7913544,469,0.08240025742005634
2273,263.7858,263.833067,1,7913574,7914992,1418,0.16441235738570767
2274,263.8344,263.850667,1,7915032,7915520,488,-0.10100287791684127
2275,263.8993,263.902833,1,7916978,7917084,106,
2276,263.942133,263.956133,1,7918263,7918683,420,0.10273385095566871
2277,263.957133,263.9612,1,7918713,7918836,123,0.44347542307249094
2278,263.9634,263.984533,1,7918901,7919535,634,0.00963057189085677
2279,263.986567,263.9928,1,7919597,7919784,187,0.10625090716539025
2280,263.998133,264.0147,1,7919943,7920441,498,0.20282905606904428
2281,264.089767,264.107567,1,7922693,7923227,534,0.21078516279704915
2282,264.1191,264.1248,1,7923573,7923744,171,0.52094641674982
2283,264.125967,264.132567,1,7923779,7923977,198,-0.13805456445720798
2284,264.178333,264.1815,1,7925349,7925445,96,
2285,264.2161,264.2535,1,7926482,7927604,1122,0.028598443433604768
2286,264.2804,264.294567,1,7928412,7928837,425,0.11614426327164613
2287,264.298733,264.3544,1,7928961,7930632,1671,-0.0255142092672068
2288,264.359833,264.3722,1,7930794,7931166,372,0.39118300651347965
2289,264.389733,264.393133,1,7931691,7931793,102,0.49642805119111055
2290,264.413467,264.42,1,7932404,7932600,196,-0.043787983399977776
2291,264.430933,264.434867,1,7932927,7933046,119,
2292,264.445967,264.4611,1,7933379,7933833,454,0.1822466221218198
2293,264.502467,264.508,1,7935074,7935239,165,0.2851473718141488
2294,264.631133,264.639167,1,7938933,7939175,242,0.12308220115352893
2295,264.669733,264.719533,1,7940091,7941585,1494,-0.0803070833403626
2296,264.7481,264.7535,1,7942443,7942604,161,-0.052780870307604054
2297,264.7569,264.7682,1,7942706,7943045,339,0.02835238750465414
2298,264.7711,264.7754,1,7943133,7943262,129,-0.21720522160019953
2299,264.7797,264.808367,1,7943391,7944251,860,-4.544391497679869e-05
2300,264.826633,264.833233,1,7944798,7944996,198,-0.016012899307675563
2301,264.837833,264.845233,1,7945134,7945356,222,0.05159514732621043
2302,264.848233,264.853367,1,7945446,7945601,155,
2303,264.8722,264.884433,1,7946166,7946532,366,0.22551170298623166
2304,264.8885,264.899933,1,7946655,7946997,342,-0.009439479023727165
2305,264.9025,264.909367,1,7947074,7947281,207,0.03253919194343265
2306,264.929567,264.933533,1,7947887,7948005,118,
2307,264.946067,265.1481,1,7948382,7954443,6061,0.39499840604171305
2308,265.151167,265.167667,1,7954535,7955030,495,0.02528105777201072
2309,265.169667,265.190767,1,7955090,7955723,633,0.13564315876308944
2310,265.192433,265.231333,1,7955772,7956939,1167,0.17059841146375837
2311,265.2414,265.2463,1,7957242,7957389,147,0.13384458889068032
2312,265.341867,265.350267,1,7960256,7960508,252,0.05173155902014455
2313,265.3606,265.363733,1,7960817,7960911,94,-0.1518962501712942
2314,265.367667,265.3764,1,7961030,7961292,262,-0.07604380821972692
2315,265.383967,265.3914,1,7961519,7961741,222,-0.13184472102391134
2316,265.3929,265.437467,1,7961787,7963124,1337,-0.04108288676273439
2317,265.440467,265.476867,1,7963214,7964306,1092,-0.004078185312321828
2318,265.4801,265.4992,1,7964403,7964975,572,-0.009682528762143506
2319,265.504233,265.549933,1,7965126,7966497,1371,0.18979779036673403
2320,265.5514,265.631967,1,7966542,7968959,2417,0.1035925909935112
2321,265.670933,265.7058,1,7970127,7971174,1047,-0.1526533428147466
2322,265.7068,265.7143,1,7971204,7971428,224,0.021716501882595992
2323,265.7332,265.746167,1,7971996,7972385,389,-0.07485947782396116
2324,265.751133,265.754533,1,7972533,7972635,102,0.3536091750437579
2325,265.772267,265.8056,1,7973168,7974168,1000,-0.03085328773021382
2326,265.885,265.888133,1,7976550,7976643,93,
2327,265.889967,265.893567,1,7976699,7976807,108,0.9692144513992889
2328,265.904867,265.9733,1,7977146,7979199,2053,-0.008235582446538959
2329,265.977067,266.015667,1,7979312,7980470,1158,0.04405299779532297
2330,266.031,266.036567,1,7980930,7981097,167,0.35163479959164706
2331,266.261767,266.2787,1,7987853,7988361,508,-0.1433156724450577
2332,266.3711,266.3748,1,7991133,7991244,111,0.02247309193387593
2333,266.376133,266.379433,1,7991283,7991382,99,
2334,266.3831,266.3982,1,7991493,7991945,452,0.22051496530639153
2335,266.4069,266.423867,1,7992207,7992716,509,0.29340107010020583
2336,266.4294,266.4457,1,7992882,7993371,489,0.24612014342708677
2337,266.45,266.455133,1,7993500,7993653,153,0.5069660699277077
2338,266.6036,266.608,1,7998107,7998240,133,
2339,266.719167,266.752567,1,8001575,8002577,1002,0.0564985660285055
2340,266.755233,266.762333,1,8002656,8002869,213,0.7822910958053165
2341,266.800133,266.8188,1,8004003,8004564,561,0.0038087105204887197
2342,266.8303,266.833833,1,8004909,8005014,105,
2343,266.869867,266.8767,1,8006096,8006301,205,-0.03779979217284039
2344,266.8844,266.896133,1,8006532,8006883,351,0.07734862962445696
2345,266.899933,266.907333,1,8006997,8007219,222,-0.07313989927365602
2346,266.914133,266.917367,1,8007423,8007521,98,0.4929823544013181
2347,266.9184,266.9309,1,8007552,8007927,375,0.14069054602996967
2348,266.941533,266.967867,1,8008245,8009036,791,0.28173139875602177
2349,266.970133,267.039867,1,8009103,8011196,2093,0.508841183795809
2350,267.045333,267.0897,1,8011359,8012691,1332,0.07453771991910002
2351,267.091233,267.144433,1,8012736,8014332,1596,0.088732522493353
2352,267.1469,267.160833,1,8014407,8014824,417,0.08655521419713375
2353,267.163733,267.239633,1,8014911,8017188,2277,0.18945972270639166
2354,267.2475,267.359733,1,8017425,8020791,3366,0.12654376656143582
2355,267.369333,267.373833,1,8021079,8021214,135,-0.17094761973486758
2356,267.435667,267.449067,1,8023070,8023472,402,0.411997817999463
2357,267.468533,267.504367,1,8024055,8025131,1076,0.04619071533236156
2358,267.5101,267.523333,1,8025303,8025699,396,-0.017488287662522008
2359,267.528733,267.5991,1,8025861,8027973,2112,0.02691647559835918
2360,267.6001,267.612767,1,8028003,8028383,380,0.09120307804132158
2361,267.618267,267.625333,1,8028548,8028759,211,0.10231696895249431
2362,267.644967,267.649067,1,8029349,8029472,123,0.004668669679454994
2363,267.701167,267.706033,1,8031035,8031180,145,-0.14411707522342673
2364,267.7093,267.713267,1,8031279,8031398,119,0.0021706412608811856
2365,267.8095,267.822567,1,8034285,8034677,392,0.2142545189209281
2366,268.101467,268.160833,1,8043044,8044824,1780,0.1207389306335091
2367,268.175133,268.1855,1,8045253,8045565,312,0.15547273228472414
2368,268.208833,268.2238,1,8046264,8046713,449,-0.007301982666030171
2369,268.3141,268.332767,1,8049423,8049983,560,0.5449165805638229
2370,268.342433,268.362067,1,8050272,8050862,590,-0.10961969835629046
2371,268.4917,268.498733,1,8054750,8054961,211,0.02926262042350992
2372,268.5546,268.5606,1,8056638,8056818,180,0.7284828025480824
2373,268.595267,268.6141,1,8057858,8058423,565,0.37982081636368964
2374,268.6152,268.619467,1,8058456,8058584,128,
2375,268.656367,268.665667,1,8059691,8059970,279,-0.07109839458152788
2376,268.668167,268.676367,1,8060045,8060291,246,-0.14380220148006734
2377,268.678667,268.682367,1,8060360,8060471,111,-0.13313413419434797
2378,268.687667,268.7019,1,8060630,8061057,427,-0.057405217991834005
2379,268.7052,268.716733,1,8061156,8061501,345,-0.016726309608064732
2380,268.7182,268.7315,1,8061546,8061944,398,0.05428368693247676
2381,268.736967,268.7543,1,8062109,8062629,520,0.0674170224473037
2382,268.756067,268.766533,1,8062682,8062995,313,0.0911368181709114
2383,268.7706,268.773633,1,8063118,8063208,90,0.2859103854888623
2384,268.777767,268.864867,1,8063333,8065946,2613,0.5277173088172411
2385,268.8691,268.874333,1,8066073,8066229,156,
2386,268.8756,268.894533,1,8066268,8066835,567,0.024500128397860355
2387,268.896733,268.918733,1,8066901,8067561,660,0.15407794517033388
2388,268.925033,268.9287,1,8067750,8067861,111,0.545326821685222
2389,268.93,269.102,1,8067900,8073059,5159,0.1616915049611117
2390,269.108967,269.2049,1,8073269,8076147,2878,0.12281579964453432
2391,269.2514,269.2552,1,8077542,8077656,114,
2392,269.320467,269.346067,1,8079614,8080382,768,-0.02625443201062481
2393,269.354867,269.3623,1,8080646,8080869,223,0.09166119199715045
2394,269.363533,269.367933,1,8080905,8081037,132,
2395,269.466567,269.490933,1,8083997,8084727,730,-0.027986826811614626
2396,269.4978,269.5106,1,8084933,8085318,385,0.11263564926799902
2397,269.5481,269.5905,1,8086442,8087715,1273,0.2916272068225004
2398,269.6011,269.6041,1,8088032,8088123,91,
2399,269.608567,269.6175,1,8088257,8088525,268,0.08789256768613789
2400,269.636633,269.643333,1,8089098,8089299,201,0.021693113428803174
2401,269.6899,269.6971,1,8090697,8090912,215,-0.045472945983641024
2402,269.6986,269.747833,1,8090958,8092434,1476,-0.004720368561499936
2403,269.750067,269.776567,1,8092502,8093297,795,0.016715341405332314
2404,269.778133,269.7971,1,8093343,8093913,570,0.15160485154198175
2405,269.8086,269.823267,1,8094258,8094698,440,0.09540177255786707
2406,269.824767,269.8462,1,8094743,8095386,643,0.1607475430212949
2407,269.8528,269.856733,1,8095584,8095701,117,-0.2878818935369649
2408,269.862567,269.866067,1,8095877,8095982,105,
2409,270.030067,270.033333,1,8100902,8100999,97,0.18897860998298974
2410,270.075633,270.145633,1,8102268,8104368,2100,0.0270504433227064
2411,270.157933,270.161533,1,8104737,8104845,108,0.01200172801039179
2412,270.1712,270.205833,1,8105136,8106174,1038,-0.07295924017697449
2413,270.2093,270.2301,1,8106279,8106903,624,0.30604039416600837
2414,270.261867,270.2651,1,8107856,8107953,97,0.08339476047779815
2415,270.266967,270.274833,1,8108009,8108244,235,-0.023450468532049955
2416,270.280933,270.289333,1,8108427,8108679,252,-0.0721709352920533
2417,270.291,270.294667,1,8108730,8108840,110,
2418,270.301233,270.3181,1,8109036,8109543,507,0.1628444656549512
2419,270.638567,270.642967,1,8119157,8119289,132,0.6656781656129384
2420,270.815667,270.8242,1,8124470,8124726,256,0.21839725151693684
2421,270.845333,270.848633,1,8125359,8125458,99,
2422,270.888467,270.900967,1,8126654,8127029,375,0.1558377778231482
2423,270.902,270.906933,1,8127060,8127207,147,
2424,270.9135,270.9192,1,8127405,8127576,171,
2425,271.1709,271.242633,1,8135127,8137278,2151,0.05557377924944185
2426,271.243867,271.259067,1,8137316,8137772,456,0.025879068864917615
2427,271.271267,271.275767,1,8138138,8138273,135,-0.05759094004834403
2428,271.2787,271.300333,1,8138361,8139009,648,-0.10443155368477736
2429,271.319467,271.326133,1,8139584,8139783,199,-0.29961908275041266
2430,271.7349,271.782067,1,8152046,8153462,1416,-0.0300427149427545
2431,271.7943,271.798767,1,8153829,8153963,134,
2432,271.8296,271.8408,1,8154888,8155224,336,-0.05805739039369469
2433,271.8819,271.907967,1,8156456,8157239,783,-0.08947671241701381
2434,271.914767,271.923267,1,8157443,8157698,255,-0.1083357347630713
2435,271.924967,271.9318,1,8157749,8157954,205,-0.054371445932689395
2436,271.950833,272.0143,1,8158524,8160429,1905,0.03879166266885538
2437,272.018033,272.040167,1,8160540,8161205,665,0.03996448990468849
2438,272.041867,272.046333,1,8161256,8161389,133,0.5982811862641002
2439,272.049433,272.065833,1,8161482,8161974,492,0.267590114587292
2440,272.0779,272.084967,1,8162337,8162549,212,0.10478316650107175
2441,272.0989,272.1614,1,8162967,8164842,1875,0.4533905011439066
2442,272.164333,272.420633,1,8164929,8172618,7689,0.014248263728813701
2443,272.475233,272.4865,1,8174256,8174594,338,-0.03573063652549427
2444,272.507633,272.568033,1,8175228,8177040,1812,-0.04881926375839599
2445,272.5723,272.5861,1,8177168,8177583,415,0.14016595134959592
2446,272.5889,272.619633,1,8177667,8178588,921,0.04201913634987118
2447,272.621233,272.6435,1,8178636,8179305,669,0.06833473423871739
2448,272.8523,272.874033,1,8185569,8186220,651,-0.46664329396990456
2449,272.875733,272.8902,1,8186271,8186706,435,-0.05919901040624247
2450,272.894933,272.9136,1,8186847,8187407,560,0.056197467825902146
2451,272.991967,273.0042,1,8189759,8190126,367,0.24712189229583745
2452,273.009833,273.015667,1,8190294,8190470,176,0.3526264544203758
2453,273.030233,273.046133,1,8190906,8191383,477,0.4867850396872841
2454,273.051267,273.062533,1,8191538,8191875,337,0.06822232282084459
2455,273.079933,273.086433,1,8192397,8192592,195,0.0729737531209159
2456,273.107733,273.1168,1,8193231,8193504,273,0.02789496347019852
2457,273.139633,273.147767,1,8194188,8194433,245,-0.003605255194522087
2458,273.154233,273.1573,1,8194626,8194719,93,
2459,273.158433,273.161533,1,8194752,8194845,93,
2460,273.196833,273.200633,1,8195904,8196018,114,-0.043554134923026046
2461,273.224333,273.236267,1,8196729,8197088,359,-0.008762455192429746
2462,273.239833,273.246333,1,8197194,8197389,195,-0.04801187343959059
2463,273.253533,273.261633,1,8197605,8197848,243,0.1589962830337357
2464,273.298933,273.315867,1,8198967,8199476,509,-0.06379356583629961
2465,273.325567,273.3545,1,8199767,8200634,867,0.044194004337933634
2466,273.361333,273.373,1,8200839,8201190,351,0.14376545862824464
2467,273.380133,273.420433,1,8201403,8202612,1209,0.09715296936994339
2468,273.421833,273.539467,1,8202654,8206184,3530,0.573848290327436
2469,273.541867,273.611933,1,8206256,8208357,2101,0.26800516644762157
2470,273.613967,273.7622,1,8208419,8212866,4447,0.05000928386869471
2471,273.7644,273.7985,1,8212932,8213955,1023,0.1406765161514767
2472,273.858233,273.867067,1,8215746,8216012,266,0.0990990284376379
2473,273.893367,273.9843,1,8216801,8219529,2728,-0.012974200995083297
2474,274.236833,274.2415,1,8227104,8227244,140,
2475,274.257467,274.270367,1,8227724,8228111,387,0.10074652442968467
2476,274.272,274.283167,1,8228160,8228495,335,0.5284270267199209
2477,274.291233,274.2989,1,8228736,8228967,231,0.07271887653636135
2478,274.454733,274.462033,1,8233641,8233860,219,-0.05439625185198783
2479,274.513467,274.531867,1,8235404,8235956,552,-0.04424771895606695
2480,274.534567,274.5474,1,8236037,8236421,384,0.039980459527522993
2481,274.5698,274.574933,1,8237094,8237247,153,0.05724218773174601
2482,274.576167,274.5806,1,8237285,8237418,133,0.2460660913373942
2483,274.585533,274.592533,1,8237565,8237775,210,-0.09076845656280985
2484,274.594467,274.6151,1,8237834,8238452,618,-0.033838994322261874
2485,274.627733,274.645667,1,8238831,8239370,539,-0.04975262326315843
2486,274.663167,274.6684,1,8239895,8240052,157,-0.1783958649466406
2487,275.0376,275.0408,1,8251128,8251224,96,
2488,275.0679,275.095567,1,8252037,8252867,830,-0.0319231522925206
2489,275.105433,275.117833,1,8253162,8253534,372,-0.06646315611995203
2490,275.1216,275.131233,1,8253648,8253936,288,-0.04519400205809495
2491,275.133133,275.153067,1,8253993,8254592,599,0.16054247474104227
2492,275.160833,275.1741,1,8254824,8255223,399,0.2661541038103686
2493,275.179733,275.291133,1,8255391,8258733,3342,0.35527388300369717
2494,275.295267,275.339833,1,8258858,8260194,1336,0.026530997467898932
2495,275.3446,275.349933,1,8260338,8260497,159,0.4259851784828754
2496,275.359467,275.380733,1,8260784,8261421,637,0.09042037654090038
2497,275.397667,275.451967,1,8261930,8263559,1629,0.031579035559922836
2498,275.453667,275.5099,1,8263610,8265297,1687,0.0191871881652025
2499,275.760533,275.7641,1,8272815,8272923,108,0.2338561565951409
2500,275.839833,275.849433,1,8275194,8275482,288,0.3821315117407227
2501,275.8506,275.859967,1,8275518,8275799,281,0.5033818804432759
2502,275.870967,275.8816,1,8276129,8276448,319,0.33668084606898585
2503,275.9774,276.036967,1,8279322,8281109,1787,-0.015942059179265458
2504,276.039233,276.053533,1,8281176,8281605,429,0.004442280977150578
2505,276.0639,276.071667,1,8281917,8282150,233,0.09340071392424988
2506,276.0807,276.088067,1,8282420,8282642,222,0.11444695130783682
2507,276.132433,276.1367,1,8283972,8284101,129,0.7771624844096535
2508,276.208733,276.213367,1,8286261,8286401,140,-0.2215093280191543
2509,276.247967,276.263,1,8287439,8287889,450,-0.15086901005172484
2510,276.270433,276.282533,1,8288112,8288475,363,-0.09275518195530924
2511,276.2888,276.2997,1,8288663,8288990,327,-0.04735240500160513
2512,276.301433,276.3068,1,8289042,8289204,162,-0.09449786258311005
2513,276.318067,276.355333,1,8289542,8290659,1117,-0.03746134722086165
2514,276.3705,276.376633,1,8291115,8291298,183,0.19695693510835036
2515,276.385467,276.545233,1,8291564,8296356,4792,0.3349090962968823
2516,276.5476,276.5894,1,8296428,8297682,1254,-0.005784015522998259
2517,276.5921,276.605233,1,8297763,8298156,393,0.05358110156725755
2518,276.6064,276.6344,1,8298192,8299032,840,0.12267448134563855
2519,276.637967,276.655167,1,8299139,8299655,516,-0.02057143679232597
2520,276.656767,276.698467,1,8299703,8300954,1251,-0.005523329782114543
2521,276.704367,276.715367,1,8301131,8301461,330,-0.05729091039055346
2522,276.782867,276.787667,1,8303486,8303630,144,-0.024606741337129746
2523,276.877867,276.8827,1,8306336,8306481,145,-0.06774397829222745
2524,276.8957,276.899533,1,8306870,8306985,115,
2525,276.9723,277.014667,1,8309169,8310440,1271,0.12875642303918852
2526,277.017533,277.0212,1,8310525,8310636,111,0.2721184445351754
2527,277.023233,277.027133,1,8310696,8310813,117,
2528,277.0342,277.0374,1,8311026,8311122,96,
2529,277.044467,277.054667,1,8311334,8311640,306,-0.08330234091414108
2530,277.057133,277.066833,1,8311713,8312004,291,-0.03291913568594803
2531,277.070633,277.0811,1,8312118,8312433,315,0.09640274271877214
2532,277.088233,277.1136,1,8312646,8313408,762,0.013274944211828822
2533,277.117367,277.1352,1,8313521,8314056,535,0.019723166429994946
2534,277.2258,277.2449,1,8316774,8317346,572,0.08410049547747382
2535,277.255233,277.272833,1,8317656,8318184,528,-0.25226090436067866
2536,277.278767,277.2828,1,8318363,8318484,121,-0.624404197233212
2537,277.317933,277.322633,1,8319537,8319678,141,-0.4638052660462546
2538,277.360833,277.3714,1,8320824,8321142,318,0.18813672611387255
2539,277.3746,277.379333,1,8321238,8321379,141,
2540,277.4194,277.433767,1,8322582,8323013,431,0.23177019839122892
2541,277.441067,277.473133,1,8323232,8324193,961,0.31163008989263813
2542,277.475567,277.490067,1,8324267,8324702,435,0.04484349175793316
2543,277.513433,277.517067,1,8325402,8325512,110,0.18623246916495728
2544,277.5547,277.559567,1,8326641,8326787,146,0.0676156288752862
2545,277.567233,277.580567,1,8327016,8327417,401,0.0118384789382591
2546,277.587867,277.596433,1,8327636,8327892,256,-0.09189139138544404
2547,277.597767,277.613067,1,8327933,8328392,459,-0.06314676286858166
2548,277.6172,277.628067,1,8328516,8328842,326,0.06072649703728658
2549,277.629233,277.639333,1,8328876,8329179,303,-0.021400353424726792
2550,277.643867,277.657367,1,8329316,8329721,405,0.22433670309987405
2551,277.661133,277.677333,1,8329833,8330319,486,0.12169026130511572
2552,277.6829,277.6996,1,8330487,8330987,500,0.06489409778065441
2553,277.7007,277.7301,1,8331020,8331903,883,-0.027318926714413716
2554,277.738867,277.743567,1,8332166,8332307,141,-0.14118127067530184
2555,277.7453,277.749633,1,8332359,8332488,129,0.08996323190009259
2556,277.750833,277.760433,1,8332524,8332812,288,-0.026027089041677574
2557,277.8035,277.813367,1,8334105,8334401,296,0.025610299155278713
2558,277.821367,277.8286,1,8334641,8334858,217,-0.1253791065301606
2559,277.830767,277.8372,1,8334923,8335116,193,0.15154958908153449
2560,277.841533,277.869333,1,8335245,8336079,834,0.0012488964404004067
2561,277.876667,277.883033,1,8336300,8336490,190,-0.16410351576107784
2562,277.906767,277.912967,1,8337203,8337389,186,0.5691540672839389
2563,277.967167,277.978367,1,8339015,8339351,336,0.000597535867615478
2564,277.9825,277.991467,1,8339475,8339744,269,0.1887899022096153
2565,277.997167,278.0014,1,8339915,8340042,127,0.17222563565074042
2566,278.0025,278.006567,1,8340075,8340197,122,
2567,278.007733,278.016067,1,8340231,8340482,251,-0.03181211288640858
2568,278.020133,278.063333,1,8340603,8341899,1296,0.0026441839061696545
2569,278.0714,278.118733,1,8342141,8343561,1420,-0.041826462922979216
2570,278.128033,278.146767,1,8343840,8344403,563,0.03567746533589321
2571,278.154367,278.179833,1,8344631,8345394,763,0.22146001423317765
2572,278.180833,278.35,1,8345424,8350500,5076,0.22670040685860007
2573,278.360167,278.464367,1,8350805,8353931,3126,0.01273073298743028
2574,278.465667,278.489867,1,8353970,8354696,726,-0.01543828470429745
2575,278.495133,278.4985,1,8354853,8354954,101,0.012354958799821954
2576,278.544467,278.553067,1,8356334,8356592,258,0.5553047379745699
2577,278.77,278.779333,1,8363099,8363379,280,-0.03976188759779829
2578,278.785867,278.789133,1,8363576,8363673,97,
2579,278.861433,278.874167,1,8365842,8366225,383,0.04617282556672659
2580,278.883733,278.906467,1,8366511,8367194,683,-0.04892372165335896
2581,278.908967,278.9518,1,8367269,8368554,1285,0.171159146606897
2582,279.2758,279.2861,1,8378274,8378582,308,0.44706420816869213
2583,279.314033,279.3216,1,8379420,8379648,228,-0.2845292893081743
2584,279.323433,279.329267,1,8379702,8379878,176,0.19549517717609624
2585,279.346267,279.3516,1,8380388,8380548,160,0.5623648185913623
2586,279.438233,279.441533,1,8383146,8383245,99,
2587,279.4541,279.459633,1,8383622,8383788,166,0.22327586433257549
2588,279.461067,279.4836,1,8383832,8384508,676,-0.08599964276660044
2589,279.4848,279.5236,1,8384544,8385708,1164,0.21310044984030063
2590,279.710267,279.713567,1,8391308,8391407,99,0.02801957556449685
2591,279.736433,279.743267,1,8392092,8392298,206,0.4299240036228297
2592,279.8124,279.8178,1,8394372,8394534,162,
2593,279.8608,279.871533,1,8395824,8396145,321,-0.040799771982810595
2594,279.899,279.906167,1,8396970,8397185,215,0.05016368321293122
2595,279.918533,279.921833,1,8397555,8397654,99,-0.24689551257851372
2596,279.927967,279.937367,1,8397839,8398121,282,0.2291275742002951
2597,280.050433,280.054167,1,8401512,8401625,113,
2598,280.096733,280.100633,1,8402901,8403018,117,
2599,280.103067,280.106767,1,8403092,8403203,111,
2600,280.107833,280.112,1,8403234,8403360,126,-0.1269567761881737
2601,280.113933,280.147133,1,8403417,8404413,996,-0.09499794288041659
2602,280.1525,280.160767,1,8404575,8404823,248,-0.09388303086204289
2603,280.182733,280.258033,1,8405481,8407740,2259,0.278762503798547
2604,280.259567,280.297367,1,8407787,8408921,1134,0.1848786965419774
2605,280.299467,280.351333,1,8408984,8410539,1555,0.07873927992905301
2606,280.353333,280.361333,1,8410599,8410839,240,-0.04936141771190507
2607,280.365033,280.3982,1,8410950,8411946,996,0.02442127299920855
2608,280.4011,280.405833,1,8412033,8412174,141,-0.057591967200087205
2609,280.406967,280.4101,1,8412209,8412303,94,0.057154380166879216
2610,280.411933,280.4156,1,8412357,8412468,111,-0.12646354095505075
2611,280.516833,280.5227,1,8415504,8415681,177,-0.4588471586227333
2612,280.698967,280.7084,1,8420969,8421252,283,0.39088224282736744
2613,280.9611,280.982,1,8428833,8429460,627,-0.01894238004503996
2614,280.985767,281.006967,1,8429573,8430209,636,-0.09424576452086056
2615,281.023167,281.027767,1,8430695,8430833,138,
2616,281.0358,281.044733,1,8431074,8431341,267,0.37910709313309715
2617,281.052,281.067033,1,8431560,8432010,450,-0.050221125794510726
2618,281.596633,281.603733,1,8447898,8448111,213,-0.09082619270777052
2619,281.674233,281.6816,1,8450226,8450448,222,-0.07356499715365328
2620,281.724533,281.728533,1,8451735,8451855,120,0.2608106178847273
2621,281.861367,281.867533,1,8455841,8456025,184,-0.03958136741105308
2622,281.887733,281.896467,1,8456631,8456894,263,0.08823990460615345
2623,281.902867,281.912833,1,8457086,8457384,298,0.5512036216945799
2624,281.932233,281.935733,1,8457966,8458071,105,-0.06196135613361932
2625,281.9632,281.9851,1,8458896,8459553,657,0.02686129592928342
2626,281.986567,281.994433,1,8459597,8459832,235,0.6429896085528213
2627,282.024967,282.0366,1,8460749,8461098,349,0.22133375306269196
2628,282.044367,282.0603,1,8461331,8461809,478,-0.08805539013714349
2629,282.089833,282.109267,1,8462694,8463278,584,-0.26632957707107574
2630,282.113133,282.116467,1,8463393,8463494,101,-0.22635753882689705
2631,282.1213,282.132633,1,8463639,8463978,339,0.21223094627047753
2632,282.151867,282.159967,1,8464556,8464799,243,-0.04043836567697316
2633,282.161767,282.165033,1,8464853,8464950,97,
2634,282.166733,282.2249,1,8465001,8466747,1746,-0.05681814804557957
2635,282.234667,282.2569,1,8467040,8467707,667,-0.06757110348745314
2636,282.259867,282.271767,1,8467796,8468153,357,0.0772427976706028
2637,282.273233,282.284267,1,8468196,8468528,332,-0.07898893410267355
2638,282.2886,282.3227,1,8468658,8469681,1023,0.11703453964102727
2639,282.328933,282.336,1,8469867,8470080,213,0.2984101335210173
2640,282.3371,282.3584,1,8470113,8470752,639,0.00021457684605545387
2641,282.367967,282.372233,1,8471039,8471166,127,-0.15082893415774248
2642,282.3767,282.548167,1,8471301,8476445,5144,0.3492116638323979
2643,282.549767,282.5555,1,8476493,8476665,172,0.009454906720341454
2644,282.5571,282.5626,1,8476713,8476878,165,0.39024251511245556
2645,282.5667,282.587233,1,8477001,8477616,615,-0.013657074176900933
2646,282.588267,282.594033,1,8477648,8477820,172,-0.07528404000724108
2647,282.686767,282.7125,1,8480603,8481375,772,-0.05251034035962321
2648,282.713533,282.7233,1,8481405,8481699,294,-0.0770537829259443
2649,282.728,282.773133,1,8481840,8483193,1353,0.08325209571755082
2650,282.886067,282.8901,1,8486582,8486703,121,0.6496488943404239
2651,282.961433,282.965367,1,8488842,8488961,119,0.6158349911516157
2652,283.123033,283.138267,1,8493690,8494148,458,0.042892731798730904
2653,283.1537,283.169367,1,8494611,8495081,470,-0.43596766072431953
2654,283.170633,283.175867,1,8495118,8495276,158,0.4805916715557845
2655,283.2026,283.291167,1,8496078,8498735,2657,0.2113839100322716
2656,283.856167,283.888933,1,8515685,8516667,982,0.06619148021464638
2657,283.8909,283.895667,1,8516727,8516870,143,0.09298520667829477
2658,283.903667,283.9081,1,8517110,8517243,133,0.384166362816902
2659,283.921467,283.938033,1,8517644,8518140,496,0.05255160574258001
2660,283.9391,283.942867,1,8518173,8518286,113,-0.06430000230889754
2661,283.9468,283.951933,1,8518404,8518557,153,
2662,283.969533,283.9803,1,8519085,8519409,324,-0.059214040352169726
2663,283.986067,284.051967,1,8519582,8521559,1977,-0.02890044334545008
2664,284.060133,284.066267,1,8521803,8521988,185,0.033933369872987236
2665,284.068967,284.105733,1,8522069,8523171,1102,0.1089421658668054
2666,284.1076,284.124967,1,8523228,8523749,521,0.17098932986051313
2667,284.1493,284.153567,1,8524479,8524607,128,-0.1301828122723906
2668,284.156967,284.171167,1,8524709,8525135,426,0.07055203219913646
2669,284.180633,284.199767,1,8525418,8525993,575,-0.057314572885445045
2670,284.200933,284.228767,1,8526027,8526863,836,0.051169169830247135
2671,284.2354,284.287833,1,8527062,8528634,1572,0.5162985579924826
2672,284.294467,284.373867,1,8528834,8531216,2382,0.08806143938954508
2673,284.3776,284.4178,1,8531328,8532534,1206,0.049537680451091665
2674,284.419033,284.441233,1,8532570,8533236,666,0.12886879825864342
2675,284.450533,284.455167,1,8533515,8533655,140,
2676,284.480367,284.4915,1,8534411,8534745,334,0.12188390155568551
2677,284.503367,284.5103,1,8535101,8535309,208,0.6993625511064089
2678,284.514433,284.518767,1,8535432,8535563,131,-0.061040380554288655
2679,284.558133,284.5622,1,8536743,8536866,123,
2680,284.564233,284.5692,1,8536926,8537076,150,0.5617256923542786
2681,284.581467,284.590167,1,8537444,8537705,261,0.005553005702323761
2682,284.5921,284.597167,1,8537763,8537915,152,0.06049145984325593
2683,284.613233,284.616467,1,8538396,8538494,98,
2684,284.626067,284.6304,1,8538782,8538912,130,-0.06810256845623953
2685,284.664833,284.6723,1,8539944,8540169,225,0.06637273149302914
2686,284.764467,284.7712,1,8542934,8543136,202,0.5410964086534346
2687,284.7751,284.804067,1,8543253,8544122,869,0.11126171726174415
2688,284.813333,284.8214,1,8544399,8544642,243,-0.04942435868009664
2689,284.828433,284.8324,1,8544852,8544972,120,0.3041908673031137
2690,285.068533,285.073667,1,8552055,8552210,155,-0.029361965570244213
2691,285.0762,285.089733,1,8552286,8552691,405,0.06735563829403116
2692,285.107733,285.1109,1,8553231,8553327,96,
2693,285.1179,285.1241,1,8553537,8553723,186,0.025152875226960258
2694,285.1603,285.163433,1,8554809,8554902,93,0.5145116712909078
2695,285.1751,285.187667,1,8555253,8555630,377,0.41374931671623444
2696,285.238433,285.2424,1,8557152,8557272,120,0.30293300913599147
2697,285.813633,285.820133,1,8574408,8574603,195,0.101894211360533
2698,285.822567,285.864767,1,8574677,8575943,1266,0.4341298305395225
2699,285.866633,285.871633,1,8575998,8576148,150,0.30391942563535773
2700,286.105667,286.2202,1,8583170,8586606,3436,0.7641348929356533
2701,286.241633,286.265367,1,8587248,8587961,713,0.12044548256758719
2702,286.2761,286.2792,1,8588283,8588376,93,
2703,286.298367,286.3127,1,8588951,8589381,430,-0.057529418611548463
2704,286.3802,286.387867,1,8591406,8591636,230,0.0035544868851271815
2705,286.389,286.415367,1,8591670,8592461,791,0.18540004536149815
2706,286.4171,286.433033,1,8592513,8592990,477,-0.007081859285216988
2707,286.448133,286.4567,1,8593443,8593701,258,0.44595350792317956
2708,286.4583,286.462667,1,8593749,8593880,131,0.15795020411772376
2709,286.469833,286.4845,1,8594094,8594535,441,-0.06196443148131763
2710,286.611833,286.6162,1,8598354,8598486,132,-0.008649620303936463
2711,286.6257,286.639867,1,8598771,8599196,425,0.3137173176071841
2712,286.640933,286.7233,1,8599227,8601699,2472,0.8144333424692989
2713,286.766033,286.771,1,8602980,8603130,150,0.16331315380888708
2714,286.789933,286.7985,1,8603697,8603955,258,-0.14688366613555656
2715,287.0996,287.1166,1,8612988,8613498,510,0.1695060183627317
2716,287.120233,287.132967,1,8613606,8613989,383,0.20544226214893838
2717,287.143167,287.1648,1,8614295,8614944,649,0.1567417494615685
2718,287.251667,287.684967,1,8617550,8630549,12999,0.2939891396261469
2719,287.698933,287.702433,1,8630967,8631072,105,0.04284115584598366
2720,287.715933,287.791033,1,8631477,8633730,2253,0.2770392944273116
2721,287.8706,287.878733,1,8636118,8636361,243,-0.056038691738936504
2722,288.1566,288.168867,1,8644698,8645066,368,0.2734033582577117
2723,288.172967,288.275467,1,8645189,8648264,3075,0.8045414213160721
2724,288.311,288.3218,1,8649330,8649654,324,0.05001555386145467
2725,288.3353,288.3413,1,8650059,8650239,180,0.7061219546243889
2726,288.347433,288.354,1,8650422,8650620,198,0.06537780775175475
2727,288.3626,288.3699,1,8650878,8651097,219,0.20802963038451694
2728,288.9169,288.927967,1,8667507,8667839,332,0.36659865710295125
2729,288.934,288.9418,1,8668020,8668254,234,0.427218104854625
2730,289.007733,289.115567,1,8670231,8673467,3236,0.7993120401107228
2731,289.121467,289.144633,1,8673644,8674338,694,0.7505025354832977
2732,289.1514,289.1981,1,8674542,8675943,1401,0.7750473903366598
2733,289.211867,289.242967,1,8676356,8677289,933,0.8398701778096057
2734,289.611533,289.765333,1,8688345,8692959,4614,0.8019447916507236
2735,289.806633,289.823733,1,8694198,8694711,513,0.5710434872171108
2736,290.151267,290.242367,1,8704538,8707271,2733,0.8499065188432138
2737,290.2645,290.275233,1,8707935,8708256,321,0.45759728128177674
2738,290.2919,290.3077,1,8708757,8709231,474,0.08011999273313941
2739,290.311733,290.317667,1,8709351,8709530,179,0.0319233345492535
2740,290.602267,290.606767,1,8718068,8718203,135,0.8234242258832911
2741,290.622967,290.659167,1,8718689,8719775,1086,0.7937910581091907
2742,290.676533,290.6966,1,8720295,8720898,603,0.7796080508986929
2743,290.7015,290.760367,1,8721045,8722811,1766,0.7742454396982356
2744,290.762533,290.777533,1,8722875,8723325,450,0.7857535775212859
2745,290.781,290.8515,1,8723430,8725545,2115,0.7115967567395836
2746,290.8598,290.870467,1,8725794,8726114,320,0.040229389231827124
2747,291.030433,291.039567,1,8730912,8731187,275,0.33661620599585207
2748,291.0652,291.078333,1,8731956,8732349,393,0.13109863053198836
2749,291.119333,291.123167,1,8733579,8733695,116,
2750,291.141267,291.252733,1,8734238,8737581,3343,0.7914918218539763
2751,291.290233,291.295233,1,8738706,8738856,150,
2752,291.314167,291.330767,1,8739425,8739923,498,0.17243226878313636
2753,291.3364,291.343433,1,8740092,8740302,210,0.08250708584878438
2754,291.3461,291.354867,1,8740383,8740646,263,0.24312042544630721
2755,291.469,291.4864,1,8744070,8744592,522,0.3489146306086091
2756,291.488667,291.495233,1,8744660,8744856,196,0.5796969673036767
2757,291.5004,291.537333,1,8745012,8746119,1107,0.15905458610674333
2758,291.541267,291.5537,1,8746238,8746611,373,0.31236833313411494
2759,291.554967,291.566367,1,8746649,8746991,342,0.131809105018953
2760,291.598767,291.6754,1,8747963,8750262,2299,0.69869417212542
2761,291.678033,291.698767,1,8750340,8750963,623,0.587948625627087
2762,291.733767,291.742233,1,8752013,8752266,253,-0.0053305238981477005
2763,291.7448,291.757567,1,8752344,8752727,383,0.015803858114335188
2764,291.759967,291.7671,1,8752799,8753013,214,0.23104305902020214
2765,291.775667,291.7905,1,8753270,8753715,445,0.1292889802893671
2766,291.8305,291.838833,1,8754915,8755164,249,0.25805188909237714
2767,291.856033,291.8668,1,8755680,8756004,324,0.09521561745736912
2768,291.8699,291.873867,1,8756097,8756216,119,0.6297711917562966
2769,291.876833,291.909033,1,8756304,8757270,966,0.4800825848600446
2770,291.917933,291.936133,1,8757537,8758083,546,0.26122825368600217
2771,291.937467,291.959533,1,8758124,8758785,661,0.3243804827046178
2772,292.023033,292.0298,1,8760690,8760894,204,0.27185837136345886
2773,292.031167,292.035867,1,8760935,8761076,141,0.17230645338565517
2774,292.037433,292.049267,1,8761122,8761478,356,-0.11996199363349745
2775,292.050267,292.073767,1,8761508,8762213,705,0.272673618827643
2776,292.0753,292.079067,1,8762259,8762372,113,
2777,292.0855,292.126467,1,8762565,8763794,1229,0.22667873512463282
2778,292.1956,292.295433,1,8765868,8768862,2994,0.7187119024729718
2779,292.332733,292.346767,1,8769981,8770403,422,0.22965178139512638
2780,292.353567,292.3606,1,8770607,8770818,211,-0.1199930550696166
2781,292.4472,292.4789,1,8773416,8774367,951,0.3584843915051979
2782,292.4918,292.4993,1,8774754,8774979,225,0.6831695242047419
2783,292.514233,292.522167,1,8775426,8775665,239,0.6106086515926318
2784,292.527067,292.5311,1,8775812,8775933,121,-0.15291590460820223
2785,292.748067,292.8047,1,8782442,8784141,1699,0.6484009670007054
2786,292.808167,292.847,1,8784245,8785410,1165,0.8692658710893001
2787,292.873167,292.879567,1,8786195,8786387,192,0.4661188238798315
2788,292.8847,292.8938,1,8786541,8786814,273,0.08524483064339153
2789,293.249767,293.262233,1,8797493,8797866,373,0.47330238752660203
2790,293.264533,293.2691,1,8797935,8798073,138,0.6126490498845812
2791,293.270933,293.274533,1,8798127,8798235,108,0.20337090721211237
2792,293.291967,293.3066,1,8798759,8799198,439,0.47855709218644
2793,293.312033,293.332467,1,8799360,8799974,614,0.5983025873280468
2794,293.3623,293.3739,1,8800869,8801217,348,0.5419145152676418
2795,293.377367,293.395367,1,8801321,8801861,540,0.6350765913832516
2796,293.427033,293.4408,1,8802810,8803224,414,0.6299038232258687
2797,293.442733,293.450733,1,8803281,8803521,240,0.4531406196277239
2798,293.478233,293.486467,1,8804346,8804594,248,0.5882162388605285
2799,293.489867,293.507733,1,8804696,8805231,535,0.5561884012596944
2800,293.528167,293.541667,1,8805845,8806250,405,0.463587651711721
2801,293.543933,293.563133,1,8806317,8806893,576,0.7477589373816215
2802,293.587667,293.592533,1,8807630,8807775,145,0.7437079539853424
2803,293.5948,293.605,1,8807844,8808150,306,0.610852929928331
2804,293.624633,293.6317,1,8808738,8808951,213,0.6459607010580759
2805,293.640433,293.659233,1,8809212,8809776,564,0.7817580961684658
2806,293.706867,293.7625,1,8811206,8812875,1669,0.5504239918487022
2807,293.765067,293.9388,1,8812952,8818164,5212,0.7893151898466392
2808,293.944467,293.984267,1,8818334,8819528,1194,0.7352331381939474
2809,294.213,294.219933,1,8826390,8826597,207,0.5963314280462827
2810,294.2235,294.437833,1,8826705,8833134,6429,0.7450342705442236
2811,294.727233,294.7508,1,8841816,8842524,708,0.8248895135482193
2812,294.752633,294.791967,1,8842578,8843759,1181,0.852902677113466
2813,294.796867,294.921567,1,8843906,8847647,3741,0.6652934491300632
2814,294.923233,295.002833,1,8847696,8850084,2388,0.6667139641509248
2815,295.2187,295.221933,1,8856561,8856657,96,0.04432571992763037
2816,295.225333,295.473,1,8856759,8864190,7431,0.7620725272552775
2817,295.744467,295.7609,1,8872334,8872827,493,0.6650044989883781
2818,295.7629,295.8458,1,8872887,8875374,2487,0.7843350687190225
2819,295.8518,295.968133,1,8875554,8879043,3489,0.7994633604554607
2820,295.973567,296.051167,1,8879207,8881535,2328,0.6993584148831692
2821,296.0555,296.077067,1,8881665,8882312,647,0.7969734900242899
2822,296.086767,296.098033,1,8882603,8882940,337,0.738361396867955
2823,296.150167,296.1532,1,8884505,8884596,91,
2824,296.292733,296.298367,1,8888781,8888951,170,0.7232413241220594
2825,296.3022,296.3178,1,8889066,8889534,468,0.755597395788288
2826,296.319867,296.4534,1,8889596,8893602,4006,0.7656499258050935
2827,296.4597,296.574067,1,8893791,8897222,3431,0.7354838119295916
2828,296.580567,296.584433,1,8897417,8897532,115,-0.15250343231916677
2829,296.8256,296.943467,1,8904768,8908304,3536,0.7243712349439748
2830,297.2486,297.253167,1,8917458,8917595,137,-0.23005551264138216
2831,297.258067,297.476833,1,8917742,8924304,6562,0.7877594724018099
2832,297.4794,297.5043,1,8924382,8925129,747,0.5704548375310019
2833,297.715467,297.806867,1,8931464,8934206,2742,0.7754513329237931
2834,297.808667,297.979033,1,8934260,8939370,5110,0.7318299281972108
2835,298.221867,298.274433,1,8946656,8948232,1576,0.6632849835213
2836,298.275433,298.283267,1,8948262,8948498,236,0.7546249848968348
2837,298.284767,298.330133,1,8948543,8949903,1360,0.8156803090979176
2838,298.346267,298.3685,1,8950388,8951055,667,0.16414584063916954
2839,298.372067,298.377767,1,8951162,8951333,171,0.053397606965617905
2840,298.575767,298.581233,1,8957273,8957436,163,0.7234211656211944
2841,298.582867,298.643767,1,8957486,8959313,1827,0.7863485704406413
2842,298.645,298.697767,1,8959350,8960933,1583,0.8109280194163775
2843,298.706333,298.738333,1,8961189,8962149,960,0.7639621631932672
2844,298.740767,298.796,1,8962223,8963880,1657,0.8022748887398394
2845,298.811567,298.843333,1,8964347,8965299,952,0.7314932320686945
2846,298.8819,298.9031,1,8966457,8967093,636,0.28948067864303034
2847,299.112567,299.417167,1,8973377,8982515,9138,0.7667236834162345
2848,299.4236,299.430033,1,8982708,8982900,192,-0.23461533289125147
2849,299.4312,299.4346,1,8982936,8983038,102,
2850,299.705467,299.728267,1,8991164,8991848,684,0.4955087529524178
2851,299.7297,299.738633,1,8991891,8992158,267,0.6748263473353473
2852,299.739867,299.836367,1,8992196,8995091,2895,0.7736154728681583
2853,299.8535,299.9503,1,8995605,8998509,2904,0.7745235443933698
2854,299.954433,299.9971,1,8998632,8999913,1281,0.680851376337597
2855,300.000767,300.025567,1,9000023,9000767,744,0.7445909470540566
2856,300.026867,300.072333,1,9000806,9002169,1363,0.7023048871627751
2857,300.080867,300.127767,1,9002426,9003833,1407,0.7103296355822137
2858,300.149533,300.159767,1,9004485,9004793,308,0.02417174471125789
2859,300.160933,300.193733,1,9004827,9005811,984,0.15975331669525378
2860,300.290167,300.5138,1,9008705,9015414,6709,0.8380589670291018
2861,300.5431,300.569867,1,9016293,9017096,803,0.7774509829908165
2862,300.5735,300.6625,1,9017205,9019875,2670,0.8400113123576439
2863,300.931567,301.054633,1,9027947,9031638,3691,0.7890080429974878
2864,301.0705,301.075533,1,9032115,9032265,150,0.18013262480514675
2865,301.077067,301.1089,1,9032312,9033267,955,0.7773294558606516
2866,301.1254,301.1849,1,9033762,9035547,1785,0.6834139292009378
2867,301.1912,301.196867,1,9035736,9035906,170,0.4098559947966829
2868,301.204067,301.2286,1,9036122,9036858,736,0.5951280689115148
2869,301.262533,301.2676,1,9037875,9038028,153,
2870,301.280033,301.300433,1,9038400,9039012,612,0.2514339425375905
2871,301.303767,301.313467,1,9039113,9039404,291,0.34925990977131655
2872,301.314867,301.336233,1,9039446,9040086,640,-0.041505493890536226
2873,301.355433,301.375567,1,9040662,9041267,605,0.7980196305794678
2874,301.377867,301.462933,1,9041336,9043887,2551,0.7598107368932518
2875,301.468033,301.4718,1,9044040,9044154,114,
2876,301.496467,301.5011,1,9044894,9045033,139,0.08434584283862112
2877,301.5096,301.513933,1,9045288,9045417,129,-0.016867782823108905
2878,301.705367,301.785667,1,9051161,9053570,2409,0.7088935662129539
2879,301.793233,301.801333,1,9053796,9054039,243,0.6217682488937359
2880,301.803133,301.955467,1,9054093,9058664,4571,0.7816689850224343
2881,301.961867,301.9649,1,9058856,9058947,91,-0.469682927895137
2882,302.2082,302.216133,1,9066246,9066483,237,0.5267299615679362
2883,302.218533,302.2342,1,9066555,9067026,471,0.7778614999412691
2884,302.236233,302.259367,1,9067086,9067781,695,0.6584511866566163
2885,302.277433,302.299967,1,9068322,9068999,677,0.7548532905212678
2886,302.3317,302.3488,1,9069951,9070464,513,0.8924969495013557
2887,302.3541,302.362867,1,9070623,9070886,263,0.5643436262758234
2888,302.368467,302.451,1,9071054,9073530,2476,0.7739676321381522
2889,302.4609,302.513433,1,9073827,9075402,1575,0.8329788702357663
2890,302.514567,302.5643,1,9075437,9076929,1492,0.7661642294478211
2891,302.5768,302.636467,1,9077304,9079094,1790,0.8513005894613088
2892,302.638533,302.6466,1,9079155,9079398,243,0.7803922150455453
2893,302.8908,302.963033,1,9086724,9088890,2166,0.7011476524728597
2894,302.971767,302.9811,1,9089153,9089433,280,0.7268571511347426
2895,302.989867,303.048667,1,9089696,9091460,1764,0.34059670456462643
2896,303.056033,303.087333,1,9091680,9092619,939,0.6179082566100743
2897,303.093833,303.1478,1,9092814,9094434,1620,0.6253327499206512
2898,303.157767,303.161367,1,9094733,9094841,108,0.4121445650723515
2899,303.162367,303.205367,1,9094871,9096161,1290,0.6539013180483695
2900,303.222767,303.227,1,9096683,9096810,127,0.27378240028997947
2901,303.237933,303.2494,1,9097137,9097482,345,0.573850078124289
2902,303.251467,303.258167,1,9097544,9097745,201,0.5675699513832198
2903,303.278267,303.353733,1,9098348,9100611,2263,0.3667027509211806
2904,303.355533,303.380167,1,9100665,9101405,740,0.014604271567890539
2905,303.402933,303.408533,1,9102087,9102255,168,0.1531291520530323
2906,303.4166,303.444767,1,9102498,9103343,845,0.3548026383365433
2907,303.4533,303.466433,1,9103599,9103992,393,0.20541045953466927
2908,303.472367,303.4811,1,9104171,9104433,262,0.06539064758043198
2909,303.486067,303.494,1,9104582,9104820,238,-0.03228988047613227
2910,303.5059,303.511867,1,9105177,9105356,179,0.033786604144637675
2911,303.5168,303.634767,1,9105504,9109043,3539,0.7907255954536939
2912,303.673133,303.683567,1,9110193,9110507,314,0.40446248422041825
2913,303.697833,303.7063,1,9110934,9111189,255,0.004353921307244351
2914,303.7096,303.720367,1,9111288,9111611,323,0.41516209974763146
2915,303.7218,303.734267,1,9111654,9112028,374,0.18438060234182307
2916,303.7665,303.773833,1,9112995,9113214,219,0.2735539893733541
2917,303.7801,303.783967,1,9113403,9113519,116,-0.20081179739868932
2918,303.785433,303.817267,1,9113562,9114518,956,0.1223723542001996
2919,303.831133,303.852033,1,9114933,9115560,627,0.10989053327662747
2920,303.854033,303.861933,1,9115620,9115857,237,-0.06079099323651329
2921,303.864067,303.869233,1,9115922,9116076,154,
2922,303.904433,303.9099,1,9117132,9117297,165,
2923,303.911933,304.028333,1,9117357,9120849,3492,0.7815059073686256
2924,304.030833,304.067233,1,9120924,9122016,1092,0.794075958668087
2925,304.069,304.106467,1,9122070,9123194,1124,0.7789309815294172
2926,304.107867,304.2587,1,9123236,9127761,4525,0.8256009655597414
2927,304.307933,304.3119,1,9129237,9129357,120,-0.33371541552036393
2928,304.389867,304.3988,1,9131696,9131964,268,0.3648862979432596
2929,304.4092,304.4366,1,9132276,9133098,822,0.16819899320306908
2930,304.465567,304.471867,1,9133967,9134156,189,-0.00960782913087723
2931,304.475033,304.482967,1,9134250,9134489,239,-0.3912731156279947
2932,304.5459,304.621433,1,9136377,9138642,2265,0.7410515557785912
2933,304.626,304.650033,1,9138780,9139500,720,0.6474348773777437
2934,304.6825,304.692533,1,9140475,9140775,300,0.5120651647990272
2935,304.6996,304.702933,1,9140988,9141087,99,-0.10539886688032835
2936,304.720733,304.725333,1,9141621,9141759,138,
2937,305.093967,305.151667,1,9152819,9154550,1731,0.7836307930392068
2938,305.153467,305.1576,1,9154604,9154728,124,-0.376829874773047
2939,305.158967,305.221567,1,9154769,9156647,1878,0.8127063305514663
2940,305.230867,305.244867,1,9156926,9157346,420,0.02556966864745765
2941,305.250933,305.274833,1,9157527,9158244,717,0.23391754093287206
2942,305.2811,305.284967,1,9158433,9158549,116,0.04183278974691373
2943,305.307367,305.324033,1,9159221,9159720,499,0.2621232667039966
2944,305.325167,305.3621,1,9159755,9160863,1108,0.252146125397645
2945,305.371933,305.3933,1,9161157,9161799,642,0.20370276793026593
2946,305.3943,305.402833,1,9161829,9162084,255,0.01843395435426451
2947,305.424467,305.534667,1,9162734,9166040,3306,0.8777738825381114
2948,305.555633,305.560333,1,9166668,9166809,141,-0.11001344681322585
2949,305.586367,305.594067,1,9167591,9167822,231,-0.03650363141896159
2950,305.681233,305.7113,1,9170436,9171339,903,0.15568591902918405
2951,305.713433,305.716567,1,9171402,9171497,95,
2952,305.727733,305.732267,1,9171831,9171968,137,0.4682618647712404
2953,305.742367,305.749467,1,9172271,9172484,213,0.30715597467637756
2954,305.8308,305.868267,1,9174924,9176048,1124,0.4822737362121942
2955,305.882833,305.904,1,9176484,9177120,636,0.6211023339859321
2956,305.9292,305.938133,1,9177876,9178143,267,0.6982191075784274
2957,305.9568,305.977067,1,9178704,9179312,608,0.8930537961152084
2958,305.978333,305.997633,1,9179349,9179928,579,0.16453318166055036
2959,306.011967,306.028567,1,9180359,9180857,498,0.060591452634860245
2960,306.031733,306.046533,1,9180951,9181395,444,0.1952102137862308
2961,306.0509,306.063433,1,9181527,9181902,375,0.06057148373674174
2962,306.0645,306.072333,1,9181935,9182169,234,-0.1100519278741336
2963,306.0878,306.102067,1,9182634,9183062,428,0.49235264931738687
2964,306.103533,306.108767,1,9183105,9183263,158,-0.19811479290900827
2965,306.110067,306.134067,1,9183302,9184022,720,0.3439835189293937
2966,306.1378,306.142367,1,9184134,9184271,137,0.7177377823302603
2967,306.1452,306.2081,1,9184356,9186243,1887,0.6114068861571066
2968,306.209433,306.277767,1,9186282,9188333,2051,0.6435207301187343
2969,306.279233,306.2849,1,9188376,9188547,171,0.3617572903137119
2970,306.289233,306.330167,1,9188676,9189905,1229,0.14336073467297772
2971,306.333933,306.3778,1,9190017,9191334,1317,0.10967562444943298
2972,306.383533,306.395333,1,9191505,9191859,354,0.45746399255386455
2973,306.402733,306.427433,1,9192081,9192822,741,0.18356676471655595
2974,306.446667,306.4545,1,9193400,9193635,235,-0.032159207925017225
2975,306.455667,306.466733,1,9193670,9194001,331,-0.08919094491099966
2976,306.471833,306.482233,1,9194154,9194466,312,0.28143327441512056
2977,306.486567,306.491867,1,9194597,9194756,159,-0.26347328305257184
2978,306.5138,306.528967,1,9195414,9195869,455,0.4382659909090114
2979,306.530267,306.535067,1,9195908,9196052,144,0.08427110980501228
2980,306.538667,306.559667,1,9196160,9196790,630,0.15484856299026062
2981,306.573967,306.595733,1,9197219,9197871,652,0.16285942489652544
2982,306.597,306.609367,1,9197910,9198281,371,0.0900320773477809
2983,306.627267,306.632533,1,9198818,9198975,157,0.25071558180363046
2984,306.640333,306.645067,1,9199209,9199352,143,0.3673825902931542
2985,306.646367,306.651367,1,9199391,9199541,150,-0.25340691293188333
2986,306.657667,306.6739,1,9199730,9200217,487,0.6333739896668157
2987,306.675767,306.709633,1,9200273,9201288,1015,0.8513761618439797
2988,306.713767,306.7269,1,9201413,9201807,394,0.7142317737963735
2989,306.7282,306.758867,1,9201846,9202766,920,0.8543870824327436
2990,306.763833,306.774567,1,9202914,9203237,323,-0.11031096360255845
2991,306.793167,306.802633,1,9203795,9204078,283,-0.0394107311249184
2992,306.815333,306.8218,1,9204459,9204654,195,-0.004015413422649011
2993,306.8435,306.856533,1,9205305,9205695,390,0.3875924885580911
2994,306.8577,306.869767,1,9205731,9206093,362,0.1595178234420389
2995,306.903967,306.907333,1,9207119,9207219,100,
2996,306.911067,306.915867,1,9207332,9207476,144,
2997,306.924633,306.944633,1,9207738,9208338,600,0.287000679800312
2998,306.9579,307.0749,1,9208737,9212247,3510,0.8715349330611538
2999,307.116333,307.120733,1,9213489,9213621,132,-0.219811038383187
3000,307.127933,307.1313,1,9213837,9213939,102,
3001,307.433367,307.4427,1,9223001,9223281,280,0.5333431296741792
3002,307.455567,307.458733,1,9223667,9223761,94,0.46493075904164666
3003,307.4703,307.489333,1,9224109,9224679,570,0.5537700045271795
3004,307.490667,307.507,1,9224720,9225210,490,0.6368461831040955
3005,307.5427,307.547833,1,9226281,9226434,153,0.26106553041960784
3006,307.553633,307.573533,1,9226608,9227205,597,0.4741011395420392
3007,307.585,307.6352,1,9227550,9229056,1506,0.5072576997548045
3008,307.653333,307.6723,1,9229599,9230169,570,0.6189686056625999
3009,307.690633,307.705667,1,9230718,9231170,452,0.5456741229494046
3010,307.713667,307.724467,1,9231410,9231734,324,0.4250799456994263
3011,307.742233,307.750733,1,9232266,9232521,255,0.1689185492278028
3012,307.753,307.762933,1,9232590,9232887,297,-0.05945052712349877
3013,307.769133,307.833067,1,9233073,9234992,1919,0.5069482066555454
3014,307.836067,308.000833,1,9235082,9240024,4942,0.7660187158438404
3015,308.011767,308.109067,1,9240353,9243272,2919,0.8036467313660117
3016,308.1105,308.113767,1,9243315,9243413,98,-0.1637355489962354
3017,308.240433,308.2478,1,9247212,9247434,222,0.3314056276990489
3018,308.2515,308.2853,1,9247545,9248559,1014,0.3150463896047115
3019,308.293633,308.303467,1,9248808,9249104,296,-0.037020868307367796
3020,308.3158,308.3251,1,9249474,9249753,279,-0.15222140421790026
3021,308.333867,308.338133,1,9250016,9250143,127,-0.38187393999480485
3022,308.355433,308.3613,1,9250662,9250839,177,
3023,308.3771,308.387833,1,9251313,9251634,321,0.10142245817499686
3024,308.393633,308.407033,1,9251808,9252210,402,0.657140186918434
3025,308.4081,308.442,1,9252243,9253260,1017,0.7694170869563038
3026,308.4535,308.4881,1,9253605,9254643,1038,0.8026522720456383
3027,308.5246,308.5315,1,9255738,9255945,207,-0.1266638061177186
3028,308.5325,308.5376,1,9255975,9256128,153,-0.0867159567160715
3029,308.5549,308.5583,1,9256647,9256749,102,
3030,308.816667,308.823267,1,9264500,9264698,198,0.6037682688833601
3031,308.824567,308.841367,1,9264737,9265241,504,0.7096184982784841
3032,308.848767,308.863767,1,9265463,9265913,450,0.8152118716161872
3033,308.865833,308.8772,1,9265974,9266316,342,0.8419911851315989
3034,308.888433,308.943067,1,9266652,9268292,1640,0.8059746889679427
3035,308.948533,308.990933,1,9268455,9269727,1272,0.7771232215581274
3036,309.0138,309.0175,1,9270414,9270525,111,
3037,309.025433,309.0478,1,9270762,9271434,672,0.012139002386195696
3038,309.049667,309.0627,1,9271490,9271881,391,0.0025270877552195994
3039,309.072267,309.080967,1,9272168,9272429,261,-0.03461562219599761
3040,309.137067,309.165333,1,9274112,9274959,847,0.40274488011184495
3041,309.171967,309.207733,1,9275159,9276231,1072,0.09784060654037154
3042,309.209,309.3267,1,9276270,9279801,3531,0.8349207999237407
3043,309.356,309.365933,1,9280680,9280977,297,-0.061870889142109524
3044,309.391733,309.395067,1,9281751,9281852,101,0.012243484196900054
3045,309.522167,309.5482,1,9285665,9286446,781,0.2510237117682376
3046,309.553,309.716233,1,9286590,9291486,4896,0.8204449014990071
3047,309.7182,309.7325,1,9291546,9291975,429,0.8285542030173091
3048,309.736367,309.740567,1,9292091,9292217,126,
3049,309.749967,309.794667,1,9292499,9293840,1341,0.7204567329612847
3050,309.801567,309.885533,1,9294047,9296565,2518,0.8154889557086714
3051,309.8867,309.8908,1,9296601,9296724,123,0.6408381736310989
3052,309.8933,309.925167,1,9296799,9297755,956,0.7667828592940112
3053,309.938667,309.942267,1,9298160,9298268,108,0.338251854597367
3054,309.9533,309.968833,1,9298599,9299064,465,0.03239900361646572
3055,309.991567,309.999133,1,9299747,9299973,226,-0.06387734927613654
3056,310.003,310.0062,1,9300090,9300186,96,
3057,310.047367,310.218933,1,9301421,9306567,5146,0.5784303288630007
3058,310.2201,310.2241,1,9306603,9306723,120,
3059,310.2252,310.231967,1,9306756,9306959,203,0.3707952125347066
3060,310.2497,310.359933,1,9307491,9310797,3306,0.8145778610703915
3061,310.3664,310.442633,1,9310992,9313278,2286,0.8180823939082172
3062,310.465133,310.550733,1,9313953,9316521,2568,0.8190487909506308
3063,310.560967,310.566467,1,9316829,9316994,165,0.7154275406692412
3064,310.573667,310.583233,1,9317210,9317496,286,0.16375363886187383
3065,310.589933,310.608233,1,9317697,9318246,549,0.09452783047485096
3066,310.617033,310.622333,1,9318510,9318669,159,0.44801287696866404
3067,310.697633,310.845433,1,9320928,9325362,4434,0.7465915330610003
3068,310.885967,310.8991,1,9326579,9326973,394,0.7474621853210373
3069,310.901733,310.9236,1,9327051,9327708,657,0.5700464144330241
3070,310.931833,311.031,1,9327954,9330930,2976,0.789487761261988
3071,311.034133,311.0936,1,9331023,9332808,1785,0.6810081081744472
3072,311.102467,311.1181,1,9333074,9333543,469,0.6785588326120541
3073,311.120667,311.134833,1,9333620,9334044,424,0.5043063395369677
3074,311.181933,311.186033,1,9335457,9335580,123,-0.08697844238084335
3075,311.195333,311.2043,1,9335859,9336129,270,0.02644859505671878
3076,311.2375,311.314767,1,9337125,9339443,2318,0.43563396767554935
3077,311.327033,311.334833,1,9339810,9340044,234,0.30899640532405825
3078,311.336767,311.344767,1,9340103,9340343,240,0.633342281991294
3079,311.355167,311.365033,1,9340655,9340950,295,0.6085663116598847
3080,311.369667,311.531,1,9341090,9345930,4840,0.7856319320921196
3081,311.548967,311.631967,1,9346469,9348959,2490,0.7348933088027116
3082,311.6331,311.636633,1,9348993,9349098,105,0.5576186765242656
3083,311.638067,311.643067,1,9349142,9349292,150,-0.08792012599312896
3084,311.662133,311.746433,1,9349863,9352392,2529,0.7510206803318483
3085,311.765633,311.770933,1,9352968,9353127,159,-0.04376051146414912
3086,311.8482,311.917167,1,9355446,9357515,2069,0.3931929099481454
3087,311.925133,311.928967,1,9357753,9357869,116,0.034860936370172874
3088,311.930533,311.940633,1,9357915,9358218,303,0.25543640551603225
3089,312.001667,312.007667,1,9360050,9360230,180,-0.023892524908401328
3090,312.015067,312.032767,1,9360452,9360983,531,0.782847129609492
3091,312.034033,312.163367,1,9361020,9364901,3881,0.7965438294380964
3092,312.164633,312.2064,1,9364938,9366192,1254,0.8051741494477826
3093,312.2125,312.287667,1,9366375,9368630,2255,0.7246819362253925
3094,312.292767,312.3173,1,9368783,9369519,736,0.7989525408280466
3095,312.323267,312.339833,1,9369698,9370194,496,0.796874602324729
3096,312.365667,312.402367,1,9370970,9372071,1101,0.09495959766487112
3097,312.404467,312.4292,1,9372134,9372876,742,0.3107759588020959
3098,312.442,312.448067,1,9373260,9373442,182,0.5179459055823684
3099,312.449233,312.699367,1,9373476,9380981,7505,0.6911099609307227
3100,312.733833,312.739167,1,9382014,9382175,161,0.7341424228321336
3101,312.767667,312.7708,1,9383030,9383124,94,
3102,312.898933,312.916233,1,9386967,9387486,519,0.59176849522598
3103,312.928767,312.942833,1,9387863,9388284,421,0.007946746277291467
3104,312.953367,312.959,1,9388601,9388770,169,0.006128818316324083
3105,312.961933,312.966367,1,9388857,9388991,134,-0.06032222423065557
3106,313.0136,313.041167,1,9390408,9391235,827,0.6617840357381869
3107,313.0526,313.073533,1,9391578,9392205,627,0.7574564631121471
3108,313.087,313.142633,1,9392610,9394278,1668,0.7756607976945691
3109,313.151033,313.174033,1,9394530,9395220,690,0.7438692071708912
3110,313.175533,313.261733,1,9395265,9397851,2586,0.6996901381150894
3111,313.264767,313.311767,1,9397943,9399353,1410,0.6228878036413995
3112,313.312933,313.337167,1,9399387,9400115,728,0.7801404083712632
3113,313.3418,313.400933,1,9400254,9402027,1773,0.7178555321095547
3114,313.405667,313.4373,1,9402170,9403119,949,0.7542838039241299
3115,313.4482,313.4512,1,9403446,9403536,90,
3116,313.460733,313.475567,1,9403821,9404267,446,0.024302795667445608
3117,313.477667,313.5054,1,9404330,9405162,832,0.1603119672635459
3118,313.5364,313.656567,1,9406092,9409697,3605,0.7135411304364726
3119,313.700933,313.713833,1,9411027,9411414,387,0.008628087794278101
3120,313.754733,313.826567,1,9412641,9414797,2156,0.5992501438123126
3121,313.829033,313.8366,1,9414870,9415098,228,0.17064044397460018
3122,313.837867,313.847967,1,9415136,9415439,303,-0.2269355545586844
3123,313.859733,313.867,1,9415791,9416010,219,0.3704628347220487
3124,314.0135,314.1732,1,9420405,9425196,4791,0.7951482742895547
3125,314.181967,314.193133,1,9425459,9425793,334,0.33270849644305894
3126,314.2105,314.229333,1,9426315,9426879,564,0.8051523535554009
3127,314.231233,314.314367,1,9426936,9429431,2495,0.810039346579115
3128,314.317633,314.3819,1,9429528,9431457,1929,0.7769202892630042
3129,314.385933,314.5083,1,9431577,9435249,3672,0.8091603535877645
3130,314.5344,314.541167,1,9436032,9436235,203,-0.10131492577929561
3131,314.542867,314.549533,1,9436286,9436485,199,0.07364358653083042
3132,314.6141,314.668733,1,9438423,9440061,1638,0.5311726186616772
3133,314.907467,315.051333,1,9447224,9451539,4315,0.7210916063472455
3134,315.053467,315.142867,1,9451604,9454286,2682,0.7807108305516544
3135,315.1634,315.1674,1,9454902,9455022,120,-0.06093453604225377
3136,315.1691,315.180267,1,9455073,9455408,335,-0.024654978246297053
3137,315.1814,315.185133,1,9455442,9455553,111,
3138,315.1912,315.2003,1,9455736,9456009,273,0.18670288417815042
3139,315.203567,315.2112,1,9456107,9456336,229,-0.21079081614786185
3140,315.271267,315.274767,1,9458138,9458243,105,
3141,315.29,315.351,1,9458700,9460530,1830,0.4909361963751396
3142,315.373933,315.377233,1,9461217,9461316,99,-0.09681423719924266
3143,315.382867,315.3861,1,9461486,9461583,97,-0.2601414837482409
3144,315.3878,315.394267,1,9461634,9461828,194,0.24179850271417042
3145,315.402167,315.405667,1,9462065,9462170,105,0.13468768654587612
3146,315.4921,315.5635,1,9464763,9466905,2142,0.7874578678719201
3147,315.5651,315.581933,1,9466953,9467457,504,0.7898829424576407
3148,315.584167,315.591267,1,9467525,9467738,213,0.8116266940883011
3149,315.596533,315.640233,1,9467895,9469206,1311,0.820865875314214
3150,315.660767,315.784433,1,9469823,9473532,3709,0.7405261621718483
3151,315.789,315.866667,1,9473670,9476000,2330,0.66555786287737
3152,315.8704,315.8775,1,9476112,9476325,213,0.5728260908605866
3153,315.881933,316.011267,1,9476457,9480338,3881,0.33003390602737814
3154,316.066967,316.071567,1,9482009,9482147,138,0.20789001817045732
3155,316.108133,316.126733,1,9483243,9483801,558,0.21009500813323892
3156,316.128967,316.136933,1,9483869,9484107,238,0.8596821501764043
3157,316.137967,316.169133,1,9484139,9485073,934,0.7176560138394724
3158,316.170133,316.174333,1,9485103,9485229,126,0.09948248125394352
3159,316.175733,316.2141,1,9485271,9486423,1152,0.8169906683048399
3160,316.2297,316.2537,1,9486891,9487611,720,-0.07146667632242217
3161,316.2561,316.261333,1,9487683,9487839,156,0.07502148937232743
3162,316.269833,316.275067,1,9488094,9488252,158,0.5602064602832593
3163,316.281267,316.401333,1,9488438,9492039,3601,0.7872895366998102
3164,316.5032,316.5945,1,9495096,9497835,2739,0.46058136570818414
3165,316.5963,316.620667,1,9497889,9498620,731,0.05115653532876849
3166,316.624033,316.632667,1,9498720,9498980,260,0.27792634432635166
3167,316.6346,316.638933,1,9499038,9499167,129,0.2666489385930382
3168,316.663167,316.6663,1,9499895,9499989,94,-0.3197231534462628
3169,316.6757,316.683467,1,9500271,9500504,233,0.2490453010189558
3170,317.0325,317.0399,1,9510975,9511197,222,0.6564391975684313
3171,317.042733,317.050667,1,9511281,9511520,239,0.5516723329929296
3172,317.0625,317.070467,1,9511875,9512114,239,0.5927298765439905
3173,317.0823,317.0876,1,9512469,9512628,159,0.5012680384543207
3174,317.0922,317.100267,1,9512766,9513008,242,0.4446251181600529
3175,317.1019,317.1149,1,9513057,9513447,390,0.6483078575916634
3176,317.117133,317.1304,1,9513513,9513912,399,0.7199859403298392
3177,317.1546,317.1718,1,9514638,9515154,516,0.5168605789996031
3178,317.206,317.213,1,9516180,9516390,210,0.5627499806718199
3179,317.227433,317.239667,1,9516822,9517190,368,0.38746478879777624
3180,317.258167,317.275267,1,9517745,9518258,513,0.29219470688685495
3181,317.276733,317.301033,1,9518301,9519030,729,0.6647684609736818
3182,317.325433,317.330633,1,9519762,9519918,156,0.4252107387076614
3183,317.3332,317.346167,1,9519996,9520385,389,0.6648716544920082
3184,317.369,317.378467,1,9521070,9521354,284,0.493356456007141
3185,317.3844,317.392267,1,9521532,9521768,236,0.37140794684834844
3186,317.429033,317.442567,1,9522870,9523277,407,0.40744689243902055
3187,317.450467,317.4793,1,9523514,9524379,865,-0.01051396611557996
3188,317.480533,317.495367,1,9524415,9524861,446,0.23041902176055162
3189,317.5001,317.506433,1,9525003,9525192,189,-0.06290450239116017
3190,317.5214,317.526467,1,9525642,9525794,152,-0.21929397900836892
3191,317.533633,317.602367,1,9526008,9528071,2063,0.7410015540141156
3192,317.613767,317.633,1,9528413,9528990,577,0.33750318136582785
3193,317.634567,317.6401,1,9529037,9529203,166,
3194,317.654433,317.659267,1,9529632,9529778,146,0.679863263565369
3195,317.664733,317.711567,1,9529941,9531347,1406,0.02107191116873896
3196,317.757167,317.763933,1,9532715,9532917,202,0.3896857067135027
3197,317.765,317.768733,1,9532950,9533061,111,0.5985338613838935
3198,317.7737,317.799667,1,9533211,9533990,779,0.25649374710477657
3199,317.811733,317.8362,1,9534351,9535086,735,0.05044609673975713
3200,317.837833,317.861467,1,9535134,9535844,710,0.25986616675444374
3201,317.869567,318.027967,1,9536087,9540839,4752,0.7420798181820002
3202,318.035333,318.064,1,9541059,9541920,861,0.8038665336283756
3203,318.066467,318.097467,1,9541994,9542924,930,0.7403522523371169
3204,318.1157,318.203867,1,9543471,9546116,2645,0.7131077641828817
3205,318.224733,318.297733,1,9546741,9548931,2190,0.6846719452507462
3206,318.309767,318.3521,1,9549293,9550563,1270,0.48360111372750153
3207,318.3532,318.366967,1,9550596,9551009,413,0.48353575683587624
3208,318.411967,318.4151,1,9552359,9552453,94,-0.2413150089171809
3209,318.485733,318.506367,1,9554571,9555191,620,0.6014128515585072
3210,318.536667,318.545433,1,9556100,9556362,262,0.4159454849959023
3211,318.610733,318.619267,1,9558321,9558578,257,0.36362550922210524
3212,318.903733,318.9129,1,9567111,9567387,276,0.6763352598713811
3213,318.914,318.919033,1,9567420,9567570,150,0.012960269778094308
3214,318.925967,318.9925,1,9567779,9569775,1996,0.5473404315965645
3215,319.008367,319.0448,1,9570251,9571344,1093,0.6524779747203852
3216,319.050267,319.054733,1,9571508,9571641,133,0.28130069207614755
3217,319.058067,319.097967,1,9571742,9572939,1197,0.5335846626200352
3218,319.110067,319.118633,1,9573302,9573558,256,0.4891143719518999
3219,319.145633,319.1514,1,9574368,9574542,174,-0.017887522570349902
3220,319.1536,319.166133,1,9574608,9574983,375,0.0029170447208642456
3221,319.1687,319.207133,1,9575061,9576213,1152,0.2128909205312323
3222,319.2221,319.344,1,9576663,9580320,3657,0.796005043146624
3223,319.585133,319.591567,1,9587553,9587747,194,0.7438016752611051
3224,319.592633,319.7572,1,9587778,9592716,4938,0.7567957124453312
3225,319.767033,319.846367,1,9593010,9595391,2381,0.7569158474500586
3226,319.9349,320.016533,1,9598047,9600495,2448,0.4396690481412304
3227,320.017533,320.021467,1,9600525,9600644,119,-0.3424887205478785
3228,320.040267,320.048233,1,9601208,9601446,238,0.5166995347506601
3229,320.057333,320.061333,1,9601719,9601839,120,0.3529993339831294
3230,320.258467,320.280033,1,9607754,9608400,646,0.7240634278773714
3231,320.3024,320.323167,1,9609072,9609695,623,0.7562584686339857
3232,320.328767,320.3868,1,9609863,9611604,1741,0.7913982976746473
3233,320.3954,320.4225,1,9611862,9612675,813,0.727678835504291
3234,320.431067,320.5013,1,9612932,9615039,2107,0.7537076823170478
3235,320.505167,320.541567,1,9615155,9616247,1092,0.6678570859793138
3236,320.565567,320.580233,1,9616967,9617406,439,0.08691227120192281
3237,320.600367,320.7302,1,9618011,9621906,3895,0.7605727979815091
3238,320.7363,320.832867,1,9622089,9624986,2897,0.7644253073895033
3239,320.8532,320.858733,1,9625596,9625761,165,-0.11057158234353429
3240,320.869767,320.8746,1,9626093,9626238,145,
3241,320.999633,321.048067,1,9629988,9631442,1454,0.5734151522410708
3242,321.0645,321.069033,1,9631935,9632070,135,0.7117617798214806
3243,321.076,321.079767,1,9632280,9632393,113,0.11671375720431469
3244,321.251733,321.333567,1,9637551,9640007,2456,0.6936709517066726
3245,321.345767,321.3712,1,9640373,9641136,763,0.7230710229975611
3246,321.3955,321.425667,1,9641865,9642770,905,0.7706966965693188
3247,321.438533,321.5008,1,9643155,9645024,1869,0.7764218221901419
3248,321.5176,321.520733,1,9645528,9645621,93,
3249,321.524233,321.5497,1,9645726,9646491,765,0.512196821862562
3250,321.573833,321.6132,1,9647214,9648396,1182,0.06087293348203013
3251,321.618267,321.630167,1,9648548,9648905,357,0.2251126436666879
3252,321.631633,321.643833,1,9648948,9649314,366,0.3417746345298045
3253,321.6639,321.704567,1,9649917,9651137,1220,0.5361231305290471
3254,321.725567,321.7344,1,9651767,9652032,265,0.1804984352986003
3255,321.836433,321.8524,1,9655092,9655572,480,0.25194334693606796
3256,321.8542,321.945367,1,9655626,9658361,2735,0.7417855792190532
3257,322.039833,322.083067,1,9661194,9662492,1298,0.6089431906117765
3258,322.090267,322.0958,1,9662708,9662874,166,0.4915594348290135
3259,322.102467,322.115233,1,9663074,9663456,382,0.12081920653236963
3260,322.4615,322.486033,1,9673845,9674580,735,0.5002159336253303
3261,322.518433,322.537233,1,9675552,9676116,564,0.6068086630864108
3262,322.543633,322.546867,1,9676308,9676406,98,0.7804231634941228
3263,322.568633,322.5737,1,9677058,9677211,153,0.6972460464601434
3264,322.5935,322.602233,1,9677805,9678066,261,0.4351952757081835
3265,322.6419,322.650767,1,9679257,9679523,266,0.3222098924897159
3266,322.659067,322.6668,1,9679772,9680004,232,0.008088185339729867
3267,322.676967,322.6852,1,9680309,9680556,247,0.1625687675671709
3268,322.6906,322.7119,1,9680718,9681357,639,0.15563501757899825
3269,322.737267,322.871533,1,9682118,9686145,4027,0.7430058721134011
3270,322.875967,322.914833,1,9686279,9687444,1165,0.7970159813446218
3271,322.916733,322.9477,1,9687501,9688431,930,0.7810430962824387
3272,322.9634,323.045933,1,9688902,9691377,2475,0.7666703458661955
3273,323.0691,323.090167,1,9692073,9692705,632,0.016367677186129706
3274,323.0912,323.097867,1,9692736,9692936,200,0.18103795025976854
3275,323.102633,323.1075,1,9693078,9693225,147,0.24286810148897497
3276,323.1101,323.1142,1,9693303,9693426,123,
3277,323.154167,323.158167,1,9694625,9694745,120,0.47795233477725796
3278,323.1602,323.191667,1,9694806,9695750,944,0.10238576325162846
3279,323.194733,323.230033,1,9695841,9696900,1059,0.05304066696597453
3280,323.2313,323.243933,1,9696939,9697317,378,0.2103698418259821
3281,323.2868,323.533833,1,9698604,9706014,7410,0.36254622007903875
3282,323.536067,323.575,1,9706082,9707250,1168,0.5387896010511796
3283,323.579067,323.592433,1,9707372,9707772,400,0.4265095625760895
3284,323.593567,323.798367,1,9707807,9713951,6144,0.31687148044272645
3285,323.819967,323.827733,1,9714599,9714831,232,0.5807827626132437
3286,324.158167,324.166033,1,9724745,9724980,235,0.5946577670498935
3287,324.1949,324.199633,1,9725847,9725988,141,0.5861666956625716
3288,324.595867,324.630567,1,9737876,9738917,1041,0.601714718418969
3289,324.6358,324.658833,1,9739074,9739764,690,0.5849288256809596
3290,324.660667,324.663967,1,9739820,9739919,99,0.1409765998432907
3291,324.666367,324.696833,1,9739991,9740904,913,0.22376276879836657
3292,324.6982,324.722933,1,9740946,9741687,741,0.17494622407716237
3293,324.730767,324.751867,1,9741923,9742556,633,0.4401778236349169
3294,324.753967,324.758933,1,9742619,9742767,148,0.620136215183446
3295,324.7619,324.804033,1,9742857,9744120,1263,0.15116347227192664
3296,324.815167,324.824567,1,9744455,9744737,282,0.2819883871737477
3297,324.830267,324.852267,1,9744908,9745568,660,0.30869446224896974
3298,324.878267,324.882333,1,9746348,9746469,121,0.008615127819127256
3299,324.883333,324.891567,1,9746499,9746747,248,0.280303349546837
3300,324.896767,324.916667,1,9746903,9747500,597,0.5847183797754818
3301,324.9278,324.9359,1,9747834,9748077,243,0.482379941924707
3302,324.973333,325.004267,1,9749199,9750128,929,0.15188515220989157
3303,325.005767,325.013933,1,9750173,9750417,244,-0.04345817459016003
3304,325.0323,325.036433,1,9750969,9751092,123,-0.026172101692255097
3305,325.042833,325.172433,1,9751284,9755172,3888,0.6949970278459127
3306,325.2106,325.218133,1,9756318,9756543,225,0.44659023468031483
3307,325.2193,325.223467,1,9756579,9756704,125,0.5624211845018473
3308,325.240133,325.320733,1,9757203,9759621,2418,0.7623595295536396
3309,325.3456,325.430967,1,9760368,9762929,2561,0.8059892922346545
3310,325.4326,325.435733,1,9762978,9763071,93,0.3482830502660629
3311,325.4867,325.490867,1,9764601,9764726,125,0.12174171221867579
3312,325.5251,325.528267,1,9765753,9765848,95,-0.08673237399889469
3313,325.548733,325.717067,1,9766461,9771512,5051,0.8245209094616581
3314,325.720567,325.7329,1,9771617,9771987,370,0.15463622339865282
3315,325.748733,325.777733,1,9772461,9773331,870,-0.00882006541060581
3316,325.784367,325.798733,1,9773531,9773961,430,0.3611848474922149
3317,325.8001,325.806333,1,9774003,9774189,186,0.02294666491971495
3318,325.829167,325.9788,1,9774875,9779364,4489,0.839513501484325
3319,325.9897,326.0599,1,9779691,9781797,2106,0.7717500834612651
3320,326.071133,326.161167,1,9782133,9784835,2702,0.7449530307783889
3321,326.1703,326.1863,1,9785109,9785589,480,0.10616568733134561
3322,326.1882,326.2249,1,9785646,9786747,1101,0.1715194220867982
3323,326.248233,326.3525,1,9787446,9790575,3129,0.827489041418834
3324,326.3573,326.4085,1,9790719,9792255,1536,0.12114716124061004
3325,326.414467,326.428367,1,9792434,9792851,417,0.2674112784299305
3326,326.429467,326.4374,1,9792884,9793122,238,0.1214280606067727
3327,326.4591,326.462333,1,9793773,9793869,96,0.47467515232310115
3328,326.4652,326.602133,1,9793956,9798063,4107,0.7994342466904953
3329,326.606233,326.628667,1,9798186,9798860,674,0.770735673365625
3330,326.631033,326.6348,1,9798930,9799044,114,0.5799479564743807
3331,326.636433,326.7225,1,9799092,9801675,2583,0.8128135168344637
3332,326.757533,326.7616,1,9802725,9802848,123,0.30074872811758085
3333,326.813367,326.8182,1,9804401,9804546,145,0.72050846162859
3334,326.829,326.871767,1,9804870,9806153,1283,0.684960617172125
3335,326.885,326.9227,1,9806550,9807681,1131,0.7333169340517516
3336,326.927667,326.953367,1,9807830,9808601,771,0.6464841023988142
3337,326.956433,326.9812,1,9808692,9809436,744,0.7077055328735817
3338,326.984133,327.025567,1,9809523,9810767,1244,0.8114690877177203
3339,327.041267,327.116033,1,9811238,9813480,2242,0.7714813031861383
3340,327.1387,327.169867,1,9814161,9815096,935,0.7864949260126881
3341,327.171633,327.285833,1,9815148,9818574,3426,0.7363012344715911
3342,327.294333,327.339367,1,9818829,9820181,1352,0.7966948008365411
3343,327.348167,327.356033,1,9820445,9820680,235,0.7098783855849862
3344,327.3642,327.384467,1,9820926,9821534,608,0.7046628515601937
3345,327.396333,327.425633,1,9821889,9822768,879,0.08639662883120591
3346,327.4271,327.447367,1,9822813,9823421,608,0.1257319888590189
3347,327.463167,327.670833,1,9823895,9830124,6229,0.8176839916029829
3348,327.7046,327.7401,1,9831138,9832203,1065,0.10164516719275103
3349,327.7482,327.751933,1,9832446,9832557,111,-0.4241493816644138
3350,327.759333,327.870867,1,9832779,9836126,3347,0.6990804540848894
3351,327.877767,327.8953,1,9836333,9836859,526,-0.02813211694101332
3352,327.9062,327.9218,1,9837186,9837654,468,0.26219498734443236
3353,327.929767,327.948067,1,9837893,9838442,549,0.028273217581316377
3354,327.968167,328.110233,1,9839045,9843306,4261,0.7497952576951221
3355,328.1168,328.134233,1,9843504,9844026,522,0.08088779698390922
3356,328.138167,328.1498,1,9844145,9844494,349,0.07455805154070562
3357,328.151433,328.170767,1,9844542,9845123,581,0.17643497520692888
3358,328.210433,328.232233,1,9846312,9846966,654,0.719662295326595
3359,328.233667,328.278933,1,9847010,9848367,1357,0.5545109594432132
3360,328.2805,328.326733,1,9848415,9849801,1386,0.7731471920604127
3361,328.3389,328.346467,1,9850167,9850394,227,0.23385583775141586
3362,328.350833,328.356933,1,9850524,9850707,183,0.19362658635272562
3363,328.712933,328.822367,1,9861387,9864671,3284,0.5843556893189839
3364,328.832367,328.8545,1,9864971,9865635,664,0.04329223355084762
3365,328.8694,328.8773,1,9866082,9866319,237,0.25599311083763043
3366,328.883267,328.905833,1,9866498,9867174,676,0.23443696526980834
3367,328.940833,329.018833,1,9868224,9870564,2340,0.6781883128049275
3368,329.022267,329.066633,1,9870668,9871998,1330,0.8038971587417012
3369,329.074967,329.080033,1,9872249,9872400,151,-0.08353598826471495
3370,329.081133,329.089967,1,9872433,9872699,266,0.0279959555116675
3371,329.091967,329.125333,1,9872759,9873759,1000,0.6294664603116782
3372,329.132067,329.218467,1,9873962,9876554,2592,0.7603637785344685
3373,329.229933,329.2532,1,9876897,9877596,699,0.0267369074425503
3374,329.256933,329.2801,1,9877707,9878403,696,0.17991003711121978
3375,329.283233,329.297233,1,9878496,9878916,420,0.13164579446611582
3376,329.3343,329.338533,1,9880029,9880155,126,0.7273649724691348
3377,329.345633,329.513,1,9880368,9885390,5022,0.7612072477404773
3378,329.517633,329.609567,1,9885528,9888287,2759,0.8069292139425217
3379,329.620567,329.639567,1,9888617,9889187,570,0.10720043391786253
3380,329.641133,329.671933,1,9889233,9890157,924,0.16926514707747706
3381,329.703267,329.8594,1,9891098,9895782,4684,0.8073081253354744
3382,329.863767,329.876467,1,9895913,9896294,381,0.5351052386481476
3383,329.886333,329.943667,1,9896589,9898310,1721,0.10426464640526578
3384,329.962567,330.015333,1,9898877,9900459,1582,0.7539637322537633
3385,330.0211,330.025867,1,9900633,9900776,143,
3386,330.0276,330.036633,1,9900828,9901098,270,0.6813310488278255
3387,330.0385,330.069067,1,9901155,9902072,917,0.859007387120015
3388,330.088433,330.1098,1,9902652,9903294,642,0.010783804102115883
3389,330.111533,330.117633,1,9903345,9903528,183,-0.044772197145419836
3390,330.129733,330.1335,1,9903891,9904005,114,
3391,330.1442,330.172233,1,9904326,9905166,840,0.6431722303522355
3392,330.184733,330.281733,1,9905541,9908451,2910,0.8040195144070194
3393,330.2854,330.385433,1,9908562,9911562,3000,0.8235245088032088
3394,330.3968,330.4017,1,9911904,9912051,147,0.32116772794350307
3395,330.416067,330.432367,1,9912482,9912971,489,0.06220965814654541
3396,330.4377,330.453033,1,9913131,9913590,459,-0.019024629936056314
3397,330.4633,330.468833,1,9913899,9914064,165,
3398,330.4706,330.483567,1,9914118,9914507,389,0.33514693934095685
3399,330.488033,330.6597,1,9914640,9919791,5151,0.8021630625707764
3400,330.664367,330.711967,1,9919931,9921359,1428,0.8165711314667452
3401,330.713133,330.734633,1,9921393,9922038,645,0.5404670838915907
3402,330.739833,330.779667,1,9922194,9923390,1196,0.8184125656685411
3403,330.7936,330.797,1,9923808,9923910,102,0.47915823233533844
3404,330.801167,330.819367,1,9924035,9924581,546,0.010445198868293239
3405,330.820467,330.827333,1,9924614,9924819,205,0.16441391226378024
3406,330.828867,330.8422,1,9924866,9925266,400,0.2995239419357622
3407,330.843933,330.8472,1,9925317,9925416,99,-0.3284582286567372
3408,330.848567,330.852833,1,9925457,9925584,127,0.3255923760514171
3409,330.882267,330.888767,1,9926468,9926663,195,0.21433761053525308
3410,330.8954,331.0172,1,9926862,9930516,3654,0.8455292114437255
3411,331.039467,331.068467,1,9931184,9932054,870,0.10157905405999196
3412,331.0722,331.084533,1,9932166,9932535,369,0.28186833362277247
3413,331.089067,331.098167,1,9932672,9932945,273,0.08489691209656773
3414,331.132233,331.256767,1,9933966,9937703,3737,0.8501243428214162
3415,331.267833,331.2748,1,9938034,9938244,210,0.418559150842161
3416,331.292,331.315167,1,9938760,9939455,695,0.2600817642268943
3417,331.316867,331.323633,1,9939506,9939708,202,0.1806522548385906
3418,331.327267,331.337,1,9939818,9940110,292,0.12955743709021733
3419,331.3382,331.353567,1,9940146,9940607,461,-0.0869840698109093
3420,331.3695,331.373033,1,9941085,9941190,105,0.7810320344733007
3421,331.375067,331.553633,1,9941252,9946608,5356,0.8513122295015167
3422,331.565233,331.6079,1,9946956,9948237,1281,0.8300874984607176
3423,331.615,331.623367,1,9948450,9948701,251,0.0249790121884881
3424,331.624933,331.662267,1,9948747,9949868,1121,0.1574280827036027
3425,331.6655,331.675467,1,9949965,9950264,299,0.027316450672556725
3426,331.677567,331.692,1,9950327,9950760,433,0.06263094232674798
3427,331.7078,331.8892,1,9951234,9956676,5442,0.8676371156894651
3428,331.9205,331.9382,1,9957615,9958146,531,0.7480064272463808
3429,331.940067,332.018333,1,9958202,9960549,2347,0.7652155359541262
3430,332.037667,332.053967,1,9961130,9961619,489,0.4188349259370583
3431,332.055633,332.0596,1,9961668,9961788,120,
3432,332.060733,332.084967,1,9961821,9962549,728,0.16057000295377108
3433,332.086933,332.1159,1,9962607,9963477,870,0.11235368229590804
3434,332.121467,332.130233,1,9963644,9963906,262,0.42254209756946537
3435,332.135467,332.279033,1,9964064,9968370,4306,0.8427769408458755
3436,332.288333,332.292333,1,9968649,9968769,120,-0.2156943957197094
3437,332.2961,332.335733,1,9968883,9970071,1188,-0.024087854884945692
3438,332.345233,332.353267,1,9970356,9970598,242,-0.08943663381494193
3439,332.380433,332.517267,1,9971412,9975518,4106,0.8454488880927433
3440,332.526767,332.538267,1,9975803,9976148,345,0.6614059177818611
3441,332.544733,332.5655,1,9976341,9976965,624,0.07628792593364733
3442,332.5684,332.5761,1,9977052,9977283,231,0.1639528723645515
3443,332.5818,332.591133,1,9977454,9977733,279,0.16606140401132535
3444,332.5947,332.604,1,9977841,9978120,279,-0.027252980989261134
3445,332.624367,332.638767,1,9978731,9979163,432,0.6024004802272093
3446,332.640233,332.680167,1,9979206,9980405,1199,0.803924737415047
3447,332.681367,332.684633,1,9980441,9980538,97,
3448,332.685767,332.738,1,9980573,9982140,1567,0.8305299724685855
3449,332.740533,332.760767,1,9982215,9982823,608,0.19500644768157943
3450,332.762467,332.799933,1,9982874,9983997,1123,0.03433635976255403
3451,332.8031,332.828633,1,9984093,9984858,765,0.18170508304608252
3452,332.830667,332.951033,1,9984920,9988530,3610,0.8673551397702843
3453,332.962933,333.054967,1,9988887,9991649,2762,0.8024132485418571
3454,333.144633,333.225533,1,9994338,9996765,2427,0.8291114553694588
3455,333.2277,333.344133,1,9996831,10000323,3492,0.8407215956430663
3456,333.3805,333.3879,1,10001415,10001637,222,0.5966121225876418
3457,333.399167,333.4189,1,10001975,10002567,592,0.10591632656425258
3458,333.4199,333.423167,1,10002597,10002695,98,
3459,333.431567,333.4374,1,10002947,10003122,175,0.01074762805464961
3460,333.4439,333.449233,1,10003317,10003476,159,
3461,333.4755,333.5281,1,10004265,10005843,1578,0.7587213603609441
3462,333.531033,333.589367,1,10005930,10007681,1751,0.8121349197726911
3463,333.590767,333.6389,1,10007723,10009167,1444,0.7118861477116916
3464,333.669067,333.6883,1,10010072,10010649,577,0.7426761301693571
3465,333.689533,333.762367,1,10010685,10012871,2186,0.7236522855440086
3466,333.764367,333.7789,1,10012931,10013367,436,0.8228640017254409
3467,333.780233,333.830033,1,10013406,10014900,1494,0.8233945788077295
3468,333.8541,333.890333,1,10015623,10016709,1086,0.7138079318489725
3469,333.892,333.8966,1,10016760,10016898,138,-0.20740448170379494
3470,333.902833,333.9235,1,10017084,10017705,621,-0.029632823080209876
3471,333.9246,333.972633,1,10017738,10019178,1440,0.3077588378809856
3472,334.0035,334.011267,1,10020105,10020338,233,0.18129559019209363
3473,334.0133,334.211533,1,10020399,10026345,5946,0.8257719242675686
3474,334.233033,334.236367,1,10026990,10027091,101,
3475,334.237767,334.2413,1,10027133,10027239,106,
3476,334.2459,334.263967,1,10027377,10027919,542,0.37458974423622227
3477,334.2662,334.270267,1,10027986,10028108,122,0.5670455503983368
3478,334.2769,334.303033,1,10028307,10029090,783,0.558557414842118
3479,334.312867,334.433533,1,10029386,10033005,3619,0.798011750040344
3480,334.4362,334.533533,1,10033086,10036005,2919,0.7660807307094296
3481,334.5463,334.567567,1,10036389,10037027,638,-0.037635536656956695
3482,334.569233,334.5782,1,10037076,10037346,270,0.1583828819813488
3483,334.582233,334.597667,1,10037466,10037930,464,0.16219308513561612
3484,334.6045,334.614167,1,10038135,10038425,290,0.02499073791232069
3485,334.6152,334.783133,1,10038456,10043493,5037,0.8002668936003885
3486,334.8098,334.839667,1,10044294,10045190,896,0.6442551315765288
3487,334.841133,334.938667,1,10045233,10048160,2927,0.7406346855784356
3488,334.940633,335.027033,1,10048218,10050810,2592,0.821011051774232
3489,335.029433,335.0512,1,10050882,10051536,654,0.8151183606044733
3490,335.054033,335.1441,1,10051620,10054323,2703,0.8027286662319936
3491,335.1462,335.1721,1,10054386,10055163,777,0.8743346050995352
3492,335.173867,335.266567,1,10055216,10057997,2781,0.8470427193628577
3493,335.269567,335.293567,1,10058087,10058807,720,0.8751812944034175
3494,335.2969,335.388133,1,10058907,10061643,2736,0.7766024976379369
3495,335.390967,335.407333,1,10061729,10062219,490,0.2738929948193908
3496,335.421667,335.476,1,10062650,10064280,1630,0.785063046328275
3497,335.4779,335.509733,1,10064337,10065291,954,0.8083746413606353
3498,335.514667,335.534933,1,10065440,10066047,607,0.8601981710709409
3499,335.541933,335.6206,1,10066257,10068618,2361,0.8361046779736642
3500,335.622633,335.6354,1,10068678,10069062,384,0.777671587914398
3501,335.638967,335.6635,1,10069169,10069905,736,0.7867368019724805
3502,335.6665,335.759,1,10069995,10072770,2775,0.826967541050193
3503,335.761567,335.788,1,10072847,10073640,793,0.8944495044110825
3504,335.790833,335.886767,1,10073724,10076603,2879,0.8221851402118068
3505,335.8887,335.9166,1,10076661,10077498,837,0.8700849965515275
3506,335.919367,336.013367,1,10077581,10080401,2820,0.8269413388495113
3507,336.016867,336.042267,1,10080506,10081268,762,0.9056170321626484
3508,336.045033,336.1407,1,10081350,10084221,2871,0.7920069768983863
3509,336.1455,336.1709,1,10084365,10085127,762,0.8884002722150962
3510,336.174233,336.223767,1,10085226,10086713,1487,0.808232321897931
3511,336.2273,336.290967,1,10086819,10088729,1910,0.7595672340094084
3512,336.2939,336.4114,1,10088817,10092342,3525,0.7390754021491655
3513,336.4144,336.4783,1,10092432,10094349,1917,0.8082304360543746
3514,336.4797,336.4829,1,10094391,10094487,96,0.7858822061079181
3515,336.485067,336.509233,1,10094552,10095276,724,0.7114000484365557
3516,336.514033,336.5306,1,10095420,10095918,498,0.901467448721434
3517,336.5444,336.6022,1,10096332,10098066,1734,0.7564427767853125
3518,336.613133,336.634767,1,10098393,10099043,650,0.8047083521881342
3519,336.638467,336.663633,1,10099154,10099908,754,0.6142175369713659
3520,336.6649,336.690433,1,10099947,10100712,765,0.730418568016333
3521,336.700033,336.713467,1,10101000,10101404,404,0.37680441892817185
3522,336.714467,336.724833,1,10101434,10101744,310,0.08564526597591174
3523,336.736067,336.794933,1,10102082,10103847,1765,0.7420642090230436
3524,336.810367,336.8139,1,10104311,10104417,106,0.13473326480329753
3525,336.853233,336.8572,1,10105596,10105716,120,-0.2548394908863941
3526,337.101367,337.130667,1,10113041,10113920,879,0.5436391470062663
3527,337.159767,337.177367,1,10114793,10115321,528,0.4839991631185402
3528,337.181567,337.2033,1,10115447,10116099,652,0.620997369472503
3529,337.300567,337.304867,1,10119017,10119146,129,0.6592273498487328
3530,337.308667,337.497067,1,10119260,10124912,5652,0.8311240897455283
3531,337.4986,337.5182,1,10124958,10125546,588,0.8023106639943036
3532,337.5194,337.602433,1,10125582,10128072,2490,0.7997399581629349
3533,337.607233,337.637567,1,10128216,10129127,911,0.7814728568812866
3534,337.6387,337.664033,1,10129161,10129920,759,0.8100097674219646
3535,337.665067,337.690333,1,10129952,10130709,757,0.8516495977141393
3536,337.693467,337.773133,1,10130804,10133193,2389,0.7921476124376732
3537,337.774433,337.8,1,10133232,10134000,768,0.8145056103620646
3538,337.8028,337.8896,1,10134084,10136688,2604,0.8173965502629158
3539,337.892733,337.910467,1,10136781,10137314,533,0.7753064180581796
3540,337.911867,338.017067,1,10137356,10140512,3156,0.8129375027748156
3541,338.020033,338.045567,1,10140600,10141367,767,0.871803331692445
3542,338.049333,338.1124,1,10141479,10143372,1893,0.7919730666343967
3543,338.114633,338.123733,1,10143438,10143711,273,0.7146222665314365
3544,338.1248,338.139833,1,10143744,10144194,450,0.7712311683069555
3545,338.1438,338.148967,1,10144314,10144469,155,0.7931565299641488
3546,338.150133,338.160267,1,10144503,10144808,305,0.49073212352435563
3547,338.173967,338.2288,1,10145219,10146864,1645,0.8066560368697994
3548,338.235833,338.263533,1,10147074,10147905,831,0.809815670550262
3549,338.276933,338.281433,1,10148307,10148442,135,0.23006019748976236
3550,338.2981,338.390933,1,10148943,10151727,2784,0.812235423757296
3551,338.3953,338.414533,1,10151859,10152435,576,0.29766656989999873
3552,338.4262,338.4804,1,10152786,10154412,1626,0.8061471221908613
3553,338.4875,338.492567,1,10154625,10154777,152,0.730885379444327
3554,338.495767,338.5177,1,10154873,10155531,658,0.811144604983404
3555,338.522367,338.5412,1,10155671,10156236,565,0.34735361934753395
3556,338.5534,338.5923,1,10156602,10157769,1167,0.782082385862372
3557,338.593433,338.648867,1,10157802,10159466,1664,0.8162237365170631
3558,338.652933,338.6807,1,10159587,10160421,834,0.504896094668786
3559,338.683233,338.914767,1,10160496,10167443,6947,0.5158446815161996
3560,338.9164,338.936867,1,10167492,10168106,614,0.7045409827064885
3561,338.947433,338.990633,1,10168422,10169718,1296,0.7276727134724046
3562,338.991767,339.0056,1,10169753,10170168,415,0.6856443962384451
3563,339.0293,339.039,1,10170879,10171170,291,0.7354066228213636
3564,339.046267,339.068667,1,10171388,10172060,672,0.539402475077785
3565,339.078167,339.116367,1,10172345,10173491,1146,0.7338146407326351
3566,339.123467,339.1343,1,10173704,10174029,325,0.5607118790324043
3567,339.157233,339.168533,1,10174716,10175055,339,0.7157114161262961
3568,339.175,339.178233,1,10175250,10175346,96,-0.4142061612980663
3569,339.207833,339.246933,1,10176234,10177407,1173,0.6828687037629597
3570,339.2527,339.266567,1,10177581,10177997,416,0.5897006976434787
3571,339.282633,339.297133,1,10178478,10178913,435,0.6358056253131295
3572,339.316033,339.356667,1,10179480,10180700,1220,0.7095503865372953
3573,339.359933,339.3676,1,10180797,10181028,231,0.8456472697119802
3574,339.3695,339.379267,1,10181085,10181378,293,0.6929435365687856
3575,339.381133,339.3843,1,10181433,10181529,96,0.20837347188480124
3576,339.396133,339.411933,1,10181883,10182357,474,-0.10074798172519885
3577,339.425567,339.441333,1,10182767,10183239,472,0.07276222726182505
3578,339.4481,339.454667,1,10183443,10183640,197,-0.06092437846230282
3579,339.466467,339.522367,1,10183994,10185671,1677,0.7234926950517004
3580,339.5505,339.636733,1,10186515,10189101,2586,0.7741035225755171
3581,339.6766,339.685467,1,10190298,10190564,266,0.37894908501533525
3582,339.694367,339.709833,1,10190831,10191294,463,-0.07027312947109639
3583,339.7154,339.7281,1,10191462,10191843,381,0.23382830646851238
3584,339.7377,339.745067,1,10192131,10192352,221,0.37098255477201825
3585,339.7475,339.832333,1,10192425,10194969,2544,0.7710199659097972
3586,339.843667,339.919433,1,10195310,10197582,2272,0.7891513399138641
3587,339.9223,339.939133,1,10197669,10198173,504,0.46750320499374276
3588,339.948533,340.0415,1,10198455,10201245,2790,0.7681046214749829
3589,340.045167,340.1432,1,10201355,10204296,2941,0.7243440346063393
3590,340.166933,340.248967,1,10205007,10207469,2462,0.7547423105070274
3591,340.250767,340.274933,1,10207523,10208247,724,0.8700377320592751
3592,340.277633,340.3939,1,10208328,10211817,3489,0.7780929025529999
3593,340.396167,340.485067,1,10211885,10214552,2667,0.846501962296926
3594,340.487667,340.500633,1,10214630,10215018,388,0.5182637423174101
3595,340.5024,340.512933,1,10215072,10215387,315,0.9609386019469512
3596,340.515367,340.603,1,10215461,10218090,2629,0.8413475609086107
3597,340.607367,340.633933,1,10218221,10219017,796,0.8620657281328579
3598,340.636133,340.736667,1,10219083,10222100,3017,0.8541146199533985
3599,340.740033,340.765267,1,10222200,10222958,758,0.8836728207507413
3600,340.7674,340.8939,1,10223022,10226817,3795,0.8420160636634498
3601,340.897333,340.973033,1,10226919,10229190,2271,0.7549156643926028
3602,340.9791,341.062233,1,10229373,10231866,2493,0.7073730684087168
3603,341.066267,341.091867,1,10231988,10232756,768,0.7585863660359079
3604,341.099233,341.1128,1,10232976,10233384,408,0.6955093886307029
3605,341.1139,341.116933,1,10233417,10233507,90,-0.37506421500420206
3606,341.128767,341.150367,1,10233863,10234511,648,0.010330271081327773
3607,341.151533,341.1623,1,10234545,10234869,324,-0.0668602936892094
3608,341.184,341.187333,1,10235520,10235619,99,
3609,341.203633,341.2073,1,10236108,10236219,111,-0.3094900734196871
3610,341.3572,341.3604,1,10240716,10240812,96,
3611,341.362,341.367,1,10240860,10241010,150,0.48576745618415157
3612,341.3748,341.3892,1,10241244,10241676,432,0.7765749276828833
3613,341.3989,341.4044,1,10241967,10242132,165,0.5601642010719476
3614,341.414167,341.424733,1,10242425,10242741,316,0.664082615192695
3615,341.4407,341.516967,1,10243221,10245509,2288,0.8201912002367903
3616,341.537067,341.655367,1,10246112,10249661,3549,0.784591968167334
3617,341.662433,341.742633,1,10249872,10252278,2406,0.7174890772072969
3618,341.747733,341.7551,1,10252431,10252653,222,0.6305703470378249
3619,341.756333,341.8393,1,10252689,10255179,2490,0.7584872469584941
3620,341.881667,341.884933,1,10256450,10256547,97,
3621,341.891033,341.898167,1,10256730,10256945,215,0.5363861999426505
3622,341.9,341.903167,1,10257000,10257095,95,
3623,341.927767,341.931833,1,10257833,10257954,121,0.22308966049405624
3624,341.935167,341.938967,1,10258055,10258169,114,0.6671872673234099
3625,341.947633,342.0616,1,10258428,10261848,3420,0.8215459172887608
3626,342.088867,342.1931,1,10262666,10265793,3127,0.769192484362833
3627,342.196633,342.215933,1,10265898,10266477,579,0.8185952766657923
3628,342.2199,342.3006,1,10266597,10269018,2421,0.8118906182919956
3629,342.308233,342.3388,1,10269246,10270164,918,0.7486806260014598
3630,342.339867,342.416267,1,10270196,10272488,2292,0.7852935317281574
3631,342.448033,342.503033,1,10273440,10275090,1650,0.7920282426974875
3632,342.527533,342.5393,1,10275825,10276179,354,0.8545805687580978
3633,342.575,342.631433,1,10277250,10278942,1692,0.7983689764174136
3634,342.649,342.6664,1,10279470,10279992,522,0.7350406597023519
3635,342.670267,342.6742,1,10280108,10280226,118,0.7518741914886342
3636,342.702267,342.759233,1,10281068,10282776,1708,0.7884706690570055
3637,342.777733,342.794167,1,10283331,10283825,494,0.7558294884046303
3638,342.797067,342.8026,1,10283912,10284078,166,0.19861415803473428
3639,342.806,342.8128,1,10284180,10284384,204,0.9079023199474573
3640,342.83,342.8705,1,10284900,10286115,1215,0.7483694833254622
3641,342.873067,342.887633,1,10286192,10286628,436,0.6127609326043777
3642,342.9105,342.923267,1,10287315,10287698,383,0.7611751727500116
3643,342.937067,342.942033,1,10288112,10288260,148,0.9043295444954782
3644,342.9591,342.9959,1,10288773,10289877,1104,0.7942714602855974
3645,342.998033,343.015367,1,10289940,10290461,521,0.7813100437267333
3646,343.026767,343.0496,1,10290803,10291488,685,0.8225179729599993
3647,343.0555,343.075167,1,10291665,10292255,590,0.8399141537780253
3648,343.088,343.108133,1,10292640,10293243,603,0.713335378862945
3649,343.109733,343.144733,1,10293291,10294341,1050,0.8015890014274907
3650,343.1642,343.180467,1,10294926,10295414,488,0.6939277993209916
3651,343.195067,343.203767,1,10295852,10296113,261,0.9187564571582642
3652,343.217667,343.276933,1,10296530,10298307,1777,0.7646038342345369
3653,343.295967,343.311267,1,10298879,10299338,459,0.7388536276963557
3654,343.318367,343.336867,1,10299551,10300106,555,0.7893803245309375
3655,343.3482,343.407133,1,10300446,10302213,1767,0.7139344145578089
3656,343.432733,343.4433,1,10302981,10303299,318,0.6462260510526975
3657,343.4462,343.469967,1,10303386,10304099,713,0.6979028951959273
3658,343.477367,343.520233,1,10304321,10305606,1285,0.6928706636177628
3659,343.524567,343.539167,1,10305737,10306175,438,0.6903452781048044
3660,343.5584,343.575167,1,10306752,10307255,503,0.6939017316194316
3661,343.580433,343.584467,1,10307412,10307534,122,0.5174728304139697
3662,343.5889,343.596833,1,10307667,10307904,237,0.6601705832258545
3663,343.598,343.603167,1,10307940,10308095,155,0.8620732648669897
3664,343.613,343.654367,1,10308390,10309631,1241,0.7835765720980558
3665,343.657733,343.673233,1,10309731,10310196,465,0.7009416126311476
3666,343.6945,343.708267,1,10310835,10311248,413,0.7255238141155786
3667,343.714367,343.730467,1,10311431,10311914,483,0.7801134623009071
3668,343.7463,343.785333,1,10312389,10313559,1170,0.7957672273845404
3669,343.7879,343.805733,1,10313637,10314171,534,0.7819244301039203
3670,343.8085,343.841733,1,10314255,10315251,996,0.7062137407421896
3671,343.854533,343.861733,1,10315635,10315851,216,-0.35002624954755507
3672,343.873933,343.877267,1,10316217,10316318,101,0.5225671363828339
3673,343.8805,343.8837,1,10316415,10316511,96,0.1094514793638691
3674,343.897567,343.9254,1,10316927,10317762,835,0.8787619084620741
3675,343.9598,343.9727,1,10318794,10319181,387,0.4857337361133739
3676,343.9835,344.011433,1,10319505,10320342,837,0.025087782951547517
3677,344.012967,344.022667,1,10320389,10320680,291,0.12016057169896731
3678,344.025333,344.030133,1,10320759,10320903,144,
3679,344.036333,344.066033,1,10321089,10321980,891,0.2120316992606989
3680,344.067567,344.0707,1,10322027,10322121,94,-0.2701645575266089
3681,344.1062,344.1219,1,10323186,10323657,471,0.457524375696777
3682,344.161233,344.265967,1,10324836,10327979,3143,0.8001342679186921
3683,344.308867,344.320067,1,10329266,10329602,336,0.7450963987109696
3684,344.325133,344.340167,1,10329753,10330205,452,0.6065554489493054
3685,344.347367,344.5238,1,10330421,10335714,5293,0.8303672231943839
3686,344.529367,344.566833,1,10335881,10337004,1123,0.7375881757913307
3687,344.5743,344.601533,1,10337229,10338045,816,0.7731479813214099
3688,344.6026,344.642567,1,10338078,10339277,1199,0.8470332975408006
3689,344.666867,344.7139,1,10340006,10341417,1411,0.7800104848316345
3690,344.7186,344.751767,1,10341558,10342553,995,0.8043423670330229
3691,344.756533,344.780967,1,10342695,10343429,734,0.8611882075335535
3692,344.782967,344.787667,1,10343489,10343630,141,0.7731636064497507
3693,344.788867,344.873667,1,10343666,10346210,2544,0.8266582018294915
3694,344.875867,344.903933,1,10346276,10347117,841,0.7013279077747565
3695,344.905933,344.995833,1,10347177,10349874,2697,0.847103929318226
3696,345.0032,345.028067,1,10350096,10350842,746,0.946218569106458
3697,345.031867,345.104733,1,10350956,10353141,2185,0.837975947925886
3698,345.1145,345.136667,1,10353435,10354100,665,0.7737927899213011
3699,345.1624,345.1956,1,10354872,10355868,996,0.06798200343145974
3700,345.1977,345.228833,1,10355931,10356864,933,0.09954383096681797
3701,345.244833,345.249633,1,10357344,10357488,144,0.7806180334159183
3702,345.2735,345.286267,1,10358205,10358588,383,0.5052132874598203
3703,345.299167,345.320167,1,10358975,10359605,630,0.8611126418895017
3704,345.3214,345.349833,1,10359642,10360494,852,0.832569827415546
3705,345.351467,345.368167,1,10360544,10361045,501,0.8717300970109223
3706,345.383933,345.417933,1,10361517,10362537,1020,0.8792552881453475
3707,345.426433,345.4361,1,10362792,10363083,291,0.7032493533442273
3708,345.4417,345.463033,1,10363251,10363890,639,0.053456003198407445
3709,345.464167,345.471133,1,10363925,10364133,208,-0.04437818543863032
3710,345.6968,345.702033,1,10370904,10371060,156,0.14001206791735005
3711,345.7282,345.735567,1,10371846,10372067,221,0.010091363918147755
3712,345.758267,345.772367,1,10372748,10373171,423,0.4024755234987566
3713,345.913067,345.927633,1,10377392,10377828,436,0.6121682896636538
3714,345.928667,345.9463,1,10377860,10378389,529,0.6149866739501005
3715,345.951933,346.011667,1,10378557,10380350,1793,0.6152744060703416
3716,346.026233,346.082567,1,10380786,10382477,1691,0.6827507359050766
3717,346.089533,346.171033,1,10382685,10385130,2445,0.520398567974659
3718,346.180633,346.186,1,10385418,10385580,162,0.2298139342685384
3719,346.193333,346.219467,1,10385799,10386584,785,0.5077267866003838
3720,346.242133,346.246633,1,10387263,10387398,135,0.5931940407156653
3721,346.263933,346.2698,1,10387917,10388094,177,-0.05669415087454485
3722,346.271467,346.274767,1,10388144,10388243,99,-0.1765129102404777
3723,346.2778,346.284867,1,10388334,10388546,212,-0.0615253509036086
3724,346.2861,346.300567,1,10388583,10389017,434,-0.10666814326191615
3725,346.305267,346.312733,1,10389158,10389381,223,-0.23274417580753806
3726,346.364567,346.367733,1,10390937,10391031,94,
3727,346.373267,346.490067,1,10391198,10394702,3504,0.8466823586437126
3728,346.5034,346.521933,1,10395102,10395657,555,0.3652148436156121
3729,346.5306,346.5547,1,10395918,10396641,723,0.0005164661438141387
3730,346.557333,346.580033,1,10396719,10397400,681,0.0930684449080394
3731,346.5889,346.595333,1,10397667,10397859,192,0.4604476688280422
3732,346.6137,346.622533,1,10398411,10398675,264,0.05828358352591743
3733,346.623967,346.660433,1,10398719,10399812,1093,0.05491377230827232
3734,346.675333,346.700033,1,10400259,10401000,741,-0.0421992171939956
3735,346.7122,346.737533,1,10401366,10402125,759,0.0369720196837822
3736,346.738533,346.899267,1,10402155,10406978,4823,0.7757458110154857
3737,346.912267,346.915833,1,10407368,10407474,106,0.0485987015128579
3738,346.9388,347.039733,1,10408164,10411191,3027,0.7882619845246727
3739,347.084867,347.089033,1,10412546,10412670,124,0.0019119902593432026
3740,347.1318,347.1452,1,10413954,10414356,402,0.5171827045173591
3741,347.1464,347.154167,1,10414392,10414625,233,0.5637299961588915
3742,347.156833,347.257467,1,10414704,10417724,3020,0.752360706273875
3743,347.2725,347.355067,1,10418175,10420652,2477,0.7549401982974052
3744,347.3561,347.3611,1,10420683,10420833,150,0.059917689289518766
3745,347.3631,347.3779,1,10420893,10421337,444,0.45254884901749504
3746,347.3874,347.4047,1,10421622,10422141,519,-0.03994877962216275
3747,347.407933,347.441067,1,10422237,10423232,995,0.0018222989709649107
3748,347.482767,347.7213,1,10424483,10431639,7156,0.6633750645889073
3749,347.722567,347.747633,1,10431677,10432428,751,0.8068139777811251
3750,347.763767,347.7917,1,10432913,10433751,838,0.17486742303702038
3751,347.795567,347.846333,1,10433867,10435389,1522,0.05073297654973153
3752,347.868267,347.997567,1,10436048,10439927,3879,0.8066414388515826
3753,348.0059,348.028067,1,10440177,10440842,665,0.2822895601306129
3754,348.0389,348.0491,1,10441167,10441473,306,0.07466645604151526
3755,348.050433,348.082033,1,10441512,10442460,948,0.11661157586041809
3756,348.120033,348.176667,1,10443600,10445300,1700,0.6633872545425474
3757,348.182667,348.2678,1,10445480,10448034,2554,0.7288815211745615
3758,348.269667,348.272967,1,10448090,10448189,99,-0.045184750948571696
3759,348.351567,348.355967,1,10450547,10450679,132,0.40190059767004477
3760,348.364533,348.4815,1,10450935,10454445,3510,0.7875919309640045
3761,348.482833,348.4876,1,10454484,10454628,144,0.6405150825207026
3762,348.492733,348.515733,1,10454781,10455471,690,0.3962183775612119
3763,348.518033,348.5666,1,10455540,10456998,1458,0.05122121343218147
3764,348.572867,348.734667,1,10457186,10462040,4854,0.8086396382559952
3765,348.738667,348.7458,1,10462160,10462374,214,-0.16153300380483218
3766,348.748533,348.756433,1,10462455,10462692,237,-0.02290192561135598
3767,348.772,348.8175,1,10463160,10464525,1365,0.06858405894200872
3768,348.856767,348.9666,1,10465703,10468998,3295,0.618318566436652
3769,348.967933,348.976533,1,10469037,10469295,258,0.7138187984404831
3770,348.987567,348.993667,1,10469627,10469810,183,-0.1852064778157952
3771,349.001233,349.0332,1,10470036,10470996,960,0.09128131286640272
3772,349.035733,349.0524,1,10471071,10471572,501,0.020836764267544945
3773,349.075367,349.1463,1,10472261,10474389,2128,0.6197611470896681
3774,349.1482,349.217667,1,10474446,10476530,2084,0.7848523111414472
3775,349.224867,349.294067,1,10476746,10478822,2076,0.802244555984502
3776,349.3001,349.3793,1,10479003,10481379,2376,0.8409396653526365
3777,349.401667,349.4289,1,10482050,10482867,817,0.7794692750715557
3778,349.442967,349.4559,1,10483289,10483677,388,0.011853598276079506
3779,349.458167,349.504267,1,10483745,10485128,1383,0.11799660840908036
3780,349.511067,349.516767,1,10485332,10485503,171,0.5879390816094798
3781,349.520567,349.6731,1,10485617,10490193,4576,0.8403843141549544
3782,349.6782,349.6843,1,10490346,10490529,183,0.2543318830865983
3783,349.6896,349.712333,1,10490688,10491369,681,0.8449546798095101
3784,349.714633,349.752067,1,10491438,10492562,1124,0.6910169396856358
3785,349.774167,349.853833,1,10493225,10495614,2389,0.8017628096673891
3786,349.884267,349.980533,1,10496528,10499415,2887,0.7813232975907861
3787,350.0018,350.012833,1,10500054,10500384,330,-0.04217328847452242
3788,350.0828,350.0884,1,10502484,10502652,168,0.28093127221174513
3789,350.094,350.113467,1,10502820,10503404,584,0.7113482929225519
3790,350.114767,350.153533,1,10503443,10504605,1162,0.6817712022286602
3791,350.163767,350.208467,1,10504913,10506254,1341,0.7953159934226192
3792,350.223433,350.260467,1,10506702,10507814,1112,-0.0246984622453619
3793,350.265633,350.2734,1,10507968,10508202,234,-0.056722802810202616
3794,350.281333,350.403033,1,10508439,10512090,3651,0.8244231387651089
3795,350.418433,350.487467,1,10512552,10514624,2072,0.8147895536330663
3796,350.5116,350.542433,1,10515348,10516272,924,0.7033282245443557
3797,350.555867,350.593567,1,10516676,10517807,1131,0.0022173472622631584
3798,350.5996,350.606667,1,10517988,10518200,212,-0.29495928402839394
3799,350.622633,350.629267,1,10518678,10518878,200,0.6111902115845586
3800,350.6316,350.859967,1,10518948,10525799,6851,0.7790279629564779
3801,350.896667,350.913267,1,10526900,10527398,498,0.004328045739509225
3802,350.923133,350.9279,1,10527693,10527837,144,0.32361144738629605
3803,351.280233,351.383667,1,10538406,10541510,3104,0.7502140296660714
3804,351.393833,351.428433,1,10541814,10542852,1038,0.7937828989938611
3805,351.438667,351.4513,1,10543160,10543539,379,0.7210575686485656
3806,351.468067,351.501567,1,10544042,10545047,1005,0.013866778386385985
3807,351.503333,351.516167,1,10545099,10545485,386,0.26296022961149046
3808,351.5178,351.526367,1,10545534,10545791,257,0.30016731451046735
3809,351.544467,351.6881,1,10546334,10550643,4309,0.794787366596531
3810,351.692833,351.696033,1,10550784,10550880,96,-0.08822694692618316
3811,351.7077,351.7243,1,10551231,10551729,498,0.055245369177714644
3812,351.7273,351.7585,1,10551819,10552755,936,0.055673331906414
3813,351.790033,351.8358,1,10553700,10555074,1374,0.13878025910657807
3814,351.8444,351.896767,1,10555332,10556903,1571,0.017464226174329227
3815,351.9034,352.021133,1,10557102,10560633,3531,0.8528747293518072
3816,352.038533,352.127067,1,10561155,10563812,2657,0.8060757266668248
3817,352.2316,352.342133,1,10566948,10570263,3315,0.8083448371639446
3818,352.3606,352.385933,1,10570818,10571577,759,-0.02711656209723541
3819,352.387267,352.395533,1,10571618,10571865,247,0.10369129486099364
3820,352.405267,352.4083,1,10572158,10572249,91,0.06350767078987327
3821,352.4103,352.414033,1,10572309,10572420,111,-0.4210888754643898
3822,352.520767,352.7986,1,10575623,10583958,8335,0.7701307589179353
3823,352.802133,352.908167,1,10584063,10587245,3182,0.7117219561986524
3824,352.910133,353.003867,1,10587303,10590116,2813,0.6571445715510978
3825,353.022167,353.147867,1,10590665,10594436,3771,0.8218009518306684
3826,353.148967,353.362,1,10594469,10600860,6391,0.7665403436307434
3827,353.3757,353.3797,1,10601271,10601391,120,0.04337355149378312
3828,353.380867,353.387567,1,10601426,10601627,201,0.02041565430596615
3829,353.4534,353.547167,1,10603602,10606415,2813,0.7842839465640189
3830,353.578433,353.5848,1,10607352,10607544,192,0.6958783729011757
3831,353.5971,353.616267,1,10607913,10608488,575,0.056190822120187785
3832,353.618,353.634833,1,10608540,10609044,504,0.21163102740458425
3833,353.638167,353.644967,1,10609145,10609349,204,-0.026936774676378256
3834,353.6524,353.784233,1,10609572,10613526,3954,0.8136941493456695
3835,353.8006,353.851533,1,10614018,10615545,1527,0.28466465587478224
3836,353.863033,354.0535,1,10615890,10621605,5715,0.8394330627795319
3837,354.055067,354.092033,1,10621652,10622760,1108,0.7574395783731922
3838,354.093767,354.224133,1,10622813,10626723,3910,0.8162925922912185
3839,354.2555,354.2636,1,10627665,10627908,243,-0.07141538716268175
3840,354.2679,354.273967,1,10628037,10628219,182,-0.09412314231977699
3841,354.283267,354.2947,1,10628498,10628841,343,0.010976111759115907
3842,354.295767,354.306533,1,10628873,10629195,322,-0.10425019922555667
3843,354.506633,354.513067,1,10635198,10635392,194,0.7122771208341011
3844,354.5324,354.578033,1,10635972,10637340,1368,0.8198368177324957
3845,354.587467,354.6002,1,10637624,10638006,382,0.840996833133311
3846,354.604867,354.682033,1,10638146,10640460,2314,0.7394379696714279
3847,354.695533,354.732633,1,10640865,10641978,1113,0.7766383571059272
3848,354.749067,354.786767,1,10642472,10643603,1131,0.7794982686706581
3849,354.800233,354.810967,1,10644006,10644329,323,0.7834393009069887
3850,354.8196,354.824933,1,10644588,10644747,159,-0.03914410486589944
3851,354.8422,354.864033,1,10645266,10645920,654,0.0719159004503562
3852,354.868933,354.897167,1,10646067,10646915,848,0.05446999442284939
3853,354.899433,354.903067,1,10646982,10647092,110,
3854,354.908767,355.068867,1,10647263,10652066,4803,0.7614452358396648
3855,355.077333,355.160667,1,10652319,10654820,2501,0.7947813525082148
3856,355.163633,355.1714,1,10654908,10655142,234,0.33925862038640314
3857,355.1877,355.1909,1,10655631,10655727,96,
3858,355.203367,355.2092,1,10656101,10656276,175,0.11731651166731526
3859,355.250167,355.2562,1,10657505,10657686,181,0.6345121172794032
3860,355.262333,355.321567,1,10657869,10659647,1778,0.6967422797957995
3861,355.322733,355.3727,1,10659681,10661181,1500,0.4185895393696561
3862,355.391567,355.436233,1,10661747,10663086,1339,0.13171353746086256
3863,355.451867,355.662033,1,10663556,10669860,6304,0.7934981664913775
3864,355.667367,355.6972,1,10670021,10670916,895,0.7332801622645929
3865,355.700067,355.7042,1,10671002,10671126,124,-0.28182419405607967
3866,355.720267,355.7358,1,10671608,10672074,466,-0.04046634106786886
3867,355.7383,355.753533,1,10672149,10672605,456,0.21379119284096743
3868,355.766833,355.889633,1,10673004,10676688,3684,0.8588910011127633
3869,355.892533,355.897433,1,10676775,10676922,147,0.2354251629968427
3870,355.903267,355.917767,1,10677098,10677533,435,-0.02265367354562687
3871,355.9189,355.925233,1,10677567,10677756,189,0.30907872235430894
3872,355.926933,355.949467,1,10677807,10678484,677,0.2704152078983109
3873,355.9805,356.0929,1,10679415,10682787,3372,0.8176824084785628
3874,356.1018,356.1283,1,10683054,10683849,795,0.7680526382449574
3875,356.1363,356.139667,1,10684089,10684190,101,
3876,356.140733,356.236633,1,10684221,10687098,2877,0.7894566129719327
3877,356.242,356.316633,1,10687260,10689498,2238,0.69348188601489
3878,356.3211,356.344733,1,10689633,10690341,708,0.693283904330435
3879,356.349333,356.365233,1,10690479,10690956,477,0.7001942935257138
3880,356.367267,356.370967,1,10691018,10691129,111,-0.03769039404807929
3881,356.3866,356.399333,1,10691598,10691979,381,0.006606656149909076
3882,356.4011,356.429233,1,10692033,10692876,843,0.05882273929807516
3883,356.450333,356.458433,1,10693509,10693752,243,-0.4125241059862267
3884,356.463767,356.6322,1,10693913,10698966,5053,0.7968231709186596
3885,356.6384,356.7065,1,10699152,10701195,2043,0.7540739239754881
3886,356.7208,356.935733,1,10701624,10708071,6447,0.7724181063861303
3887,356.940267,357.0252,1,10708208,10710756,2548,0.8042896587891493
3888,357.043833,357.053033,1,10711314,10711590,276,-0.06087214640139481
3889,357.058667,357.068633,1,10711760,10712058,298,0.3029040496735429
3890,357.0755,357.1743,1,10712265,10715229,2964,0.7873370400038898
3891,357.188267,357.194367,1,10715648,10715831,183,0.09834193144124408
3892,357.2207,357.223833,1,10716621,10716714,93,
3893,357.2742,357.397367,1,10718226,10721921,3695,0.8342995361175813
3894,357.407833,357.417867,1,10722234,10722536,302,0.434445395525532
3895,357.4296,357.716833,1,10722888,10731504,8616,0.8200133631717517
3896,357.735733,357.742,1,10732071,10732260,189,0.16497483678041458
3897,357.7546,357.778767,1,10732638,10733363,725,0.22835105502318698
3898,357.7903,357.798733,1,10733709,10733961,252,0.20162242907684186
3899,357.836933,357.8426,1,10735107,10735278,171,0.6996541847998453
3900,357.843933,357.8902,1,10735317,10736706,1389,0.4275679180875657
3901,357.991933,358.1123,1,10739757,10743369,3612,0.803278736546837
3902,358.1168,358.3122,1,10743504,10749366,5862,0.7465792917790854
3903,358.327867,358.333333,1,10749836,10749999,163,0.011735692039975444
3904,358.447333,358.550633,1,10753419,10756518,3099,0.6578106140760337
3905,358.561333,358.623833,1,10756839,10758714,1875,0.7887025335937345
3906,358.632167,358.6861,1,10758965,10760583,1618,0.7998142194001048
3907,358.690367,358.9519,1,10760711,10768557,7846,0.660722342798113
3908,358.953667,358.979033,1,10768610,10769370,760,0.5889433544876471
3909,358.9824,359.074133,1,10769472,10772223,2751,0.8214501094024117
3910,359.075167,359.1024,1,10772255,10773072,817,0.7930563163925095
3911,359.1051,359.198133,1,10773153,10775943,2790,0.7703470777741892
3912,359.2009,359.228033,1,10776027,10776840,813,0.7777180454645403
3913,359.231033,359.3055,1,10776930,10779165,2235,0.8223879033100814
3914,359.307533,359.346733,1,10779225,10780401,1176,0.6985954943005107
3915,359.3565,359.4519,1,10780695,10783557,2862,0.8486449434038862
3916,359.454533,359.482367,1,10783635,10784471,836,0.8220932470768233
3917,359.484933,359.5831,1,10784547,10787493,2946,0.783383842173306
3918,359.586967,359.6124,1,10787609,10788372,763,0.7935066220110403
3919,359.6152,359.710167,1,10788456,10791305,2849,0.7694928151323066
3920,359.711367,359.7374,1,10791341,10792122,781,0.912347716061832
3921,359.7399,359.826367,1,10792197,10794791,2594,0.8193148864797494
3922,359.828433,359.854167,1,10794852,10795625,773,0.8512289624190756
3923,359.856333,359.9439,1,10795689,10798317,2628,0.7696789930951748
3924,359.9464,359.973,1,10798392,10799190,798,0.5760461723328502
3925,359.976,360.052867,1,10799280,10801586,2306,0.6764008908685347
3926,360.059367,360.0788,1,10801781,10802364,583,0.7719397034027172
3927,360.079833,360.091667,1,10802394,10802750,356,0.5654963491077516
3928,360.0964,360.103367,1,10802892,10803101,209,0.728014749115593
3929,360.1158,360.137833,1,10803474,10804134,660,-0.07036725839039189
3930,360.149767,360.154933,1,10804493,10804647,154,0.1223336671831397
3931,360.1746,360.230233,1,10805238,10806906,1668,0.7938390683259411
3932,360.252133,360.262967,1,10807563,10807889,326,0.013783824502250528
3933,360.3105,360.423667,1,10809315,10812710,3395,0.7849907338210976
3934,360.438833,360.4422,1,10813164,10813266,102,-0.04578183058382705
3935,360.510567,360.513667,1,10815317,10815410,93,0.05062426162238484
3936,360.5215,360.650733,1,10815645,10819521,3876,0.7879634015947163
3937,360.6702,360.8696,1,10820106,10826088,5982,0.2798232425848786
3938,360.902467,360.922333,1,10827074,10827669,595,0.11917151026745437
3939,360.924467,360.949667,1,10827734,10828490,756,0.2897824666309554
3940,360.9507,360.958067,1,10828521,10828742,221,0.2913701693626409
3941,360.961667,360.980933,1,10828850,10829427,577,-0.02959395077952106
3942,360.9986,361.022667,1,10829958,10830680,722,0.7849250654454495
3943,361.024433,361.0528,1,10830732,10831584,852,0.702419030262721
3944,361.056333,361.072833,1,10831689,10832184,495,0.8507741723291763
3945,361.0777,361.1002,1,10832331,10833006,675,0.6843437779581981
3946,361.108333,361.112,1,10833249,10833360,111,-0.2767150259850214
3947,361.127133,361.160433,1,10833813,10834812,999,0.8373785902015614
3948,361.1678,361.254667,1,10835034,10837640,2606,0.7867037093820877
3949,361.263933,361.4612,1,10837917,10843836,5919,0.73606736158259
3950,361.4662,361.508033,1,10843986,10845240,1254,0.07865285842512902
3951,361.514133,361.537867,1,10845423,10846136,713,0.13230309743784738
3952,361.569533,361.5728,1,10847085,10847184,99,0.46239315764343375
3953,361.576433,361.579867,1,10847292,10847396,104,0.5040545648980482
3954,361.5811,361.691833,1,10847433,10850754,3321,0.8313182002963878
3955,361.6948,361.737733,1,10850844,10852131,1287,0.8655319851337973
3956,361.740233,361.767667,1,10852206,10853030,824,0.05755382640360279
3957,361.768933,361.805667,1,10853067,10854170,1103,0.049968885215394054
3958,361.807333,361.811767,1,10854219,10854353,134,
3959,361.843967,361.905533,1,10855319,10857165,1846,0.7888759359921812
3960,361.909,361.9585,1,10857270,10858755,1485,0.7298073066164306
3961,361.959633,362.0406,1,10858788,10861218,2430,0.5877405027572322
3962,362.0528,362.2795,1,10861584,10868385,6801,0.42098202194564055
3963,362.3042,362.413467,1,10869126,10872404,3278,0.7761109517647463
3964,362.427833,363.0928,1,10872834,10892784,19950,0.5252172751847738
3965,363.101867,363.123967,1,10893056,10893719,663,0.3281024265190125
3966,363.1251,363.2313,1,10893753,10896939,3186,0.48419294248216543
3967,363.263867,363.285067,1,10897916,10898552,636,0.41518594107727674
3968,363.2931,363.323933,1,10898793,10899717,924,0.18867221791111935
3969,363.327133,363.3661,1,10899813,10900983,1170,0.6806375058112999
3970,363.367967,363.536867,1,10901039,10906106,5067,0.7906028195289592
3971,363.538067,363.5415,1,10906142,10906245,103,0.8446147892826341
3972,363.545033,363.585733,1,10906350,10907571,1221,0.6790549626993672
3973,363.606233,363.651967,1,10908186,10909559,1373,0.14215371088963605
3974,363.6817,363.845733,1,10910451,10915371,4920,0.8226797067602126
3975,363.858933,363.930467,1,10915767,10917914,2147,0.7620134223066806
3976,363.977867,363.983433,1,10919336,10919502,166,-0.09379785626173247
3977,364.0895,364.093,1,10922685,10922790,105,0.45599068803731196
3978,364.106067,364.133967,1,10923182,10924019,837,0.31736286394432006
3979,364.1528,364.1574,1,10924584,10924722,138,0.13471878368498716
3980,364.187533,364.3064,1,10925625,10929192,3567,0.859211698455463
3981,364.325833,364.339667,1,10929774,10930190,416,0.3799182028022227
3982,364.350633,364.366767,1,10930518,10931003,485,-0.012041256784462223
3983,364.368867,364.381533,1,10931066,10931445,379,0.13104770558060622
3984,364.388933,364.398233,1,10931667,10931946,279,-0.08481059234244623
3985,364.4252,364.436267,1,10932756,10933088,332,0.5297401760694529
3986,364.4415,364.468933,1,10933245,10934067,822,0.45112950401935675
3987,364.492,364.511333,1,10934760,10935339,579,0.2885909971549732
3988,364.517833,364.570367,1,10935534,10937111,1577,0.7010452452012235
3989,364.574567,364.603667,1,10937237,10938110,873,0.7624821729497074
3990,364.609833,364.630367,1,10938294,10938911,617,0.8040520773185963
3991,364.631933,364.675567,1,10938957,10940267,1310,0.758979424710082
3992,364.689433,364.697167,1,10940682,10940915,233,0.2879817647107368
3993,364.709233,364.7237,1,10941276,10941711,435,0.015917654344990907
3994,364.7282,364.733033,1,10941846,10941990,144,
3995,364.7361,364.7485,1,10942083,10942455,372,0.1781315974824232
3996,364.753867,364.761833,1,10942616,10942854,238,-0.11644003802363877
3997,364.7789,364.7827,1,10943367,10943481,114,
3998,364.7905,364.916067,1,10943715,10947482,3767,0.8152281512747591
3999,364.965033,364.972067,1,10948950,10949162,212,0.5678162454786004
4000,365.270033,365.2801,1,10958100,10958403,303,0.7331509047060852
4001,365.286133,365.3485,1,10958583,10960455,1872,0.6464350132756759
4002,365.374133,365.378067,1,10961223,10961342,119,0.6581221884672952
4003,365.395733,365.4133,1,10961871,10962399,528,0.8590567953948418
4004,365.438233,365.444667,1,10963146,10963340,194,0.39973889980861654
4005,365.455467,365.515067,1,10963664,10965452,1788,0.03322247644397819
4006,365.546833,365.6118,1,10966404,10968354,1950,0.785191431980989
4007,365.613,365.696633,1,10968390,10970898,2508,0.8194054187513489
4008,365.701,365.715733,1,10971030,10971471,441,0.7205316155662524
4009,365.724667,365.766533,1,10971740,10972995,1255,0.7590950510565515
4010,365.792633,365.843233,1,10973778,10975296,1518,0.15825668411446317
4011,365.8446,365.878833,1,10975338,10976364,1026,0.18078517618206336
4012,365.904,366.021,1,10977120,10980630,3510,0.8069051739316756
4013,366.0496,366.064933,1,10981488,10981947,459,0.18004739168626682
4014,366.0668,366.086367,1,10982004,10982591,587,0.07018375005315663
4015,366.087533,366.110567,1,10982625,10983317,692,0.19899962095295987
4016,366.113,366.121233,1,10983390,10983636,246,0.2299075713883495
4017,366.152433,366.277467,1,10984572,10988324,3752,0.8576264716305567
4018,366.4327,366.4787,1,10992981,10994361,1380,0.1354254788376935
4019,366.4941,366.666267,1,10994823,10999988,5165,0.8583512536683952
4020,366.674033,366.751067,1,11000220,11002532,2312,0.8407454480538883
4021,366.767067,366.780033,1,11003012,11003400,388,0.36090795383884006
4022,366.782867,366.794933,1,11003486,11003847,361,-0.005574576539613942
4023,366.802133,366.822733,1,11004063,11004681,618,0.16119015710248077
4024,366.827067,366.837,1,11004812,11005110,298,-0.08537213428554195
4025,366.856967,366.864933,1,11005709,11005947,238,0.4357664463042316
4026,366.8681,366.894067,1,11006043,11006822,779,0.26128518264476513
4027,366.896133,366.905667,1,11006883,11007170,287,-0.31225140266025597
4028,366.9152,366.96,1,11007456,11008800,1344,0.000148322375576822
4029,366.983867,366.9883,1,11009516,11009649,133,0.5754440760349776
4030,366.993067,367.144233,1,11009792,11014326,4534,0.8086136609260418
4031,367.157367,367.164667,1,11014721,11014940,219,0.22724395955386878
4032,367.178033,367.1995,1,11015340,11015985,645,0.1715476359531649
4033,367.203167,367.217,1,11016095,11016510,415,0.20631401305076089
4034,367.220533,367.2434,1,11016615,11017302,687,-0.05374899835027478
4035,367.269033,367.2744,1,11018070,11018232,162,0.07261115864140277
4036,367.275767,367.492667,1,11018273,11024780,6507,0.8568701724824003
4037,367.496033,367.608833,1,11024880,11028264,3384,0.8101443322268992
4038,367.611933,367.615433,1,11028357,11028462,105,-0.5333133902944323
4039,367.628467,367.650833,1,11028854,11029524,670,0.16260606489331783
4040,367.654433,367.6767,1,11029632,11030301,669,-0.0778216328798688
4041,367.679433,367.689633,1,11030382,11030688,306,-0.18586840921232434
4042,367.706633,367.7117,1,11031198,11031351,153,0.3206839333581879
4043,367.713733,368.0121,1,11031411,11040363,8952,0.7429901964405916
4044,368.025867,368.0307,1,11040776,11040921,145,-0.07716143175648434
4045,368.060667,368.067933,1,11041820,11042037,217,-0.11996803830188064
4046,368.089767,368.096433,1,11042693,11042892,199,-0.23679681144547915
4047,368.101767,368.119567,1,11043053,11043587,534,0.5717283264067231
4048,368.1426,368.160133,1,11044278,11044803,525,0.41617196637944914
4049,368.161967,368.418967,1,11044859,11052569,7710,0.7231003433315332
4050,368.422167,368.497167,1,11052665,11054915,2250,0.2066975379631872
4051,368.523833,368.945233,1,11055714,11068356,12642,0.4913937685647925
4052,368.9468,369.011967,1,11068404,11070359,1955,0.08234188880601331
4053,369.0136,369.1828,1,11070408,11075484,5076,0.8269319790242061
4054,369.197667,369.202933,1,11075930,11076087,157,
4055,369.2084,369.2555,1,11076252,11077665,1413,0.06342501835073651
4056,369.2566,369.265933,1,11077698,11077977,279,0.5435184290742872
4057,369.283533,369.309667,1,11078505,11079290,785,0.8184456013875643
4058,369.311,369.409867,1,11079330,11082296,2966,0.8320573298763492
4059,369.569067,369.7357,1,11087072,11092071,4999,0.7779835017684512
4060,369.7368,369.834667,1,11092104,11095040,2936,0.7828950387121293
4061,369.835667,369.8405,1,11095070,11095215,145,0.6590856146921307
4062,369.851067,369.860733,1,11095532,11095821,289,0.0590835970881362
4063,369.865133,369.876233,1,11095953,11096286,333,-0.07784209711891717
4064,369.883733,369.8881,1,11096511,11096643,132,0.04663989377897338
4065,369.889433,369.9037,1,11096682,11097111,429,0.19015256386544346
4066,369.9056,369.911167,1,11097168,11097335,167,0.06482122096219693
4067,369.9202,369.927933,1,11097606,11097837,231,0.42809182021164144
4068,369.9291,370.1154,1,11097873,11103462,5589,0.8562958040893563
4069,370.123567,370.154267,1,11103707,11104628,921,0.8079912098974865
4070,370.156167,370.2218,1,11104685,11106654,1969,0.7995421510018373
4071,370.225033,370.323367,1,11106750,11109701,2951,0.8172034768466246
4072,370.3405,370.343733,1,11110215,11110311,96,0.5360685060976935
4073,370.356667,370.3634,1,11110700,11110902,202,-0.10562527092165755
4074,370.4337,370.4891,1,11113011,11114673,1662,0.2217896001510571
4075,370.6207,370.624233,1,11118621,11118726,105,0.012054704343236165
4076,370.6314,370.688767,1,11118942,11120663,1721,0.7502638518968417
4077,370.691633,370.720233,1,11120748,11121606,858,0.7308216440152174
4078,370.721467,370.752633,1,11121644,11122578,934,0.833061166142405
4079,370.777067,370.809767,1,11123312,11124293,981,0.7773892609725229
4080,370.817833,370.8209,1,11124534,11124627,93,-0.01598076105918653
4081,370.827667,370.8839,1,11124830,11126517,1687,0.6816965637137157
4082,370.8914,370.894533,1,11126742,11126835,93,0.46986083871614853
4083,370.899633,370.917833,1,11126988,11127534,546,0.6948999706877617
4084,370.922067,370.930333,1,11127662,11127909,247,0.5632013817920014
4085,370.9483,371.0042,1,11128449,11130126,1677,0.10432805000648607
4086,371.019667,371.027267,1,11130590,11130818,228,0.675147716789309
4087,371.029533,371.160333,1,11130885,11134809,3924,0.8399778445615579
4088,371.164467,371.2375,1,11134934,11137125,2191,0.7700247357812862
4089,371.243533,371.2832,1,11137305,11138496,1191,0.7707034176737906
4090,371.288167,371.366867,1,11138645,11141006,2361,0.8195248993913181
4091,371.3927,371.4192,1,11141781,11142576,795,0.7144307343215067
4092,371.422833,371.5097,1,11142684,11145291,2607,0.7870787664069261
4093,371.5281,371.5312,1,11145843,11145936,93,
4094,371.5356,371.543367,1,11146068,11146301,233,0.0001213824640277646
4095,371.5533,371.6713,1,11146599,11150139,3540,0.7749600831347786
4096,371.7836,371.7911,1,11153508,11153733,225,0.14239837031774005
4097,371.800167,371.877867,1,11154005,11156336,2331,0.8103929444190606
4098,371.8797,371.920633,1,11156391,11157618,1227,0.8555334529777815
4099,372.573533,372.585967,1,11177205,11177579,374,0.7517554497154484
4100,372.5872,372.6078,1,11177616,11178234,618,0.4086369815368571
4101,372.633467,372.655067,1,11179004,11179652,648,0.6285772001628938
4102,372.893233,372.908767,1,11186796,11187263,467,0.5496124577100225
4103,372.913167,372.9241,1,11187395,11187723,328,0.45699149241198334
4104,372.962533,372.9721,1,11188875,11189163,288,0.7217167095894093
4105,372.973967,372.978667,1,11189219,11189360,141,0.5877235439187658
4106,373.129633,373.135333,1,11193888,11194059,171,0.3124311563081823
4107,373.137467,373.151033,1,11194124,11194530,406,-0.10683503765108746
4108,373.154233,373.173533,1,11194626,11195205,579,0.18462930685423407
4109,373.1748,373.178567,1,11195244,11195357,113,-0.2331126760040334
4110,373.185067,373.216133,1,11195552,11196483,931,-0.030551242753929106
4111,373.2242,373.277233,1,11196726,11198316,1590,0.7519034274589587
4112,373.286867,373.326367,1,11198606,11199791,1185,0.8165415961449808
4113,373.361967,373.3718,1,11200859,11201154,295,-0.15289471013357483
4114,373.376467,373.385067,1,11201294,11201552,258,0.07099155464069688
4115,373.388433,373.3971,1,11201652,11201913,261,0.40191766167663495
4116,373.4039,373.407033,1,11202117,11202210,93,
4117,373.409433,373.531967,1,11202282,11205959,3677,0.8656118469914602
4118,373.5545,373.6423,1,11206635,11209269,2634,0.8212384287618641
4119,373.662267,373.666133,1,11209868,11209983,115,-0.002716826266917234
4120,373.668167,373.6712,1,11210045,11210136,91,
4121,374.060167,374.0897,1,11221805,11222691,886,0.5409290958842186
4122,374.100967,374.143833,1,11223029,11224314,1285,0.6103211771726513
4123,374.162767,374.199133,1,11224883,11225973,1090,0.7141491258306972
4124,374.215333,374.254033,1,11226459,11227620,1161,0.5843535124506238
4125,374.266767,374.273633,1,11228003,11228208,205,0.5542968199307269
4126,374.3049,374.311533,1,11229147,11229345,198,0.510492801405674
4127,374.3137,374.344733,1,11229411,11230341,930,0.16011982097347643
4128,374.345833,374.365433,1,11230374,11230962,588,0.18929158959333367
4129,374.368067,374.3753,1,11231042,11231259,217,0.048434663721808754
4130,374.377533,374.497967,1,11231325,11234939,3614,0.8010120357180309
4131,374.528167,374.532833,1,11235845,11235984,139,0.6033387352219434
4132,374.548867,374.558633,1,11236466,11236758,292,-0.09303759970537313
4133,374.5664,374.571633,1,11236992,11237148,156,-0.013468094758679135
4134,374.584367,374.5892,1,11237531,11237676,145,0.7628422809644048
4135,374.635133,374.6593,1,11239053,11239779,726,0.5775473684899499
4136,374.674433,374.762133,1,11240232,11242863,2631,0.825689261674962
4137,374.7645,374.768433,1,11242935,11243052,117,0.3330241933250685
4138,374.7701,374.7748,1,11243103,11243244,141,0.20831773134358103
4139,374.778433,374.8702,1,11243352,11246106,2754,0.8066076466494535
4140,374.876667,374.882067,1,11246300,11246462,162,0.08460316108779363
4141,375.0131,375.016367,1,11250393,11250491,98,
4142,375.040967,375.05,1,11251229,11251500,271,0.31543391176805274
4143,375.0576,375.062067,1,11251728,11251862,134,0.5167322494817359
4144,375.200967,375.297133,1,11256029,11258913,2884,0.8106425141190295
4145,375.300333,375.356767,1,11259009,11260703,1694,0.7625384225554551
4146,375.362533,375.444567,1,11260875,11263337,2462,0.7662334991735842
4147,375.448967,375.565133,1,11263469,11266953,3484,0.4688043056833034
4148,375.5844,375.587433,1,11267532,11267622,90,0.35093564474812033
4149,375.5913,375.745467,1,11267739,11272364,4625,0.7859151493406185
4150,375.7611,375.940367,1,11272833,11278211,5378,0.6938709873239438
4151,375.9494,375.958267,1,11278482,11278748,266,0.09381001985319384
4152,375.961367,375.966633,1,11278841,11278998,157,-0.20506467724846933
4153,375.978467,375.981767,1,11279354,11279453,99,-0.0026293739135724126
4154,375.988967,375.997233,1,11279669,11279916,247,-0.22138439240727995
4155,376.0293,376.036733,1,11280879,11281101,222,-0.018160595511799105
4156,376.038967,376.2159,1,11281169,11286477,5308,0.8279190784320332
4157,376.235867,376.305233,1,11287076,11289156,2080,0.7710242697398607
4158,376.306567,376.3753,1,11289197,11291259,2062,0.7807014839591195
4159,376.392667,376.4287,1,11291780,11292861,1081,0.7142632546967617
4160,376.442333,376.4515,1,11293269,11293545,276,-0.1067410153916268
4161,376.454267,376.487267,1,11293628,11294618,990,0.0742947058484423
4162,376.5106,376.613833,1,11295318,11298414,3096,0.7572004689443265
4163,376.6282,376.6497,1,11298846,11299491,645,-0.012582249122225856
4164,376.6513,376.655233,1,11299539,11299656,117,
4165,376.672933,376.817167,1,11300187,11304515,4328,0.7605640707150795
4166,376.874733,376.877767,1,11306241,11306333,92,0.22110672927733563
4167,376.880833,376.884367,1,11306424,11306531,107,0.10667208848127675
4168,376.935633,376.940767,1,11308068,11308223,155,-0.3931238906090558
4169,377.100733,377.104167,1,11313021,11313125,104,0.5630505688010737
4170,377.107167,377.229233,1,11313215,11316876,3661,0.8089045613664089
4171,377.242467,377.257133,1,11317274,11317713,439,0.506602690475018
4172,377.258733,377.279833,1,11317761,11318394,633,0.7393520785561468
4173,377.289167,377.2935,1,11318675,11318805,130,0.5939406200008422
4174,377.3208,377.409633,1,11319624,11322288,2664,0.7428237532224952
4175,377.423667,377.529933,1,11322710,11325897,3187,0.7955533609659198
4176,377.5585,377.570433,1,11326755,11327112,357,0.28282035499897856
4177,377.581567,377.695033,1,11327447,11330850,3403,0.804230520642186
4178,377.780767,377.791667,1,11333423,11333750,327,0.24404334922709064
4179,377.794733,377.815567,1,11333841,11334467,626,0.7938249644928538
4180,377.8181,378.016,1,11334543,11340480,5937,0.7654393205079059
4181,378.0194,378.120567,1,11340582,11343617,3035,0.8320679514760464
4182,378.122567,378.2357,1,11343677,11347071,3394,0.7832474862833626
4183,378.2393,378.329967,1,11347179,11349899,2720,0.5421666977633357
4184,378.3322,378.358367,1,11349966,11350751,785,0.8360928325884633
4185,378.360967,378.4562,1,11350829,11353686,2857,0.8415515854501301
4186,378.457533,378.482767,1,11353725,11354483,758,0.7877170738000514
4187,378.483833,378.601133,1,11354514,11358033,3519,0.830066526064078
4188,378.6114,378.708867,1,11358342,11361266,2924,0.8277122739707062
4189,378.7123,378.7385,1,11361369,11362155,786,0.8752950865883282
4190,378.740467,378.837967,1,11362214,11365139,2925,0.7926979530737386
4191,378.840733,378.867133,1,11365221,11366013,792,0.8440999724122399
4192,378.8701,378.9658,1,11366103,11368974,2871,0.791953421017813
4193,378.9701,378.9914,1,11369103,11369742,639,0.7766375545800938
4194,378.9997,379.055767,1,11369991,11371673,1682,0.7883911174364978
4195,379.074567,379.091167,1,11372237,11372735,498,0.7871841479075941
4196,379.094733,379.0979,1,11372841,11372937,96,-0.040392691068568264
4197,379.099067,379.112867,1,11372972,11373386,414,0.7739176942262955
4198,379.1266,379.184233,1,11373798,11375526,1728,0.8120687677876014
4199,379.186533,379.2189,1,11375595,11376567,972,0.8054492110381964
4200,379.223833,379.240267,1,11376714,11377208,494,0.7338852763096857
4201,379.254733,379.296433,1,11377641,11378892,1251,0.7811074257369056
4202,379.297867,379.3152,1,11378936,11379456,520,0.7163146308136803
4203,379.317567,379.349167,1,11379527,11380475,948,0.7926162720462205
4204,379.353867,379.381967,1,11380616,11381459,843,0.5490209014607756
4205,379.385133,379.4362,1,11381553,11383086,1533,0.6477316383097219
4206,379.4436,379.476067,1,11383308,11384282,974,0.7900703940209844
4207,379.4783,379.563833,1,11384349,11386914,2565,0.663766775936455
4208,379.572967,379.592267,1,11387189,11387768,579,0.8435142625745352
4209,379.607467,379.612667,1,11388224,11388380,156,0.03398880302176759
4210,379.6143,379.6192,1,11388429,11388576,147,0.019152356785811106
4211,379.621133,379.630933,1,11388633,11388927,294,0.08433308764496687
4212,379.6419,379.644933,1,11389257,11389347,90,
4213,379.656333,379.659667,1,11389689,11389790,101,
4214,379.6725,379.7303,1,11390175,11391909,1734,0.7425131039563793
4215,379.750733,379.755467,1,11392521,11392664,143,
4216,379.764467,379.767733,1,11392934,11393031,97,-0.09296640709781176
4217,379.768933,379.8603,1,11393067,11395809,2742,0.8134974149807938
4218,379.883833,379.8878,1,11396514,11396634,120,
4219,379.9046,379.923,1,11397138,11397690,552,-0.027955965797809405
4220,379.9257,379.940633,1,11397771,11398218,447,0.10774216280523506
4221,379.944833,379.9523,1,11398344,11398569,225,-0.11389892527906356
4222,379.999,380.0438,1,11399970,11401314,1344,0.8228171062872582
4223,380.046733,380.137767,1,11401401,11404133,2732,0.8298046483429705
4224,380.153233,380.1908,1,11404596,11405724,1128,0.70417513344422
4225,380.195967,380.2321,1,11405879,11406963,1084,0.03625149900537763
4226,380.234033,380.254267,1,11407020,11407628,608,0.033983006248301716
4227,380.2801,380.437233,1,11408403,11413116,4713,0.819998805619664
4228,380.446933,380.520133,1,11413407,11415603,2196,0.5349727196203965
4229,380.530633,380.579933,1,11415918,11417397,1479,0.0375642564139385
4230,380.591,380.594233,1,11417730,11417826,96,0.6210077516743542
4231,380.599967,380.6213,1,11417999,11418639,640,0.8631953541823091
4232,380.622533,380.713767,1,11418675,11421413,2738,0.8072902963437563
4233,380.7273,380.747233,1,11421819,11422416,597,0.0322014728139442
4234,380.749667,380.779933,1,11422490,11423397,907,0.11167449665236283
4235,380.795733,380.7999,1,11423871,11423997,126,0.6137848509875633
4236,380.803367,380.908833,1,11424101,11427264,3163,0.8382089496135925
4237,380.9266,381.0593,1,11427798,11431779,3981,0.7991488671888155
4238,381.0837,381.0937,1,11432511,11432811,300,0.5607696211623519
4239,381.098167,381.147867,1,11432945,11434436,1491,0.05339961319649589
4240,381.173267,381.179733,1,11435198,11435391,193,-0.03672117601424994
4241,381.185,381.379933,1,11435550,11441397,5847,0.7987336819373723
4242,381.382567,381.4441,1,11441477,11443323,1846,0.7869406738563006
4243,381.4454,381.479233,1,11443362,11444376,1014,0.3727453696646957
4244,381.687233,381.991233,1,11450616,11459736,9120,0.7862569366044473
4245,382.025033,382.046,1,11460750,11461380,630,-0.049091389322051635
4246,382.050833,382.087033,1,11461524,11462610,1086,0.07098644953563177
4247,382.0885,382.099433,1,11462655,11462982,327,0.12011693315372997
4248,382.100933,382.212367,1,11463027,11466371,3344,0.8329082841938474
4249,382.2162,382.220233,1,11466486,11466606,120,-0.5162701791532182
4250,382.223067,382.2273,1,11466692,11466819,127,-0.5274820555053147
4251,382.2388,382.2932,1,11467164,11468796,1632,0.08164887863093205
4252,382.299667,382.305033,1,11468990,11469150,160,0.5437570643491701
4253,382.310133,382.4001,1,11469303,11472003,2700,0.8454839483009361
4254,382.401633,382.487367,1,11472048,11474621,2573,0.8353274807597003
4255,382.4932,382.6081,1,11474796,11478243,3447,0.7598004024165976
4256,382.628867,382.668967,1,11478866,11480069,1203,0.047820345998089916
4257,382.670567,382.690367,1,11480117,11480711,594,-0.04815548686778704
4258,382.694167,382.707767,1,11480825,11481233,408,0.21552916924116272
4259,382.727433,382.769967,1,11481822,11483099,1277,0.004723434992599427
4260,382.779567,382.798433,1,11483387,11483952,565,-0.00411622007679684
4261,382.803767,382.807067,1,11484113,11484212,99,
4262,382.816,382.948567,1,11484480,11488457,3977,0.8393420514124774
4263,382.953733,382.958133,1,11488611,11488743,132,0.7069981151276249
4264,382.964033,382.984333,1,11488920,11489529,609,-0.047299143420363995
4265,382.995167,383.0342,1,11489855,11491026,1171,-0.03723688219646455
4266,383.035367,383.055033,1,11491061,11491650,589,-0.07923077361354526
4267,383.063533,383.089233,1,11491905,11492676,771,0.08790267637948554
4268,383.0905,383.114833,1,11492715,11493444,729,0.29729489260524256
4269,383.122967,383.144333,1,11493689,11494329,640,0.02521972050350966
4270,383.1455,383.158967,1,11494365,11494769,404,0.08216008246605602
4271,383.160333,383.171767,1,11494809,11495153,344,0.25141644596861057
4272,383.176833,383.1813,1,11495304,11495439,135,-0.14339602002882146
4273,383.195867,383.200067,1,11495876,11496002,126,0.16266316640245243
4274,383.205967,383.218333,1,11496179,11496549,370,0.3104198231456466
4275,383.2207,383.224567,1,11496621,11496737,116,0.34504063944436236
4276,383.225633,383.4193,1,11496768,11502579,5811,0.6424493992584778
4277,383.424433,383.440433,1,11502732,11503212,480,0.7430580061092301
4278,383.441533,383.461833,1,11503245,11503854,609,0.7335861035692892
4279,383.474533,383.495933,1,11504235,11504877,642,0.1421841925983377
4280,383.501967,383.528833,1,11505059,11505864,805,-0.041129452419367614
4281,383.531667,383.5452,1,11505950,11506356,406,0.27830257200452063
4282,383.5618,383.565833,1,11506854,11506974,120,0.4731014891650722
4283,383.5739,383.576933,1,11507217,11507307,90,-0.0394067016684015
4284,383.5807,383.756233,1,11507421,11512686,5265,0.8267771364835607
4285,383.769533,383.806367,1,11513085,11514191,1106,0.7471337667316784
4286,383.808933,383.896167,1,11514267,11516885,2618,0.7424205112451361
4287,383.925667,384.032733,1,11517770,11520981,3211,0.7956603169706619
4288,384.048167,384.058433,1,11521445,11521752,307,0.08375805658463893
4289,384.0858,384.089333,1,11522574,11522679,105,-0.22399565468886823
4290,384.114167,384.121333,1,11523425,11523639,214,0.014665965306257503
4291,384.124933,384.155,1,11523747,11524650,903,0.7309607798985351
4292,384.1667,384.315533,1,11525001,11529465,4464,0.7430536200092356
4293,384.321333,384.3676,1,11529639,11531028,1389,0.7987600111044667
4294,384.376733,384.406067,1,11531301,11532182,881,0.7861280079936246
4295,384.408967,384.473167,1,11532269,11534195,1926,0.7958004409887439
4296,384.4778,384.496667,1,11534334,11534900,566,0.8272471201847297
4297,384.501567,384.5125,1,11535047,11535375,328,0.7131229275320923
4298,384.526533,384.5322,1,11535795,11535966,171,0.6247221134902246
4299,384.536167,384.5588,1,11536085,11536764,679,0.12159408372946931
4300,384.5603,384.570067,1,11536809,11537102,293,0.058491259684365124
4301,384.5721,384.599733,1,11537163,11537991,828,-0.0215779065168787
4302,384.617733,384.623267,1,11538531,11538698,167,0.5006728812403302
4303,384.629833,384.6348,1,11538894,11539044,150,-0.052135164798629896
4304,384.651967,384.783533,1,11539559,11543505,3946,0.8223326821645517
4305,384.785267,384.788933,1,11543558,11543667,109,
4306,384.7915,384.7949,1,11543745,11543847,102,
4307,384.8007,384.872067,1,11544021,11546162,2141,0.5258127497921264
4308,384.8818,384.885067,1,11546454,11546552,98,0.3340734293692846
4309,384.8891,385.0028,1,11546673,11550084,3411,0.8427380072356427
4310,385.006233,385.011867,1,11550186,11550356,170,0.4362881857832251
4311,385.021433,385.043933,1,11550642,11551317,675,0.11258052777324476
4312,385.045433,385.0922,1,11551362,11552766,1404,0.015038814697641387
4313,385.102733,385.112167,1,11553081,11553365,284,0.09322603444124991
4314,385.113667,385.116967,1,11553410,11553509,99,0.5546310474311857
4315,385.128133,385.289767,1,11553843,11558693,4850,0.8210440646996635
4316,385.2932,385.296933,1,11558796,11558907,111,-0.16168439391624675
4317,385.3527,385.370733,1,11560581,11561121,540,0.09791401172768052
4318,385.3718,385.377933,1,11561154,11561337,183,0.25050973619198325
4319,385.410367,385.413867,1,11562311,11562416,105,0.7335340506134163
4320,385.453833,385.473433,1,11563614,11564202,588,0.848317374887545
4321,385.4756,385.5731,1,11564268,11567193,2925,0.8555280048180683
4322,385.583633,385.591067,1,11567508,11567732,224,0.384309809692109
4323,385.5988,385.6539,1,11567964,11569617,1653,0.12938476952727662
4324,385.6585,385.6676,1,11569755,11570028,273,-0.07002742633231188
4325,385.669067,385.6831,1,11570072,11570493,421,0.24694005529702856
4326,385.685633,385.689633,1,11570568,11570688,120,
4327,385.7056,385.789633,1,11571168,11573688,2520,0.8211836467494363
4328,385.793633,385.8818,1,11573808,11576454,2646,0.8424162561983767
4329,385.8988,386.1319,1,11576964,11583957,6993,0.8176526061700657
4330,386.133067,386.157867,1,11583992,11584736,744,0.34203032557674484
4331,386.163667,386.197667,1,11584910,11585930,1020,0.08906709240569018
4332,386.211367,386.2153,1,11586341,11586459,118,
4333,386.2168,386.222967,1,11586504,11586689,185,0.5062437633633398
4334,386.224567,386.228733,1,11586737,11586861,124,0.4861214267938103
4335,386.234067,386.2398,1,11587022,11587194,172,0.11787362364644495
4336,386.243667,386.2632,1,11587310,11587896,586,0.390902506127847
4337,386.279533,386.428867,1,11588385,11592866,4481,0.8023063725627256
4338,386.435867,386.592467,1,11593076,11597774,4698,0.7717715860132426
4339,386.595167,386.615767,1,11597855,11598473,618,0.3343277672769611
4340,386.629633,386.663367,1,11598888,11599901,1013,0.17506957649886876
4341,386.684167,386.700833,1,11600525,11601024,499,0.5487083327467663
4342,386.702433,386.905867,1,11601072,11607176,6104,0.841246112601043
4343,386.922833,386.9274,1,11607684,11607822,138,0.005013310551379472
4344,386.9322,386.956133,1,11607966,11608683,717,0.08994292492472268
4345,386.9672,386.988033,1,11609016,11609640,624,-0.02088869025162782
4346,386.991533,387.0034,1,11609745,11610102,357,0.25510007607319707
4347,387.019767,387.033433,1,11610593,11611002,409,0.28660380486941917
4348,387.035033,387.05,1,11611050,11611500,450,0.20102655766121427
4349,387.054267,387.068833,1,11611628,11612064,436,0.4671530666036287
4350,387.094233,387.104133,1,11612826,11613123,297,0.13900796018471476
4351,387.1228,387.126867,1,11613684,11613806,122,
4352,387.131467,387.140433,1,11613944,11614212,268,0.4455088354845702
4353,387.1432,387.147767,1,11614296,11614433,137,0.8323753261495767
4354,387.153933,387.207233,1,11614617,11616216,1599,0.7539793226518623
4355,387.210667,387.2379,1,11616320,11617137,817,0.8014515040323851
4356,387.239067,387.3176,1,11617172,11619528,2356,0.7356159674146119
4357,387.319267,387.329133,1,11619578,11619873,295,0.5038437696206284
4358,387.3404,387.365333,1,11620212,11620959,747,0.03318101880729521
4359,387.366667,387.3759,1,11621000,11621277,277,0.17949208425990024
4360,387.3795,387.383133,1,11621385,11621493,108,-0.23649707065073514
4361,387.397967,387.4157,1,11621939,11622471,532,0.4900748054281609
4362,387.416733,387.425133,1,11622501,11622753,252,0.3796008286192645
4363,387.4273,387.448467,1,11622819,11623454,635,0.2168679968941994
4364,387.464933,387.6008,1,11623947,11628024,4077,0.8305947743415549
4365,387.6157,387.630667,1,11628471,11628920,449,0.09078459618168333
4366,387.633067,387.637567,1,11628992,11629127,135,0.4846690082871388
4367,387.6468,387.688267,1,11629404,11630648,1244,-0.16779681052094922
4368,387.689267,387.6961,1,11630678,11630883,205,-0.31372132210118836
4369,387.7154,387.7886,1,11631462,11633658,2196,0.3897214661399572
4370,387.7897,387.7967,1,11633691,11633901,210,0.16993540339649152
4371,387.805033,387.811933,1,11634150,11634357,207,0.28496939227808965
4372,387.818067,387.822667,1,11634542,11634680,138,-0.04317726995488962
4373,387.855767,387.875033,1,11635673,11636250,577,0.18659595686077768
4374,387.8815,387.899867,1,11636445,11636996,551,0.2637045683608068
4375,387.9201,388.048267,1,11637603,11641448,3845,0.7233302155323151
4376,388.055733,388.076667,1,11641671,11642300,629,0.5786898873273233
4377,388.0791,388.129933,1,11642373,11643897,1524,0.6301929226286532
4378,388.1401,388.166067,1,11644203,11644982,779,0.5600066721073865
4379,388.172367,388.187967,1,11645171,11645639,468,0.6330622013599302
4380,388.207433,388.284967,1,11646222,11648549,2327,0.4916753539568614
4381,388.302167,388.4263,1,11649065,11652789,3724,0.6986911202668497
4382,388.436,388.5036,1,11653080,11655108,2028,0.13154274355754558
4383,388.5064,388.534,1,11655192,11656020,828,0.08842885145442622
4384,388.5351,388.5402,1,11656053,11656206,153,0.03761291787086296
4385,388.541333,388.5594,1,11656239,11656782,543,0.49295558258933236
4386,388.568233,388.5873,1,11657046,11657619,573,0.08039596178896623
4387,388.5945,388.612033,1,11657835,11658360,525,0.045872258939012645
4388,388.6196,388.631267,1,11658588,11658938,350,0.12010515441727905
4389,388.6343,388.6453,1,11659029,11659359,330,-0.05182503258174091
4390,388.687533,388.766333,1,11660625,11662989,2364,0.5669928572698177
4391,388.770167,388.806533,1,11663105,11664195,1090,0.40231607969677646
4392,388.807633,388.838067,1,11664228,11665142,914,0.6980378301622275
4393,388.8394,388.8529,1,11665182,11665587,405,0.4236084033164525
4394,388.860733,388.902133,1,11665821,11667063,1242,0.19234001019128152
4395,388.904533,388.9474,1,11667135,11668422,1287,0.023767701411042643
4396,388.9552,388.982967,1,11668656,11669489,833,0.2523457326234411
4397,388.985867,389.0058,1,11669576,11670174,598,0.16981421557916812
4398,389.0205,389.027767,1,11670615,11670833,218,-0.014445606820542568
4399,389.038333,389.042167,1,11671149,11671265,116,-0.21396144319054586
4400,389.047967,389.057567,1,11671439,11671727,288,0.010761785370817933
4401,389.058733,389.062,1,11671761,11671860,99,0.5750147520985901
4402,389.0874,389.091233,1,11672622,11672736,114,-0.22669432015146637
4403,389.092267,389.110367,1,11672768,11673311,543,-0.18786712778604303
4404,389.1115,389.181933,1,11673345,11675457,2112,0.149989483589598
4405,389.1832,389.1929,1,11675496,11675787,291,0.18908633395365718
4406,389.241033,389.2511,1,11677230,11677533,303,0.643995330966735
4407,389.254933,389.2748,1,11677647,11678244,597,0.450327366759615
4408,389.294833,389.314167,1,11678844,11679425,581,0.4635196151351464
4409,389.3381,389.343133,1,11680143,11680293,150,-0.12858105476372558
4410,389.3735,389.383667,1,11681205,11681510,305,-0.28697728753199686
4411,389.3895,389.4044,1,11681685,11682132,447,0.32997613314400087
4412,389.4199,389.435567,1,11682597,11683067,470,0.011572170429469057
4413,389.436633,389.442167,1,11683098,11683265,167,0.15339738335262057
4414,389.4496,389.457533,1,11683488,11683725,237,0.1850136553178662
4415,389.467833,389.578467,1,11684034,11687354,3320,0.6506968103431515
4416,389.597433,389.6115,1,11687922,11688345,423,0.3082272589925138
4417,389.612633,389.616233,1,11688378,11688486,108,0.44503705988112574
4418,389.621767,389.653233,1,11688653,11689596,943,0.21457790293876777
4419,389.655633,389.666467,1,11689668,11689994,326,0.18039045408234067
4420,389.670233,389.696233,1,11690106,11690886,780,-0.06207538861000652
4421,389.703033,389.808167,1,11691090,11694245,3155,-0.12118820847735653
4422,389.8342,389.995233,1,11695026,11699856,4830,0.838273124832311
4423,390.003633,390.103633,1,11700108,11703108,3000,0.8280525959639047
4424,390.120667,390.232533,1,11703620,11706975,3355,0.7472386545579304
4425,391.099933,391.107133,1,11732997,11733213,216,0.6038032251432462
4426,391.108267,391.135467,1,11733248,11734064,816,0.6846838630468958
4427,391.170633,391.1761,1,11735118,11735283,165,0.49163245374919273
4428,391.179967,391.184233,1,11735399,11735526,127,0.30244513793239103
4429,391.191833,391.205933,1,11735754,11736177,423,0.7858955393298087
4430,391.231367,391.239833,1,11736941,11737194,253,0.5792039571409303
4431,391.244433,391.274867,1,11737332,11738246,914,0.6778371542787688
4432,391.3203,391.336167,1,11739609,11740085,476,0.6963548598317373
4433,391.3613,391.3661,1,11740839,11740983,144,0.6893123303601346
4434,391.369467,391.385433,1,11741084,11741562,478,0.6378638409076567
4435,391.411767,391.423367,1,11742353,11742701,348,0.43192099892368163
4436,391.436167,391.450433,1,11743085,11743512,427,0.02548339845111254
4437,391.4557,391.459333,1,11743671,11743779,108,
4438,391.460567,391.4737,1,11743817,11744211,394,0.09083673476610588
4439,391.4756,391.4831,1,11744268,11744493,225,0.26961325048425094
4440,391.506033,391.6198,1,11745180,11748594,3414,0.6571841519003007
4441,391.643433,391.651967,1,11749302,11749559,257,0.3286035214660755
4442,391.655833,391.661533,1,11749674,11749845,171,0.28225322319639473
4443,391.663567,391.687633,1,11749907,11750628,721,0.26575673565987057
4444,391.690167,391.700167,1,11750705,11751005,300,0.13791939149346313
4445,391.703133,391.713,1,11751093,11751390,297,0.22191469450000936
4446,391.714967,391.726333,1,11751449,11751789,340,-0.05757561679442253
4447,391.7405,391.7573,1,11752215,11752719,504,0.16720542391646095
4448,391.766233,391.791133,1,11752986,11753733,747,0.0898858874858756
4449,391.7961,391.954167,1,11753883,11758625,4742,0.7031064230867938
4450,391.9652,391.981667,1,11758956,11759450,494,0.3862261244187991
4451,391.986933,392.001367,1,11759607,11760041,434,0.07840377263717686
4452,392.002433,392.038333,1,11760072,11761149,1077,-0.027957341906642796
4453,392.054467,392.096367,1,11761634,11762891,1257,0.05888737356743875
4454,392.110767,392.134167,1,11763323,11764025,702,0.070921259291724
4455,392.1372,392.150767,1,11764116,11764523,407,-0.16535497179110065
4456,392.1827,392.186567,1,11765481,11765597,116,0.20154978383592087
4457,392.195533,392.200667,1,11765865,11766020,155,0.6706086043608499
4458,392.207333,392.2665,1,11766219,11767995,1776,0.8311943870073035
4459,392.2693,392.332167,1,11768079,11769965,1886,0.820212561498044
4460,392.339267,392.394167,1,11770178,11771825,1647,0.82660437213629
4461,392.400033,392.440567,1,11772000,11773217,1217,0.7927550151176681
4462,392.453,392.566633,1,11773590,11776998,3408,0.8067458776613738
4463,392.586167,392.594467,1,11777585,11777834,249,0.04969688018111827
4464,392.598833,392.602967,1,11777964,11778089,125,
4465,392.613533,392.633233,1,11778405,11778996,591,0.5483002603378331
4466,392.6381,392.6421,1,11779143,11779263,120,
4467,392.647333,392.727333,1,11779419,11781819,2400,0.7904554770788084
4468,392.7316,392.735533,1,11781948,11782065,117,0.4689075119048456
4469,392.7368,392.747,1,11782104,11782410,306,-0.024384446588900564
4470,392.778333,392.7845,1,11783349,11783535,186,
4471,392.852933,392.858667,1,11785587,11785760,173,0.1875102213899346
4472,392.861,392.8649,1,11785830,11785947,117,
4473,392.867267,392.889667,1,11786018,11786690,672,0.1896048468280225
4474,392.8907,392.8943,1,11786721,11786829,108,0.345293051900241
4475,392.904333,392.9465,1,11787129,11788395,1266,-0.02747717543558194
4476,392.9605,392.964067,1,11788815,11788922,107,0.05762618024200078
4477,392.968867,393.236633,1,11789066,11797098,8032,0.7893804574525383
4478,393.248067,393.251967,1,11797442,11797559,117,0.147815475583887
4479,393.271267,393.274967,1,11798138,11798249,111,
4480,393.2808,393.284733,1,11798424,11798541,117,0.5475416788956169
4481,394.010333,394.0188,1,11820309,11820564,255,0.3279124411779209
4482,394.032133,394.0401,1,11820963,11821203,240,0.6468302216705518
4483,394.0665,394.1079,1,11821995,11823237,1242,0.7218732118492348
4484,394.125033,394.1721,1,11823750,11825163,1413,0.6709175279628494
4485,394.184067,394.1887,1,11825522,11825661,139,0.8720745353312622
4486,394.1922,394.245567,1,11825766,11827367,1601,0.6246952227289151
4487,394.260767,394.306833,1,11827823,11829204,1381,0.7385275539045429
4488,394.3129,394.366533,1,11829387,11830995,1608,0.662065324013847
4489,394.383867,394.416433,1,11831516,11832492,976,0.7498017127110138
4490,394.420167,394.4353,1,11832605,11833059,454,0.8468855759591172
4491,394.441933,394.4698,1,11833257,11834094,837,0.7286326757170708
4492,394.477533,394.535967,1,11834325,11836079,1754,0.08065462820256229
4493,394.5574,394.670833,1,11836722,11840124,3402,0.8053119401658467
4494,394.676867,394.686667,1,11840306,11840600,294,0.07650299626732521
4495,394.687867,394.701,1,11840636,11841030,394,0.034130015976878994
4496,394.707867,394.723167,1,11841236,11841695,459,-0.004914235807411134
4497,394.7254,394.761733,1,11841762,11842851,1089,0.01733668394125889
4498,394.768067,394.7843,1,11843042,11843529,487,0.3130723872579594
4499,394.7866,394.7947,1,11843598,11843841,243,0.08051874412154619
4500,394.8001,394.824433,1,11844003,11844732,729,0.380912576723895
4501,394.833233,394.874233,1,11844996,11846226,1230,0.05149109302535539
4502,394.878433,395.046933,1,11846352,11851407,5055,0.680532068142942
4503,395.055167,395.127567,1,11851655,11853827,2172,0.8350312312636987
4504,395.1302,395.136867,1,11853906,11854106,200,0.4203568626720291
4505,395.148967,395.1544,1,11854469,11854632,163,-0.04857705791454101
4506,395.160167,395.242767,1,11854805,11857283,2478,0.7749798327242271
4507,395.261367,395.2721,1,11857841,11858163,322,-0.03333426457358727
4508,395.284833,395.449633,1,11858544,11863488,4944,0.36039436850331474
4509,395.458,395.521767,1,11863740,11865653,1913,0.157575965817871
4510,395.5335,395.6499,1,11866005,11869497,3492,0.8176079421853935
4511,395.700467,395.705567,1,11871014,11871167,153,0.3710576278488224
4512,395.711333,395.717767,1,11871339,11871533,194,-0.052048166019002744
4513,395.726433,395.747067,1,11871792,11872412,620,0.2631321443692876
4514,395.831933,395.8389,1,11874957,11875167,210,0.21410585308784957
4515,395.858433,395.892533,1,11875752,11876775,1023,0.6995124175516784
4516,395.897233,395.9076,1,11876916,11877228,312,0.1112272418123425
4517,395.908633,395.916533,1,11877258,11877495,237,0.47183353233373804
4518,395.917967,395.921133,1,11877539,11877633,94,
4519,395.968167,395.977933,1,11879045,11879337,292,0.5761713157793096
4520,395.9802,396.014267,1,11879406,11880428,1022,0.20779947670887447
4521,396.0185,396.035333,1,11880555,11881059,504,0.029341039583061793
4522,396.0366,396.065467,1,11881098,11881964,866,0.15783325620427183
4523,396.0762,396.1192,1,11882286,11883576,1290,0.6278453328557458
4524,396.120333,396.176133,1,11883609,11885283,1674,0.5571818444663185
4525,396.209567,396.237367,1,11886287,11887121,834,0.6898378963255516
4526,396.2451,396.251533,1,11887353,11887545,192,0.1596629379327404
4527,396.254333,396.313533,1,11887629,11889405,1776,0.2927685399075443
4528,396.3214,396.325,1,11889642,11889750,108,0.16388286132785254
4529,396.336033,396.361567,1,11890080,11890847,767,0.729330347566676
4530,396.371,396.386133,1,11891130,11891583,453,0.16822873478748876
4531,396.3872,396.4077,1,11891616,11892231,615,0.09410377328728542
4532,396.4097,396.440033,1,11892291,11893200,909,0.20485589005312044
4533,396.444267,396.706467,1,11893328,11901194,7866,0.7184871015419403
4534,396.720467,396.774567,1,11901614,11903237,1623,0.45148487443306184
4535,396.785233,396.7964,1,11903556,11903892,336,0.21762734036748965
4536,396.8162,396.820367,1,11904486,11904611,125,0.7588570978805989
4537,397.245867,397.2754,1,11917376,11918262,886,0.7788827958981517
4538,397.2918,397.331867,1,11918754,11919956,1202,0.7683583771513555
4539,397.347333,397.4204,1,11920419,11922612,2193,0.7629438532453222
4540,397.4247,397.508833,1,11922741,11925264,2523,0.7604473967376033
4541,397.511667,397.559233,1,11925350,11926776,1426,0.7649819849594011
4542,397.564067,397.5983,1,11926922,11927949,1027,0.07374081430704733
4543,397.600967,397.635133,1,11928029,11929053,1024,0.09567568784568575
4544,397.645433,397.905867,1,11929362,11937176,7814,0.8155865969224478
4545,397.928633,397.9521,1,11937858,11938563,705,0.7016056803894631
4546,397.987633,398.0059,1,11939628,11940177,549,0.013787707183985793
4547,398.016133,398.025067,1,11940483,11940752,269,-0.014667865522870284
4548,398.035067,398.0413,1,11941052,11941239,187,-0.054245134586222335
4549,398.1406,398.144733,1,11944218,11944341,123,0.4780457731995803
4550,398.1515,398.212533,1,11944545,11946375,1830,0.7504479236861833
4551,398.213733,398.3657,1,11946411,11950971,4560,0.7534924756424802
4552,398.368033,398.376467,1,11951040,11951294,254,0.23192561093433542
4553,398.398567,398.474533,1,11951957,11954235,2278,0.734751173927187
4554,398.476667,398.536967,1,11954300,11956109,1809,0.7607764545091734
4555,398.5516,398.5927,1,11956548,11957781,1233,0.6935482694848184
4556,398.609133,398.6297,1,11958273,11958891,618,0.042685230543973295
4557,398.633033,398.642433,1,11958990,11959272,282,0.14533759667975898
4558,398.6968,398.773967,1,11960904,11963219,2315,0.3131600423117833
4559,398.7777,398.780833,1,11963331,11963424,93,-0.5258058409533737
4560,398.792467,398.799967,1,11963774,11963999,225,0.07453027483866245
4561,398.804967,398.8096,1,11964149,11964288,139,0.5013755641999672
4562,398.8106,398.814367,1,11964318,11964431,113,-0.008031397863527233
4563,398.8158,398.830633,1,11964474,11964918,444,0.22470978701868485
4564,398.834733,398.975033,1,11965041,11969250,4209,0.7419827559393464
4565,398.978267,399.028367,1,11969348,11970851,1503,0.7623215942710923
4566,399.032833,399.2661,1,11970984,11977983,6999,0.47502912661499835
4567,399.291933,399.297733,1,11978757,11978931,174,0.4671066891665178
4568,399.3776,399.3808,1,11981328,11981424,96,0.10260792913139909
4569,399.383133,399.392333,1,11981493,11981769,276,-0.0369727440210152
4570,399.395,399.399033,1,11981850,11981970,120,-0.10209223556330131
4571,399.401067,399.4079,1,11982032,11982237,205,0.07648668203512933
4572,399.417567,399.424633,1,11982527,11982738,211,0.37829941822712215
4573,399.7822,399.788733,1,11993466,11993661,195,0.7687979208615568
4574,399.808967,399.848733,1,11994269,11995461,1192,0.6405325672410982
4575,399.890867,399.908,1,11996726,11997240,514,0.7427488637180192
4576,399.911633,399.918567,1,11997348,11997557,209,0.5860704320047377
4577,399.942933,400.002833,1,11998287,12000084,1797,0.6546775838889578
4578,400.0039,400.009067,1,12000117,12000272,155,0.1536073397519457
4579,400.010233,400.021867,1,12000306,12000656,350,0.9036376439809042
4580,400.031067,400.036367,1,12000932,12001091,159,0.7135105651324021
4581,400.0449,400.065833,1,12001347,12001974,627,0.6795021512406536
4582,400.083133,400.2418,1,12002493,12007254,4761,0.4720597553375267
4583,400.244267,400.3404,1,12007328,12010212,2884,0.7746871890152024
4584,400.352833,400.397467,1,12010584,12011924,1340,0.8062564538715755
4585,400.411433,400.419067,1,12012342,12012572,230,0.657284935660924
4586,400.420367,400.445033,1,12012611,12013350,739,0.7818376116496355
4587,400.467467,400.5095,1,12014024,12015285,1261,0.07837869255726473
4588,400.510967,400.520933,1,12015329,12015627,298,0.10604513115671682
4589,400.542533,400.657167,1,12016275,12019715,3440,0.7907255796884974
4590,400.669133,400.693467,1,12020073,12020804,731,-0.025722055817534208
4591,400.698767,400.715267,1,12020963,12021458,495,-0.023975809164725023
4592,400.748733,400.798367,1,12022461,12023951,1490,0.16231063540459179
4593,400.8093,400.8206,1,12024279,12024618,339,0.0042920068774168025
4594,400.823133,400.833733,1,12024693,12025011,318,0.08021323687002833
4595,400.837,400.843667,1,12025110,12025310,200,-0.09894178338143081
4596,400.8846,400.940133,1,12026538,12028203,1665,0.7504899500435714
4597,400.941267,400.986567,1,12028238,12029597,1359,0.7781942074230942
4598,400.988033,400.994,1,12029640,12029820,180,0.4809910772447846
4599,401.010567,401.033433,1,12030317,12031002,685,-0.029624988076681496
4600,401.0345,401.0664,1,12031035,12031992,957,0.08148245713771407
4601,401.1052,401.111233,1,12033156,12033336,180,0.41267110989279426
4602,401.122833,401.305167,1,12033684,12039155,5471,0.7004376623868241
4603,401.341867,401.422267,1,12040256,12042668,2412,0.6073130820046054
4604,401.4533,401.4968,1,12043599,12044904,1305,0.18413545235224546
4605,401.8019,401.829367,1,12054057,12054881,824,0.8130411753560924
4606,401.8394,401.898433,1,12055182,12056952,1770,0.8322055542178806
4607,401.9,401.956267,1,12057000,12058688,1688,0.777994542694786
4608,401.962267,402.021867,1,12058868,12060656,1788,0.7787870068936592
4609,402.040967,402.078467,1,12061229,12062354,1125,0.7754047441798253
4610,402.080567,402.1393,1,12062417,12064179,1762,0.7543052641076635
4611,402.1528,402.202333,1,12064584,12066069,1485,0.8161061626798832
4612,402.2099,402.226033,1,12066297,12066780,483,0.7593805131445197
4613,402.2312,402.234533,1,12066936,12067035,99,0.2849129829575546
4614,402.238767,402.2983,1,12067163,12068949,1786,0.06045846189337766
4615,402.3165,402.334133,1,12069495,12070023,528,0.7159058569187455
4616,402.335133,402.433333,1,12070053,12072999,2946,0.8178390825179029
4617,402.4517,402.4585,1,12073551,12073755,204,0.608075739914267
4618,402.464267,402.477167,1,12073928,12074315,387,-0.08169078013781908
4619,402.482133,402.508167,1,12074463,12075245,782,0.15850047934569209
4620,402.521967,402.5869,1,12075659,12077607,1948,0.6999837963671873
4621,402.588733,402.677367,1,12077661,12080321,2660,0.7383719642056512
4622,402.6811,402.694467,1,12080433,12080834,401,0.4705521507583219
4623,403.072833,403.095833,1,12092184,12092874,690,0.7308358308804751
4624,403.100433,403.103767,1,12093012,12093113,101,0.21925399428630885
4625,403.111033,403.172733,1,12093330,12095181,1851,0.5572427705525642
4626,403.174233,403.196733,1,12095226,12095901,675,0.801423400038543
4627,403.2089,403.239433,1,12096267,12097182,915,0.7885322218637718
4628,403.2487,403.3203,1,12097461,12099609,2148,0.7530460731736349
4629,403.3238,403.3302,1,12099714,12099906,192,0.31200764849551677
4630,403.334433,403.3571,1,12100032,12100713,681,0.7564326651164435
4631,403.371767,403.380667,1,12101153,12101420,267,0.1462012821894409
4632,403.3892,403.408667,1,12101676,12102260,584,-0.06136519255494613
4633,403.4106,403.4399,1,12102318,12103197,879,0.034874380604252415
4634,403.457767,403.5806,1,12103733,12107418,3685,0.8284444479211751
4635,403.602233,403.611367,1,12108066,12108341,275,0.14863465314838628
4636,403.628033,403.655167,1,12108840,12109655,815,0.03440677178564556
4637,403.663333,403.684033,1,12109899,12110520,621,0.2415455903625638
4638,403.7416,403.756467,1,12112248,12112694,446,0.720001069183306
4639,403.7582,403.8006,1,12112746,12114018,1272,0.5626521915940146
4640,403.895733,403.952733,1,12116871,12118581,1710,0.7418683871843905
4641,403.954033,403.998633,1,12118620,12119958,1338,0.7955862085441249
4642,404.0217,404.026567,1,12120651,12120797,146,0.05361955226617309
4643,404.047467,404.052033,1,12121424,12121560,136,0.09857732985330687
4644,404.093167,404.096333,1,12122795,12122889,94,
4645,404.104433,404.155867,1,12123132,12124676,1544,0.37094901586535095
4646,404.182533,404.189167,1,12125475,12125675,200,0.29688506841113926
4647,404.1904,404.194733,1,12125712,12125841,129,
4648,404.234,404.263667,1,12127020,12127910,890,0.814841967786084
4649,404.265367,404.366833,1,12127961,12131004,3043,0.7223067456337192
4650,404.391467,404.401833,1,12131744,12132054,310,-0.08401562230883997
4651,404.4052,404.417033,1,12132156,12132510,354,0.17136040682426745
4652,404.423933,404.435033,1,12132717,12133050,333,0.01638033010094057
4653,404.436167,404.445633,1,12133085,12133368,283,0.15011439858730086
4654,404.469967,404.475167,1,12134099,12134255,156,0.17876617892463054
4655,404.483667,404.493267,1,12134510,12134798,288,0.11221398166891042
4656,404.494267,404.522633,1,12134828,12135678,850,0.5131124507181063
4657,404.548633,404.5533,1,12136458,12136599,141,0.7935118565937709
4658,404.662567,404.668367,1,12139877,12140051,174,
4659,404.6776,404.7647,1,12140328,12142941,2613,0.713654005817828
4660,404.7659,404.784767,1,12142977,12143543,566,0.706634957417528
4661,404.846833,404.906633,1,12145404,12147198,1794,0.5862500818110233
4662,404.9109,404.922233,1,12147327,12147666,339,0.09517397049084236
4663,404.9416,404.9519,1,12148248,12148557,309,0.16773415919099724
4664,404.989733,405.177933,1,12149691,12155337,5646,0.7904715347593003
4665,405.1882,405.3393,1,12155646,12160179,4533,0.3917653590046024
4666,405.635567,405.668833,1,12169067,12170064,997,0.7164127074919943
4667,405.6721,405.727233,1,12170163,12171816,1653,0.801390406643681
4668,405.7294,405.7328,1,12171882,12171984,102,0.6363542230278212
4669,405.734067,405.760733,1,12172022,12172821,799,0.7782805344137625
4670,405.7644,405.780233,1,12172932,12173406,474,0.6315997269783842
4671,405.790667,405.877433,1,12173720,12176322,2602,0.7649666290509652
4672,405.886367,405.892867,1,12176591,12176786,195,-0.06436760951065043
4673,405.901033,405.908767,1,12177030,12177263,233,-0.11033835196968945
4674,405.919033,405.9244,1,12177570,12177732,162,
4675,406.204267,406.306167,1,12186128,12189185,3057,0.42695718912060016
4676,406.336867,406.345567,1,12190106,12190367,261,-0.09553781501221216
4677,406.346967,406.351167,1,12190409,12190535,126,
4678,406.481,406.484,1,12194430,12194520,90,-0.3270727181572044
4679,406.511433,406.552267,1,12195342,12196568,1226,0.7350062596194455
4680,406.5538,406.5792,1,12196614,12197376,762,0.4738828254683556
4681,406.5995,406.634267,1,12197985,12199028,1043,0.7280287582110704
4682,406.6374,406.679233,1,12199122,12200376,1254,0.7313125582827332
4683,406.684733,406.719733,1,12200541,12201591,1050,0.6219606400594795
4684,406.734,406.8326,1,12202020,12204978,2958,0.7394313941233015
4685,406.8493,406.9331,1,12205479,12207993,2514,0.6813065547518014
4686,406.955833,406.969033,1,12208674,12209070,396,-0.0660851590265486
4687,406.9701,406.9915,1,12209103,12209745,642,0.09376879575298327
4688,406.9978,407.004267,1,12209934,12210128,194,
4689,407.1167,407.124033,1,12213501,12213720,219,0.3100441190387256
4690,407.125167,407.1564,1,12213755,12214692,937,0.6055575683807476
4691,407.159133,407.1752,1,12214773,12215256,483,0.3269375428722738
4692,407.178767,407.259633,1,12215363,12217788,2425,0.6212881325374959
4693,407.3044,407.316867,1,12219132,12219506,374,0.1873865316768297
4694,407.376833,407.4783,1,12221304,12224349,3045,0.7348897754529029
4695,407.4863,407.498833,1,12224589,12224964,375,0.4320305018443719
4696,407.503633,407.543567,1,12225108,12226307,1199,-0.016045307980812135
4697,407.580067,407.5889,1,12227402,12227667,265,0.5567515213610686
4698,407.5923,407.613033,1,12227769,12228390,621,0.25472757021896436
4699,407.620667,407.655433,1,12228620,12229662,1042,0.05871901090560045
4700,407.6571,407.6646,1,12229713,12229938,225,0.05120810085073911
4701,407.665667,407.668967,1,12229970,12230069,99,
4702,407.671567,407.680967,1,12230147,12230429,282,-0.11426790562355439
4703,407.7093,407.7174,1,12231279,12231522,243,0.41949388769016915
4704,407.7261,407.734,1,12231783,12232020,237,0.7950373146489256
4705,407.7359,407.8314,1,12232077,12234942,2865,0.7177417073643068
4706,407.832967,407.841133,1,12234989,12235233,244,0.7763696951882147
4707,407.842267,407.8534,1,12235268,12235602,334,0.36696278443518404
4708,407.8554,407.915867,1,12235662,12237476,1814,0.6537511894822349
4709,407.925067,407.969567,1,12237752,12239087,1335,0.3246802927452205
4710,407.971233,408.035833,1,12239136,12241074,1938,0.3143172455102808
4711,408.050933,408.100033,1,12241527,12243000,1473,0.391961469284726
4712,408.1018,408.2397,1,12243054,12247191,4137,0.36304358500769307
4713,408.240867,408.246,1,12247226,12247380,154,0.39841690927863704
4714,408.2732,408.2981,1,12248196,12248943,747,0.1296186320582594
4715,408.299233,408.3433,1,12248976,12250299,1323,0.1717205119804607
4716,408.346233,408.351633,1,12250386,12250548,162,0.043895407573605855
4717,408.555133,408.5714,1,12256653,12257142,489,0.6454712099957952
4718,408.581633,408.584667,1,12257448,12257540,92,
4719,408.587233,408.593167,1,12257616,12257795,179,0.3457674925495546
4720,408.594333,408.601733,1,12257829,12258051,222,0.35414669074372546
4721,408.605733,408.6158,1,12258171,12258474,303,0.22753711156981601
4722,408.641167,408.6477,1,12259235,12259431,196,0.627064122867613
4723,408.673467,408.7018,1,12260204,12261054,850,0.324960570148149
4724,408.756933,408.775733,1,12262707,12263271,564,0.4526447897822024
4725,408.803533,408.808733,1,12264105,12264261,156,0.4323701824602487
4726,408.8172,408.824867,1,12264516,12264746,230,0.21804583454230583
4727,408.8427,408.8488,1,12265281,12265464,183,0.3453184648265477
4728,408.8552,408.929133,1,12265656,12267873,2217,-0.0030804103738992106
4729,408.9602,409.0653,1,12268806,12271959,3153,0.7384087929165839
4730,409.0816,409.1024,1,12272448,12273072,624,0.008701865484688175
4731,409.103967,409.126933,1,12273119,12273807,688,0.07915043570845115
4732,409.1316,409.1351,1,12273948,12274053,105,
4733,409.162433,409.202,1,12274872,12276060,1188,0.15800342443926932
4734,409.207533,409.236167,1,12276225,12277085,860,0.006507363180748603
4735,409.239533,409.2615,1,12277185,12277845,660,-0.015132791104769007
4736,409.292933,409.615333,1,12278787,12288459,9672,0.49236274991588036
4737,409.617033,409.866433,1,12288510,12295992,7482,0.2874981724020102
4738,409.869567,409.9885,1,12296087,12299655,3568,0.8266831382105645
4739,409.994067,410.0302,1,12299822,12300906,1084,0.7468488902837497
4740,410.0541,410.066267,1,12301623,12301988,365,0.6700477183142879
4741,410.0683,410.091333,1,12302049,12302739,690,-0.007174844333464226
4742,410.102767,410.137,1,12303083,12304110,1027,0.46998375463802117
4743,410.141333,410.153333,1,12304239,12304599,360,0.3439489117096415
4744,410.155233,410.158667,1,12304656,12304760,104,-0.3834278430123027
4745,410.3045,410.3122,1,12309135,12309366,231,-0.02874043298698433
4746,410.5975,410.603933,1,12317925,12318117,192,0.5843689052991762
4747,410.629467,410.671667,1,12318884,12320150,1266,0.7951504404917378
4748,410.705233,410.721433,1,12321156,12321642,486,0.7551738610414385
4749,410.725933,410.729167,1,12321777,12321875,98,-0.10134167322670601
4750,410.741333,410.784233,1,12322239,12323526,1287,0.5407431156000505
4751,410.804667,410.824567,1,12324140,12324737,597,0.6256492372871628
4752,411.046,411.0523,1,12331380,12331569,189,0.01550878135950078
4753,411.055033,411.058067,1,12331650,12331742,92,
4754,411.068833,411.080267,1,12332064,12332408,344,0.825646152498856
4755,411.081833,411.1384,1,12332454,12334152,1698,0.6466952190409689
4756,411.139833,411.145167,1,12334194,12334355,161,0.5026528550869469
4757,411.148067,411.171533,1,12334442,12335145,703,0.8053557443230022
4758,411.686067,411.728567,1,12350582,12351857,1275,0.6098071855236361
4759,411.7462,411.8053,1,12352386,12354159,1773,0.5124055613814319
4760,411.824333,411.8835,1,12354729,12356505,1776,0.6571616328634142
4761,411.890467,411.962833,1,12356714,12358884,2170,0.7144978243334955
4762,411.9724,411.995367,1,12359172,12359861,689,0.5475517252683697
4763,412.004033,412.013,1,12360120,12360390,270,0.5268968355006252
4764,412.059467,412.0634,1,12361784,12361902,118,-0.13433641698070944
4765,412.074567,412.078933,1,12362237,12362367,130,-0.04534040187983436
4766,412.0861,412.090633,1,12362583,12362718,135,0.5178806753412837
4767,412.1326,412.136733,1,12363978,12364101,123,0.0608649685852543
4768,412.145167,412.252933,1,12364355,12367587,3232,0.8198102063060829
4769,412.310467,412.3315,1,12369314,12369945,631,0.16345328562981964
4770,412.5481,412.5583,1,12376443,12376749,306,0.5597932180086717
4771,412.5641,412.592133,1,12376923,12377763,840,0.6355407289456039
4772,412.596567,412.6922,1,12377897,12380766,2869,0.7543438389386807
4773,412.742967,412.752367,1,12382289,12382571,282,-0.07500382948597623
4774,412.758567,412.766233,1,12382757,12382986,229,-0.3681779131490471
4775,412.901667,413.021133,1,12387050,12390633,3583,0.6955813137709073
4776,413.0551,413.062667,1,12391653,12391880,227,0.48180808290967575
4777,413.070567,413.159,1,12392117,12394770,2653,0.5001614101600587
4778,413.225333,413.2533,1,12396759,12397599,840,0.3549531723431214
4779,413.2567,413.270967,1,12397701,12398129,428,-0.014524797771483041
4780,413.2826,413.345367,1,12398478,12400361,1883,0.40551003880435077
4781,413.3683,413.382567,1,12401049,12401477,428,0.2789047417132701
4782,413.3836,413.39,1,12401508,12401700,192,
4783,413.393133,413.410967,1,12401793,12402329,536,0.01917708277285835
4784,413.413333,413.422833,1,12402399,12402684,285,0.08653265150405616
4785,413.423833,413.543833,1,12402714,12406314,3600,0.7251490765568678
4786,413.5745,413.5828,1,12407235,12407484,249,-0.009583630374632885
4787,413.598933,413.604133,1,12407967,12408123,156,
4788,414.091967,414.202933,1,12422759,12426087,3328,0.8032618363563818
4789,414.213633,414.221467,1,12426408,12426644,236,0.014496501654500003
4790,414.505233,414.582633,1,12435156,12437478,2322,0.7778135803552638
4791,414.583667,414.6441,1,12437510,12439323,1813,0.7575127477818177
4792,414.652867,414.732033,1,12439586,12441960,2374,0.719555544932661
4793,414.748267,414.7575,1,12442448,12442725,277,0.6430393218839743
4794,414.8011,414.8225,1,12444033,12444675,642,0.1513132193944017
4795,414.997633,415.171033,1,12449928,12455130,5202,0.7607014595569729
4796,415.1915,415.200533,1,12455745,12456015,270,0.7200845600885296
4797,415.202067,415.216333,1,12456062,12456489,427,0.7571316131983152
4798,415.225,415.352667,1,12456750,12460580,3830,0.7211231026230357
4799,415.379067,415.382467,1,12461372,12461474,102,-0.0370513345252325
4800,415.384567,415.3892,1,12461537,12461676,139,
4801,415.6246,415.6462,1,12468738,12469386,648,0.6110785423737536
4802,415.650867,415.654533,1,12469526,12469635,109,0.6266363571260941
4803,415.6565,415.664433,1,12469695,12469932,237,0.5968060899619594
4804,415.715567,415.722,1,12471467,12471660,193,0.41953935020677424
4805,415.751433,415.754433,1,12472542,12472632,90,0.6806002154698498
4806,415.758033,415.774133,1,12472740,12473223,483,0.6852628406982727
4807,415.780367,415.7993,1,12473411,12473979,568,0.6942618567831524
4808,415.8293,415.843433,1,12474879,12475302,423,0.6148704051978575
4809,415.8672,415.8819,1,12476016,12476457,441,0.622057759547272
4810,415.8835,415.897733,1,12476505,12476931,426,0.6840095829886833
4811,415.929833,415.940867,1,12477894,12478226,332,0.12814354902410816
4812,415.9458,415.976933,1,12478374,12479307,933,0.0026539837956638785
4813,416.010667,416.146567,1,12480320,12484397,4077,0.7666057750736118
4814,416.163467,416.167967,1,12484904,12485039,135,-0.1580819854735034
4815,416.168967,416.2722,1,12485069,12488166,3097,0.712282871317575
4816,416.276767,416.296533,1,12488303,12488895,592,0.7884315412055451
4817,416.298933,416.4361,1,12488967,12493083,4116,0.6941181078245632
4818,416.4613,416.4679,1,12493839,12494037,198,0.29305012222070415
4819,416.8733,416.8815,1,12506199,12506445,246,0.5410223310923444
4820,416.883033,416.895567,1,12506490,12506867,377,0.5576673561931174
4821,416.9196,416.958833,1,12507588,12508764,1176,0.5762298702683559
4822,416.9651,416.9756,1,12508953,12509268,315,0.4597445987137518
4823,416.9979,417.018233,1,12509937,12510546,609,0.5402474576518402
4824,417.041667,417.045133,1,12511250,12511353,103,-0.10171011679150883
4825,417.0498,417.060633,1,12511494,12511818,324,0.35671662970470336
4826,417.062667,417.083433,1,12511880,12512502,622,0.48790374560720395
4827,417.100933,417.118233,1,12513027,12513546,519,0.393779412468595
4828,417.1238,417.128833,1,12513714,12513864,150,-0.19450691647484664
4829,417.158533,417.175967,1,12514755,12515279,524,0.5549041124361657
4830,417.197333,417.207033,1,12515919,12516210,291,0.5510954675716706
4831,417.214133,417.2237,1,12516423,12516711,288,0.5152825717971009
4832,417.2637,417.3141,1,12517911,12519423,1512,0.006467310804844153
4833,417.325833,417.329233,1,12519774,12519876,102,0.1414867110079285
4834,417.338633,417.513133,1,12520158,12525393,5235,0.7230210821417017
4835,417.530433,417.5583,1,12525912,12526749,837,0.6493178389054043
4836,417.561133,417.692967,1,12526833,12530789,3956,0.7173048955815214
4837,417.708833,417.747133,1,12531264,12532413,1149,0.7624514125185029
4838,417.765467,417.7804,1,12532964,12533412,448,-0.08633385577886961
4839,417.7821,417.8037,1,12533463,12534111,648,0.06471816457689172
4840,417.804933,417.813433,1,12534147,12534402,255,0.1695205884708883
4841,417.8356,417.839,1,12535068,12535170,102,-0.2693006615672883
4842,417.846467,418.0741,1,12535394,12542223,6829,0.7675297105995704
4843,418.0861,418.089267,1,12542583,12542678,95,-0.33930601111609143
4844,418.226267,418.2299,1,12546788,12546897,109,0.5869445523388023
4845,418.2312,418.372733,1,12546936,12551181,4245,0.825980801433165
4846,418.394467,418.5111,1,12551834,12555333,3499,0.7913820950664949
4847,418.517233,418.556,1,12555516,12556680,1164,0.7649588611377977
4848,418.557567,418.6029,1,12556727,12558087,1360,0.7036195306942115
4849,418.611167,418.707867,1,12558335,12561236,2901,0.7702242393451425
4850,418.7147,418.7333,1,12561441,12561999,558,0.6823139196477275
4851,418.7479,418.7521,1,12562437,12562563,126,-0.022820473801408964
4852,418.7597,418.7689,1,12562791,12563067,276,-0.03215201783251179
4853,418.7734,418.783267,1,12563202,12563498,296,0.20381820545510163
4854,418.787067,418.794067,1,12563612,12563822,210,0.38424396971586927
4855,418.832633,418.846133,1,12564978,12565383,405,0.8861468924374485
4856,418.8476,418.942767,1,12565428,12568283,2855,0.7999520966005725
4857,418.958267,418.9782,1,12568748,12569346,598,-0.08680261927363658
4858,418.9915,418.996167,1,12569745,12569885,140,-0.10548598033490574
4859,419.0004,419.115867,1,12570012,12573476,3464,0.8072649952775803
4860,419.147967,419.240667,1,12574439,12577220,2781,0.803740776380115
4861,419.255067,419.258233,1,12577652,12577746,94,-0.17752201663251005
4862,419.835467,419.870567,1,12595064,12596117,1053,0.5187050866676702
4863,419.932167,419.941233,1,12597965,12598236,271,0.5927488324100921
4864,420.0545,420.067367,1,12601635,12602021,386,0.6063921813120583
4865,420.115867,420.1352,1,12603476,12604056,580,0.6101453221834849
4866,420.2344,420.238233,1,12607032,12607146,114,-0.2949618247072871
4867,420.246167,420.364433,1,12607385,12610932,3547,0.7493894024466407
4868,420.3711,420.5003,1,12611133,12615009,3876,0.7735976639644754
4869,420.537633,420.5466,1,12616128,12616398,270,0.45121222393638344
4870,420.8531,420.878967,1,12625593,12626369,776,0.7609652998947412
4871,420.880433,420.945567,1,12626412,12628367,1955,0.6286461149816521
4872,420.946733,420.949933,1,12628401,12628497,96,0.5643160259007839
4873,420.951,421.042133,1,12628530,12631263,2733,0.7833230302291646
4874,421.0446,421.048333,1,12631338,12631449,111,0.29722731340817604
4875,421.0499,421.053567,1,12631497,12631607,110,-0.25200717260022604
4876,421.057033,421.060633,1,12631710,12631818,108,-0.016727577491967453
4877,421.167833,421.172667,1,12635034,12635180,146,0.3209034259461199
4878,421.1754,421.189533,1,12635262,12635685,423,0.5816027890854312
4879,421.1915,421.288467,1,12635745,12638654,2909,0.7947013380993992
4880,421.6682,421.677567,1,12650046,12650327,281,0.40246477892595756
4881,421.6797,421.6848,1,12650391,12650544,153,0.5716335640823632
4882,421.690267,421.766667,1,12650708,12653000,2292,0.7931152339209135
4883,421.774967,421.875933,1,12653249,12656277,3028,0.7498061253955188
4884,421.878267,421.948567,1,12656348,12658457,2109,0.6345535592332127
4885,421.950967,422.0032,1,12658529,12660096,1567,0.7839790707808391
4886,422.015533,422.0545,1,12660465,12661635,1170,0.666988268408227
4887,422.058733,422.065767,1,12661761,12661973,212,0.44682801339594735
4888,422.072,422.080567,1,12662160,12662417,257,-0.1624003169312248
4889,422.0898,422.116467,1,12662694,12663494,800,0.15228151550346292
4890,422.136733,422.141367,1,12664101,12664241,140,0.6392299736023269
4891,422.1445,422.312,1,12664335,12669360,5025,0.8006304000367428
4892,422.327933,422.427767,1,12669837,12672833,2996,0.6133332051244136
4893,422.451167,422.5331,1,12673535,12675993,2458,0.7865268823754499
4894,422.5477,422.5654,1,12676431,12676962,531,0.029586902144909798
4895,422.578,422.5811,1,12677340,12677433,93,
4896,422.615333,422.6187,1,12678459,12678561,102,0.32409323520806543
4897,422.626567,422.681667,1,12678797,12680450,1653,0.6893078084094982
4898,422.683767,422.736033,1,12680513,12682080,1567,0.7623751444208767
4899,422.744767,422.75,1,12682343,12682500,157,-0.08975145209083259
4900,422.751533,422.758867,1,12682545,12682766,221,-0.033289834704920175
4901,422.759933,422.781567,1,12682797,12683447,650,0.24484808585203352
4902,422.798233,422.918567,1,12683946,12687557,3611,0.8058624686384664
4903,422.9511,422.9543,1,12688533,12688629,96,
4904,422.956967,422.9629,1,12688709,12688887,178,0.05946463444775903
4905,423.2021,423.2505,1,12696063,12697515,1452,0.7650173144415982
4906,423.264767,423.286233,1,12697943,12698586,643,0.632408649198906
4907,423.2905,423.310367,1,12698715,12699311,596,0.5595562931363748
4908,423.342233,423.431467,1,12700266,12702944,2678,0.5873806062638285
4909,423.4368,423.4578,1,12703104,12703734,630,0.7368047611315006
4910,423.459667,423.525267,1,12703790,12705758,1968,0.6792988209918275
4911,423.537867,423.5551,1,12706136,12706653,517,0.6133767129610124
4912,423.556633,423.646067,1,12706698,12709382,2684,0.7688388451528032
4913,423.658867,423.661967,1,12709766,12709859,93,0.008984232824001945
4914,423.669967,423.677533,1,12710099,12710325,226,0.12345250755864166
4915,423.6967,423.704167,1,12710901,12711125,224,-0.3386894280935434
4916,423.7362,423.741467,1,12712086,12712244,158,0.022440036473037776
4917,423.744467,423.9567,1,12712334,12718701,6367,0.7873724402419169
4918,423.9724,424.0753,1,12719172,12722259,3087,0.7257353288177222
4919,424.0764,424.162333,1,12722292,12724869,2577,0.8169581167558244
4920,424.164967,424.188133,1,12724949,12725643,694,0.8168552109681727
4921,424.1898,424.281433,1,12725694,12728442,2748,0.7793556562612797
4922,424.283333,424.309767,1,12728499,12729293,794,0.8439565524915486
4923,424.312567,424.430033,1,12729377,12732900,3523,0.7811422743876498
4924,424.433433,424.551067,1,12733002,12736532,3530,0.7772794144270233
4925,424.557867,424.652733,1,12736736,12739581,2845,0.7869679598064937
4926,424.654033,424.6817,1,12739620,12740451,831,0.2194305194752561
4927,424.684733,424.765533,1,12740541,12742965,2424,0.5166160683405009
4928,424.7666,424.781367,1,12742998,12743441,443,0.8225611771171792
4929,424.7836,424.810733,1,12743508,12744321,813,0.7779321286457132
4930,424.813367,424.9089,1,12744401,12747267,2866,0.8036422753713509
4931,424.911267,424.937267,1,12747338,12748118,780,0.6558315557012466
4932,424.9399,425.0358,1,12748197,12751074,2877,0.771313924330611
4933,425.0393,425.065233,1,12751179,12751956,777,0.7246584950866782
4934,425.0691,425.163933,1,12752073,12754917,2844,0.8325325707658652
4935,425.1675,425.1875,1,12755025,12755625,600,0.7972948767094648
4936,425.196933,425.2972,1,12755907,12758916,3009,0.8207240668058983
4937,425.3064,425.327733,1,12759192,12759831,639,0.7189218695222861
4938,425.3305,425.3857,1,12759915,12761571,1656,0.7864007700719683
4939,425.395,425.421033,1,12761850,12762630,780,0.8266735345523643
4940,425.4262,425.429667,1,12762786,12762890,104,0.2690348436869723
4941,425.457167,425.495233,1,12763715,12764856,1141,0.7423131252100464
4942,425.4971,425.510567,1,12764913,12765317,404,0.853932357148207
4943,425.534467,425.546233,1,12766034,12766386,352,0.5322904826238137
4944,425.551633,425.565367,1,12766548,12766961,413,0.15737060637335112
4945,425.585567,425.641167,1,12767567,12769235,1668,0.8022976047806517
4946,425.668567,425.675867,1,12770057,12770276,219,0.6093795792633292
4947,425.7033,425.7636,1,12771099,12772908,1809,0.7504477650691324
4948,426.050933,426.056067,1,12781527,12781682,155,0.6131242236953538
4949,426.058267,426.0669,1,12781748,12782007,259,0.5372480361648775
4950,426.074767,426.142767,1,12782243,12784283,2040,0.7093590646965658
4951,426.1498,426.163167,1,12784494,12784895,401,0.6408353580960365
4952,426.199167,426.283667,1,12785975,12788510,2535,0.8041544049488133
4953,426.2851,426.289133,1,12788553,12788673,120,-0.2559322087274817
4954,426.2909,426.2951,1,12788727,12788853,126,-0.005833184573656552
4955,426.3122,426.316767,1,12789366,12789503,137,0.20507784426456724
4956,426.410633,426.505833,1,12792318,12795174,2856,0.8031214427663619
4957,426.521267,426.539667,1,12795638,12796190,552,0.038520674902016085
4958,426.5451,426.554233,1,12796353,12796626,273,0.06536347723144678
4959,426.646133,426.707167,1,12799383,12801215,1832,0.7542162282668633
4960,426.7083,426.713367,1,12801249,12801401,152,0.13774146046495397
4961,426.718733,426.7723,1,12801561,12803169,1608,0.7880915127886391
4962,426.776067,426.8007,1,12803282,12804021,739,0.03151426308499442
4963,426.8047,426.813067,1,12804141,12804392,251,0.10091386283261793
4964,426.815367,426.843067,1,12804461,12805292,831,0.13808891443425128
4965,426.921033,427.206667,1,12807630,12816200,8570,0.6938795402491181
4966,427.2087,427.267133,1,12816261,12818013,1752,0.8183689512340657
4967,427.271567,427.290467,1,12818147,12818714,567,0.762845303541296
4968,427.292033,427.344167,1,12818760,12820325,1565,0.7420969471036852
4969,427.3468,427.3634,1,12820404,12820902,498,0.32040046289319374
4970,427.398767,427.4036,1,12821963,12822108,145,
4971,427.419433,427.4555,1,12822582,12823665,1083,-0.06948488506118564
4972,427.462833,427.465967,1,12823884,12823979,95,-0.35366035000191764
4973,427.473167,427.698367,1,12824195,12830951,6756,0.7876493433388465
4974,427.706867,427.795067,1,12831206,12833852,2646,0.8052789045249047
4975,427.8113,427.840067,1,12834339,12835202,863,0.021879685513444783
4976,427.843667,427.854333,1,12835310,12835629,319,0.10726569188437927
4977,427.855867,427.859833,1,12835676,12835794,118,
4978,427.862167,427.866567,1,12835865,12835997,132,
4979,427.8727,428.0787,1,12836181,12842361,6180,0.8577313176843931
4980,428.0965,428.104167,1,12842895,12843125,230,-0.09948318384546527
4981,428.105167,428.1106,1,12843155,12843318,163,0.06684984074591427
4982,428.1131,428.118967,1,12843393,12843569,176,0.004173454049608168
4983,428.126833,428.1319,1,12843804,12843957,153,0.03302427785939541
4984,428.3266,428.466967,1,12849798,12854009,4211,0.8184138735683995
4985,428.475733,428.575467,1,12854271,12857264,2993,0.7919321668151551
4986,428.577067,428.583733,1,12857312,12857511,199,0.6963249301046505
4987,428.600067,428.711567,1,12858002,12861347,3345,0.7363035383690112
4988,428.7131,428.765867,1,12861393,12862976,1583,0.7763512543997885
4989,428.771267,428.835933,1,12863138,12865077,1939,0.7148087451104153
4990,428.840067,428.872933,1,12865202,12866187,985,0.4025357715130496
4991,428.896633,428.9169,1,12866898,12867507,609,-0.10362602263762219
4992,428.9265,429.0511,1,12867795,12871533,3738,0.780421362438036
4993,429.0702,429.073767,1,12872106,12872213,107,
4994,429.152067,429.271833,1,12874562,12878154,3592,0.7949480187046815
4995,429.302267,429.311367,1,12879068,12879341,273,0.634642461868004
4996,429.322633,429.358633,1,12879678,12880758,1080,0.01845838828235202
4997,429.3601,429.55,1,12880803,12886500,5697,0.8058853651312192
4998,429.555233,429.6561,1,12886656,12889683,3027,0.7226794368508965
4999,429.661033,429.6853,1,12889830,12890559,729,0.46332893765938415
5000,429.687833,429.7406,1,12890634,12892218,1584,0.4354142752126106
5001,429.745367,429.824767,1,12892361,12894743,2382,0.7988501215484651
5002,429.8537,429.908133,1,12895611,12897243,1632,0.8141202062129047
5003,429.9113,429.918267,1,12897339,12897548,209,0.7973553698440734
5004,429.922733,429.941033,1,12897681,12898230,549,0.861110434353508
5005,429.944133,429.963833,1,12898323,12898914,591,0.7930853882557629
5006,429.967433,429.970967,1,12899022,12899129,107,0.13450842537380242
5007,429.9744,430.064533,1,12899232,12901935,2703,0.8093132080340789
5008,430.0685,430.083567,1,12902055,12902507,452,0.6113415559033455
5009,430.098133,430.134633,1,12902943,12904038,1095,0.8016213574185082
5010,430.135633,430.153167,1,12904068,12904595,527,0.8747226334666008
5011,430.1551,430.1873,1,12904653,12905619,966,0.7597670068278435
5012,430.1917,430.1971,1,12905751,12905913,162,0.3963785561680468
5013,430.199167,430.2111,1,12905975,12906333,358,0.4434541847667787
5014,430.222167,430.2591,1,12906665,12907773,1108,0.8001049204278776
5015,430.261333,430.313433,1,12907839,12909402,1563,0.7648596671820099
5016,430.319633,430.324067,1,12909588,12909722,134,0.859318982943179
5017,430.328833,430.337267,1,12909864,12910118,254,0.3616968371300261
5018,430.3492,430.465933,1,12910476,12913977,3501,0.8188421880076315
5019,430.476567,430.556633,1,12914297,12916698,2401,0.6619994139019983
5020,430.5685,430.573267,1,12917055,12917198,143,0.18659495791353176
5021,430.5746,430.586233,1,12917238,12917586,348,0.004228495260537152
5022,430.594433,430.603067,1,12917832,12918092,260,-0.17216167661808612
5023,430.6041,430.620333,1,12918123,12918609,486,0.04216151800497072
5024,430.628667,430.7035,1,12918860,12921105,2245,0.8039141929367029
5025,430.818033,431.002233,1,12924540,12930066,5526,0.8520693752700566
5026,431.023233,431.056,1,12930696,12931680,984,0.7347425228043634
5027,431.058033,431.1289,1,12931740,12933867,2127,0.8152623448751604
5028,431.151433,431.1829,1,12934542,12935487,945,0.8126236383949372
5029,431.185833,431.258033,1,12935574,12937740,2166,0.7641627309485821
5030,431.2605,431.270133,1,12937815,12938103,288,-0.09011905343131457
5031,431.281267,431.306067,1,12938438,12939182,744,0.24256024272043922
5032,431.310067,431.3221,1,12939302,12939663,361,-0.08767390642929339
5033,431.345,431.461867,1,12940350,12943856,3506,0.8357590619221898
5034,431.473833,431.543333,1,12944214,12946299,2085,0.07381970344818213
5035,431.550633,431.557067,1,12946518,12946712,194,0.31056518652436693
5036,431.561967,431.679733,1,12946859,12950391,3532,0.7758408409925834
5037,431.6928,431.714167,1,12950784,12951425,641,0.04217489679996007
5038,431.7176,431.738133,1,12951528,12952143,615,-0.015539583802727883
5039,431.743033,431.7494,1,12952290,12952482,192,0.1121415339577382
5040,431.769333,431.9141,1,12953079,12957423,4344,0.7875612536514167
5041,431.925767,431.956333,1,12957773,12958689,916,0.7317891118336857
5042,431.959233,431.996267,1,12958776,12959888,1112,0.7941732362499332
5043,431.999767,432.1003,1,12959993,12963009,3016,0.8104116567494634
5044,432.101667,432.1378,1,12963050,12964134,1084,0.7334466996782082
5045,432.146533,432.178433,1,12964395,12965352,957,0.005969256065615942
5046,432.1795,432.200333,1,12965385,12966009,624,-0.055377132381635656
5047,432.216367,432.221633,1,12966491,12966648,157,0.7013859560606114
5048,432.222833,432.387333,1,12966684,12971619,4935,0.8193200019407016
5049,432.396833,432.519433,1,12971904,12975582,3678,0.7901779566090903
5050,432.541233,432.544267,1,12976236,12976328,92,0.021368703973708245
5051,432.560267,432.568667,1,12976808,12977060,252,-0.0682454963296127
5052,433.006167,433.093833,1,12990185,12992814,2629,0.6191411688180458
5053,433.109,433.140533,1,12993270,12994215,945,0.671278801498435
5054,433.1624,433.2033,1,12994872,12996099,1227,0.6420766365709341
5055,433.216067,433.221,1,12996482,12996630,148,0.42373425925119507
5056,433.2576,433.283533,1,12997728,12998505,777,-0.03987181085360653
5057,433.284767,433.2992,1,12998543,12998976,433,0.0466203635065077
5058,433.3099,433.320267,1,12999297,12999608,311,-0.05298558879546637
5059,433.321367,433.4302,1,12999641,13002906,3265,0.7898237742147354
5060,433.454233,433.473533,1,13003626,13004205,579,0.06901613645848112
5061,433.485933,433.695533,1,13004577,13010865,6288,0.8253679093553443
5062,433.717267,433.726133,1,13011518,13011783,265,0.007367805880695965
5063,433.729833,433.739167,1,13011894,13012175,281,0.04309994394915319
5064,433.7565,433.856767,1,13012695,13015703,3008,0.7758375501388733
5065,433.860967,433.868633,1,13015829,13016058,229,0.21992963470249488
5066,433.937867,433.9413,1,13018136,13018239,103,-0.09648184192587565
5067,433.9461,434.159067,1,13018383,13024772,6389,0.7357256974952365
5068,434.164167,434.245833,1,13024925,13027374,2449,0.6576385856363844
5069,434.248033,434.302333,1,13027440,13029069,1629,0.7346326297133215
5070,434.309867,434.326367,1,13029296,13029791,495,0.008578347760437175
5071,434.327367,434.520067,1,13029821,13035602,5781,0.7863373550221777
5072,434.535767,434.831533,1,13036073,13044945,8872,0.7937996140888592
5073,434.832967,434.974,1,13044989,13049220,4231,0.7891479723293037
5074,434.975367,435.0003,1,13049261,13050009,748,0.8634457949855929
5075,435.002767,435.091333,1,13050083,13052739,2656,0.8389866943752287
5076,435.095233,435.1196,1,13052856,13053588,732,0.6704019108595807
5077,435.121233,435.211033,1,13053636,13056330,2694,0.8413055187629523
5078,435.213467,435.239867,1,13056404,13057196,792,0.6579842937789682
5079,435.242433,435.368067,1,13057272,13061042,3770,0.5154363193599141
5080,435.3702,435.4636,1,13061106,13063908,2802,0.8304242200434666
5081,435.466967,435.492633,1,13064009,13064778,769,0.8192118333079571
5082,435.4952,435.575867,1,13064856,13067276,2420,0.7893794944184273
5083,435.576867,435.590767,1,13067306,13067723,417,0.8988785049016582
5084,435.5933,435.620833,1,13067799,13068624,825,0.7384441552344193
5085,435.6244,435.7211,1,13068732,13071633,2901,0.8284296943366508
5086,435.724067,435.7511,1,13071722,13072533,811,0.6695702958757836
5087,435.754067,435.8526,1,13072622,13075578,2956,0.7420490533619205
5088,435.854,435.881167,1,13075620,13076435,815,0.6127966541212917
5089,435.883233,435.983267,1,13076496,13079498,3002,0.6819166385273981
5090,435.987033,436.014167,1,13079610,13080425,815,0.8158056809872233
5091,436.017533,436.1438,1,13080525,13084314,3789,0.8437488951694998
5092,436.1526,436.209667,1,13084578,13086290,1712,0.8056879357451956
5093,436.216967,436.246667,1,13086509,13087400,891,0.8115788956473177
5094,436.252967,436.257533,1,13087589,13087725,136,-0.17338863383567985
5095,436.2594,436.263167,1,13087782,13087895,113,
5096,436.284533,436.339833,1,13088535,13090194,1659,0.7474444737205888
5097,436.365933,436.3746,1,13090977,13091238,261,0.8556788780315305
5098,436.3826,436.3945,1,13091478,13091835,357,0.26839594846953246
5099,436.412233,436.454467,1,13092366,13093634,1268,0.6852293283555494
5100,436.4575,436.469167,1,13093725,13094075,350,0.7248688327779601
5101,436.495167,436.5032,1,13094855,13095096,241,0.45483704378749856
5102,436.5119,436.522933,1,13095357,13095687,330,0.5517193828396803
5103,436.523967,436.5299,1,13095719,13095897,178,0.26624685808478754
5104,436.531567,436.5393,1,13095947,13096179,232,0.4085139909111349
5105,436.5456,436.586833,1,13096368,13097604,1236,0.683527582329416
5106,436.608267,436.612333,1,13098248,13098369,121,-0.039762363056596695
5107,436.615533,436.634333,1,13098465,13099029,564,0.25213355299858825
5108,436.639667,436.643767,1,13099190,13099313,123,0.6694355331902713
5109,436.646033,436.726967,1,13099380,13101809,2429,0.7886436861431262
5110,436.732533,436.7434,1,13101975,13102302,327,0.3254344677447081
5111,436.745667,436.752367,1,13102370,13102571,201,0.006721584648229755
5112,436.772167,436.777567,1,13103165,13103327,162,0.3531497666452746
5113,436.8473,436.865033,1,13105419,13105950,531,0.7795910007297275
5114,436.867433,436.9589,1,13106022,13108767,2745,0.8239327176689799
5115,436.985533,437.0371,1,13109565,13111113,1548,-0.007620856992249775
5116,437.045467,437.257233,1,13111364,13117716,6352,0.794307202105799
5117,437.262133,437.305933,1,13117863,13119177,1314,0.789377354616715
5118,437.308133,437.328267,1,13119243,13119848,605,0.5236169778781872
5119,437.340833,437.493933,1,13120224,13124817,4593,0.7492228054020469
5120,437.498033,437.506533,1,13124940,13125195,255,-0.2227091588162009
5121,437.518833,437.559,1,13125564,13126770,1206,-0.04712707238066363
5122,437.564233,437.7483,1,13126926,13132449,5523,0.8279945300846021
5123,437.7596,437.8063,1,13132788,13134189,1401,0.7865179011168233
5124,437.824,437.8675,1,13134720,13136025,1305,0.619992454598606
5125,437.880267,437.895167,1,13136408,13136855,447,-0.022269823792723985
5126,437.896933,437.906667,1,13136907,13137200,293,-0.1230702166947001
5127,437.908167,437.927167,1,13137245,13137815,570,0.033511369637625694
5128,437.944,438.0744,1,13138320,13142232,3912,0.8210287318438569
5129,438.079367,438.1622,1,13142381,13144866,2485,0.7552502381415837
5130,438.165567,438.207667,1,13144967,13146230,1263,0.7850774888628563
5131,438.2161,438.276167,1,13146483,13148285,1802,0.679650163087002
5132,438.2845,438.298167,1,13148535,13148945,410,-0.22094461778721247
5133,438.301133,438.3101,1,13149033,13149303,270,0.27880155024858655
5134,438.312133,438.322033,1,13149363,13149660,297,0.032265060824469574
5135,438.340133,438.418967,1,13150203,13152569,2366,0.7841559113755842
5136,438.450967,438.455733,1,13153529,13153671,142,0.2035680580931871
5137,438.462033,438.468333,1,13153860,13154049,189,0.7364833673863554
5138,438.512933,438.5179,1,13155387,13155537,150,0.39614297030879475
5139,438.522633,438.687667,1,13155678,13160630,4952,0.8378072122789556
5140,438.689667,438.6935,1,13160690,13160805,115,-0.1140276821990049
5141,438.697133,438.7413,1,13160913,13162239,1326,0.7745773571153278
5142,438.744233,438.825667,1,13162326,13164770,2444,0.8113383626457488
5143,438.8282,438.938667,1,13164846,13168160,3314,0.8043357685480534
5144,438.9405,438.9449,1,13168215,13168347,132,0.8137022853898134
5145,438.950933,438.9545,1,13168527,13168635,108,0.2414380884047101
5146,438.970833,439.0272,1,13169124,13170816,1692,0.773545114599216
5147,439.041333,439.059133,1,13171239,13171773,534,0.4910896647431771
5148,439.0634,439.084833,1,13171902,13172544,642,0.2119883565101223
5149,439.094133,439.187533,1,13172823,13175625,2802,0.8097322803035929
5150,439.1918,439.205933,1,13175754,13176177,423,0.6312654140191268
5151,439.2224,439.317667,1,13176672,13179530,2858,0.8193786362733451
5152,439.319867,439.403133,1,13179596,13182093,2497,0.778566028413476
5153,439.4043,439.432733,1,13182129,13182981,852,0.7929424228018486
5154,439.448467,439.4646,1,13183454,13183938,484,-0.08529438121257929
5155,439.466,439.474667,1,13183980,13184240,260,0.27041523881573803
5156,439.476233,439.488467,1,13184286,13184654,368,0.14559998489381634
5157,439.4937,439.4997,1,13184811,13184991,180,-0.01987374761251856
5158,439.546933,439.550433,1,13186407,13186512,105,0.1420892786675369
5159,439.555933,439.618433,1,13186677,13188552,1875,0.7920616945118345
5160,439.619833,439.958133,1,13188594,13198743,10149,0.34769845161553814
5161,439.959233,440.1796,1,13198776,13205388,6612,0.8427245943507881
5162,440.199767,440.230767,1,13205993,13206923,930,0.07941124471422766
5163,440.2322,440.2542,1,13206966,13207626,660,0.10920038594331453
5164,440.290867,440.294833,1,13208726,13208844,118,
5165,440.317433,440.322533,1,13209522,13209675,153,0.6969668565607621
5166,440.326667,440.409933,1,13209800,13212297,2497,0.8481476812965582
5167,440.411633,440.5358,1,13212348,13216074,3726,0.7790554272070059
5168,440.559633,440.575933,1,13216788,13217277,489,-0.024274845675358536
5169,440.576967,440.626133,1,13217309,13218783,1474,0.32921173550571925
5170,440.628533,440.633933,1,13218855,13219017,162,-0.22110355542745103
5171,440.640933,440.644333,1,13219227,13219329,102,
5172,440.645433,440.649667,1,13219362,13219490,128,0.34964322360299516
5173,440.6631,440.783067,1,13219893,13223492,3599,0.8381465996539652
5174,440.784667,440.791733,1,13223540,13223751,211,0.28551456507542505
5175,440.793267,440.856767,1,13223798,13225703,1905,0.22980735258082532
5176,440.868033,440.883367,1,13226040,13226501,461,0.42194662186327136
5177,440.893467,441.009233,1,13226804,13230276,3472,0.579751300197969
5178,441.010233,441.1095,1,13230306,13233285,2979,0.7025052778954771
5179,441.136667,441.254233,1,13234100,13237626,3526,0.8528943865513249
5180,441.362133,441.7024,1,13240863,13251072,10209,0.23176669789648935
5181,441.7159,441.726167,1,13251477,13251785,308,0.2727751376674568
5182,441.727167,441.775767,1,13251815,13253273,1458,0.21782440278102103
5183,441.7769,441.7921,1,13253307,13253763,456,0.033784712958907705
5184,441.815633,441.960333,1,13254468,13258809,4341,0.8286277095884776
5185,441.974567,441.980033,1,13259237,13259400,163,0.21498182295023244
5186,441.9816,441.996567,1,13259448,13259897,449,0.0340111908444736
5187,441.999833,442.0592,1,13259994,13261776,1782,0.27235383156553056
5188,442.061233,442.0657,1,13261836,13261971,135,0.4015855053700775
5189,442.085233,442.090133,1,13262556,13262703,147,0.7228636080306791
5190,442.0935,442.097933,1,13262805,13262937,132,0.5058457224733011
5191,442.114,442.262033,1,13263420,13267860,4440,0.83579718774195
5192,442.277233,442.284067,1,13268316,13268522,206,0.05608044729667281
5193,442.2881,442.301033,1,13268643,13269030,387,0.11785981372297709
5194,442.302233,442.342067,1,13269066,13270262,1196,0.20679656310458122
5195,442.3463,442.359333,1,13270389,13270779,390,-0.04714736415732467
5196,442.379533,442.384267,1,13271385,13271528,143,
5197,442.398167,442.4183,1,13271945,13272549,604,0.5172043456269257
5198,442.433067,442.448767,1,13272992,13273463,471,-0.07905937629147146
5199,442.453833,442.460867,1,13273614,13273826,212,-0.013057548371036471
5200,442.467933,442.474867,1,13274037,13274246,209,-0.12245550045568653
5201,442.5087,442.513867,1,13275261,13275416,155,0.6333119217296663
5202,442.5176,442.540767,1,13275528,13276223,695,0.6428208738911798
5203,442.544267,442.610133,1,13276328,13278303,1975,0.8059142053204018
5204,442.611833,442.6678,1,13278354,13280034,1680,0.6364271366213997
5205,442.6708,442.701833,1,13280124,13281054,930,0.8017855161047915
5206,442.710833,442.714567,1,13281324,13281437,113,0.23243245199821924
5207,442.7225,442.753633,1,13281675,13282608,933,0.1513893313417766
5208,442.7558,442.761633,1,13282674,13282848,174,0.17458864111235048
5209,442.762833,442.776133,1,13282884,13283283,399,0.1883980747478589
5210,442.777133,442.783733,1,13283313,13283511,198,0.13291315918014293
5211,442.808567,442.815667,1,13284257,13284470,213,0.5426045727973434
5212,442.8216,442.828067,1,13284648,13284842,194,0.5811232126719269
5213,442.832233,442.857767,1,13284966,13285733,767,0.2006108239500826
5214,442.861167,442.883667,1,13285835,13286510,675,0.06515604826163321
5215,442.885067,442.8923,1,13286552,13286769,217,0.016475114423483685
5216,442.8937,443.0199,1,13286811,13290597,3786,0.8024042690349757
5217,443.024933,443.037933,1,13290747,13291137,390,0.6151885381247018
5218,443.040733,443.063933,1,13291221,13291917,696,-0.024475034620635033
5219,443.066067,443.0771,1,13291982,13292313,331,0.013852863228390138
5220,443.079267,443.088467,1,13292378,13292654,276,-0.00960350826503974
5221,443.093967,443.0975,1,13292819,13292925,106,-0.1360814792226071
5222,443.115833,443.127767,1,13293474,13293833,359,0.45016256350599526
5223,443.139733,443.163567,1,13294191,13294907,716,-0.032265456058764255
5224,443.164867,443.203367,1,13294946,13296101,1155,-0.08482856067059069
5225,443.2047,443.218967,1,13296141,13296569,428,-0.03758611591883775
5226,443.220033,443.2276,1,13296600,13296828,228,-0.24226970656419314
5227,443.274267,443.421767,1,13298228,13302653,4425,0.802941513362075
5228,443.4281,443.4652,1,13302843,13303956,1113,-0.027865477593125666
5229,443.466733,443.486533,1,13304001,13304595,594,0.14736051543772796
5230,443.5281,443.571133,1,13305843,13307133,1290,0.13883719962258234
5231,443.5732,443.602767,1,13307196,13308083,887,0.10177255147222877
5232,443.6067,443.6161,1,13308201,13308483,282,0.04882589060652496
5233,443.6209,443.630233,1,13308627,13308906,279,-0.28866201272415876
5234,443.631367,443.636967,1,13308941,13309109,168,-0.4253061614880631
5235,443.661267,443.670767,1,13309838,13310123,285,-0.3383496393298748
5236,443.6742,443.734067,1,13310226,13312022,1796,0.018724400592343936
5237,443.741133,443.906133,1,13312233,13317183,4950,0.788064323295648
5238,443.908333,444.0574,1,13317249,13321722,4473,0.8040072672323262
5239,444.075233,444.089833,1,13322256,13322694,438,-0.05344292161567776
5240,444.092,444.096533,1,13322760,13322895,135,0.6137298582676634
5241,444.0987,444.102433,1,13322961,13323072,111,-0.10708628737982953
5242,444.104,444.107967,1,13323120,13323239,119,0.2078431972777846
5243,444.1112,444.1158,1,13323336,13323474,138,-0.0014183937924914828
5244,444.154867,444.160167,1,13324646,13324805,159,-0.4734023947964381
5245,444.4134,444.714633,1,13332402,13341438,9036,0.7431742638156497
5246,444.737467,444.740967,1,13342124,13342229,105,-0.14730917099255708
5247,444.8123,444.816233,1,13344369,13344486,117,
5248,444.818433,444.900967,1,13344552,13347029,2477,0.7188787725962351
5249,444.9025,444.9161,1,13347075,13347483,408,0.6326626638829443
5250,444.933467,444.978167,1,13348004,13349345,1341,0.7685695132813399
5251,444.980567,444.989,1,13349417,13349670,253,0.5464114318738115
5252,444.990267,445.051567,1,13349708,13351547,1839,0.752402710760865
5253,445.072267,445.155167,1,13352168,13354655,2487,0.7796759196925805
5254,445.158433,445.3865,1,13354752,13361595,6843,0.8201571146088742
5255,445.3892,445.508033,1,13361676,13365240,3564,0.810971196872373
5256,445.5114,445.536567,1,13365342,13366097,755,0.8618313201310237
5257,445.539033,445.630167,1,13366170,13368905,2735,0.748124488265722
5258,445.631767,445.659167,1,13368953,13369775,822,0.6015948249782985
5259,445.661367,445.755367,1,13369841,13372661,2820,0.4631394185569683
5260,445.758667,445.783967,1,13372760,13373519,759,0.6142305170684458
5261,445.7877,445.8829,1,13373631,13376487,2856,0.7970328361878314
5262,445.886333,445.912133,1,13376589,13377363,774,0.7899109207890568
5263,445.916033,446.009867,1,13377480,13380296,2816,0.8017517936397649
5264,446.014167,446.019367,1,13380425,13380581,156,0.5834239760900147
5265,446.022267,446.032067,1,13380668,13380962,294,0.23609021631783364
5266,446.046133,446.1019,1,13381383,13383057,1674,0.7949611787813494
5267,446.114167,446.1345,1,13383425,13384035,610,0.7569625734482983
5268,446.139533,446.1543,1,13384185,13384629,444,0.7076944853966269
5269,446.170067,446.227867,1,13385102,13386836,1734,0.7877146805367407
5270,446.244267,446.261667,1,13387328,13387850,522,0.7398904830632366
5271,446.267467,446.283767,1,13388024,13388513,489,0.6482729667391689
5272,446.2971,446.336933,1,13388913,13390107,1194,0.8071535574318135
5273,446.340667,446.355067,1,13390220,13390652,432,0.7372770348214568
5274,446.381067,446.3872,1,13391432,13391616,184,0.7659855776845368
5275,446.393467,446.410167,1,13391804,13392305,501,0.5716821945957704
5276,446.423567,446.4635,1,13392707,13393905,1198,0.7606570138185653
5277,446.4667,446.480033,1,13394001,13394400,399,0.7132871887590613
5278,446.5025,446.513167,1,13395075,13395395,320,0.7833696402749634
5279,446.521,446.537367,1,13395630,13396121,491,0.49838649699876814
5280,446.540467,446.597067,1,13396214,13397912,1698,0.7290188715577733
5281,446.610033,446.623167,1,13398300,13398695,395,-0.009894136062214898
5282,446.6276,446.637933,1,13398828,13399137,309,0.04657830403052845
5283,446.6926,446.702367,1,13400778,13401071,293,0.5451650471963869
5284,446.706833,446.717533,1,13401204,13401525,321,0.21578264385761986
5285,446.720867,446.8138,1,13401626,13404414,2788,0.7605219202176134
5286,446.8314,446.8344,1,13404942,13405032,90,-0.08158703665509993
5287,446.936967,446.9501,1,13408109,13408503,394,0.49419717013521686
5288,446.957767,446.9709,1,13408733,13409127,394,0.1279018342155747
5289,446.973267,447.135267,1,13409198,13414058,4860,0.7951195413216375
5290,447.146433,447.1795,1,13414392,13415385,993,0.5203447460184575
5291,447.197633,447.251267,1,13415928,13417538,1610,0.3005051805266964
5292,447.264333,447.620133,1,13417929,13428603,10674,0.5347593086466741
5293,447.634733,447.678833,1,13429041,13430364,1323,0.10726616050566706
5294,447.7096,447.793533,1,13431288,13433805,2517,0.7807818777764906
5295,447.7953,447.816833,1,13433859,13434504,645,0.8302973491855443
5296,447.822567,447.8256,1,13434677,13434768,91,
5297,447.8438,447.863167,1,13435314,13435895,581,-0.02504409323888283
5298,447.8645,447.874933,1,13435935,13436247,312,-0.06831294684467365
5299,447.8762,448.024533,1,13436286,13440735,4449,0.8576453822544622
5300,448.325933,448.4035,1,13449777,13452105,2328,0.6211368390703483
5301,448.405167,448.4201,1,13452155,13452603,448,0.6307849260112441
5302,448.4301,448.4406,1,13452903,13453218,315,0.2821573733683888
5303,448.469133,448.487233,1,13454073,13454616,543,0.5653562939294133
5304,448.508667,448.5188,1,13455260,13455564,304,0.5641085832049074
5305,448.526967,448.5372,1,13455809,13456116,307,0.5418400732978437
5306,448.567133,448.610067,1,13457013,13458302,1289,-0.05013057070011269
5307,448.611667,448.6204,1,13458350,13458612,262,
5308,448.636767,448.641967,1,13459103,13459259,156,0.7112269010510057
5309,448.648333,448.910033,1,13459449,13467300,7851,0.7769939961604372
5310,448.943733,448.951867,1,13468311,13468556,245,0.19386240827473014
5311,448.954,448.974933,1,13468620,13469247,627,0.0774005083645307
5312,448.975933,448.996967,1,13469277,13469909,632,0.18547081801103682
5313,449.002833,449.137433,1,13470084,13474122,4038,0.8263975582714478
5314,449.161167,449.287667,1,13474835,13478630,3795,0.8192219085347451
5315,449.313767,449.319967,1,13479413,13479599,186,-0.1081235202795346
5316,449.373933,449.378967,1,13481217,13481369,152,0.7293226133924631
5317,449.380767,449.5219,1,13481423,13485657,4234,0.821926497740999
5318,450.064333,450.1089,1,13501929,13503267,1338,0.7564098564873059
5319,450.110933,450.125,1,13503327,13503750,423,0.8623498369321205
5320,450.133033,450.175733,1,13503990,13505271,1281,0.7335741597843354
5321,450.200233,450.226033,1,13506006,13506780,774,0.7649795271111918
5322,450.2408,450.355,1,13507224,13510650,3426,0.7491013316796529
5323,450.357333,450.376633,1,13510719,13511298,579,0.7240228090066111
5324,450.3836,450.424367,1,13511508,13512731,1223,0.724444303495539
5325,450.432467,450.4517,1,13512974,13513551,577,0.4703067873967809
5326,450.454467,450.520067,1,13513634,13515602,1968,0.6215811247833655
5327,450.537233,450.540433,1,13516116,13516212,96,
5328,450.5432,450.600067,1,13516296,13518002,1706,0.7343950439033894
5329,450.601533,450.700633,1,13518045,13521018,2973,0.6787582000944382
5330,450.727567,450.9405,1,13521827,13528215,6388,0.520273134699268
5331,450.941533,451.097867,1,13528245,13532936,4691,0.5080327034641345
5332,451.126667,451.141033,1,13533800,13534230,430,0.331180934725285
5333,451.142633,451.1841,1,13534278,13535523,1245,0.0754361524712919
5334,451.1897,451.193967,1,13535691,13535819,128,
5335,451.208867,451.236867,1,13536266,13537106,840,0.535332644804404
5336,451.247267,451.327467,1,13537418,13539824,2406,0.8155286193110768
5337,451.336367,451.427867,1,13540091,13542836,2745,0.8160046073559868
5338,451.488167,451.4921,1,13544645,13544763,118,
5339,451.5236,451.553167,1,13545708,13546595,887,0.5458379673795104
5340,451.5714,451.706933,1,13547142,13551207,4065,0.6686003290259205
5341,451.708267,451.761833,1,13551248,13552854,1606,0.7125835567044876
5342,451.763667,451.769267,1,13552910,13553078,168,0.010923730656345535
5343,451.788433,451.875433,1,13553652,13556262,2610,0.7361954124603535
5344,451.8824,451.900867,1,13556472,13557026,554,0.693348706950157
5345,451.904033,451.957967,1,13557120,13558739,1619,-0.023851115158171364
5346,451.961967,451.9893,1,13558859,13559679,820,0.06471237662621629
5347,452.005933,452.2336,1,13560177,13567008,6831,0.7829972318686714
5348,452.238967,452.274467,1,13567169,13568234,1065,0.005424869376632397
5349,452.2777,452.310533,1,13568331,13569315,984,0.10747552949800568
5350,452.335933,452.423133,1,13570077,13572693,2616,0.7713489087310758
5351,452.4243,452.451967,1,13572729,13573559,830,0.7930840758630792
5352,452.476667,452.496433,1,13574300,13574892,592,0.4224665986903024
5353,452.4975,452.522633,1,13574925,13575678,753,0.0651815527726
5354,452.5243,452.548033,1,13575729,13576440,711,0.15313956682889396
5355,452.550167,452.671067,1,13576505,13580132,3627,0.7645195918646305
5356,452.672267,452.776467,1,13580168,13583294,3126,0.7911660625805339
5357,452.778167,452.815233,1,13583345,13584456,1111,0.6477998148131484
5358,452.8294,452.833567,1,13584882,13585007,125,0.46530301203650054
5359,452.839067,452.8421,1,13585172,13585263,91,0.42054322097458474
5360,452.847133,452.8504,1,13585413,13585512,99,0.10904168458524302
5361,452.8527,452.868267,1,13585581,13586048,467,-0.01588491545053738
5362,452.871233,452.910233,1,13586136,13587306,1170,0.3408050637161694
5363,452.911533,453.1035,1,13587345,13593105,5760,0.7831268302695236
5364,453.1045,453.113867,1,13593135,13593416,281,0.6303729212114663
5365,453.137433,453.2111,1,13594122,13596333,2211,0.8314945895720401
5366,453.2211,453.263333,1,13596633,13597899,1266,0.8139374477265526
5367,453.2766,453.323233,1,13598298,13599696,1398,0.07335352076045473
5368,453.3427,453.346867,1,13600281,13600406,125,0.41147877984076214
5369,453.348733,453.4836,1,13600461,13604508,4047,0.8047048853871195
5370,453.494867,453.578433,1,13604846,13607352,2506,0.7825072420938812
5371,453.671233,453.679067,1,13610136,13610372,236,0.24834536221825543
5372,453.6836,453.831933,1,13610508,13614957,4449,0.8050956148455254
5373,453.8409,453.925567,1,13615227,13617767,2540,0.798338443810154
5374,453.9307,453.934233,1,13617921,13618026,105,
5375,453.943067,453.9541,1,13618292,13618623,331,-0.014360469778025128
5376,453.957133,453.9939,1,13618713,13619817,1104,0.17273545270284518
5377,454.020967,454.1441,1,13620629,13624323,3694,0.8518521317245726
5378,454.147367,454.1521,1,13624421,13624563,142,0.6456917961022476
5379,454.1548,454.1666,1,13624644,13624998,354,0.2253230290313378
5380,454.169367,454.2224,1,13625081,13626672,1591,0.20908912447097824
5381,454.2256,454.238867,1,13626768,13627166,398,0.4704078797525202
5382,454.2409,454.36,1,13627227,13630800,3573,0.8739096694148264
5383,454.370433,454.379267,1,13631112,13631378,266,0.4379945004358397
5384,454.381233,454.438567,1,13631436,13633157,1721,0.03420668855989625
5385,454.458333,454.579767,1,13633749,13637393,3644,0.8270591356164807
5386,454.584,454.629767,1,13637520,13638893,1373,0.8174676293057404
5387,454.6308,454.672433,1,13638924,13640172,1248,0.759325708199367
5388,454.6765,454.7513,1,13640295,13642539,2244,0.8048245143323163
5389,454.760367,454.802133,1,13642811,13644063,1252,0.7581367309109585
5390,454.810533,454.814433,1,13644315,13644432,117,
5391,454.827,454.8421,1,13644810,13645263,453,-0.033525859974967515
5392,454.847067,454.867667,1,13645412,13646030,618,0.15077851565538697
5393,454.876933,454.885833,1,13646307,13646574,267,-0.05357639492727746
5394,454.9042,455.2773,1,13647126,13658319,11193,0.8201894845972214
5395,455.2799,455.307767,1,13658397,13659233,836,0.7960801935720644
5396,455.3263,455.3427,1,13659789,13660281,492,0.038330494230049826
5397,455.345567,455.352533,1,13660367,13660575,208,0.04877422928304765
5398,455.354067,455.370433,1,13660622,13661112,490,0.1739778838323574
5399,455.3722,455.382033,1,13661166,13661460,294,0.47017923406660733
5400,455.419867,455.663233,1,13662596,13669896,7300,0.7555647985251837
5401,455.6842,455.6905,1,13670526,13670715,189,
5402,455.771567,455.775,1,13673147,13673250,103,0.5710964104290627
5403,455.776933,455.875467,1,13673307,13676264,2957,0.7660920738020361
5404,455.881933,455.940833,1,13676457,13678224,1767,0.8295220764254165
5405,455.9419,455.986533,1,13678257,13679595,1338,0.7514472454639826
5406,455.9878,455.998967,1,13679634,13679969,335,0.6450203407343478
5407,456.0129,456.095967,1,13680387,13682879,2492,0.8039370492448178
5408,456.1127,456.123167,1,13683381,13683695,314,-0.0003207861806633645
5409,456.1266,456.1475,1,13683798,13684425,627,0.18425075034737934
5410,456.149533,456.1598,1,13684485,13684794,309,0.2641764253903405
5411,456.205467,456.219933,1,13686164,13686597,433,0.6398187955459367
5412,456.2211,456.318033,1,13686633,13689540,2907,0.8043356085701382
5413,456.348767,456.465133,1,13690463,13693953,3490,0.8221981525242497
5414,456.47,456.510933,1,13694100,13695327,1227,0.7136118738702952
5415,456.512933,456.563733,1,13695387,13696911,1524,0.7437568452410265
5416,456.568767,456.7408,1,13697063,13702224,5161,0.8447880719474904
5417,456.747,456.809967,1,13702410,13704299,1889,0.7424844264140756
5418,456.8152,456.8491,1,13704456,13705473,1017,0.7263522712656292
5419,456.867533,456.881367,1,13706025,13706441,416,-0.04552933932843897
5420,456.885167,456.900433,1,13706555,13707012,457,0.18990822034223895
5421,456.901467,456.917733,1,13707044,13707531,487,0.27082475712313153
5422,456.920633,456.927533,1,13707618,13707825,207,0.20334677268527462
5423,456.943333,456.949767,1,13708299,13708493,194,0.28341392076595784
5424,456.955433,457.1199,1,13708662,13713597,4935,0.8001801451209611
5425,457.143,457.271767,1,13714290,13718153,3863,0.7451082936464533
5426,457.304933,457.315267,1,13719147,13719458,311,-0.05940160041916384
5427,457.317,457.324667,1,13719510,13719740,230,-0.12150637581095784
5428,457.358067,457.3634,1,13720742,13720902,160,-0.050575688394963715
5429,457.368833,457.461033,1,13721064,13723830,2766,0.7569171256020185
5430,457.466133,457.4879,1,13723983,13724637,654,0.8920083695192973
5431,457.494133,457.498233,1,13724823,13724946,123,
5432,457.519167,457.5261,1,13725575,13725783,208,0.46800592723270346
5433,457.5337,457.556767,1,13726011,13726703,692,0.06152413327860597
5434,457.561467,457.5671,1,13726844,13727013,169,
5435,457.5822,457.758967,1,13727466,13732769,5303,0.7946728560549345
5436,457.795933,457.8015,1,13733877,13734045,168,0.2900281397879984
5437,457.814333,457.8317,1,13734429,13734951,522,-0.04050712004361829
5438,458.432367,458.4608,1,13752971,13753824,853,0.5877010637087577
5439,458.5248,458.534333,1,13755744,13756029,285,0.4032661331531717
5440,458.688633,458.769867,1,13760658,13763096,2438,0.8072148025069852
5441,458.773933,458.918033,1,13763217,13767540,4323,0.8160961090123134
5442,459.184167,459.224533,1,13775525,13776735,1210,0.6902500099890171
5443,459.234467,459.2423,1,13777034,13777269,235,0.2846137945234914
5444,459.243867,459.260333,1,13777316,13777809,493,0.5384960900062075
5445,459.261333,459.282733,1,13777839,13778481,642,0.7174132621931083
5446,459.509033,459.568,1,13785270,13787040,1770,0.7282816876884469
5447,459.569,459.614467,1,13787070,13788434,1364,0.7791264731814888
5448,459.651867,459.659067,1,13789556,13789772,216,-0.029991207323964708
5449,459.660067,459.669967,1,13789802,13790099,297,0.031407888913554956
5450,459.673767,459.6814,1,13790213,13790442,229,-0.12500295787496363
5451,459.7397,459.748167,1,13792191,13792445,254,0.6420902404555979
5452,459.7504,459.7538,1,13792512,13792614,102,0.5415564177149075
5453,459.7576,459.764167,1,13792728,13792925,197,0.4653631669291879
5454,459.7734,459.805867,1,13793202,13794176,974,0.13907212823643259
5455,459.820967,460.0045,1,13794629,13800135,5506,0.8519082693963225
5456,460.3952,460.4044,1,13811856,13812132,276,0.5141450130438069
5457,460.409233,460.423067,1,13812276,13812692,416,0.7271171905921602
5458,460.424867,460.450467,1,13812746,13813514,768,0.6935353235249228
5459,460.451467,460.487167,1,13813544,13814615,1071,0.5297384515033523
5460,460.503967,460.533433,1,13815119,13816002,883,0.5681007151781566
5461,460.555367,460.5916,1,13816661,13817748,1087,0.62049622256254
5462,460.602633,460.612667,1,13818078,13818380,302,0.6111415918905783
5463,460.6515,460.655533,1,13819545,13819665,120,
5464,460.6584,460.673767,1,13819752,13820213,461,-0.09296430273412093
5465,460.6754,460.704067,1,13820262,13821122,860,-0.04806849500558707
5466,460.728867,460.733967,1,13821866,13822019,153,0.7166243495080361
5467,460.736333,460.892333,1,13822089,13826769,4680,0.7012229307630843
5468,460.9093,461.0061,1,13827279,13830183,2904,0.7870158462236516
5469,461.020567,461.025367,1,13830617,13830761,144,0.24587558807770682
5470,461.0272,461.032333,1,13830816,13830969,153,
5471,461.127167,461.247567,1,13833815,13837427,3612,0.8023336723399879
5472,461.2725,461.461133,1,13838175,13843833,5658,0.7684366433805814
5473,461.466267,461.608167,1,13843988,13848245,4257,0.7315406855812546
5474,461.6218,461.6323,1,13848654,13848969,315,0.051734055499707075
5475,461.6337,461.640133,1,13849011,13849203,192,0.24248168940407516
5476,461.709533,461.764467,1,13851285,13852934,1649,0.7357006596074567
5477,461.7669,461.814833,1,13853007,13854444,1437,0.8133604489456723
5478,461.8221,461.939433,1,13854663,13858182,3519,0.8006874053922874
5479,461.944967,461.9875,1,13858349,13859625,1276,0.6795331449381563
5480,461.988867,462.011633,1,13859666,13860348,682,0.8196891061522308
5481,462.013333,462.0877,1,13860399,13862631,2232,0.8223120061392282
5482,462.090867,462.112833,1,13862726,13863384,658,0.7401433350550557
5483,462.115933,462.201733,1,13863477,13866051,2574,0.8168708086044344
5484,462.204133,462.321267,1,13866123,13869638,3515,0.7409533583106427
5485,462.3225,462.350033,1,13869675,13870500,825,0.7309111257422665
5486,462.353033,462.448867,1,13870590,13873466,2876,0.7206349805184644
5487,462.450267,462.476833,1,13873508,13874304,796,0.6754039706633274
5488,462.480067,462.573367,1,13874402,13877201,2799,0.8528352358840113
5489,462.576067,462.6017,1,13877282,13878051,769,0.8245793132635468
5490,462.604533,462.7017,1,13878135,13881051,2916,0.8546663143377541
5491,462.7033,462.730733,1,13881099,13881921,822,0.8196977236194566
5492,462.7342,462.832167,1,13882026,13884965,2939,0.7883047270965152
5493,462.835133,462.859067,1,13885053,13885772,719,0.8111598041042324
5494,462.865433,462.9921,1,13885962,13889763,3801,0.7953890161220704
5495,462.994533,463.0836,1,13889835,13892508,2673,0.8230746192208016
5496,463.084633,463.191467,1,13892538,13895744,3206,0.7751625523803091
5497,463.206433,463.209867,1,13896192,13896296,104,
5498,463.212433,463.216933,1,13896372,13896507,135,-0.04584809242194791
5499,463.224733,463.234267,1,13896741,13897028,287,0.15024274479547595
5500,463.235767,463.247867,1,13897073,13897436,363,0.21061747256796806
5501,463.2549,463.328833,1,13897647,13899864,2217,0.778224932204451
5502,463.365033,463.3684,1,13900950,13901052,102,-0.12571446515184154
5503,463.4955,463.6975,1,13904865,13910925,6060,0.8007650907008705
5504,463.700033,463.706967,1,13911000,13911209,209,0.7434923496765375
5505,463.721033,463.751333,1,13911630,13912539,909,0.747359622955211
5506,463.754667,463.830733,1,13912640,13914921,2281,0.8124847502982643
5507,463.843233,463.856133,1,13915296,13915683,387,0.45895358816767945
5508,463.869533,463.875833,1,13916085,13916274,189,0.003960789009340011
5509,464.196767,464.2042,1,13925903,13926126,223,0.3163193078076282
5510,464.205267,464.212433,1,13926158,13926372,214,0.4529951514430468
5511,464.2156,464.228567,1,13926468,13926857,389,0.48032137569124045
5512,464.263367,464.298867,1,13927901,13928966,1065,0.6616588345862842
5513,464.312767,464.331667,1,13929383,13929950,567,0.7100628471555753
5514,464.332867,464.3404,1,13929986,13930212,226,0.5803392826848726
5515,464.372433,464.378633,1,13931172,13931358,186,0.44988516379751425
5516,464.3825,464.399467,1,13931475,13931984,509,0.5533689739838982
5517,464.4134,464.434567,1,13932402,13933037,635,0.6024407083105483
5518,464.4866,464.491967,1,13934598,13934759,161,0.6181440118869309
5519,464.4947,464.509133,1,13934841,13935273,432,0.6348979081981585
5520,464.528667,464.5339,1,13935860,13936017,157,0.510956900627719
5521,464.542833,464.5583,1,13936284,13936749,465,0.5723715243350477
5522,464.770767,464.920667,1,13943123,13947620,4497,0.8246297145509667
5523,464.933033,464.939133,1,13947990,13948173,183,-0.11422048975897309
5524,465.0034,465.106867,1,13950102,13953206,3104,0.8289188604053249
5525,465.187367,465.1939,1,13955621,13955817,196,-0.15580732141738735
5526,465.199133,465.2172,1,13955973,13956516,543,0.33565719152752466
5527,465.218433,465.260133,1,13956552,13957803,1251,0.8150484597240513
5528,465.262233,465.275767,1,13957866,13958273,407,0.5117884122500582
5529,465.277,465.3063,1,13958310,13959189,879,0.8486643591015721
5530,465.310467,465.313567,1,13959314,13959407,93,
5531,465.3221,465.3379,1,13959663,13960137,474,-0.027150704766091136
5532,465.3446,465.3549,1,13960338,13960647,309,0.16758601686942223
5533,465.3562,465.3672,1,13960686,13961016,330,0.25601323177213914
5534,465.371233,465.382167,1,13961136,13961465,329,0.3839429186262565
5535,465.398633,465.402867,1,13961958,13962086,128,0.5066732585304915
5536,465.407233,465.5194,1,13962216,13965582,3366,0.8265965391971193
5537,465.5221,465.601267,1,13965663,13968038,2375,0.8069236222078566
5538,465.602433,465.606833,1,13968072,13968204,132,0.32018121927939136
5539,465.607933,465.644433,1,13968237,13969332,1095,0.6549550217242863
5540,465.6719,465.6907,1,13970157,13970721,564,-0.06284189735584873
5541,465.693267,465.7368,1,13970798,13972104,1306,0.18544364361836138
5542,465.738,465.747733,1,13972140,13972431,291,0.5550585148301513
5543,465.979633,465.993967,1,13979388,13979819,431,0.7502689778708279
5544,466.001267,466.032167,1,13980038,13980965,927,0.7584249729247529
5545,466.0583,466.0632,1,13981749,13981896,147,0.7790803944320438
5546,466.0665,466.0752,1,13981995,13982256,261,0.7538250833352115
5547,466.0878,466.107733,1,13982634,13983231,597,0.6483321382732294
5548,466.116067,466.1204,1,13983482,13983612,130,0.1434043661933453
5549,466.1214,466.146833,1,13983642,13984404,762,0.5704169363343203
5550,466.1494,466.165233,1,13984482,13984956,474,0.644021215580985
5551,466.1822,466.197233,1,13985466,13985916,450,0.7627291748050009
5552,466.218333,466.244633,1,13986549,13987338,789,0.7308641412038769
5553,466.253567,466.2632,1,13987607,13987896,289,-0.0204752038306983
5554,466.271867,466.3337,1,13988156,13990011,1855,0.4099737757821865
5555,466.342967,466.346233,1,13990289,13990386,97,
5556,466.348167,466.402233,1,13990445,13992066,1621,0.7721009453002436
5557,466.411467,466.455433,1,13992344,13993662,1318,0.8135420923001369
5558,466.47,466.502167,1,13994100,13995065,965,-0.010334102054633375
5559,466.503433,466.5075,1,13995102,13995225,123,-0.17935708681312496
5560,466.5087,466.5133,1,13995261,13995399,138,
5561,466.5157,466.522367,1,13995471,13995671,200,0.38889028620256477
5562,466.523667,466.636333,1,13995710,13999089,3379,0.8507994565381661
5563,466.664167,466.7492,1,13999925,14002476,2551,0.7965431995307944
5564,466.768233,466.773167,1,14003046,14003195,149,-0.2125627858941384
5565,466.788567,466.791833,1,14003657,14003754,97,
5566,466.8467,466.961867,1,14005401,14008856,3455,0.6990923880019291
5567,466.977833,467.0056,1,14009334,14010168,834,0.7144431722933522
5568,467.009867,467.0426,1,14010296,14011278,982,0.6241355331743125
5569,467.053533,467.1158,1,14011605,14013474,1869,0.6460596995012479
5570,467.127767,467.345,1,14013833,14020350,6517,0.49469148830322734
5571,467.3597,467.416367,1,14020791,14022491,1700,0.11909259248996064
5572,467.431833,467.618067,1,14022954,14028542,5588,0.7925793829989085
5573,467.619533,467.7463,1,14028585,14032389,3804,0.7616511497242316
5574,468.286433,468.2959,1,14048592,14048877,285,0.7105347002673058
5575,468.309767,468.321133,1,14049293,14049633,340,0.5572003342305875
5576,468.322167,468.333233,1,14049665,14049996,331,0.45060767898269805
5577,468.3499,468.387667,1,14050497,14051630,1133,0.5957927833309062
5578,468.4048,468.445533,1,14052144,14053365,1221,0.6755894813573966
5579,468.450467,468.456333,1,14053514,14053689,175,0.11783221360089806
5580,468.4725,468.4907,1,14054175,14054721,546,0.7122933951157199
5581,468.496133,468.502867,1,14054883,14055086,203,0.526855223087886
5582,468.508467,468.551667,1,14055254,14056550,1296,0.5993546962119365
5583,468.5745,468.587633,1,14057235,14057628,393,0.6604718557355134
5584,468.588667,468.5969,1,14057660,14057907,247,0.5729276046980163
5585,468.643033,468.651233,1,14059290,14059536,246,0.005758520911143678
5586,468.652367,468.657333,1,14059571,14059719,148,0.003050624699548572
5587,468.663133,468.681933,1,14059893,14060457,564,0.10298815085752773
5588,468.698333,468.703067,1,14060949,14061092,143,-0.09160995386984988
5589,468.710533,468.848,1,14061315,14065440,4125,0.7811880510805278
5590,468.968833,468.996133,1,14069064,14069883,819,0.6301423251907816
5591,469.008367,469.100267,1,14070251,14073008,2757,0.8182774787707041
5592,469.117367,469.202433,1,14073521,14076072,2551,0.8290354678913132
5593,469.220267,469.227033,1,14076608,14076810,202,-0.00015859930503026653
5594,469.234133,469.238233,1,14077023,14077146,123,
5595,469.3365,469.450967,1,14080095,14083529,3434,0.8447978969720896
5596,469.687567,469.763,1,14090627,14092890,2263,0.8134355927172628
5597,469.774333,469.898033,1,14093229,14096940,3711,0.800991183432577
5598,469.902467,469.905667,1,14097074,14097170,96,0.22513385900009408
5599,469.9109,469.919733,1,14097327,14097591,264,0.27951512609278584
5600,469.927233,469.983667,1,14097816,14099510,1694,0.8146951870949515
5601,469.9957,470.0262,1,14099871,14100786,915,0.689684882705131
5602,470.044,470.0589,1,14101320,14101767,447,-0.09176759412721751
5603,470.063567,470.081467,1,14101907,14102444,537,-0.07684758455346305
5604,470.0836,470.0905,1,14102508,14102715,207,-0.17982076954498952
5605,470.115433,470.121533,1,14103462,14103645,183,0.6511713927620972
5606,470.1234,470.270567,1,14103702,14108117,4415,0.8559302960411879
5607,470.290867,470.406167,1,14108726,14112185,3459,0.7923413995117536
5608,470.915967,470.919267,1,14127479,14127578,99,0.5257163978709032
5609,470.9244,470.9539,1,14127732,14128617,885,0.4484111187244874
5610,470.993867,471.017567,1,14129816,14130527,711,0.7135320229220847
5611,471.042933,471.0471,1,14131287,14131413,126,0.469780307942637
5612,471.053333,471.095167,1,14131599,14132855,1256,0.63269077165444
5613,471.125433,471.158967,1,14133762,14134769,1007,0.6063060816002166
5614,471.1843,471.2686,1,14135529,14138058,2529,0.7899612488362179
5615,471.272933,471.2765,1,14138187,14138295,108,0.49145724837004817
5616,471.2785,471.283033,1,14138355,14138490,135,-0.06340455202656468
5617,471.287167,471.2904,1,14138615,14138712,97,-0.09080010501202476
5618,471.372367,471.379167,1,14141171,14141375,204,0.09118520939657905
5619,471.3813,471.432867,1,14141439,14142986,1547,0.7197454406300006
5620,471.434967,471.482733,1,14143049,14144481,1432,0.6697281503878657
5621,471.496433,471.5174,1,14144892,14145522,630,-0.01321194481970844
5622,471.519067,471.538433,1,14145572,14146152,580,0.20747315243762568
5623,471.540033,471.5518,1,14146200,14146554,354,-0.1174357440408501
5624,471.569933,471.684733,1,14147097,14150541,3444,0.7848333998335584
5625,471.6879,471.730067,1,14150637,14151902,1265,0.5847386541778212
5626,471.7313,471.842833,1,14151939,14155284,3345,0.8232968623770088
5627,471.859033,471.862333,1,14155770,14155869,99,0.4114942800910189
5628,471.863667,471.8708,1,14155910,14156124,214,0.47495317962606265
5629,471.876667,471.924733,1,14156300,14157741,1441,0.09919573164283894
5630,471.944733,472.062167,1,14158341,14161865,3524,0.8074132019563772
5631,472.0831,472.0874,1,14162493,14162622,129,0.19767177444178247
5632,472.093133,472.1026,1,14162793,14163078,285,0.06687447463362473
5633,472.1102,472.113667,1,14163306,14163410,104,0.16832792082009465
5634,472.120933,472.2459,1,14163627,14167377,3750,0.8490032587012092
5635,472.289333,472.304267,1,14168679,14169128,449,0.07786535461032595
5636,472.383233,472.4749,1,14171496,14174247,2751,0.7921871859138938
5637,472.4813,472.490167,1,14174439,14174705,266,0.7989642597774602
5638,472.492467,472.616233,1,14174774,14178486,3712,0.8037214999024265
5639,472.635767,472.650867,1,14179073,14179526,453,-0.15669428776860816
5640,472.655367,472.673533,1,14179661,14180205,544,-0.11032337440807884
5641,472.675067,472.6866,1,14180252,14180598,346,-0.17396941046872538
5642,472.717733,472.843733,1,14181531,14185311,3780,0.8101185200916213
5643,472.846167,472.920167,1,14185385,14187605,2220,0.5591406006453656
5644,472.922733,472.937333,1,14187681,14188119,438,0.6145213959364638
5645,472.943367,472.951167,1,14188301,14188535,234,0.6962790789843731
5646,472.952167,473.0557,1,14188565,14191671,3106,0.8071547813996812
5647,473.0676,473.150367,1,14192028,14194511,2483,-0.039376046678005656
5648,473.155033,473.158133,1,14194650,14194743,93,
5649,473.1687,473.1723,1,14195061,14195169,108,
5650,473.184567,473.305233,1,14195537,14199156,3619,0.8170652918182532
5651,473.311733,473.315533,1,14199351,14199465,114,
5652,473.3166,473.320467,1,14199498,14199614,116,
5653,473.324667,473.328433,1,14199740,14199852,112,0.3581225313623381
5654,473.329467,473.4016,1,14199884,14202048,2164,0.1932406720793258
5655,473.420967,473.4287,1,14202629,14202861,232,0.27125514214336033
5656,473.4393,473.5482,1,14203179,14206446,3267,0.8377975768228272
5657,473.5509,473.556033,1,14206527,14206680,153,
5658,473.560067,473.565433,1,14206802,14206962,160,0.06334544063652556
5659,473.566667,473.623667,1,14207000,14208710,1710,0.13830887573673423
5660,473.6292,473.647733,1,14208876,14209431,555,0.0010730266361748673
5661,473.658133,473.6714,1,14209743,14210142,399,0.3599829955541932
5662,473.674633,473.709,1,14210238,14211270,1032,0.3516375095193235
5663,473.7104,473.7139,1,14211312,14211417,105,
5664,473.715767,473.7343,1,14211473,14212029,556,0.04890435200769165
5665,473.735533,473.7571,1,14212065,14212713,648,0.099824911444922
5666,473.761933,473.768667,1,14212857,14213060,203,-0.09789449753905691
5667,473.8102,473.8157,1,14214306,14214471,165,0.43781289062913276
5668,473.8239,473.8768,1,14214717,14216304,1587,0.7749315316999246
5669,473.881033,473.938267,1,14216430,14218148,1718,0.4764760401423561
5670,473.941667,474.0222,1,14218250,14220666,2416,0.6989164243056302
5671,474.023733,474.031233,1,14220711,14220936,225,0.7224309008872395
5672,474.0331,474.063767,1,14220993,14221913,920,0.8489052513308513
5673,474.077167,474.083567,1,14222315,14222507,192,-0.07757920904248712
5674,474.085667,474.094033,1,14222570,14222820,250,-0.08208296976546146
5675,474.0972,474.127233,1,14222916,14223816,900,0.0051058438058189295
5676,474.169267,474.174533,1,14225078,14225235,157,0.005990110650926901
5677,474.181133,474.220233,1,14225433,14226606,1173,0.5482327362356337
5678,474.227233,474.258067,1,14226816,14227742,926,0.041725206883003574
5679,474.2597,474.2701,1,14227791,14228103,312,-0.06980724530287034
5680,474.302167,474.307933,1,14229065,14229237,172,0.7012945155198049
5681,474.308967,474.338533,1,14229269,14230155,886,0.775269056184666
5682,474.3445,474.489033,1,14230335,14234670,4335,0.7326367130689372
5683,474.492033,474.530633,1,14234760,14235918,1158,0.7977510260020511
5684,474.5498,474.5603,1,14236494,14236809,315,0.27419451742183215
5685,474.569867,474.589233,1,14237096,14237676,580,0.010252993294400043
5686,474.599833,474.620767,1,14237994,14238623,629,0.25098566350495405
5687,474.623533,474.632633,1,14238705,14238978,273,-0.04354469837495324
5688,474.652667,474.656467,1,14239580,14239694,114,0.5621985562399316
5689,474.657867,474.786633,1,14239736,14243598,3862,0.819191788603686
5690,474.802667,474.820267,1,14244080,14244608,528,0.07050168843806193
5691,474.824467,474.842467,1,14244734,14245274,540,0.2250713953992568
5692,474.8485,474.854867,1,14245455,14245646,191,0.3717446964335573
5693,474.913633,474.956267,1,14247408,14248688,1280,0.18673035565366403
5694,474.957467,474.984833,1,14248724,14249544,820,-0.04483715092103591
5695,474.985933,475.008367,1,14249577,14250251,674,-0.09745495692709309
5696,475.030067,475.033233,1,14250902,14250996,94,
5697,475.038067,475.041467,1,14251142,14251244,102,0.4874867973017584
5698,475.046433,475.148233,1,14251392,14254446,3054,0.8215666593360488
5699,475.149367,475.169967,1,14254481,14255099,618,0.05855854469918739
5700,475.185767,475.281033,1,14255573,14258430,2857,0.8032456679764538
5701,475.2845,475.291733,1,14258535,14258751,216,0.7806679794038341
5702,475.305467,475.3868,1,14259164,14261604,2440,0.5963321220182071
5703,475.399267,475.407533,1,14261978,14262225,247,0.24428986095305893
5704,475.408833,475.413967,1,14262264,14262419,155,-0.033374328393289646
5705,475.429733,475.438833,1,14262891,14263164,273,0.06987323477311544
5706,475.443567,475.469667,1,14263307,14264090,783,0.552052993761715
5707,475.484033,475.568967,1,14264520,14267069,2549,0.7813518430442092
5708,475.586733,475.592667,1,14267601,14267780,179,0.05415688783344749
5709,476.418933,476.4551,1,14292567,14293653,1086,0.5991741768599614
5710,476.4789,476.497367,1,14294367,14294921,554,0.6984957012226087
5711,476.812167,476.9464,1,14304365,14308392,4027,0.8256015856266883
5712,477.5781,477.589933,1,14327343,14327697,354,0.6164825082119703
5713,477.5996,477.607167,1,14327988,14328215,227,0.578482723430926
5714,477.6512,477.6739,1,14329536,14330217,681,0.825172446764338
5715,477.686767,477.6902,1,14330603,14330706,103,0.2577980413848208
5716,477.7442,477.753,1,14332326,14332590,264,0.7931229248877669
5717,477.754,477.760567,1,14332620,14332817,197,0.5647515091640184
5718,477.789333,477.792633,1,14333679,14333778,99,0.7165210227653336
5719,477.7945,477.812333,1,14333835,14334369,534,0.5974422477923866
5720,477.8153,477.833667,1,14334459,14335010,551,0.8513217315666067
5721,477.869967,477.884633,1,14336099,14336538,439,0.7581224975902524
5722,477.904833,477.9199,1,14337144,14337597,453,0.7914739587108838
5723,477.9216,477.9317,1,14337648,14337951,303,0.5743580822190039
5724,477.965367,477.974267,1,14338961,14339228,267,-0.0553740782878025
5725,477.9807,478.005567,1,14339421,14340167,746,0.15205151272795117
5726,478.0084,478.011533,1,14340252,14340345,93,
5727,478.021367,478.030067,1,14340641,14340902,261,0.0303211964541805
5728,478.033833,478.1378,1,14341014,14344134,3120,0.7292764353080208
5729,478.1544,478.173233,1,14344632,14345196,564,-0.00754161060376137
5730,478.178567,478.183,1,14345357,14345490,133,0.14456341142411447
5731,478.186167,478.190233,1,14345585,14345706,121,0.10243614501299501
5732,478.218033,478.222967,1,14346540,14346689,149,-0.1395706649816079
5733,478.225,478.229533,1,14346750,14346885,135,0.09272823160042497
5734,478.2835,478.4047,1,14348505,14352141,3636,0.8161259868582283
5735,478.417467,478.425733,1,14352524,14352771,247,-0.010946626082558936
5736,479.029833,479.056733,1,14370894,14371701,807,0.7846094579453243
5737,479.0697,479.128167,1,14372091,14373845,1754,0.6818457760216675
5738,479.147233,479.188233,1,14374416,14375646,1230,0.6455912424370157
5739,479.192,479.202,1,14375760,14376060,300,0.856255608378165
5740,479.2036,479.255067,1,14376108,14377652,1544,0.6929993431860072
5741,479.272833,479.287567,1,14378184,14378627,443,0.7805213443119965
5742,479.289667,479.310967,1,14378690,14379329,639,0.7199590689443643
5743,479.326533,479.3543,1,14379795,14380629,834,0.7873837076812238
5744,479.3708,479.4275,1,14381124,14382825,1701,0.10034112748242985
5745,479.447533,479.612767,1,14383425,14388383,4958,0.8030418977183461
5746,479.625067,479.674067,1,14388752,14390222,1470,0.8119359458502288
5747,479.696033,479.726333,1,14390880,14391789,909,0.8076034206097397
5748,479.741267,479.760833,1,14392238,14392824,586,0.10133518778497053
5749,479.7639,479.792633,1,14392917,14393778,861,0.17286366710300202
5750,479.808967,479.967633,1,14394269,14399028,4759,0.8143388463763307
5751,479.978,480.0447,1,14399340,14401341,2001,0.8284373630931027
5752,480.050967,480.056167,1,14401529,14401685,156,0.6002617262358574
5753,480.068933,480.080767,1,14402067,14402423,356,0.09701066612157486
5754,480.082533,480.094233,1,14402475,14402826,351,0.08994038788726558
5755,480.098933,480.106867,1,14402967,14403206,239,-0.13668877882241534
5756,480.214067,480.2834,1,14406422,14408502,2080,0.7749534371277448
5757,480.287667,480.291033,1,14408630,14408730,100,-0.1469662279254215
5758,480.298267,480.307467,1,14408948,14409224,276,-0.14136919628504566
5759,480.736433,480.7627,1,14422092,14422881,789,0.660036001046087
5760,480.7644,480.778433,1,14422932,14423352,420,0.5223733991372679
5761,480.7896,480.811567,1,14423688,14424347,659,0.6196641008192635
5762,480.814567,480.8188,1,14424437,14424564,127,0.5259768301063809
5763,481.898567,481.906533,1,14456957,14457195,238,0.6885117571582707
5764,481.911,481.9308,1,14457330,14457924,594,0.5691597143014663
5765,481.945333,481.952567,1,14458359,14458577,218,-0.021689844769530606
5766,481.953733,482.049667,1,14458611,14461490,2879,0.7795374411247468
5767,482.051033,482.055067,1,14461530,14461652,122,0.3517141679458188
5768,482.063167,482.0688,1,14461895,14462064,169,-0.0466368387692687
5769,482.072433,482.0758,1,14462172,14462274,102,
5770,482.268167,482.275067,1,14468045,14468252,207,0.3807495572379715
5771,482.284267,482.388667,1,14468528,14471660,3132,0.8114189147755745
5772,482.39,482.440733,1,14471700,14473221,1521,0.7669621153006349
5773,482.452967,482.480933,1,14473589,14474427,838,0.6621248079654227
5774,482.4914,482.495633,1,14474742,14474868,126,0.509808696965675
5775,482.513633,482.5378,1,14475408,14476134,726,0.01575699787940286
5776,482.538867,482.566333,1,14476166,14476989,823,0.11538813790146588
5777,482.5749,482.735567,1,14477247,14482067,4820,0.8227529791372614
5778,482.7488,482.767467,1,14482464,14483024,560,0.6823251136644796
5779,482.773867,482.809867,1,14483216,14484296,1080,0.7720974438713379
5780,482.829267,482.9218,1,14484878,14487654,2776,0.8266007981192577
5781,482.924067,482.953267,1,14487722,14488598,876,0.7850098615277356
5782,482.9563,482.965933,1,14488689,14488977,288,0.035153086675700794
5783,482.968167,482.978933,1,14489045,14489367,322,-0.04826977609860693
5784,482.981133,483.014933,1,14489433,14490447,1014,0.18786847403859175
5785,483.032567,483.1481,1,14490977,14494443,3466,0.750412917410228
5786,483.1507,483.167933,1,14494521,14495037,516,-0.254090873808144
5787,483.174833,483.183933,1,14495244,14495517,273,0.03163107546693195
5788,483.1856,483.196033,1,14495568,14495880,312,-0.22321992482240385
5789,483.199567,483.208267,1,14495987,14496248,261,-0.6102999087329531
5790,483.216233,483.4177,1,14496486,14502531,6045,0.8418261477591865
5791,483.438033,483.443267,1,14503140,14503298,158,-0.061038937576249876
5792,483.444267,483.455033,1,14503328,14503650,322,0.047546923980949486
5793,483.4609,483.466233,1,14503827,14503986,159,-0.14568267253005657
5794,483.474033,483.4828,1,14504220,14504484,264,0.08134690785040964
5795,483.490133,483.496867,1,14504703,14504906,203,-0.13867090454336098
5796,484.1591,484.173567,1,14524773,14525207,434,0.6583319642056318
5797,484.175833,484.185367,1,14525274,14525561,287,0.5658956561528139
5798,484.186933,484.1904,1,14525607,14525712,105,0.31349484827320045
5799,484.223967,484.2345,1,14526719,14527035,316,0.5160261443763063
5800,484.2547,484.2624,1,14527641,14527872,231,0.756421205438494
5801,484.285467,484.303833,1,14528564,14529114,550,0.6319471409285783
5802,484.3347,484.3616,1,14530041,14530848,807,0.6658929837485726
5803,484.383267,484.394233,1,14531498,14531826,328,0.5909757868564438
5804,484.416467,484.421567,1,14532494,14532647,153,0.6319727276906202
5805,484.425233,484.434067,1,14532756,14533022,266,0.657886705589259
5806,488.6022,488.606167,1,14658066,14658185,119,0.3009650670869403
5807,488.673967,488.680367,1,14660219,14660411,192,0.6276526672111175
5808,488.726233,488.733,1,14661786,14661990,204,0.2295436346786872
5809,488.798133,488.822867,1,14663943,14664686,743,0.5136615876916129
5810,488.8507,488.861433,1,14665521,14665842,321,0.565054445732522
5811,488.863067,488.8821,1,14665892,14666463,571,0.8367444659237967
5812,488.912,488.933433,1,14667360,14668002,642,0.6811137895481562
5813,488.950333,488.961633,1,14668509,14668848,339,0.5679200229266905
5814,488.9704,488.980067,1,14669112,14669402,290,0.33584348932783287
5815,489.2439,489.342533,1,14677317,14680275,2958,0.8136551267483824
5816,489.8978,489.901,1,14696934,14697030,96,0.820647999724576
5817,489.9065,489.9133,1,14697195,14697399,204,0.5887249689571051
5818,489.918667,489.9353,1,14697560,14698059,499,0.7084815416087081
5819,489.939967,489.945333,1,14698199,14698359,160,-0.30945297434086694
5820,489.9764,489.984067,1,14699292,14699522,230,0.5468908179650868
5821,489.9853,489.992333,1,14699559,14699769,210,0.39864066731525516
5822,490.021667,490.034367,1,14700650,14701031,381,0.23055358466085907
5823,490.045833,490.053867,1,14701374,14701616,242,0.688747308569682
5824,490.065133,490.081167,1,14701953,14702435,482,0.7419657071304611
5825,490.0907,490.105533,1,14702721,14703165,444,0.6575556879469939
5826,490.108667,490.126167,1,14703260,14703785,525,0.620695246975556
5827,490.286067,490.289133,1,14708582,14708673,91,0.5368837795064211
5828,490.311333,490.4653,1,14709339,14713959,4620,0.5007929721680473
5829,490.476267,490.4824,1,14714288,14714472,184,0.5321416302718276
5830,490.484167,490.488767,1,14714525,14714663,138,0.49794647699136574
5831,490.4993,490.5181,1,14714979,14715543,564,-0.016126456816930826
5832,490.520567,490.531033,1,14715617,14715930,313,-0.0335017714463803
5833,490.536067,490.542,1,14716082,14716260,178,-0.12200161286441943
5834,490.7841,490.949967,1,14723523,14728499,4976,0.7914682710594494
5835,490.9649,490.9898,1,14728947,14729694,747,0.8044471894560425
5836,490.990867,491.047233,1,14729726,14731416,1690,0.5504510794762844
5837,491.3165,491.353933,1,14739495,14740617,1122,0.6354736835510997
5838,491.3564,491.370067,1,14740692,14741102,410,0.631753609650036
5839,491.383367,491.401533,1,14741501,14742045,544,0.6864511603576741
5840,491.4305,491.492433,1,14742915,14744772,1857,0.746012514679385
5841,491.496733,491.5022,1,14744901,14745066,165,0.6518608631601644
5842,491.505433,491.544267,1,14745162,14746328,1166,0.7772398292097563
5843,491.564933,491.599267,1,14746947,14747978,1031,0.7368131454103088
5844,491.612067,491.640333,1,14748362,14749209,847,0.7832850223741408
5845,491.647633,491.662933,1,14749428,14749887,459,0.4938506161393672
5846,491.6692,491.724967,1,14750076,14751749,1673,0.16208253938672895
5847,491.733667,491.738567,1,14752010,14752157,147,0.00117308034028919
5848,491.750767,491.9278,1,14752523,14757834,5311,0.7546078150537137
5849,491.932833,491.959467,1,14757984,14758784,800,0.7082899940603755
5850,491.976767,491.988833,1,14759303,14759664,361,0.7188515402160074
5851,492.326,492.495333,1,14769780,14774859,5079,0.7874006788314258
5852,492.503433,492.5556,1,14775102,14776668,1566,0.8109211085155761
5853,492.560467,492.5772,1,14776814,14777316,502,0.6865971315102506
5854,492.579667,492.594867,1,14777390,14777846,456,0.6935976000317134
5855,492.869667,493.090167,1,14786090,14792705,6615,0.8110065436845467
5856,493.116,493.196333,1,14793480,14795889,2409,0.7303659713576537
5857,493.2031,493.209333,1,14796093,14796279,186,-0.11652996390728468
5858,493.4763,493.485633,1,14804289,14804568,279,0.7829107986736835
5859,493.487167,493.506767,1,14804615,14805203,588,0.6225400921794447
5860,493.557567,493.5625,1,14806727,14806875,148,0.6817926534187783
5861,493.601167,493.6082,1,14808035,14808246,211,0.12506754798004532
5862,493.609367,493.617567,1,14808281,14808527,246,0.2403723920163668
5863,493.6222,493.644167,1,14808666,14809325,659,0.03200053373419301
5864,493.648033,493.655833,1,14809440,14809674,234,0.11214010445859761
5865,493.6572,493.661,1,14809716,14809830,114,0.32930208516815485
5866,493.6626,493.680733,1,14809878,14810421,543,0.1730531692476667
5867,493.705367,493.709067,1,14811161,14811272,111,
5868,493.724167,493.8832,1,14811725,14816496,4771,0.8298072777707757
5869,493.919433,493.963767,1,14817582,14818913,1331,0.7649187793408622
5870,493.969233,494.119733,1,14819076,14823591,4515,0.7325268976237576
5871,494.138167,494.1428,1,14824145,14824284,139,-0.060938854564906435
5872,494.1441,494.148333,1,14824323,14824449,126,0.07551622097234334
5873,494.327033,494.330267,1,14829810,14829908,98,-0.10263973524826525
5874,494.476633,494.5458,1,14834298,14836374,2076,0.7887623949689447
5875,494.552733,494.6283,1,14836581,14838849,2268,0.8063835282160093
5876,494.642467,494.766167,1,14839274,14842985,3711,0.7901785710656114
5877,494.7713,494.849133,1,14843139,14845473,2334,0.7029774911353034
5878,494.8546,494.877867,1,14845638,14846336,698,0.6638025236014253
5879,494.884067,494.8971,1,14846522,14846913,391,0.40963436770066763
5880,494.916467,494.9285,1,14847494,14847855,361,-0.03936507437874943
5881,494.932533,494.9516,1,14847975,14848548,573,0.19957283650100802
5882,494.9555,494.967967,1,14848665,14849039,374,0.05379144557245022
5883,495.000033,495.006233,1,14850000,14850186,186,-0.1973814565658873
5884,495.0094,495.311833,1,14850282,14859354,9072,0.7204670338864891
5885,495.812667,495.873333,1,14874380,14876199,1819,0.6517619619005303
5886,495.878133,495.913833,1,14876343,14877414,1071,0.8402506726029129
5887,495.915767,495.969833,1,14877473,14879094,1621,0.7535630823308982
5888,495.974367,496.033,1,14879231,14880990,1759,0.6533238692919692
5889,496.0511,496.0884,1,14881533,14882652,1119,0.6607031840488697
5890,496.096,496.149767,1,14882880,14884493,1613,0.6473010087431796
5891,496.170767,496.218833,1,14885123,14886564,1441,0.8259212863011594
5892,496.229467,496.243633,1,14886884,14887308,424,0.5820157510324891
5893,496.4402,496.4647,1,14893206,14893941,735,0.7448675013231436
5894,496.473133,496.588633,1,14894193,14897658,3465,0.8106847944583626
5895,496.6041,496.7905,1,14898123,14903715,5592,0.7724889862967255
5896,496.795833,496.932033,1,14903874,14907960,4086,0.7215008736616769
5897,496.947333,496.9509,1,14908419,14908527,108,-0.03382124731780295
5898,496.951933,496.964433,1,14908557,14908932,375,0.07905210473967703
5899,496.967033,496.9704,1,14909010,14909112,102,
5900,496.9724,496.9771,1,14909172,14909313,141,
5901,497.0576,497.164767,1,14911728,14914943,3215,0.746985887558743
5902,497.201033,497.207,1,14916030,14916210,180,-0.020027139682598654
5903,497.411133,497.431033,1,14922333,14922930,597,0.8077662433613371
5904,497.433067,497.5295,1,14922992,14925885,2893,0.7683225961492773
5905,497.531033,497.607967,1,14925930,14928239,2309,0.7738564741557019
5906,497.610367,497.759933,1,14928311,14932797,4486,0.7820442028743831
5907,497.763967,497.789233,1,14932919,14933676,757,0.6923636929964
5908,497.7926,497.797,1,14933778,14933910,132,0.08207644606313343
5909,497.812367,497.817833,1,14934371,14934534,163,-0.193254627708691
5910,497.841,497.860467,1,14935230,14935814,584,0.6376664111562508
5911,497.8762,497.958067,1,14936286,14938742,2456,0.7950873718376985
5912,497.969533,497.973333,1,14939085,14939199,114,0.21211770633324195
5913,497.974567,497.9811,1,14939237,14939433,196,0.1274324364295281
5914,498.010667,498.013933,1,14940320,14940417,97,-0.3286069188193968
5915,498.0872,498.0924,1,14942616,14942772,156,0.3717147526896828
5916,498.096733,498.106767,1,14942901,14943203,302,0.4112339904961167
5917,498.108267,498.1468,1,14943248,14944404,1156,0.7394679207380408
5918,498.148533,498.153233,1,14944455,14944596,141,-0.04394593450629284
5919,498.155567,498.200467,1,14944667,14946014,1347,0.7573948102204938
5920,498.228033,498.238133,1,14946840,14947143,303,0.5783031406856778
5921,498.2394,498.2468,1,14947182,14947404,222,0.10452428814535622
5922,498.320367,498.324767,1,14949611,14949743,132,0.34904577017239335
5923,498.331633,498.695667,1,14949948,14960870,10922,0.6672607072247454
5924,498.699933,498.704067,1,14960997,14961122,125,0.1248667174000587
5925,498.705133,498.7107,1,14961153,14961321,168,-0.10599133952463359
5926,498.753367,498.770833,1,14962601,14963124,523,0.2610542888385866
5927,498.7783,498.786867,1,14963349,14963606,257,0.0013525784704149003
5928,498.788167,498.825233,1,14963645,14964756,1111,0.05689695289280866
5929,498.869633,499.027467,1,14966088,14970824,4736,0.8321792533099447
5930,499.0447,499.049333,1,14971341,14971479,138,0.3443675103567375
5931,499.062033,499.086333,1,14971860,14972589,729,-0.00036146049450303897
5932,499.088767,499.1112,1,14972663,14973336,673,0.14910651728744131
5933,499.1703,499.305367,1,14975109,14979161,4052,0.7675827846930976
5934,499.319333,499.323067,1,14979579,14979692,113,0.7534716370360527
5935,499.331367,499.3349,1,14979941,14980047,106,0.11255654012896951
5936,499.337833,499.360467,1,14980134,14980814,680,-2.0055220812111702e-05
5937,499.362267,499.373033,1,14980868,14981190,322,-0.13512379409372602
5938,499.375133,499.3844,1,14981253,14981532,279,-0.13017550894403246
5939,499.4824,499.4957,1,14984472,14984871,399,0.7428629108182838
5940,499.4977,499.5368,1,14984931,14986104,1173,0.7433889725274015
5941,499.538133,499.5903,1,14986143,14987709,1566,0.7484930950141688
5942,499.6024,499.610833,1,14988072,14988324,252,-0.12157314322401674
5943,499.6127,499.6213,1,14988381,14988639,258,-0.08457172722869143
5944,499.623633,499.6381,1,14988708,14989143,435,0.06728046535022496
5945,499.6403,499.648633,1,14989209,14989458,249,0.395405175173731
5946,499.666633,499.666967,1,14989998,14990009,11,
5947,499.770567,499.785833,1,14993117,14993574,457,-0.1340061477291376
5948,499.7989,499.875333,1,14993967,14996259,2292,0.5233162531736532
5949,499.890467,500.019667,1,14996714,15000590,3876,0.5872151454237651
5950,500.0408,500.062333,1,15001224,15001869,645,0.004106621659911353
5951,500.066733,500.087433,1,15002001,15002622,621,0.029224984173592077
5952,500.093233,500.097133,1,15002796,15002913,117,-0.2395858220174038
5953,500.2126,500.337867,1,15006378,15010136,3758,0.7687819598705534
5954,500.3422,500.35,1,15010266,15010500,234,0.026274376103671247
5955,500.3747,500.3849,1,15011241,15011547,306,0.7814907524635762
5956,500.3905,500.408867,1,15011715,15012266,551,0.6571240527127087
5957,500.4161,500.492133,1,15012483,15014763,2280,0.8175341852109469
5958,500.500667,500.518533,1,15015020,15015555,535,0.8193311991565327
5959,500.522367,500.530033,1,15015671,15015900,229,0.838923699589438
5960,500.533733,500.5843,1,15016011,15017529,1518,0.7552388246612204
5961,500.5886,500.604733,1,15017658,15018141,483,0.7574071868041092
5962,500.606333,500.621533,1,15018189,15018645,456,0.5437742788644784
5963,500.652367,500.665133,1,15019571,15019953,382,-0.1045246993018638
5964,500.668033,500.695667,1,15020040,15020870,830,0.17620618838789237
5965,500.731267,500.7364,1,15021938,15022092,154,0.3939953087941367
5966,500.740433,500.918667,1,15022212,15027560,5348,0.8299575722992721
5967,500.941367,500.9672,1,15028241,15029016,775,0.7259805700486472
5968,500.9829,500.994933,1,15029487,15029847,360,-0.1118108220371269
5969,501.0006,501.036333,1,15030018,15031089,1071,0.1323275083411074
5970,501.0908,501.237333,1,15032724,15037119,4395,0.8165480225756571
5971,501.239167,501.244667,1,15037175,15037340,165,0.4766376618322431
5972,501.2575,501.3054,1,15037725,15039162,1437,0.10490385300792567
5973,501.306467,501.315967,1,15039194,15039479,285,0.4805520516615568
5974,501.317033,501.320133,1,15039510,15039603,93,
5975,501.3399,501.3581,1,15040197,15040743,546,0.5979694285217335
5976,501.3593,501.4509,1,15040779,15043527,2748,0.8160019472793789
5977,501.470233,501.4821,1,15044106,15044463,357,0.35749421592260355
5978,501.494333,501.5278,1,15044829,15045834,1005,0.03162130629322758
5979,501.5313,501.6579,1,15045939,15049737,3798,0.7644819035748287
5980,501.676333,501.742633,1,15050289,15052278,1989,0.8005957079641935
5981,501.770333,501.803267,1,15053109,15054098,989,0.7106925713241148
5982,501.813167,501.831867,1,15054395,15054956,561,-0.0023304588212486083
5983,501.840233,501.867433,1,15055206,15056022,816,0.12323161525966671
5984,501.8688,501.872433,1,15056064,15056172,108,
5985,501.898067,502.115333,1,15056942,15063459,6517,0.8425258821821002
5986,502.137667,502.203133,1,15064130,15066093,1963,0.22691547056579817
5987,502.219,502.339967,1,15066570,15070199,3629,0.7378748586345918
5988,502.378567,502.3912,1,15071357,15071736,379,0.21951207818064256
5989,502.401367,502.414333,1,15072041,15072429,388,0.029602461760346994
5990,502.4154,502.426667,1,15072462,15072800,338,-0.07831313189414972
5991,502.4353,502.448033,1,15073059,15073440,381,0.2683876410908098
5992,502.5038,502.700967,1,15075114,15081029,5915,0.8144303881660286
5993,502.708967,502.7249,1,15081269,15081747,478,0.6905809276000064
5994,502.729567,502.743933,1,15081887,15082317,430,0.6307911372604803
5995,502.765467,502.7988,1,15082964,15083964,1000,0.17378986785607345
5996,502.801267,502.8271,1,15084038,15084813,775,0.012413479615789744
5997,502.8456,503.0281,1,15085368,15090843,5475,0.8328706259454804
5998,503.042067,503.072733,1,15091262,15092181,919,0.84817443134318
5999,503.075933,503.153767,1,15092277,15094613,2336,0.8483661735917213
6000,503.1854,503.199133,1,15095562,15095973,411,0.09427607065217929
6001,503.200333,503.207267,1,15096009,15096218,209,-0.04602764409023589
6002,503.209833,503.220333,1,15096294,15096609,315,0.06981878133079372
6003,503.230933,503.237233,1,15096927,15097116,189,-0.11709924488285595
6004,503.2788,503.397033,1,15098364,15101910,3546,0.8146162507877339
6005,503.4247,503.434867,1,15102741,15103046,305,0.5698349655649961
6006,503.439867,503.465833,1,15103196,15103974,778,0.1515351894141149
6007,503.468433,503.503433,1,15104052,15105102,1050,0.10798089876299831
6008,503.516867,503.521767,1,15105506,15105653,147,0.45670779405558903
6009,503.5245,503.615833,1,15105735,15108474,2739,0.8420020805277768
6010,503.6171,503.7307,1,15108513,15111921,3408,0.8309613522867514
6011,504.040667,504.0776,1,15121220,15122328,1108,0.8307156987074026
6012,504.079,504.216333,1,15122370,15126489,4119,0.8402188022239159
6013,504.230467,504.325533,1,15126914,15129765,2851,0.8065416253751106
6014,504.331767,504.360733,1,15129953,15130821,868,0.9191744699163369
6015,504.375367,504.3786,1,15131261,15131358,97,-0.08083939689104921
6016,504.384633,504.3924,1,15131538,15131772,234,0.06409313366785264
6017,504.397867,504.406367,1,15131936,15132191,255,0.06034034626418831
6018,504.4283,504.432033,1,15132849,15132960,111,0.8984408510166145
6019,504.501933,504.506667,1,15135057,15135200,143,0.4714017346312176
6020,504.519567,504.5373,1,15135587,15136119,532,0.32356085037456156
6021,504.5396,504.552533,1,15136188,15136575,387,0.39122173425456985
6022,504.5557,504.582367,1,15136671,15137471,800,-0.008274601789561225
6023,504.583433,504.5927,1,15137502,15137781,279,0.1285876085936927
6024,504.594233,504.603767,1,15137826,15138113,287,0.18514454127154634
6025,504.624733,504.630767,1,15138741,15138923,182,0.15718581546258834
6026,504.633967,504.705267,1,15139019,15141158,2139,0.798266557367473
6027,504.708533,504.783933,1,15141255,15143517,2262,0.7580794748110555
6028,504.7853,504.828767,1,15143559,15144863,1304,0.8363288129692287
6029,504.831233,504.8373,1,15144936,15145119,183,0.7021295178890571
6030,504.8593,504.8816,1,15145779,15146448,669,0.8920691723309376
6031,504.8828,504.929967,1,15146484,15147899,1415,0.809165668824965
6032,504.9344,504.967167,1,15148032,15149015,983,0.7084675580067952
6033,505.311,505.320967,1,15159330,15159629,299,0.5793445406980103
6034,505.322633,505.335233,1,15159678,15160056,378,0.8585194680631739
6035,505.3455,505.377333,1,15160365,15161319,954,0.8213587457518418
6036,505.3882,505.442933,1,15161646,15163287,1641,0.8353839629757495
6037,505.4536,505.554267,1,15163608,15166628,3020,0.7741484312748136
6038,505.555367,505.565833,1,15166661,15166974,313,0.5224635853015627
6039,505.567767,505.5724,1,15167033,15167172,139,0.3392378008209452
6040,505.5773,505.637933,1,15167319,15169137,1818,0.8147638544831108
6041,505.657567,505.660867,1,15169727,15169826,99,0.5317910004035729
6042,505.668567,505.6992,1,15170057,15170976,919,0.8465517966994248
6043,506.003033,506.076633,1,15180090,15182298,2208,0.7992032078937418
6044,506.081967,506.175833,1,15182459,15185274,2815,0.8241395915388829
6045,506.189467,506.286033,1,15185684,15188580,2896,0.7920868797302144
6046,506.308833,506.4027,1,15189264,15192081,2817,0.7604153807585481
6047,506.406233,506.478367,1,15192186,15194351,2165,0.7598016608240024
6048,506.481667,506.552667,1,15194450,15196580,2130,0.8343320131151882
6049,506.555467,506.559267,1,15196664,15196778,114,0.3605881191415335
6050,506.561267,506.6372,1,15196838,15199116,2278,0.7755840317000052
6051,506.638233,506.6551,1,15199146,15199653,507,0.46065634987593407
6052,506.6567,506.7614,1,15199701,15202842,3141,0.8265162398376076
6053,506.770133,506.776567,1,15203103,15203297,194,
6054,506.783,506.7989,1,15203490,15203967,477,0.19095741951196943
6055,506.8065,506.8103,1,15204195,15204309,114,0.0305680443884465
6056,506.818867,506.822333,1,15204566,15204669,103,-0.060852489311745576
6057,506.846267,506.8513,1,15205388,15205539,151,-0.09215233990898426
6058,506.862433,506.867267,1,15205872,15206018,146,0.26691949637067897
6059,506.8788,506.887333,1,15206364,15206619,255,0.256522312908063
6060,506.939833,507.010667,1,15208194,15210320,2126,0.633371999506111
6061,507.044433,507.070433,1,15211332,15212112,780,0.007190939579635108
6062,507.201667,507.2087,1,15216050,15216261,211,0.01402320552180622
6063,507.223433,507.229267,1,15216702,15216878,176,-0.129577517679092
6064,507.235067,507.245733,1,15217052,15217371,319,0.21344808234294035
6065,507.256867,507.3828,1,15217706,15221484,3778,0.39653653952459395
6066,507.394433,507.4133,1,15221832,15222399,567,0.4737785383836339
6067,507.416567,507.420867,1,15222497,15222626,129,-0.0954558939271229
6068,507.4219,507.4303,1,15222657,15222909,252,0.18296859915384972
6069,507.434533,507.5289,1,15223035,15225867,2832,0.7926528603902846
6070,507.541233,507.6146,1,15226236,15228438,2202,0.8381764980757426
6071,507.6186,507.6229,1,15228558,15228687,129,0.6500300836737567
6072,507.640467,507.7392,1,15229214,15232176,2962,0.768686630096523
6073,507.7421,507.765767,1,15232263,15232973,710,0.6425983306471285
6074,507.767767,507.775567,1,15233033,15233267,234,0.2347933834492117
6075,507.778367,507.819467,1,15233351,15234584,1233,0.74710923535964
6076,507.824633,507.885767,1,15234738,15236573,1835,0.8333114793410029
6077,507.8965,507.913433,1,15236895,15237402,507,0.7052364861328749
6078,507.9185,507.926133,1,15237555,15237783,228,0.2651386096980767
6079,507.934367,507.941067,1,15238031,15238232,201,-0.20661201969358367
6080,507.948333,507.970933,1,15238449,15239127,678,-0.10828971135501315
6081,507.9722,508.003333,1,15239166,15240099,933,-0.005217454797486619
6082,508.0287,508.034033,1,15240861,15241020,159,0.7595275407717218
6083,508.0352,508.041067,1,15241056,15241232,176,0.4078339323120968
6084,508.056833,508.067967,1,15241704,15242039,335,0.43975482001428023
6085,508.0712,508.092767,1,15242136,15242783,647,-0.3938345446643318
6086,508.131967,508.295967,1,15243959,15248879,4920,0.7751804996914557
6087,508.400367,508.405133,1,15252011,15252153,142,0.2581986610697499
6088,508.482133,508.485767,1,15254463,15254573,110,0.2162272030878077
6089,508.721267,508.727833,1,15261638,15261834,196,0.6630249834899747
6090,508.7325,508.7375,1,15261975,15262125,150,0.6630753279668168
6091,508.7491,508.753933,1,15262473,15262617,144,0.7354623084147748
6092,508.7975,508.8019,1,15263925,15264057,132,0.4865408948748466
6093,508.820733,508.825333,1,15264621,15264759,138,0.25668058996009346
6094,508.8439,508.8545,1,15265317,15265635,318,0.5403124097743652
6095,508.9106,508.925567,1,15267318,15267767,449,0.5646860043211049
6096,508.9617,508.971567,1,15268851,15269147,296,0.5184922307078527
6097,509.114567,509.187667,1,15273437,15275630,2193,0.7539642473814682
6098,509.1896,509.223167,1,15275688,15276695,1007,0.8249224180013727
6099,509.257133,509.2639,1,15277713,15277917,204,0.27503112514343975
6100,509.4292,509.432667,1,15282876,15282980,104,0.41208043993149923
6101,509.435267,509.479567,1,15283058,15284387,1329,0.604836127140437
6102,509.6547,509.6895,1,15289641,15290685,1044,0.718993009841628
6103,509.690733,509.738267,1,15290721,15292148,1427,0.7185121979684398
6104,509.742567,509.772733,1,15292277,15293181,904,0.8322561525380098
6105,509.795433,509.8266,1,15293862,15294798,936,0.7211351183127629
6106,509.839867,509.8959,1,15295196,15296877,1681,0.5842405421193535
6107,509.906433,509.9119,1,15297192,15297357,165,0.3272590102992328
6108,509.919533,509.9425,1,15297585,15298275,690,0.6206975691589078
6109,509.956533,509.962067,1,15298695,15298862,167,0.4038959154481867
6110,509.969733,510.018067,1,15299091,15300542,1451,0.07548763205054747
6111,510.024733,510.030467,1,15300741,15300914,173,0.42394287210849846
6112,510.033167,510.198233,1,15300995,15305946,4951,0.8034959291184874
6113,510.199433,510.332633,1,15305982,15309978,3996,0.7382039309435531
6114,510.346333,510.350767,1,15310389,15310523,134,-0.017848464579236674
6115,510.357667,510.3636,1,15310730,15310908,178,0.6081723681575567
6116,510.382,510.3924,1,15311460,15311772,312,-0.03609998403419492
6117,510.402967,510.422467,1,15312089,15312674,585,0.43980744694950547
6118,510.423467,510.4286,1,15312704,15312858,154,0.32628718504691534
6119,510.4307,510.434,1,15312921,15313020,99,0.7358495981216162
6120,510.4698,510.509833,1,15314094,15315294,1200,0.19226159712025345
6121,511.0373,511.076533,1,15331119,15332295,1176,0.7274603187059326
6122,511.1197,511.1419,1,15333591,15334257,666,0.8413842748095931
6123,511.167533,511.197533,1,15335025,15335925,900,0.6537834753107744
6124,511.2005,511.2271,1,15336015,15336813,798,0.8453422062739921
6125,511.2583,511.266533,1,15337749,15337995,246,0.6904108016804258
6126,511.270133,511.294367,1,15338103,15338831,728,0.6282516872456624
6127,511.31,511.3825,1,15339300,15341475,2175,0.673915746373009
6128,511.3848,511.393033,1,15341544,15341790,246,0.2667414578816587
6129,511.394033,511.3971,1,15341820,15341913,93,0.3419190860915397
6130,511.4386,511.451867,1,15343158,15343556,398,-0.5339692904899316
6131,511.452967,511.456467,1,15343589,15343694,105,-0.47633670539213285
6132,511.466867,511.473567,1,15344006,15344207,201,0.2516587824674145
6133,511.475333,511.4787,1,15344259,15344361,102,0.393749518079515
6134,511.500767,511.6088,1,15345023,15348264,3241,0.8225492416167528
6135,511.627367,511.638167,1,15348821,15349145,324,0.6275288295613991
6136,511.646767,511.650567,1,15349403,15349517,114,0.8319203857808969
6137,511.6673,511.671667,1,15350019,15350150,131,
6138,511.7329,511.903,1,15351987,15357090,5103,0.8124735529496003
6139,511.920633,512.054467,1,15357618,15361634,4016,0.7660252747346282
6140,512.076367,512.0805,1,15362291,15362415,124,-0.010866342237071561
6141,512.081567,512.085267,1,15362447,15362558,111,
6142,512.343567,512.3558,1,15370307,15370674,367,0.387154319165636
6143,512.3577,512.367533,1,15370731,15371025,294,-0.030879144196716266
6144,512.377233,512.390533,1,15371316,15371715,399,0.25478195133370246
6145,512.391967,512.396133,1,15371759,15371883,124,0.23577142222398156
6146,512.441067,512.450633,1,15373232,15373518,286,0.4356690463652545
6147,512.460433,512.481867,1,15373812,15374456,644,0.02862486251744197
6148,512.482867,512.4905,1,15374486,15374715,229,0.2404241363933029
6149,512.4935,512.502,1,15374805,15375059,254,0.2846991697823434
6150,512.506267,512.7012,1,15375188,15381036,5848,0.8053809134016512
6151,512.721867,512.787633,1,15381656,15383628,1972,0.7855871017687314
6152,512.792467,512.809233,1,15383774,15384276,502,0.7745031454793979
6153,512.810333,512.8237,1,15384309,15384711,402,0.4339173085558207
6154,512.843167,512.849767,1,15385295,15385493,198,-0.05391444975519562
6155,512.8521,512.8933,1,15385562,15386798,1236,0.11910594898783292
6156,512.921433,512.936367,1,15387642,15388091,449,0.7918931922355976
6157,512.9376,513.054633,1,15388128,15391638,3510,0.8563517800497467
6158,513.061867,513.067467,1,15391856,15392024,168,0.8246283760436288
6159,513.070633,513.076333,1,15392118,15392289,171,0.7109059777025476
6160,513.078467,513.163333,1,15392354,15394899,2545,0.80445655508948
6161,513.169767,513.2264,1,15395093,15396792,1699,0.7947376704181123
6162,513.751,513.757033,1,15412530,15412710,180,0.7818375316801801
6163,513.7588,513.7871,1,15412763,15413613,850,0.2952863352832332
6164,513.8128,513.831033,1,15414384,15414930,546,0.5957978630272416
6165,513.851233,513.860567,1,15415536,15415817,281,0.47971197804269394
6166,514.010067,514.016133,1,15420302,15420483,181,0.469369735797945
6167,514.018167,514.1897,1,15420545,15425691,5146,0.8219651171092301
6168,514.200633,514.244133,1,15426018,15427323,1305,0.8406199803501564
6169,514.2469,514.251733,1,15427407,15427551,144,0.19033450003488833
6170,514.266633,514.2962,1,15427998,15428886,888,0.7855367505950828
6171,514.3279,514.4017,1,15429837,15432051,2214,0.7784214433222095
6172,514.419,514.424167,1,15432570,15432725,155,-0.05261778837747498
6173,514.426067,514.430733,1,15432782,15432921,139,-0.04179797962440436
6174,514.435567,514.439,1,15433067,15433169,102,
6175,514.484567,514.490167,1,15434537,15434705,168,0.5790155178776644
6176,514.495667,514.553967,1,15434870,15436619,1749,0.7453560761383846
6177,514.555433,514.613367,1,15436662,15438401,1739,0.8420061542745803
6178,514.621533,514.683533,1,15438645,15440505,1860,0.7997625124028012
6179,514.6914,514.738967,1,15440742,15442169,1427,0.8374916593548887
6180,514.743967,514.763433,1,15442319,15442902,583,0.6695384351484877
6181,514.764433,514.815933,1,15442932,15444477,1545,0.7076988966955047
6182,514.8178,514.9188,1,15444534,15447564,3030,0.822513653903671
6183,514.921467,515.003967,1,15447644,15450119,2475,0.8411034925605646
6184,515.006033,515.030533,1,15450180,15450915,735,0.7978331348162492
6185,515.032067,515.153233,1,15450962,15454596,3634,0.780910152312582
6186,515.155533,515.247133,1,15454665,15457413,2748,0.7644060738336778
6187,515.249733,515.274833,1,15457491,15458244,753,0.696318783370852
6188,515.2784,515.371367,1,15458352,15461141,2789,0.4519304061725733
6189,515.373833,515.393567,1,15461214,15461807,593,0.8412365685787151
6190,515.404067,515.476467,1,15462122,15464294,2172,0.8371379291420926
6191,515.477767,515.522867,1,15464333,15465686,1353,0.8172594583970605
6192,515.527567,515.6231,1,15465827,15468693,2866,0.8542825463279291
6193,515.6259,515.6524,1,15468777,15469571,794,0.7861951978716941
6194,515.655633,515.751267,1,15469668,15472538,2870,0.8576684077285556
6195,515.755167,515.759333,1,15472655,15472779,124,0.6850544500605982
6196,515.7623,515.777233,1,15472869,15473316,447,0.8436097765088783
6197,515.784633,515.881733,1,15473538,15476451,2913,0.8283616678559945
6198,515.884267,515.9111,1,15476528,15477333,805,0.8428544536101196
6199,515.913267,516.011067,1,15477398,15480332,2934,0.8417188521115194
6200,516.014767,516.0342,1,15480443,15481026,583,0.8871893194488415
6201,516.044867,516.1021,1,15481346,15483062,1716,0.7610770872497733
6202,516.129933,516.136433,1,15483897,15484092,195,0.5697069125729707
6203,516.141567,516.145133,1,15484247,15484353,106,0.5276552319726648
6204,516.146967,516.157933,1,15484409,15484737,328,0.8650826384039262
6205,516.170367,516.208733,1,15485111,15486261,1150,0.8462331188556401
6206,516.210567,516.224733,1,15486317,15486741,424,0.8114355187439799
6207,516.243333,516.258567,1,15487299,15487757,458,0.7589593292685247
6208,516.261533,516.266667,1,15487845,15488000,155,0.051446995509318534
6209,516.2712,516.329867,1,15488136,15489896,1760,0.7677529327452983
6210,516.3316,516.342933,1,15489948,15490287,339,0.7794285178469822
6211,516.3548,516.358667,1,15490643,15490760,117,-0.02344983097044592
6212,516.3601,516.366,1,15490803,15490980,177,-0.04889497067388498
6213,516.376933,516.380867,1,15491307,15491426,119,
6214,516.388867,516.397867,1,15491666,15491936,270,-0.11271259545242623
6215,516.5426,516.600433,1,15496278,15498012,1734,0.7443490404310233
6216,516.6119,516.627267,1,15498357,15498818,461,0.02327409978015833
6217,516.628433,516.6321,1,15498852,15498963,111,-0.27486053964495033
6218,517.2511,517.277467,1,15517532,15518324,792,0.5309118010527483
6219,517.3429,517.350067,1,15520287,15520502,215,0.4811028753430186
6220,517.492,517.514833,1,15524759,15525444,685,0.5348412816070297
6221,517.558233,517.574267,1,15526746,15527228,482,0.6373076111121742
6222,517.594133,517.597267,1,15527823,15527918,95,-0.15002308634396055
6223,517.733933,517.8605,1,15532017,15535815,3798,0.7706368844344498
6224,517.870467,517.9405,1,15536114,15538215,2101,0.792231570974668
6225,517.952033,518.112867,1,15538560,15543386,4826,0.6918000922866997
6226,518.124933,518.1327,1,15543747,15543981,234,0.07388991001033281
6227,518.218933,518.4193,1,15546567,15552579,6012,0.8077172539403487
6228,518.7622,518.7875,1,15562866,15563625,759,0.7637410613218627
6229,518.802367,518.853267,1,15564071,15565598,1527,0.663309987591765
6230,518.869133,518.895433,1,15566073,15566862,789,0.6673698601132708
6231,518.913133,518.952867,1,15567393,15568586,1193,0.6119703842444741
6232,518.968633,518.978567,1,15569058,15569357,299,0.664850906953506
6233,519.008433,519.0143,1,15570252,15570429,177,0.299528814299472
6234,519.021133,519.032833,1,15570633,15570984,351,-0.018906023919503537
6235,519.034067,519.0545,1,15571022,15571634,612,0.16784858413465076
6236,519.058633,519.0876,1,15571758,15572627,869,0.9010116078893454
6237,519.0887,519.124333,1,15572661,15573729,1068,0.8397845776585812
6238,519.1329,519.1765,1,15573986,15575295,1309,0.8475112334664664
6239,519.199467,519.211333,1,15575984,15576339,355,-0.04463221085079369
6240,519.2143,519.233233,1,15576429,15576996,567,0.2045238187919669
6241,519.239567,519.2485,1,15577187,15577455,268,-0.0441748733347166
6242,519.2518,519.256267,1,15577554,15577688,134,0.13900599157230437
6243,519.259567,519.431833,1,15577787,15582954,5167,0.7195127982121009
6244,519.461067,519.5652,1,15583832,15586956,3124,0.8012122784197168
6245,519.566533,519.5697,1,15586995,15587091,96,0.33338204467780735
6246,519.580933,519.586267,1,15587427,15587588,161,0.09789043757872673
6247,520.6561,520.690467,1,15619683,15620714,1031,0.5408696286592921
6248,520.716133,520.733267,1,15621483,15621998,515,0.5828688516712448
6249,520.929167,520.981567,1,15627875,15629447,1572,0.6849021327121988
6250,520.988067,521.073267,1,15629642,15632198,2556,0.8367105265507936
6251,521.0924,521.0974,1,15632772,15632922,150,0.025860692964985835
6252,521.2811,521.296133,1,15638433,15638883,450,0.5517086591575434
6253,521.2978,521.339933,1,15638934,15640197,1263,0.8275272076537414
6254,521.342033,521.384333,1,15640260,15641529,1269,0.8359743820892699
6255,521.402,521.412467,1,15642060,15642374,314,-0.013469265831569006
6256,521.422133,521.430133,1,15642663,15642903,240,0.024513988707085307
6257,521.451367,521.4557,1,15643541,15643671,130,
6258,521.4577,521.461033,1,15643731,15643830,99,
6259,521.463067,521.467267,1,15643892,15644018,126,0.18512593418981832
6260,521.6242,521.642533,1,15648726,15649275,549,0.6684540611165903
6261,521.662233,521.669133,1,15649866,15650073,207,-0.05895594989120131
6262,522.3228,522.360567,1,15669684,15670817,1133,0.5611602919575488
6263,522.3768,522.421267,1,15671304,15672638,1334,0.6281529470456109
6264,522.813933,522.860833,1,15684417,15685824,1407,0.6378937039854526
6265,522.8774,522.945967,1,15686321,15688379,2058,0.5836155447743367
6266,522.954767,523.030533,1,15688643,15690915,2272,0.5778887629140392
6267,523.036733,523.060767,1,15691101,15691823,722,0.6876414093241094
6268,523.064967,523.074867,1,15691949,15692246,297,0.4539013156571004
6269,523.111167,523.157633,1,15693335,15694728,1393,0.14135798042734052
6270,523.1793,523.302533,1,15695379,15699075,3696,0.750445004432366
6271,523.798067,523.8064,1,15713942,15714192,250,0.6178166209269765
6272,523.808833,523.869833,1,15714264,15716094,1830,0.820650683294136
6273,523.8716,523.9278,1,15716147,15717834,1687,0.8147928472620779
6274,523.9348,523.967533,1,15718044,15719025,981,0.8090541915548425
6275,523.971467,524.029233,1,15719144,15720876,1732,0.8302667298009655
6276,524.0459,524.072633,1,15721376,15722178,802,0.6638083778460977
6277,524.102533,524.110567,1,15723075,15723317,242,0.05583708463635237
6278,524.113533,524.127733,1,15723405,15723831,426,0.014957862370612236
6279,524.1297,524.1416,1,15723890,15724248,358,0.083799188608913
6280,524.331033,524.338167,1,15729930,15730145,215,0.2278103465672119
6281,524.346133,524.446467,1,15730383,15733394,3011,0.7255007826477923
6282,524.4594,524.466933,1,15733781,15734007,226,0.2333614753170054
6283,524.468867,524.471933,1,15734066,15734157,91,
6284,524.475367,524.480767,1,15734261,15734423,162,-0.04296930938338845
6285,524.4973,524.5102,1,15734919,15735306,387,-0.016690992470897486
6286,524.762567,524.7701,1,15742877,15743102,225,0.37559837744093433
6287,524.771533,524.9405,1,15743145,15748215,5070,0.7273298867079337
6288,524.9419,525.0059,1,15748257,15750177,1920,0.6658646866712351
6289,525.0101,525.0266,1,15750302,15750798,496,0.7525762183772587
6290,525.036433,525.107833,1,15751092,15753234,2142,0.8024631634756749
6291,525.134167,525.1431,1,15754025,15754293,268,0.1578215780188176
6292,525.624267,525.645333,1,15768728,15769359,631,0.6446567197015504
6293,525.665367,525.691367,1,15769961,15770741,780,0.7747475209264238
6294,525.695467,525.759033,1,15770864,15772770,1906,0.7703862549598266
6295,525.7844,525.8682,1,15773532,15776046,2514,0.743644592598421
6296,525.8714,525.958633,1,15776142,15778758,2616,0.8265462960412678
6297,525.960367,525.9862,1,15778811,15779586,775,0.762805488391196
6298,526.003033,526.048867,1,15780090,15781466,1376,0.6328191485171833
6299,526.051433,526.085433,1,15781542,15782562,1020,0.8124434866373192
6300,526.117467,526.1256,1,15783524,15783767,243,0.10198436780801395
6301,526.127533,526.1319,1,15783825,15783957,132,
6302,526.134233,526.143,1,15784026,15784290,264,-0.05353831591877019
6303,526.148267,526.1525,1,15784448,15784575,127,-0.3011046960808798
6304,526.399867,526.523833,1,15791996,15795714,3718,0.7933335879738004
6305,526.5307,526.7895,1,15795921,15803685,7764,0.7215408888621274
6306,526.8249,526.832567,1,15804746,15804977,231,0.1494719548488287
6307,526.833733,526.8403,1,15805011,15805208,197,
6308,526.877533,526.881933,1,15806325,15806457,132,0.5224062645853524
6309,526.8838,526.978633,1,15806513,15809358,2845,0.8003327718347109
6310,526.996833,527.0028,1,15809904,15810084,180,0.12067837269223464
6311,527.338133,527.349667,1,15820143,15820490,347,0.5717325148355877
6312,527.3544,527.3911,1,15820632,15821733,1101,0.787867663307806
6313,527.413233,527.4313,1,15822396,15822938,542,0.7494662577448019
6314,527.440333,527.464333,1,15823209,15823929,720,0.6204189917741922
6315,527.465933,527.4696,1,15823977,15824088,111,0.5200398671534269
6316,527.4716,527.518633,1,15824147,15825558,1411,0.6312920939337088
6317,527.5388,527.5576,1,15826164,15826728,564,0.7894376932127355
6318,527.5755,527.5884,1,15827265,15827652,387,0.7693197836135023
6319,527.596967,527.614433,1,15827909,15828432,523,0.7086424815847084
6320,527.630033,527.6377,1,15828900,15829131,231,0.46436049827349
6321,527.6444,527.676233,1,15829332,15830286,954,-0.06769299653602749
6322,527.679833,527.7036,1,15830394,15831108,714,-0.01002243463272438
6323,527.758967,527.8346,1,15832769,15835038,2269,0.6910716063296394
6324,527.862867,527.9551,1,15835886,15838653,2767,0.5872320627355267
6325,527.968733,528.009,1,15839061,15840270,1209,0.5813852311364257
6326,528.038667,528.041867,1,15841160,15841256,96,0.272935197848043
6327,528.053233,528.077133,1,15841596,15842313,717,0.5399352733119932
6328,528.094,528.097167,1,15842820,15842915,95,0.08782333581852161
6329,528.101,528.185033,1,15843030,15845550,2520,0.6478014359693073
6330,528.2469,528.420533,1,15847407,15852615,5208,0.8394845361612416
6331,528.458733,528.468167,1,15853761,15854045,284,0.9233935898602226
6332,528.469333,528.591567,1,15854079,15857747,3668,0.8238202987535853
6333,528.654067,528.657367,1,15859622,15859721,99,
6334,528.9148,528.919467,1,15867444,15867584,140,0.3865875493813763
6335,528.936867,528.9583,1,15868106,15868749,643,0.7209323175175023
6336,528.980633,529.0047,1,15869418,15870140,722,0.848384159893822
6337,529.0088,529.067333,1,15870263,15872019,1756,0.736034717889365
6338,529.075467,529.131033,1,15872264,15873930,1666,0.7334805247556427
6339,529.152367,529.160133,1,15874571,15874803,232,0.7921765040009685
6340,529.161233,529.192333,1,15874836,15875769,933,0.6874092007328194
6341,529.197533,529.253833,1,15875925,15877614,1689,0.6156264056624996
6342,529.2724,529.301767,1,15878171,15879053,882,0.761751204581955
6343,529.3076,529.3189,1,15879228,15879567,339,0.8165203063366588
6344,529.3288,529.346767,1,15879864,15880403,539,0.7517518925521565
6345,529.364867,529.410567,1,15880946,15882317,1371,-0.006147195907473121
6346,529.414167,529.4213,1,15882425,15882639,214,0.3523355458184787
6347,529.431,529.5389,1,15882930,15886167,3237,0.794941101860512
6348,529.563067,529.6504,1,15886892,15889512,2620,0.7866032495402493
6349,529.739967,529.7446,1,15892199,15892338,139,0.07164363904893635
6350,529.759633,529.864933,1,15892788,15895947,3159,0.8140819357919119
6351,529.874033,529.961467,1,15896220,15898844,2624,0.7768994744713851
6352,529.994833,530.009367,1,15899844,15900281,437,0.3662488534492166
6353,530.0115,530.036667,1,15900344,15901100,756,0.06236655949574352
6354,530.038633,530.048867,1,15901158,15901466,308,0.019291459543280376
6355,530.052867,530.077467,1,15901586,15902324,738,0.9292671144845481
6356,530.079333,530.162767,1,15902379,15904883,2504,0.7073917296010024
6357,530.579433,530.5855,1,15917382,15917565,183,0.6786632000679309
6358,530.5939,530.645067,1,15917816,15919352,1536,0.4851457733228681
6359,530.6603,530.674967,1,15919809,15920249,440,0.5154180275195044
6360,530.703167,530.7199,1,15921095,15921597,502,0.35760990498504697
6361,530.742933,530.765067,1,15922287,15922952,665,0.4156762595305423
6362,530.773867,530.856133,1,15923216,15925683,2467,0.8083591338457594
6363,531.111467,531.218067,1,15933344,15936542,3198,0.8258319765022061
6364,531.2242,531.258033,1,15936726,15937740,1014,0.7873224955712709
6365,531.271833,531.2789,1,15938154,15938367,213,-0.11480060648525056
6366,531.280567,531.3108,1,15938417,15939324,907,0.18624031579759104
6367,531.3131,531.328433,1,15939392,15939852,460,-0.002146197964989742
6368,531.3561,531.467333,1,15940683,15944019,3336,0.8131929604372208
6369,531.480667,531.4882,1,15944420,15944646,226,-0.06962453226800167
6370,531.495267,531.5006,1,15944858,15945017,159,-0.08471782593213736
6371,531.503133,531.532167,1,15945093,15945965,872,-0.011584741396873917
6372,531.545133,531.742467,1,15946353,15952274,5921,0.7737193866657027
6373,531.745067,531.7498,1,15952352,15952494,142,0.42230088344993005
6374,532.0716,532.077333,1,15962148,15962319,171,0.5427501976465336
6375,532.079133,532.085933,1,15962373,15962577,204,0.6329107970803757
6376,532.092033,532.200967,1,15962760,15966029,3269,0.765303952944487
6377,532.217367,532.291133,1,15966521,15968733,2212,0.8037214086543375
6378,532.292633,532.301167,1,15968778,15969035,257,0.7376683782054073
6379,532.307633,532.378,1,15969228,15971340,2112,0.8162307578475849
6380,532.38,532.385933,1,15971400,15971577,177,0.14851376857990495
6381,532.3897,532.413567,1,15971690,15972407,717,0.5779500496140668
6382,532.431567,532.438267,1,15972947,15973148,201,0.25327520945326615
6383,532.441767,532.465833,1,15973253,15973974,721,0.04608050283084676
6384,532.467733,532.480067,1,15974031,15974402,371,-0.2519747024891283
6385,532.503833,532.6649,1,15975114,15979947,4833,0.8436219797068641
6386,532.667667,532.713733,1,15980030,15981411,1381,0.8129755610342844
6387,532.737433,532.7624,1,15982122,15982871,749,0.7642641308137748
6388,532.767467,532.8219,1,15983024,15984657,1633,0.6101172416351758
6389,532.833267,532.8683,1,15984998,15986049,1051,0.7158278713844131
6390,532.900833,532.923967,1,15987024,15987719,695,0.12365508818655077
6391,532.949633,533.202767,1,15988488,15996083,7595,0.48534391465929694
6392,533.230267,533.326667,1,15996908,15999800,2892,0.7618605926721791
6393,533.327833,533.3519,1,15999834,16000557,723,0.45836685508208874
6394,533.3545,533.435633,1,16000635,16003068,2433,0.784118400252369
6395,533.4396,533.4619,1,16003188,16003857,669,0.6861416860886685
6396,533.465,533.540267,1,16003950,16006208,2258,0.5625547811856635
6397,533.543067,533.5544,1,16006292,16006632,340,0.8419221021561307
6398,533.5554,533.5807,1,16006661,16007421,760,0.7429067667510644
6399,533.584933,533.662767,1,16007547,16009883,2336,0.8213863235369321
6400,533.664733,533.7048,1,16009941,16011144,1203,0.7825040457050199
6401,533.707967,533.800133,1,16011239,16014003,2764,0.8411413964502606
6402,533.8034,533.823833,1,16014102,16014714,612,0.7714989799933386
6403,533.833067,533.8866,1,16014992,16016598,1606,0.7925972961741118
6404,533.8891,533.920867,1,16016673,16017626,953,0.8288141373403916
6405,533.923367,533.927567,1,16017701,16017827,126,0.19002606503770608
6406,533.954067,533.9901,1,16018622,16019703,1081,0.7905788663189024
6407,533.991333,534.010833,1,16019739,16020324,585,0.7493422701080243
6408,534.023233,534.041033,1,16020696,16021230,534,0.797164879105782
6409,534.046767,534.051933,1,16021403,16021557,154,0.58238601201464
6410,534.0771,534.1141,1,16022313,16023423,1110,0.825015633886566
6411,534.115833,534.131567,1,16023474,16023947,473,0.8052673913860424
6412,534.140467,534.1644,1,16024214,16024932,718,0.8518687567803408
6413,534.1707,534.174633,1,16025121,16025238,117,0.18792011933682481
6414,534.179967,534.185,1,16025399,16025549,150,-0.37412251100105226
6415,534.2018,534.2553,1,16026054,16027659,1605,0.7873455287813902
6416,534.280567,534.290333,1,16028417,16028709,292,0.6841513355020548
6417,534.295167,534.298367,1,16028855,16028951,96,0.40641327471393285
6418,534.326567,534.3313,1,16029797,16029939,142,0.5970992709253583
6419,534.3432,534.382967,1,16030296,16031489,1193,0.7551500352645864
6420,534.3888,534.391967,1,16031663,16031759,96,0.8015432012949468
6421,534.407033,534.420133,1,16032210,16032603,393,0.4004809081902745
6422,534.431967,534.4356,1,16032959,16033068,109,0.43694152150765353
6423,534.445,534.448,1,16033350,16033440,90,0.5010883673607677
6424,534.450867,534.458667,1,16033526,16033760,234,-0.12988094990392487
6425,534.475567,534.480933,1,16034267,16034427,160,-0.26996126003466586
6426,534.504467,534.5157,1,16035134,16035471,337,0.3342105807546517
6427,534.519667,534.523133,1,16035590,16035693,103,
6428,534.5284,534.6176,1,16035852,16038528,2676,0.7898702969137602
6429,534.633367,534.6401,1,16039001,16039202,201,-0.012338334294973736
6430,534.783167,534.8026,1,16043495,16044078,583,0.9069394765137831
6431,534.803867,534.907533,1,16044116,16047225,3109,0.8186018974066044
6432,535.338733,535.3455,1,16060161,16060365,204,0.7194673210882003
6433,535.350567,535.3694,1,16060517,16061082,565,0.4053589388064738
6434,535.3949,535.4125,1,16061847,16062375,528,0.612478153008532
6435,535.419967,535.4231,1,16062599,16062693,94,0.5947046329932192
6436,535.682967,535.735167,1,16070489,16072055,1566,0.7001052800783367
6437,535.740933,535.790967,1,16072227,16073729,1502,0.7640847138452915
6438,535.802567,535.808567,1,16074077,16074257,180,-0.0713412304822984
6439,535.8306,535.840633,1,16074918,16075218,300,-0.05660052967636031
6440,535.855833,535.859133,1,16075674,16075773,99,0.1919609664140504
6441,535.862533,535.869633,1,16075875,16076088,213,-0.08690410764379429
6442,536.0029,536.013033,1,16080086,16080390,304,-0.04025373730468166
6443,536.019267,536.134533,1,16080578,16084035,3457,0.8658541968984306
6444,536.1384,536.143333,1,16084152,16084299,147,0.1704238154283072
6445,536.145433,536.152567,1,16084362,16084577,215,-0.010419644496679063
6446,536.4482,536.461667,1,16093446,16093850,404,0.676349400580699
6447,536.466,536.535533,1,16093980,16096065,2085,0.6004046171563752
6448,536.5529,536.616533,1,16096587,16098495,1908,0.6520087450330886
6449,536.621867,536.6379,1,16098656,16099136,480,0.6571245001079075
6450,536.639767,536.695167,1,16099193,16100855,1662,0.6482816175397276
6451,536.705233,536.728467,1,16101156,16101854,698,0.5689590104217855
6452,536.736,536.744067,1,16102080,16102322,242,0.636080764613811
6453,536.757,536.7607,1,16102709,16102821,112,0.5363923221112568
6454,536.767733,536.831567,1,16103031,16104947,1916,0.5634760911941992
6455,536.8327,536.840267,1,16104981,16105208,227,0.38598291576374505
6456,536.8436,537.009667,1,16105308,16110290,4982,0.7933351829777066
6457,537.019733,537.078733,1,16110591,16112361,1770,0.8275601625630308
6458,537.114333,537.117567,1,16113429,16113527,98,
6459,537.1296,537.133,1,16113888,16113990,102,
6460,537.164133,537.167633,1,16114923,16115028,105,
6461,537.177733,537.292033,1,16115331,16118760,3429,0.7873141916646009
6462,537.3021,537.310233,1,16119063,16119306,243,0.6302660730887426
6463,537.314733,537.325633,1,16119441,16119768,327,0.6679761555880035
6464,537.3269,537.330533,1,16119807,16119915,108,0.6991705464180381
6465,537.3347,537.351733,1,16120041,16120551,510,-0.002699287786957272
6466,537.357967,537.361233,1,16120739,16120836,97,
6467,537.370233,537.457,1,16121106,16123710,2604,0.8079857591403324
6468,537.4584,537.582433,1,16123752,16127472,3720,0.849012509569526
6469,537.5992,537.602933,1,16127976,16128087,111,-0.017241043136825892
6470,537.616567,537.628667,1,16128497,16128860,363,-0.05537789121483651
6471,537.630467,537.6341,1,16128914,16129023,109,-0.0006457088408942976
6472,537.6354,537.6397,1,16129062,16129190,128,-0.07266882736395852
6473,537.642967,537.652833,1,16129289,16129584,295,-0.037066987442233974
6474,537.659533,537.663167,1,16129785,16129895,110,
6475,537.6704,537.784333,1,16130112,16133529,3417,0.7841299552681134
6476,537.796233,537.804433,1,16133886,16134132,246,0.25653628980717
6477,537.8262,537.834067,1,16134786,16135022,236,0.06473112438598032
6478,538.1186,538.158233,1,16143558,16144746,1188,0.7955004475764546
6479,538.169533,538.187267,1,16145085,16145618,533,0.5871907845577774
6480,538.1894,538.193033,1,16145682,16145790,108,0.37887793350186677
6481,538.1965,538.202267,1,16145895,16146068,173,0.4579165573483783
6482,538.246867,538.2792,1,16147406,16148375,969,0.5823248668649018
6483,538.2953,538.3114,1,16148859,16149342,483,0.4855009398263959
6484,538.357833,538.375733,1,16150734,16151271,537,0.6099921430165827
6485,538.3797,538.400067,1,16151390,16152002,612,0.5554653576937368
6486,538.413567,538.418067,1,16152407,16152542,135,0.4095643626479573
6487,538.4536,538.4816,1,16153608,16154447,839,0.0282760787369468
6488,538.483167,538.498567,1,16154495,16154957,462,0.20656191902716972
6489,538.511267,538.517533,1,16155338,16155525,187,0.3315756410613973
6490,538.518567,538.593167,1,16155557,16157795,2238,0.8166478567208912
6491,538.600733,538.692733,1,16158021,16160781,2760,0.7944734056915611
6492,538.7147,538.7397,1,16161441,16162191,750,0.75719869205565
6493,538.7434,538.752333,1,16162301,16162569,268,0.44255208856342204
6494,538.753433,538.950033,1,16162602,16168500,5898,0.7636552113052106
6495,538.976533,538.9815,1,16169295,16169445,150,-0.03824412614336868
6496,538.991467,538.9978,1,16169744,16169934,190,-0.20227096902589203
6497,539.262033,539.267067,1,16177860,16178012,152,0.7910475617777869
6498,539.268667,539.296833,1,16178060,16178904,844,0.6733379852452563
6499,539.310967,539.317033,1,16179329,16179510,181,0.42350506610265576
6500,539.338733,539.362933,1,16180161,16180887,726,0.9349558408320314
6501,539.364033,539.4196,1,16180920,16182587,1667,0.7877360703175168
6502,539.424133,539.499533,1,16182723,16184985,2262,0.7885498460456548
6503,539.5014,539.576867,1,16185042,16187306,2264,0.7212431542458655
6504,539.580533,539.686033,1,16187415,16190580,3165,0.8162191841228702
6505,539.687033,539.701467,1,16190610,16191044,434,0.5237748874267469
6506,539.712233,539.727233,1,16191366,16191816,450,-0.10856591867501367
6507,539.7299,540.001533,1,16191897,16200045,8148,0.2113646506752573
6508,540.028167,540.102733,1,16200845,16203081,2236,0.7879722076965021
6509,540.1326,540.154767,1,16203978,16204643,665,0.7944033906609866
6510,540.1584,540.165767,1,16204752,16204973,221,0.31609378687729284
6511,540.167,540.210067,1,16205010,16206302,1292,0.7766648523373706
6512,540.214367,540.2319,1,16206431,16206957,526,0.6496338462340226
6513,540.235367,540.2593,1,16207061,16207779,718,0.8076796385343182
6514,540.261467,540.2694,1,16207844,16208082,238,0.7704523663212988
6515,540.276533,540.347033,1,16208295,16210410,2115,0.7872222565876594
6516,540.3481,540.373367,1,16210443,16211201,758,0.6477232428011442
6517,540.376033,540.4694,1,16211280,16214081,2801,0.8151763064237021
6518,540.470933,540.4972,1,16214127,16214916,789,0.8244660372539986
6519,540.500567,540.5776,1,16215017,16217327,2310,0.8073766068891952
6520,540.58,540.5921,1,16217400,16217762,362,0.9118878702349291
6521,540.595167,540.613967,1,16217855,16218419,564,0.8173947258471385
6522,540.615733,540.620033,1,16218471,16218600,129,0.8903139440640798
6523,540.623833,540.716633,1,16218714,16221498,2784,0.8573355473313584
6524,540.718333,540.7455,1,16221549,16222365,816,0.6878747871581021
6525,540.747667,540.842533,1,16222430,16225275,2845,0.8628454649634497
6526,540.844633,540.85,1,16225338,16225500,162,0.6554718342289125
6527,540.851667,540.873267,1,16225550,16226198,648,0.8967307478582435
6528,540.876,540.971933,1,16226280,16229157,2877,0.8428068755025163
6529,540.9733,540.9995,1,16229199,16229985,786,0.8555498607830924
6530,541.0026,541.0984,1,16230078,16232952,2874,0.8771811579017132
6531,541.101167,541.127933,1,16233035,16233837,802,0.8945061268242918
6532,541.130967,541.2317,1,16233929,16236951,3022,0.8373652006758183
6533,541.233367,541.255167,1,16237001,16237655,654,0.9153922537334047
6534,541.261733,541.355833,1,16237851,16240674,2823,0.8070824829057225
6535,541.3596,541.374833,1,16240788,16241244,456,0.5716704228723921
6536,541.388767,541.429333,1,16241663,16242879,1216,0.8081810998912845
6537,541.430967,541.445833,1,16242929,16243374,445,0.8003376523092205
6538,541.451267,541.455433,1,16243538,16243662,124,-0.08338222229724485
6539,541.472,541.480267,1,16244160,16244408,248,0.75662804035739
6540,541.484833,541.489367,1,16244544,16244681,137,0.49613726870718333
6541,541.494967,541.5006,1,16244849,16245017,168,0.8229988745469723
6542,541.5165,541.572367,1,16245494,16247171,1677,0.7924382521163924
6543,541.574967,541.5838,1,16247249,16247514,265,0.22723948093991592
6544,541.598,541.631867,1,16247939,16248956,1017,0.5173638131687244
6545,541.643933,541.6829,1,16249317,16250487,1170,0.7426994304672354
6546,541.6859,541.7027,1,16250576,16251081,505,0.8032769302364491
6547,541.708767,541.7351,1,16251263,16252053,790,0.7646375019800904
6548,541.736433,541.7437,1,16252092,16252311,219,-0.06951907552243716
6549,541.751667,541.807267,1,16252550,16254218,1668,0.4609158538430062
6550,541.8087,541.828033,1,16254261,16254840,579,0.6086255709129648
6551,542.386433,542.395033,1,16271592,16271850,258,0.25738691886579
6552,542.484967,542.512867,1,16274549,16275386,837,0.6796857450268208
6553,542.537633,542.554667,1,16276128,16276640,512,0.8068446757634484
6554,542.556167,542.594233,1,16276685,16277826,1141,0.7685283004320984
6555,542.619533,542.633,1,16278585,16278990,405,0.6834721360516082
6556,542.637833,542.643667,1,16279134,16279310,176,0.5042028743465449
6557,542.653567,542.6611,1,16279607,16279833,226,0.7968562941805593
6558,542.699133,542.7202,1,16280973,16281606,633,0.6162945450787644
6559,542.741867,542.745633,1,16282256,16282368,112,0.6332142067108202
6560,542.7534,542.759233,1,16282602,16282776,174,0.48068109186873925
6561,542.769833,542.783567,1,16283094,16283507,413,0.4444414518711073
6562,542.803033,542.824967,1,16284090,16284749,659,0.5285393860066014
6563,542.826833,542.835133,1,16284804,16285053,249,-0.16374630577355856
6564,542.866667,542.871667,1,16286000,16286150,150,0.5726941252997996
6565,542.8752,542.8867,1,16286255,16286601,346,0.5365035724730581
6566,542.909033,542.9182,1,16287270,16287545,275,0.5237049122572278
6567,542.925167,542.9351,1,16287755,16288053,298,0.5197293953919315
6568,543.063467,543.072667,1,16291904,16292180,276,0.6196639383684607
6569,543.087133,543.1893,1,16292613,16295679,3066,0.8402911715324043
6570,543.223633,543.242067,1,16296708,16297262,554,0.0716118371909561
6571,543.247367,543.2636,1,16297421,16297908,487,-0.029408910065127854
6572,543.267,543.276967,1,16298010,16298309,299,-0.002849158394450963
6573,543.280633,543.2863,1,16298418,16298589,171,-0.1543059508411183
6574,543.340933,543.3453,1,16300227,16300358,131,0.06376974651459255
6575,543.3744,543.5742,1,16301232,16307226,5994,0.8060759029864133
6576,543.598867,543.617,1,16307966,16308509,543,0.7274503374675323
6577,543.6186,543.628467,1,16308558,16308854,296,0.05192195589019571
6578,543.6702,543.675167,1,16310106,16310255,149,-0.02304843274386125
6579,543.677167,543.680433,1,16310315,16310412,97,0.02650472086124756
6580,543.800533,543.8065,1,16314015,16314195,180,0.6279428884651208
6581,543.8312,543.9702,1,16314935,16319106,4171,0.8339084274571229
6582,544.002567,544.0823,1,16320077,16322469,2392,0.7921378102484935
6583,544.093333,544.0989,1,16322799,16322966,167,-0.060191072819952285
6584,544.122967,544.137167,1,16323689,16324115,426,0.09169339071271657
6585,544.1387,544.172167,1,16324161,16325165,1004,-0.018211001938064596
6586,544.1801,544.189467,1,16325403,16325684,281,0.05176503173905833
6587,544.191633,544.196033,1,16325748,16325880,132,0.3293504483927131
6588,544.2107,544.219767,1,16326321,16326593,272,0.52776417441402
6589,544.2225,544.255967,1,16326674,16327679,1005,0.40890587969690034
6590,544.3593,544.365033,1,16330778,16330950,172,0.0659227909891315
6591,544.372967,544.423367,1,16331189,16332701,1512,0.8345916997580651
6592,544.426333,544.600167,1,16332789,16338005,5216,0.8453862698045841
6593,544.605367,544.619933,1,16338161,16338597,436,0.7410316334777193
6594,544.624267,544.639667,1,16338728,16339190,462,0.5841808087314959
6595,544.664733,544.673033,1,16339941,16340190,249,0.3564018627869991
6596,544.674367,544.6784,1,16340231,16340352,121,0.5681787998507896
6597,544.6947,544.7075,1,16340841,16341225,384,-0.07109818851504787
6598,544.716467,544.7256,1,16341494,16341768,274,0.09911855453224167
6599,544.731833,544.738267,1,16341954,16342148,194,-0.04841027193996634
6600,544.772933,544.825967,1,16343187,16344779,1592,-0.18239361861120967
6601,544.837633,544.8411,1,16345128,16345233,105,0.49591613730236156
6602,544.8422,544.867833,1,16345266,16346034,768,-0.012723729261059582
6603,544.898767,545.028033,1,16346963,16350840,3877,0.8007600034612024
6604,545.162833,545.170067,1,16354884,16355102,218,0.41788997810059586
6605,545.175833,545.186333,1,16355274,16355589,315,0.13589567068039382
6606,545.191567,545.2151,1,16355747,16356453,706,0.004602342052527956
6607,545.2255,545.240767,1,16356765,16357223,458,-0.029238468787622176
6608,545.2422,545.2528,1,16357266,16357584,318,0.11126491568825014
6609,545.2554,545.261233,1,16357662,16357836,174,0.6090446380948271
6610,545.268133,545.380433,1,16358043,16361412,3369,0.7642750499708792
6611,545.381733,545.454567,1,16361451,16363637,2186,0.81241501159178
6612,545.476067,545.499033,1,16364282,16364970,688,0.7857045356259397
6613,545.502067,545.546733,1,16365062,16366401,1339,0.7558983296854183
6614,545.5501,545.587567,1,16366503,16367627,1124,0.7994034905990991
6615,545.600733,545.646333,1,16368021,16369389,1368,0.7733244986631486
6616,545.648467,545.669033,1,16369454,16370070,616,0.7045143139239096
6617,545.690867,545.710133,1,16370726,16371303,577,0.17572156524014057
6618,545.7192,545.7681,1,16371576,16373043,1467,0.12680607824379944
6619,545.7702,545.7832,1,16373106,16373495,389,-0.01760443325536331
6620,545.830633,545.837467,1,16374918,16375124,206,0.5942389142195964
6621,545.838467,545.845133,1,16375154,16375353,199,0.2275340367882726
6622,545.851267,545.864433,1,16375538,16375932,394,-0.00012139945073653059
6623,545.889433,545.898267,1,16376682,16376948,266,0.44328377908388333
6624,545.942967,545.9477,1,16378289,16378431,142,-0.04001731397450644
6625,545.955733,545.964967,1,16378671,16378949,278,0.1360826935089728
6626,545.966467,545.9706,1,16378994,16379118,124,-0.114452251687919
6627,546.0294,546.159433,1,16380882,16384782,3900,0.3987712287806445
6628,546.167867,546.269733,1,16385036,16388091,3055,0.7902393892505222
6629,546.2738,546.286,1,16388214,16388579,365,0.5767310021710857
6630,546.2877,546.364333,1,16388631,16390929,2298,0.7543740228864011
6631,546.377767,546.389733,1,16391333,16391691,358,-0.05242774622742574
6632,546.455767,546.460333,1,16393673,16393809,136,0.36445645855153663
6633,546.464967,546.561667,1,16393949,16396850,2901,0.8155155483665072
6634,546.582133,546.5873,1,16397463,16397619,156,-0.07728553445819243
6635,546.662367,546.668633,1,16399871,16400058,187,0.3874438691747692
6636,546.671233,546.741467,1,16400136,16402244,2108,0.6637822008175231
6637,546.7425,546.843533,1,16402274,16405305,3031,0.7460085262491966
6638,546.8837,546.908133,1,16406511,16407243,732,0.8283687052435296
6639,546.9103,546.9853,1,16407309,16409559,2250,0.7494607720062699
6640,546.997667,547.0968,1,16409930,16412904,2974,0.7970171326281141
6641,547.1088,547.1154,1,16413264,16413462,198,-0.10452027737119024
6642,547.1181,547.1301,1,16413543,16413903,360,0.030408730883918166
6643,547.133,547.141667,1,16413990,16414250,260,-0.021021265241274505
6644,547.142733,547.160833,1,16414281,16414824,543,-0.004556413453628402
6645,547.187533,547.374533,1,16415625,16421235,5610,0.823068399907572
6646,547.385433,547.390733,1,16421562,16421721,159,0.41690998055473993
6647,547.406367,547.426667,1,16422191,16422800,609,-0.05836192655648758
6648,547.428067,547.436333,1,16422842,16423089,247,-0.019593988964611418
6649,547.438333,547.4555,1,16423149,16423665,516,0.08192565377412629
6650,547.4601,547.4681,1,16423803,16424043,240,0.43056535438096427
6651,547.480833,547.483867,1,16424424,16424516,92,
6652,547.4858,547.6049,1,16424574,16428147,3573,0.8103333629273631
6653,547.621167,547.687833,1,16428635,16430634,1999,0.787178069555367
6654,547.7026,547.7131,1,16431077,16431393,316,0.6395755428753465
6655,547.714767,547.7423,1,16431443,16432269,826,0.8298829309191028
6656,547.753767,547.807267,1,16432613,16434218,1605,-0.013261267773642749
6657,547.82,547.9136,1,16434600,16437408,2808,0.7983093383758738
6658,547.9184,548.034433,1,16437552,16441032,3480,0.8074981945677625
6659,548.050033,548.0542,1,16441500,16441626,126,
6660,548.0583,548.0618,1,16441749,16441853,104,
6661,548.094967,548.098267,1,16442849,16442948,99,0.06040732882903577
6662,548.100033,548.1043,1,16443000,16443128,128,0.3023995677881336
6663,548.107,548.113067,1,16443210,16443392,182,0.3814580823938467
6664,548.168333,548.171467,1,16445049,16445144,95,
6665,548.190267,548.194167,1,16445708,16445825,117,0.7830407803570317
6666,548.211167,548.4796,1,16446335,16454388,8053,0.8152538155441152
6667,548.481833,548.541367,1,16454454,16456241,1787,0.7919354041695746
6668,548.550133,548.565467,1,16456503,16456964,461,0.79367894280396
6669,548.567167,548.583833,1,16457015,16457514,499,0.6212219211897737
6670,548.5935,548.651633,1,16457804,16459548,1744,-0.05522052163841154
6671,548.6798,548.782467,1,16460394,16463474,3080,0.8349876487941745
6672,548.784767,548.7885,1,16463543,16463655,112,0.01673664472072588
6673,548.799233,548.828167,1,16463976,16464845,869,0.08361951286527794
6674,548.843433,548.852067,1,16465302,16465562,260,0.4217589794682209
6675,548.8535,548.979967,1,16465605,16469399,3794,0.8365772259633532
6676,548.993767,549.0205,1,16469813,16470615,802,0.02619938866551368
6677,549.024367,549.0306,1,16470731,16470918,187,-0.2000537893001529
6678,549.031867,549.035467,1,16470956,16471064,108,-0.5080436211098882
6679,549.1082,549.242033,1,16473246,16477260,4014,0.8111080585940826
6680,549.245833,549.342267,1,16477374,16480268,2894,0.8013309189570799
6681,549.358267,549.3769,1,16480748,16481307,559,-0.04379219676849049
6682,549.383433,549.391167,1,16481502,16481735,233,0.18449944357089137
6683,549.393333,549.402233,1,16481799,16482066,267,0.013527844597503013
6684,549.4149,549.418133,1,16482447,16482543,96,-0.06491020792148627
6685,549.423167,549.432,1,16482695,16482960,265,0.4888484339960476
6686,549.437,549.612567,1,16483110,16488377,5267,0.8365607406190647
6687,549.6143,549.6389,1,16488428,16489167,739,0.8197530238964169
6688,549.6413,549.6443,1,16489239,16489329,90,0.24156021983175419
6689,549.6458,549.772233,1,16489374,16493166,3792,0.7164129050940112
6690,549.774033,549.780533,1,16493220,16493415,195,0.7615254451178758
6691,549.791167,549.8216,1,16493735,16494648,913,0.8033219424292298
6692,549.825167,549.917433,1,16494755,16497522,2767,0.8086350305213081
6693,549.923,549.927533,1,16497690,16497825,135,-0.01293920539559752
6694,549.941433,549.952767,1,16498242,16498583,341,0.06157075550440384
6695,549.9539,549.9732,1,16498617,16499196,579,0.059598841074028054
6696,549.979333,549.986067,1,16499379,16499582,203,-0.0863947197842878
6697,550.007633,550.136033,1,16500228,16504080,3852,0.8098443594198135
6698,550.173567,550.181133,1,16505207,16505433,226,0.48308299391717846
6699,550.194867,550.2011,1,16505846,16506033,187,0.03559831694178713
6700,550.419967,550.518567,1,16512599,16515557,2958,0.6370011489960524
6701,550.519567,550.535267,1,16515587,16516058,471,0.03862623127621645
6702,550.560433,550.5778,1,16516812,16517334,522,0.5913747786590147
6703,550.598933,550.611133,1,16517967,16518333,366,0.5967963146935539
6704,550.619167,550.627133,1,16518575,16518813,238,0.654157688413898
6705,550.663533,550.683467,1,16519905,16520504,599,-0.0327331269970002
6706,550.684567,550.702233,1,16520537,16521066,529,-0.07862598825534214
6707,550.713067,550.719133,1,16521392,16521573,181,0.26659175935781326
6708,550.721,550.730633,1,16521630,16521918,288,0.10239539494950305
6709,550.732233,550.818767,1,16521966,16524563,2597,0.7601251877881406
6710,550.820367,550.8695,1,16524611,16526085,1474,0.8311624993507475
6711,550.889767,550.9002,1,16526693,16527006,313,-0.07239864656246144
6712,550.901433,550.908833,1,16527042,16527264,222,-0.0155421875405902
6713,550.9112,550.914333,1,16527336,16527429,93,0.3534652284030654
6714,550.915433,550.925767,1,16527462,16527773,311,-0.007070399124466819
6715,550.944033,550.964367,1,16528320,16528931,611,0.6183455120704866
6716,550.981467,551.0631,1,16529444,16531892,2448,0.8105847556345501
6717,551.085467,551.1781,1,16532564,16535343,2779,0.8298782853599327
6718,551.191467,551.201567,1,16535744,16536047,303,0.2287390519176689
6719,551.284667,551.391933,1,16538540,16541757,3217,0.7440434031376512
6720,551.3951,551.421467,1,16541852,16542644,792,0.7221871531438623
6721,551.425933,551.518467,1,16542777,16545554,2777,0.7839060791704945
6722,551.5214,551.543533,1,16545642,16546305,663,0.6680188196942758
6723,551.5454,551.596267,1,16546362,16547888,1526,0.7386462664960549
6724,551.600133,551.657433,1,16548003,16549722,1719,0.8467973360525883
6725,551.6658,551.697933,1,16549974,16550937,963,0.7381940262929575
6726,551.7185,551.730233,1,16551554,16551906,352,0.008651486942355957
6727,551.732233,551.7567,1,16551966,16552701,735,0.1311741087912528
6728,551.794433,552.023767,1,16553832,16560713,6881,0.8221296757468539
6729,552.0272,552.033367,1,16560816,16561001,185,-0.24828547340989043
6730,552.044133,552.1636,1,16561323,16564908,3585,0.7475685719176355
6731,552.255733,552.374867,1,16567671,16571246,3575,0.7955860095857014
6732,552.395867,552.415233,1,16571876,16572456,580,-0.02824297627700344
6733,552.444233,552.602633,1,16573326,16578078,4752,0.8575349660939577
6734,552.628133,552.6359,1,16578843,16579077,234,-0.029157432241267458
6735,552.6525,552.658667,1,16579575,16579760,185,0.02254920501854184
6736,552.672833,552.677033,1,16580184,16580310,126,-0.062107650567259455
6737,552.8809,552.964733,1,16586427,16588941,2514,0.7588039023099707
6738,552.972033,553.106933,1,16589160,16593207,4047,0.7821967111865626
6739,553.1301,553.203767,1,16593903,16596113,2210,0.06553675943234973
6740,553.247167,553.362367,1,16597415,16600871,3456,0.8065848622017978
6741,553.3696,553.3801,1,16601088,16601403,315,0.5095671533681577
6742,553.384,553.427167,1,16601520,16602815,1295,0.3308257574822748
6743,553.429133,553.457633,1,16602873,16603728,855,0.07244183004053185
6744,553.466467,553.4769,1,16603994,16604307,313,0.4121234972716595
6745,553.488933,553.5455,1,16604667,16606364,1697,0.777690331471238
6746,553.546767,553.5979,1,16606403,16607937,1534,0.8125173486893985
6747,553.602567,553.614167,1,16608077,16608425,348,0.3630879350527814
6748,553.617233,553.6928,1,16608516,16610784,2268,0.14088224665878793
6749,553.6972,553.701833,1,16610915,16611054,139,0.1456944769191796
6750,553.7071,553.916667,1,16611212,16617500,6288,0.820300158101453
6751,553.921933,553.9531,1,16617657,16618592,935,0.6964971709853216
6752,553.967133,554.022233,1,16619013,16620666,1653,0.05215042004435873
6753,554.041433,554.046467,1,16621242,16621394,152,0.027953850714216674
6754,554.049133,554.255267,1,16621473,16627658,6185,0.8515527514208893
6755,554.2572,554.344333,1,16627716,16630329,2613,0.7506939443804359
6756,554.369867,554.3842,1,16631096,16631525,429,0.43627466428789063
6757,554.390967,554.453433,1,16631729,16633602,1873,0.07971750677341892
6758,554.4567,554.699367,1,16633700,16640981,7281,0.8004237706022168
6759,554.701733,554.704867,1,16641051,16641146,95,-0.35369715767399484
6760,554.706567,554.781533,1,16641197,16643445,2248,0.41778432900445317
6761,554.785967,554.803533,1,16643579,16644105,526,0.7790841223595466
6762,554.8098,554.8571,1,16644294,16645712,1418,0.7071073261212147
6763,554.863367,554.869633,1,16645901,16646088,187,0.17120866299489562
6764,554.911133,554.919467,1,16647333,16647584,251,0.3272364224614812
6765,554.924333,554.931333,1,16647729,16647939,210,0.7263938094331149
6766,554.933667,554.954033,1,16648010,16648620,610,0.1331075644831241
6767,554.955533,554.9755,1,16648665,16649265,600,0.1076420049445812
6768,554.976733,554.987467,1,16649301,16649624,323,0.0030385137320604635
6769,555.006967,555.1227,1,16650209,16653681,3472,0.8132565179957316
6770,555.130233,555.141733,1,16653906,16654251,345,0.4964921969755336
6771,555.148,555.1875,1,16654440,16655625,1185,0.16378617417388924
6772,555.189067,555.219267,1,16655672,16656578,906,0.058572281038417044
6773,555.2429,555.438,1,16657286,16663140,5854,0.8028782557367854
6774,555.439,555.476467,1,16663169,16664294,1125,0.6735800734668073
6775,555.499767,555.560633,1,16664993,16666818,1825,0.7719005182932478
6776,555.567233,555.585067,1,16667016,16667552,536,0.7664344615420873
6777,555.5873,555.6176,1,16667619,16668528,909,0.5632276237741156
6778,555.618967,555.675667,1,16668569,16670270,1701,0.34887986360942547
6779,555.685733,555.844233,1,16670571,16675326,4755,0.8512203727120619
6780,555.8486,555.9149,1,16675458,16677447,1989,-0.01995349675791447
6781,555.939367,555.943967,1,16678181,16678319,138,0.5729594067295192
6782,555.9533,556.0652,1,16678599,16681956,3357,0.7943731664679606
6783,556.074067,556.134167,1,16682222,16684025,1803,0.174505312916563
6784,556.135233,556.151867,1,16684056,16684556,500,-0.08798860519740523
6785,556.155633,556.1589,1,16684668,16684767,99,
6786,556.174167,556.180967,1,16685225,16685429,204,-0.23826964017781752
6787,556.187167,556.300867,1,16685615,16689026,3411,0.8094991737579642
6788,556.317067,556.3271,1,16689512,16689813,301,0.04565451662871563
6789,556.332367,556.342333,1,16689971,16690269,298,-0.13014156559092044
6790,556.3442,556.4029,1,16690326,16692087,1761,0.037235367923446006
6791,556.408367,556.546433,1,16692251,16696392,4141,0.8281103506569185
6792,556.5498,556.6061,1,16696494,16698183,1689,0.7856974437313289
6793,556.6082,556.6294,1,16698246,16698882,636,0.7951695260934949
6794,556.6353,556.6649,1,16699059,16699947,888,0.8615854229674013
6795,556.670867,556.6999,1,16700126,16700996,870,-0.031296181667414984
6796,556.702667,557.1038,1,16701080,16713114,12034,0.43370042313446944
6797,557.1165,557.266267,1,16713495,16717988,4493,0.8343274581137066
6798,557.268,557.282967,1,16718040,16718489,449,0.08581873445224576
6799,557.289267,557.465833,1,16718678,16723974,5296,0.74259317288432
6800,557.485567,557.4975,1,16724567,16724924,357,0.5210941499861038
6801,557.5036,557.550967,1,16725108,16726529,1421,0.3520386307858604
6802,557.5549,557.569867,1,16726647,16727096,449,-0.12162625632580533
6803,557.580667,557.714267,1,16727420,16731428,4008,0.8211824380287923
6804,557.716033,557.825433,1,16731480,16734762,3282,0.849935016798916
6805,557.8363,557.902167,1,16735089,16737065,1976,0.3937142496959414
6806,557.908667,557.926933,1,16737260,16737807,547,0.2532013570427054
6807,557.9295,557.941967,1,16737884,16738259,375,0.05709051306458218
6808,557.951967,557.978567,1,16738559,16739357,798,-0.02964688617419996
6809,557.981133,557.9889,1,16739433,16739666,233,-0.20179723993676238
6810,557.991,558.002367,1,16739730,16740071,341,0.03711298989522703
6811,558.0035,558.013567,1,16740105,16740407,302,0.06603793220561929
6812,558.060933,558.2269,1,16741827,16746807,4980,0.8312637605987859
6813,558.233767,558.265967,1,16747013,16747979,966,0.7775930168445987
6814,558.2713,558.2773,1,16748139,16748318,179,-0.4993372928355749
6815,558.281767,558.312533,1,16748453,16749375,922,0.056227800622849065
6816,558.315533,558.333367,1,16749465,16750001,536,0.05483158493675612
6817,558.370533,558.388,1,16751115,16751640,525,0.7725101433292867
6818,558.3897,558.4891,1,16751690,16754673,2983,0.8334089515727227
6819,558.4996,558.509767,1,16754988,16755293,305,0.4379244250305559
6820,558.517133,558.567067,1,16755513,16757012,1499,0.2371759413494074
6821,558.568533,558.5831,1,16757055,16757492,437,-0.06219206910518584
6822,558.605367,558.608867,1,16758161,16758266,105,0.13136888323276413
6823,558.6115,558.6927,1,16758345,16760780,2435,0.7960836647393051
6824,558.7055,558.733,1,16761165,16761989,824,0.839195602243924
6825,558.7414,558.751633,1,16762242,16762548,306,0.3234953347113688
6826,558.758533,558.763567,1,16762755,16762907,152,0.8969244095789416
6827,558.766833,558.8238,1,16763004,16764714,1710,0.0678564537970217
6828,558.8251,558.829267,1,16764753,16764878,125,0.3557334381591681
6829,558.8307,558.834467,1,16764921,16765034,113,
6830,558.860633,558.984233,1,16765818,16769526,3708,0.8326737624968802
6831,559.0008,559.0131,1,16770024,16770393,369,0.3406757690072969
6832,559.024667,559.0523,1,16770740,16771568,828,0.05219636067476585
6833,559.055433,559.066567,1,16771662,16771997,335,0.20059688512161467
6834,559.074267,559.0872,1,16772228,16772616,388,-0.06843437903929253
6835,559.103733,559.155767,1,16773111,16774673,1562,0.2205712888445472
6836,559.163933,559.180967,1,16774917,16775429,512,0.016304649139334545
6837,559.182267,559.194533,1,16775468,16775835,367,0.13974217941574146
6838,559.197933,559.206967,1,16775937,16776209,272,0.31967300972046303
6839,559.208367,559.211767,1,16776251,16776353,102,0.17755816085443232
6840,559.239867,559.397333,1,16777196,16781919,4723,0.7979444908028557
6841,559.408,559.510667,1,16782240,16785320,3080,0.7342788181481743
6842,559.518233,559.584467,1,16785546,16787534,1988,0.8015681894724564
6843,559.586633,559.590633,1,16787598,16787718,120,0.11582964003333646
6844,559.603833,559.6288,1,16788114,16788864,750,0.7755722352283269
6845,559.6442,559.6566,1,16789326,16789698,372,0.45012178943510156
6846,559.661133,559.6782,1,16789833,16790346,513,0.07716304219475624
6847,559.6793,559.703867,1,16790379,16791116,737,0.0460112738317767
6848,559.7058,559.717967,1,16791174,16791539,365,-0.08632364629705544
6849,559.737833,560.0482,1,16792134,16801446,9312,0.7444558499892715
6850,560.149267,560.1554,1,16804478,16804662,184,0.19502188399949397
6851,560.156667,560.352333,1,16804700,16810569,5869,0.7165561804556787
6852,560.3541,560.369167,1,16810623,16811075,452,0.5881967464088987
6853,560.379467,560.450333,1,16811384,16813509,2125,0.8407950633624451
6854,560.4545,560.541367,1,16813635,16816241,2606,0.7047202653204186
6855,560.544333,560.560933,1,16816329,16816827,498,0.7658067330591914
6856,560.562133,560.688567,1,16816863,16820657,3794,0.8248381864741066
6857,560.6917,560.696033,1,16820751,16820880,129,0.3101157144395674
6858,560.700533,560.708367,1,16821015,16821251,236,-0.05806869685199854
6859,560.712533,560.721733,1,16821375,16821651,276,0.022827313614750388
6860,560.725067,560.7349,1,16821752,16822047,295,-0.06327153306867779
6861,560.7378,560.746733,1,16822134,16822401,267,0.10382159190416133
6862,560.752267,560.7624,1,16822568,16822872,304,0.07565186458472856
6863,560.784933,560.790067,1,16823547,16823702,155,0.44268288579350257
6864,560.792033,560.9543,1,16823760,16828629,4869,0.8370913309879919
6865,560.970633,560.986933,1,16829118,16829607,489,0.7517784570424367
6866,560.987933,561.094933,1,16829637,16832847,3210,0.8313501132956048
6867,561.100133,561.2712,1,16833003,16838136,5133,0.7193488927612807
6868,561.277133,561.3251,1,16838313,16839753,1440,0.7828783180716626
6869,561.328533,561.335033,1,16839855,16840050,195,0.7735317814034123
6870,561.3395,561.407767,1,16840185,16842233,2048,0.7608803825919269
6871,561.4256,561.429567,1,16842768,16842887,119,-0.046757944003983136
6872,561.431067,561.4415,1,16842932,16843245,313,0.0788333500712863
6873,561.446867,561.449867,1,16843406,16843496,90,0.2557327521025229
6874,561.5084,561.513167,1,16845252,16845395,143,0.3101756261974712
6875,561.5173,561.6627,1,16845519,16849881,4362,0.7847926434222477
6876,561.6641,561.7361,1,16849923,16852083,2160,0.8048787943669232
6877,561.743133,561.8293,1,16852293,16854879,2586,0.798792194342219
6878,561.841967,561.873367,1,16855259,16856201,942,-0.03161062236681951
6879,561.8759,561.8861,1,16856277,16856583,306,0.045115858034665515
6880,561.902667,562.099233,1,16857080,16862976,5896,0.8048280879674733
6881,562.118933,562.128333,1,16863567,16863849,282,-0.009731377123664182
6882,562.152967,562.1575,1,16864589,16864725,136,0.01756474872096435
6883,562.2135,562.264533,1,16866405,16867935,1530,0.8276708298208618
6884,562.266033,562.271167,1,16867980,16868135,155,0.17959287547516786
6885,562.272233,562.3265,1,16868166,16869795,1629,0.7571975791271357
6886,562.343467,562.348867,1,16870304,16870466,162,0.010306299178237274
6887,562.351067,562.391967,1,16870532,16871759,1227,0.17414704462912986
6888,562.3939,562.4053,1,16871817,16872159,342,0.0692009311762646
6889,562.4063,562.415033,1,16872189,16872450,261,-0.06848809170831861
6890,562.422733,562.4265,1,16872681,16872795,114,
6891,562.433733,562.664167,1,16873011,16879925,6914,0.8089066894420223
6892,562.6707,562.703567,1,16880121,16881107,986,0.5676695674496586
6893,562.7125,562.716633,1,16881375,16881498,123,-0.003162070311499627
6894,562.7204,562.7416,1,16881612,16882248,636,0.18554143424469882
6895,562.7427,562.773,1,16882281,16883190,909,0.03025022122354943
6896,562.808433,562.932267,1,16884252,16887968,3716,0.8303451294770489
6897,562.933267,563.054967,1,16887998,16891649,3651,0.8206166631090366
6898,563.058733,563.1312,1,16891761,16893936,2175,0.5772521197345762
6899,563.149333,563.153867,1,16894479,16894616,137,0.8263102990766504
6900,563.1855,563.2965,1,16895565,16898895,3330,0.8475247529198302
6901,563.2994,563.305467,1,16898982,16899164,182,-0.4584606591550202
6902,563.306667,563.381633,1,16899200,16901448,2248,0.47088436757418645
6903,563.3981,563.5158,1,16901943,16905474,3531,0.8202646575074178
6904,563.518033,563.533867,1,16905540,16906016,476,0.5456478140268987
6905,563.5395,563.603133,1,16906185,16908093,1908,0.12546835239396537
6906,563.611167,563.616067,1,16908335,16908482,147,0.5972345322602386
6907,563.619467,563.627567,1,16908584,16908827,243,0.6283627190329428
6908,563.6368,563.696333,1,16909104,16910889,1785,0.7981730067985457
6909,563.6984,563.7526,1,16910952,16912578,1626,0.8409282057844801
6910,563.7602,563.785233,1,16912806,16913556,750,0.07313321352280445
6911,563.7891,563.7983,1,16913673,16913949,276,0.24424727725047463
6912,563.805067,563.811667,1,16914152,16914350,198,0.11794308468981131
6913,563.827267,563.831333,1,16914818,16914939,121,0.05078695664181911
6914,563.841667,563.911033,1,16915250,16917330,2080,0.4857202418759114
6915,563.916933,563.949967,1,16917507,16918499,992,0.31979188110230067
6916,563.956067,564.016367,1,16918682,16920491,1809,0.4488427513804826
6917,564.036,564.0396,1,16921080,16921188,108,0.4449696597450426
6918,564.040633,564.070033,1,16921218,16922100,882,0.5920230282174974
6919,564.074067,564.161233,1,16922222,16924836,2614,0.6004818956505822
6920,564.1658,564.278967,1,16924974,16928369,3395,0.705182037043654
6921,564.294233,564.299567,1,16928826,16928987,161,-0.11711850088210049
6922,564.306867,564.361667,1,16929206,16930850,1644,0.5826920852274206
6923,564.379767,564.454433,1,16931393,16933632,2239,0.803556084283767
6924,564.455467,564.512967,1,16933664,16935389,1725,0.7752438835764947
6925,564.520067,564.608433,1,16935602,16938252,2650,0.8299659907650649
6926,564.610667,564.641167,1,16938320,16939235,915,0.8720156746745542
6927,564.6489,564.668367,1,16939467,16940051,584,-0.010476236373905578
6928,564.670433,564.682233,1,16940112,16940466,354,0.08870672707955873
6929,564.6901,564.702067,1,16940703,16941062,359,0.027719619902537587
6930,564.7048,564.7125,1,16941144,16941375,231,
6931,564.764067,564.896467,1,16942922,16946894,3972,0.6669239840761625
6932,564.9083,565.102667,1,16947249,16953080,5831,0.807015057327841
6933,565.117367,565.1478,1,16953521,16954434,913,0.08705444576745369
6934,565.148867,565.162933,1,16954466,16954887,421,0.04712828400688623
6935,565.190833,565.310633,1,16955724,16959318,3594,0.8410483489676152
6936,565.3492,565.363833,1,16960476,16960914,438,0.21022793155218156
6937,565.375833,565.387067,1,16961274,16961612,338,-0.056851067544407545
6938,565.391033,565.394133,1,16961730,16961823,93,
6939,565.3952,565.413533,1,16961856,16962405,549,-0.031286701850527225
6940,565.832033,565.848467,1,16974960,16975454,494,0.6038716393548268
6941,565.8495,565.914567,1,16975485,16977437,1952,0.6166871251935863
6942,565.927467,565.9942,1,16977824,16979826,2002,0.673388282706963
6943,566.000133,566.086367,1,16980003,16982591,2588,0.5901205392484465
6944,566.0928,566.117167,1,16982784,16983515,731,0.6676101922059833
6945,566.128267,566.1432,1,16983848,16984296,448,0.6817673457933353
6946,566.166767,566.176067,1,16985003,16985282,279,0.0016016493110918909
6947,566.1776,566.221067,1,16985328,16986632,1304,0.31514761203332214
6948,566.2487,566.3904,1,16987461,16991712,4251,0.846472964028361
6949,566.402633,566.4147,1,16992078,16992441,363,0.38746802762430693
6950,566.4188,566.4231,1,16992564,16992693,129,
6951,566.424333,566.4471,1,16992729,16993413,684,0.220191213818685
6952,566.450033,566.481,1,16993500,16994430,930,0.17844151430614758
6953,566.5737,566.587567,1,16997211,16997627,416,0.5380750506228301
6954,566.594567,566.6261,1,16997837,16998783,946,0.780497428376476
6955,566.6277,566.679767,1,16998831,17000393,1562,0.7905465576473142
6956,566.6811,566.685533,1,17000433,17000565,132,0.3490552746570587
6957,566.6986,566.722067,1,17000958,17001662,704,0.04005098102001836
6958,566.731233,566.740167,1,17001936,17002205,269,-0.12337429783682732
6959,566.759633,566.773567,1,17002788,17003207,419,0.057052439476918904
6960,566.777567,566.793333,1,17003327,17003799,472,0.1590017413923241
6961,566.795833,566.8019,1,17003874,17004057,183,0.3062515735204477
6962,566.805267,566.8152,1,17004158,17004456,298,0.23014832537857705
6963,566.816833,566.8217,1,17004504,17004651,147,-0.05831509443690166
6964,566.834733,566.878733,1,17005041,17006361,1320,0.6847641879058236
6965,566.8857,566.978367,1,17006571,17009351,2780,0.7533238053757051
6966,567.019733,567.027933,1,17010591,17010837,246,0.31672353723758656
6967,567.033433,567.0413,1,17011002,17011239,237,-0.0709559873470015
6968,567.043033,567.046367,1,17011290,17011391,101,-0.11767560114708514
6969,567.075333,567.198067,1,17012259,17015942,3683,0.8006815983471645
6970,567.233867,567.243,1,17017016,17017290,274,0.3304461707875611
6971,567.261133,567.2721,1,17017833,17018163,330,-0.11669974478828105
6972,567.279533,567.293567,1,17018385,17018807,422,-0.2538016370305978
6973,567.2965,567.302667,1,17018895,17019080,185,-0.33359700867988
6974,567.526067,567.552667,1,17025782,17026580,798,0.8151385920811925
6975,567.5726,567.586233,1,17027178,17027586,408,0.8201400640326048
6976,567.5941,567.632667,1,17027823,17028980,1157,0.8541255599148716
6977,567.634,567.641067,1,17029020,17029232,212,0.36911100811877245
6978,567.646933,567.7128,1,17029407,17031384,1977,0.704622851657242
6979,567.717,567.804,1,17031510,17034120,2610,0.7247000349775827
6980,567.811667,567.836833,1,17034350,17035104,754,0.6913670104811488
6981,567.837933,567.860933,1,17035137,17035827,690,0.5082304283115963
6982,567.8761,567.8981,1,17036283,17036943,660,0.027264056462012125
6983,567.9042,567.911867,1,17037126,17037356,230,0.38615260815295055
6984,567.917267,567.934033,1,17037518,17038020,502,0.3340592869632523
6985,567.943033,567.9571,1,17038290,17038713,423,0.09474412721109912
6986,567.988767,568.0505,1,17039663,17041515,1852,0.6536743693873901
6987,568.0556,568.121233,1,17041668,17043636,1968,0.7324904710504788
6988,568.123967,568.197567,1,17043719,17045927,2208,0.47393181243185983
6989,568.2198,568.223533,1,17046594,17046705,111,0.3164809573430482
6990,568.242867,568.2576,1,17047286,17047728,442,0.367915237543549
6991,568.354033,568.371033,1,17050620,17051130,510,0.7337703878878631
6992,568.3946,568.402933,1,17051838,17052087,249,0.8581050162412892
6993,568.426733,568.457433,1,17052801,17053722,921,0.7425002898094504
6994,568.460233,568.4692,1,17053806,17054076,270,0.15570328153084756
6995,568.470233,568.532533,1,17054106,17055975,1869,0.7188081982892687
6996,568.561533,568.5658,1,17056845,17056974,129,0.19937259756911802
6997,568.58,568.598567,1,17057400,17057957,557,-0.18125089896785473
6998,568.613133,568.6944,1,17058393,17060832,2439,0.762459634680825
6999,568.707333,568.793533,1,17061219,17063805,2586,0.8207487009958443
7000,568.815367,568.8184,1,17064461,17064552,91,
7001,569.184433,569.197167,1,17075532,17075915,383,0.7261922728661824
7002,569.2066,569.216767,1,17076198,17076503,305,0.49443443647513413
7003,569.258,569.267233,1,17077740,17078016,276,0.6896057259247428
7004,569.3187,569.327833,1,17079561,17079834,273,0.334541295987528
7005,569.3515,569.359033,1,17080545,17080770,225,0.7138709041318796
7006,569.363233,569.368233,1,17080896,17081046,150,0.1885217055666718
7007,569.3959,569.3994,1,17081877,17081982,105,0.7027558174151178
7008,569.4016,569.442033,1,17082048,17083260,1212,0.6439842734902688
7009,569.476533,569.489567,1,17084295,17084687,392,0.7163929961343553
7010,569.5165,569.524467,1,17085495,17085734,239,0.577675948505834
7011,569.5306,569.5399,1,17085918,17086197,279,0.6376578832493478
7012,569.559633,569.565833,1,17086788,17086974,186,-0.0664311553241048
7013,569.5739,569.578433,1,17087217,17087352,135,0.47992579071183594
7014,569.590267,569.601333,1,17087708,17088039,331,-0.05890888943124778
7015,569.604533,569.615467,1,17088135,17088464,329,0.0811649778784846
7016,569.619,569.626233,1,17088570,17088786,216,0.2399129058245673
7017,569.645533,569.651433,1,17089365,17089542,177,-0.2834867265394734
7018,569.657067,569.779467,1,17089712,17093384,3672,0.7836071279271383
7019,569.804733,569.834733,1,17094141,17095041,900,-0.054668471353774235
7020,569.8421,570.01,1,17095263,17100300,5037,0.8140242815957143
7021,570.044133,570.051733,1,17101323,17101551,228,0.8024901429029418
7022,570.055533,570.062033,1,17101665,17101860,195,-0.08686956850489456
7023,570.064633,570.070233,1,17101938,17102106,168,-0.02053684138131246
7024,570.074633,570.079233,1,17102238,17102376,138,-0.07271732293142265
7025,570.232033,570.243767,1,17106960,17107313,353,0.5933919130218835
7026,570.245233,570.261267,1,17107356,17107838,482,0.5049849045973941
7027,570.295367,570.309433,1,17108861,17109282,421,0.6068276231560157
7028,570.335467,570.342467,1,17110064,17110274,210,0.6153399805596231
7029,570.3708,570.411833,1,17111124,17112354,1230,0.5584601172030192
7030,570.412933,570.4758,1,17112387,17114274,1887,0.8272070527682497
7031,570.496267,570.500033,1,17114888,17115000,112,
7032,570.579967,570.5833,1,17117399,17117499,100,
7033,570.5869,570.590733,1,17117607,17117721,114,0.2675411166153665
7034,570.5954,570.610133,1,17117862,17118303,441,0.6537247987054806
7035,570.612467,570.6524,1,17118374,17119572,1198,0.7237386258646696
7036,570.6559,570.716633,1,17119677,17121498,1821,0.8101382581265255
7037,570.718233,570.778867,1,17121546,17123366,1820,0.8177070968313419
7038,570.790967,570.971833,1,17123729,17129154,5425,0.7813204194234447
7039,570.999267,571.010133,1,17129978,17130303,325,-0.04398127387905173
7040,571.016533,571.024267,1,17130495,17130728,233,0.06633836101832065
7041,571.032467,571.040633,1,17130974,17131218,244,-0.08183569128089407
7042,571.209033,571.218767,1,17136270,17136563,293,0.764213797125009
7043,571.220067,571.253267,1,17136602,17137598,996,0.6587691135354777
7044,571.3755,571.3788,1,17141265,17141364,99,
7045,571.391867,571.4647,1,17141756,17143941,2185,0.7678811702150494
7046,571.494433,571.5944,1,17144832,17147832,3000,0.7815726264608088
7047,571.604033,571.622667,1,17148120,17148680,560,0.5140642821583946
7048,571.625367,571.6825,1,17148761,17150475,1714,0.7068520541803778
7049,571.6894,571.697467,1,17150682,17150924,242,0.5724685058477378
7050,571.702633,571.727,1,17151078,17151810,732,0.6128359841077772
7051,571.740333,571.7461,1,17152209,17152383,174,0.44131928589413133
7052,571.7586,571.7773,1,17152758,17153319,561,0.07096781444538891
7053,571.779067,571.785733,1,17153372,17153571,199,0.0299812595813846
7054,571.787533,571.7997,1,17153625,17153991,366,-0.01853633331322667
7055,571.830833,571.9679,1,17154924,17159037,4113,0.8053002993677062
7056,571.977833,572.071867,1,17159334,17162156,2822,0.8069573217538909
7057,572.212333,572.341533,1,17166369,17170245,3876,0.6947291460432979
7058,572.387067,572.397867,1,17171612,17171936,324,-0.013775515731997034
7059,572.399667,572.414,1,17171990,17172420,430,0.12829091758471234
7060,572.4835,572.507067,1,17174505,17175212,707,0.7407876723240169
7061,572.5245,572.564567,1,17175735,17176937,1202,0.8390631655704646
7062,572.574367,572.61,1,17177231,17178300,1069,0.8276910744335719
7063,572.6187,572.624367,1,17178561,17178731,170,-0.043306105745927796
7064,572.632467,572.661633,1,17178974,17179848,874,0.01966874618225929
7065,572.6628,572.681667,1,17179884,17180450,566,0.16799333129748834
7066,572.685,572.695333,1,17180550,17180859,309,0.07372187598284435
7067,572.7397,572.789833,1,17182191,17183694,1503,0.7423151169091722
7068,572.791767,572.838567,1,17183753,17185157,1404,0.8127272541606652
7069,572.867933,572.893433,1,17186037,17186802,765,0.0026220641032116483
7070,572.895733,572.909133,1,17186871,17187273,402,0.17251643784353812
7071,572.910633,572.930133,1,17187318,17187903,585,0.04746973783290349
7072,572.956633,573.1486,1,17188698,17194458,5760,0.8384523921448125
7073,573.152633,573.157,1,17194578,17194710,132,0.32259010000362764
7074,573.173033,573.1806,1,17195190,17195418,228,-0.0005452100610267083
7075,573.200767,573.2039,1,17196023,17196117,94,
7076,573.380767,573.4631,1,17201423,17203893,2470,0.8283623716300974
7077,573.469967,573.605033,1,17204099,17208150,4051,0.8151548143355377
7078,573.6063,573.6104,1,17208189,17208312,123,-0.19407887622994385
7079,573.625867,573.682967,1,17208776,17210489,1713,0.8115180382332017
7080,573.691433,573.7253,1,17210742,17211759,1017,0.7188469214695259
7081,573.7404,573.795167,1,17212212,17213855,1643,0.09352697045738871
7082,573.821167,573.988333,1,17214635,17219649,5014,0.8326651881276647
7083,573.9897,574.014767,1,17219691,17220443,752,0.7750304609091929
7084,574.016067,574.0603,1,17220482,17221809,1327,0.7891301794241111
7085,574.066167,574.137,1,17221985,17224110,2125,0.8316157287718892
7086,574.138467,574.144,1,17224154,17224320,166,0.4563052277884109
7087,574.158267,574.187667,1,17224748,17225630,882,0.7921603012999369
7088,574.190867,574.291133,1,17225726,17228733,3007,0.8107171180530567
7089,574.293133,574.377,1,17228793,17231310,2517,0.8067597292999917
7090,574.3788,574.497933,1,17231364,17234937,3573,0.7554128501574909
7091,574.500133,574.527633,1,17235003,17235828,825,0.825007620982747
7092,574.530133,574.654833,1,17235903,17239644,3741,0.8336921121490244
7093,574.658133,574.7486,1,17239743,17242458,2715,0.8519728232032004
7094,574.7503,574.7744,1,17242509,17243232,723,0.617987206053715
7095,574.781467,574.9045,1,17243444,17247135,3691,0.810474344502547
7096,574.907533,575.0031,1,17247225,17250093,2868,0.837583835365452
7097,575.006033,575.0334,1,17250180,17251002,822,0.7881939699950528
7098,575.0371,575.134833,1,17251113,17254044,2931,0.804322266375681
7099,575.137967,575.163767,1,17254139,17254913,774,0.592289659039059
7100,575.166967,575.250833,1,17255009,17257524,2515,0.7700382222949679
7101,575.257433,575.330767,1,17257722,17259923,2201,0.8022443502561717
7102,575.3481,575.3601,1,17260443,17260803,360,0.8564083815884794
7103,575.378267,575.3817,1,17261348,17261451,103,
7104,575.3842,575.388167,1,17261526,17261645,119,-0.07814602603307143
7105,575.3921,575.398767,1,17261763,17261963,200,-0.08271439770934959
7106,575.403833,575.414833,1,17262114,17262444,330,0.29995659480924364
7107,575.425367,575.495767,1,17262761,17264873,2112,0.7977381100783548
7108,575.519,575.525533,1,17265570,17265765,195,-0.08613116049584824
7109,576.1496,576.1589,1,17284488,17284767,279,0.7343061529429598
7110,576.177767,576.181967,1,17285333,17285459,126,0.7784169409171229
7111,576.283767,576.290467,1,17288513,17288714,201,0.530256650611316
7112,576.308867,576.3128,1,17289266,17289384,118,-0.13139266790164109
7113,576.352367,576.361267,1,17290571,17290838,267,0.6489961981742907
7114,576.387667,576.3915,1,17291630,17291745,115,0.5435586616512621
7115,576.392967,576.410633,1,17291789,17292318,529,0.5588090536724765
7116,576.5373,576.659067,1,17296119,17299772,3653,0.7960757355292023
7117,576.907233,576.954933,1,17307216,17308647,1431,0.6194728875548974
7118,576.9585,577.0323,1,17308755,17310969,2214,0.7622990752774196
7119,577.05,577.055533,1,17311500,17311665,165,0.06550461102118467
7120,577.192767,577.197433,1,17315783,17315922,139,-0.24082921294952256
7121,577.205233,577.236767,1,17316156,17317103,947,0.32627059450691387
7122,577.245867,577.254633,1,17317376,17317638,262,0.08032798974494292
7123,577.2585,577.261867,1,17317755,17317856,101,
7124,577.263,577.267233,1,17317890,17318016,126,-0.12383625108074647
7125,577.282467,577.444367,1,17318474,17323331,4857,0.7673649713068385
7126,577.454333,577.5834,1,17323629,17327502,3873,0.7989986563523139
7127,577.5864,577.664333,1,17327592,17329929,2337,0.8265424167175173
7128,577.665367,577.6884,1,17329961,17330652,691,0.7602866090015882
7129,577.689667,577.698867,1,17330690,17330966,276,0.6872688455566294
7130,577.700067,577.753,1,17331002,17332590,1588,0.8436398641581304
7131,577.755733,577.803533,1,17332671,17334105,1434,0.7627693490802975
7132,577.805833,577.882233,1,17334174,17336466,2292,0.833847535431723
7133,577.8834,577.9059,1,17336502,17337177,675,0.6579009915717897
7134,577.9077,577.929067,1,17337231,17337872,641,0.832911783677377
7135,577.932333,578.044367,1,17337969,17341331,3362,0.8311343517104236
7136,578.058333,578.153633,1,17341749,17344608,2859,0.8332118894079118
7137,578.156067,578.173767,1,17344682,17345213,531,0.7271833508077844
7138,578.186267,578.281467,1,17345588,17348444,2856,0.8433982468060709
7139,578.283833,578.3044,1,17348514,17349132,618,0.781941575171181
7140,578.3113,578.4374,1,17349339,17353122,3783,0.7491580810416364
7141,578.444767,578.5442,1,17353343,17356326,2983,0.7273505889380897
7142,578.545633,578.568333,1,17356368,17357049,681,0.6494184902071165
7143,578.575933,578.678033,1,17357277,17360340,3063,0.8269766483230373
7144,578.681133,578.7037,1,17360433,17361111,678,0.7826914481534866
7145,578.708667,578.826667,1,17361260,17364800,3540,0.7927529043925278
7146,578.840833,578.9396,1,17365224,17368188,2964,0.8037849654891049
7147,578.9414,578.965333,1,17368242,17368959,717,0.894372672882912
7148,578.966733,578.970033,1,17369001,17369100,99,0.015175928912660236
7149,578.973633,579.013467,1,17369208,17370404,1196,0.8103584463616519
7150,579.014833,579.072067,1,17370444,17372162,1718,0.6074300682861243
7151,579.073633,579.1041,1,17372208,17373123,915,0.6522748816260815
7152,579.105933,579.196467,1,17373177,17375894,2717,0.7501158365145936
7153,579.210633,579.226067,1,17376318,17376782,464,-0.03891627095607838
7154,579.227533,579.231233,1,17376825,17376936,111,-0.23945858813322857
7155,579.2439,579.3253,1,17377317,17379759,2442,0.7891556369761347
7156,579.356833,579.359967,1,17380704,17380799,95,-0.04515931482794981
7157,579.362633,579.367167,1,17380878,17381015,137,0.6688725890382976
7158,579.368367,579.373933,1,17381051,17381217,166,0.47912460947902286
7159,579.639167,579.650033,1,17389175,17389500,325,0.7287372374847765
7160,579.651867,579.6664,1,17389556,17389992,436,0.5511651552701168
7161,579.696633,579.714033,1,17390898,17391420,522,0.5399046371560566
7162,579.720067,579.7233,1,17391602,17391699,97,0.030166137730279288
7163,579.987033,580.190367,1,17399610,17405711,6101,0.7936824535243083
7164,580.480667,580.516333,1,17414420,17415489,1069,0.8040104182901785
7165,580.5201,580.568333,1,17415603,17417049,1446,0.6582771685039331
7166,580.569567,580.577167,1,17417087,17417315,228,0.05171129526930167
7167,580.5848,580.617067,1,17417544,17418512,968,0.6369452776930972
7168,580.635,580.675567,1,17419050,17420267,1217,0.5921765832699951
7169,580.687933,580.693433,1,17420637,17420802,165,0.6297001222971115
7170,580.738,580.784367,1,17422140,17423531,1391,0.14950572052011163
7171,580.7948,580.9005,1,17423844,17427015,3171,0.7931241678826896
7172,580.9167,580.941233,1,17427501,17428236,735,-0.018332230882031043
7173,580.942233,580.951,1,17428266,17428530,264,-0.20173916528464864
7174,580.963633,581.134667,1,17428908,17434040,5132,0.7255162195481958
7175,581.152333,581.160267,1,17434569,17434808,239,-0.10657736734371176
7176,581.181067,581.2884,1,17435432,17438652,3220,0.7871569451058621
7177,581.293767,581.298367,1,17438813,17438951,138,0.40933639214217005
7178,581.323667,581.326867,1,17439710,17439806,96,0.18307947512343192
7179,581.376,581.381633,1,17441280,17441448,168,0.34875594660436754
7180,581.389567,581.5783,1,17441687,17447349,5662,0.8037922461245898
7181,581.600333,581.6181,1,17448009,17448543,534,0.7644411160706714
7182,581.6196,581.7469,1,17448588,17452407,3819,0.762568948230765
7183,581.774367,581.799833,1,17453231,17453994,763,0.7996547717696577
7184,581.8032,581.811167,1,17454096,17454335,239,0.2661304414945448
7185,581.812167,581.881,1,17454365,17456430,2065,0.7079679237504138
7186,581.8821,582.010433,1,17456463,17460312,3849,0.7076394196038648
7187,582.014567,582.018367,1,17460437,17460551,114,0.8063134785174759
7188,582.024167,582.117767,1,17460725,17463533,2808,0.8497534375171507
7189,582.121167,582.144533,1,17463635,17464335,700,0.8204241907527153
7190,582.150367,582.246033,1,17464511,17467380,2869,0.842020103267921
7191,582.249267,582.274633,1,17467478,17468238,760,0.6572031025409214
7192,582.278067,582.3744,1,17468342,17471232,2890,0.8257218094359464
7193,582.3761,582.403033,1,17471283,17472090,807,0.7185713154888661
7194,582.406333,582.4769,1,17472189,17474307,2118,0.8165739162435515
7195,582.478433,582.4987,1,17474352,17474961,609,0.7946467838192868
7196,582.5024,582.5224,1,17475072,17475672,600,0.645325071232164
7197,582.634233,582.894767,1,17479026,17486843,7817,0.48207423881852657
7198,582.920633,582.9597,1,17487618,17488791,1173,0.5906157257217045
7199,582.9617,582.977467,1,17488851,17489324,473,0.6688366752742285
7200,582.978567,583.0132,1,17489357,17490396,1039,0.5214568315217006
7201,583.048333,583.085933,1,17491449,17492577,1128,0.5378498714223222
7202,583.089767,583.104267,1,17492693,17493128,435,0.7485166187801535
7203,583.112267,583.142,1,17493368,17494260,892,0.6682565679630668
7204,583.1758,583.215533,1,17495274,17496465,1191,0.7617800000185978
7205,583.218467,583.2329,1,17496554,17496987,433,0.8275844954472316
7206,583.259967,583.270233,1,17497799,17498106,307,0.8000571225615495
7207,583.2759,583.292367,1,17498277,17498771,494,0.39272290411953076
7208,583.307267,583.346633,1,17499218,17500398,1180,0.6784739076470173
7209,583.352033,583.363367,1,17500560,17500901,341,0.7052831913531881
7210,583.3882,583.398267,1,17501646,17501948,302,0.8057120246087511
7211,583.403433,583.409333,1,17502102,17502279,177,-0.057773884521378355
7212,583.410933,583.417033,1,17502327,17502510,183,0.6407061385019345
7213,583.435367,583.475967,1,17503061,17504279,1218,0.6911054532523826
7214,583.4779,583.4926,1,17504337,17504778,441,0.5613198243572489
7215,583.517633,583.528167,1,17505528,17505845,317,0.8141638800426173
7216,583.538833,583.5513,1,17506164,17506539,375,0.9518902258867941
7217,583.567533,583.605867,1,17507025,17508176,1151,0.7600476684367597
7218,583.612767,583.622833,1,17508383,17508684,301,0.6743544500214652
7219,583.650333,583.657033,1,17509509,17509710,201,0.5785231250521955
7220,583.664267,583.668733,1,17509928,17510061,133,0.2415857096192336
7221,583.6698,583.673133,1,17510094,17510193,99,0.7328188424380233
7222,583.682167,583.726567,1,17510465,17511797,1332,0.7147514011077098
7223,583.728367,583.7398,1,17511851,17512194,343,0.4381275979235276
7224,583.751767,583.755133,1,17512553,17512653,100,
7225,583.7616,583.7747,1,17512848,17513241,393,0.12471911861466466
7226,583.777133,583.786533,1,17513313,17513595,282,-0.11046747172111744
7227,583.787633,583.800933,1,17513628,17514027,399,-0.24628901632392164
7228,583.803133,583.807733,1,17514093,17514231,138,-0.15616291905200624
7229,583.808767,583.814233,1,17514263,17514426,163,-0.19068889466970593
7230,583.8423,583.845467,1,17515269,17515364,95,-0.27821591795899303
7231,583.860133,583.9122,1,17515803,17517366,1563,0.7845722276858101
7232,583.933467,583.947567,1,17518004,17518427,423,0.003791162963037749
7233,583.9804,583.984167,1,17519412,17519525,113,-0.06806044704991336
7234,583.9913,584.079933,1,17519739,17522397,2658,0.8070803167910103
7235,584.082533,584.0919,1,17522475,17522757,282,0.1454834160682088
7236,584.1188,584.1664,1,17523564,17524992,1428,-0.10205286328468156
7237,584.173267,584.181633,1,17525198,17525448,250,0.2521484971178629
7238,584.198767,584.341667,1,17525963,17530250,4287,0.7945460865606953
7239,584.353333,584.3898,1,17530599,17531694,1095,0.657052534067882
7240,584.395533,584.398567,1,17531865,17531957,92,-0.22630335058119366
7241,584.402,584.454033,1,17532060,17533620,1560,0.11019922034160305
7242,584.466067,584.6798,1,17533982,17540394,6412,0.8571643955023012
7243,584.692867,584.706033,1,17540786,17541180,394,0.5666430874430078
7244,584.7139,584.764167,1,17541417,17542925,1508,0.09941887155448874
7245,584.814733,584.900133,1,17544441,17547003,2562,0.816016849627454
7246,584.911767,585.025933,1,17547353,17550777,3424,0.8532317243382815
7247,585.0409,585.058967,1,17551227,17551769,542,0.03380604356641947
7248,585.0603,585.0947,1,17551809,17552841,1032,0.009211418234961112
7249,585.127233,585.250033,1,17553816,17557500,3684,0.8175740888043834
7250,585.251567,585.3241,1,17557547,17559723,2176,0.11695049968570549
7251,585.327267,585.335,1,17559818,17560050,232,0.022677585895891618
7252,585.340733,585.457833,1,17560221,17563734,3513,0.5978658790972359
7253,585.4687,585.4784,1,17564061,17564352,291,0.5451553637100687
7254,585.488133,585.492433,1,17564643,17564772,129,
7255,585.4972,585.552633,1,17564916,17566578,1662,0.16660786845707068
7256,585.554367,585.5613,1,17566631,17566839,208,
7257,585.565933,585.594,1,17566977,17567820,843,0.9105848519049672
7258,585.5969,585.700167,1,17567907,17571005,3098,0.8052863377566658
7259,585.704,585.712233,1,17571120,17571366,246,0.3245917919392477
7260,585.7134,585.778633,1,17571402,17573358,1956,0.25085639375698243
7261,585.7934,585.797567,1,17573802,17573927,125,0.3278119100500376
7262,585.8021,585.944333,1,17574063,17578329,4266,0.79834924923609
7263,585.958433,586.171667,1,17578752,17585150,6398,0.5719222102404011
7264,586.184867,586.2048,1,17585546,17586144,598,-0.009852908333346524
7265,586.2069,586.238667,1,17586207,17587160,953,0.05522326275084067
7266,586.248267,586.3991,1,17587448,17591973,4525,0.778430330241228
7267,586.405233,586.457767,1,17592156,17593733,1577,0.0006584613854772156
7268,586.484733,586.638667,1,17594541,17599160,4619,0.8536619467002478
7269,586.6438,586.865967,1,17599314,17605979,6665,0.4967916289044254
7270,586.867467,586.871567,1,17606024,17606147,123,0.07122748310197226
7271,586.8788,586.8829,1,17606364,17606487,123,-0.0003225855232603797
7272,586.8842,586.892767,1,17606526,17606783,257,0.07845815106474777
7273,587.158433,587.2315,1,17614752,17616945,2193,0.4527324280373881
7274,587.243433,587.378033,1,17617302,17621340,4038,0.8144318153281617
7275,587.3914,587.411433,1,17621742,17622342,600,0.3063677430242381
7276,587.415133,587.472333,1,17622453,17624169,1716,-0.06714896588003967
7277,587.498533,587.801367,1,17624955,17634041,9086,0.7661900445757646
7278,587.8206,587.835233,1,17634618,17635056,438,0.3812907919041496
7279,587.838033,587.842033,1,17635140,17635260,120,-0.11979339235335584
7280,587.844933,587.868633,1,17635347,17636058,711,0.05514106095156334
7281,587.8699,587.889733,1,17636097,17636691,594,0.09415242715268647
7282,587.891833,587.902833,1,17636754,17637084,330,0.4368270796447691
7283,587.911133,587.916367,1,17637333,17637491,158,0.2972651876854536
7284,587.921333,588.0969,1,17637639,17642907,5268,0.8297460897677017
7285,588.099,588.1193,1,17642970,17643579,609,0.8733542186793019
7286,588.135067,588.177033,1,17644052,17645310,1258,0.8327156871433065
7287,588.1825,588.210533,1,17645475,17646315,840,0.8679926718131353
7288,588.2314,588.286733,1,17646942,17648601,1659,0.029045454020515456
7289,588.2903,588.303833,1,17648709,17649114,405,-0.18482261501455954
7290,588.335833,588.340967,1,17650074,17650229,155,0.2841916934053265
7291,588.347867,588.512733,1,17650436,17655381,4945,0.8421492550269247
7292,588.5232,588.575267,1,17655696,17657258,1562,0.7881442100544155
7293,588.5763,588.6259,1,17657289,17658777,1488,0.8032129608306459
7294,588.650567,588.661133,1,17659517,17659833,316,-0.3100421758487676
7295,588.670067,588.713933,1,17660102,17661417,1315,-0.04119775742356976
7296,588.722367,588.727633,1,17661671,17661828,157,0.327115951980925
7297,588.755367,588.761933,1,17662661,17662857,196,0.011651494981978653
7298,588.763667,588.887033,1,17662910,17666610,3700,0.8563364025527346
7299,588.9159,588.950267,1,17667477,17668508,1031,0.04309539766942353
7300,588.951267,588.958633,1,17668538,17668758,220,0.10868166078728045
7301,588.966367,588.982767,1,17668991,17669483,492,0.13594716822680186
7302,589.0063,589.013633,1,17670189,17670408,219,0.2927113457706916
7303,589.0213,589.032033,1,17670639,17670960,321,0.2666877351482529
7304,589.0422,589.0507,1,17671266,17671521,255,0.19666318826553036
7305,589.0551,589.293833,1,17671653,17678814,7161,0.7968486805090802
7306,589.307833,589.3218,1,17679234,17679654,420,0.7108131624073742
7307,589.329667,589.339933,1,17679890,17680197,307,0.594531318585373
7308,589.356367,589.418867,1,17680691,17682566,1875,0.1996035391920975
7309,589.421633,589.4343,1,17682648,17683029,381,0.09414619864206092
7310,589.459367,589.571867,1,17683781,17687156,3375,0.7779062635967452
7311,589.599533,589.606933,1,17687985,17688207,222,0.30581603395401913
7312,589.608067,589.691467,1,17688242,17690744,2502,0.49772033621605566
7313,589.701567,589.7434,1,17691047,17692302,1255,0.24703863776527124
7314,589.7513,589.795633,1,17692539,17693868,1329,-0.0619797692348877
7315,589.820667,589.981,1,17694620,17699430,4810,0.8281418578355546
7316,590.0281,590.0355,1,17700843,17701065,222,-0.15718337651123765
7317,590.047033,590.052567,1,17701410,17701577,167,0.13600363170917087
7318,590.282367,590.298067,1,17708471,17708942,471,0.737592037886809
7319,590.303867,590.337033,1,17709116,17710110,994,0.6944969099442156
7320,590.362233,590.3809,1,17710866,17711427,561,0.8076659409008715
7321,590.392933,590.465433,1,17711787,17713962,2175,0.6262880557162106
7322,590.485733,590.502667,1,17714571,17715080,509,0.7592810079289956
7323,590.524567,590.536633,1,17715737,17716098,361,0.7268787714641106
7324,590.541333,590.557,1,17716239,17716710,471,0.5768812248558862
7325,590.5745,590.6243,1,17717235,17718729,1494,0.02907257941857976
7326,590.6254,590.6415,1,17718762,17719245,483,-0.028299337297479132
7327,590.660267,590.665,1,17719808,17719950,142,
7328,590.6832,590.836567,1,17720496,17725097,4601,0.8220233145983162
7329,590.844767,590.879467,1,17725343,17726384,1041,0.7083719340305832
7330,590.903567,591.011967,1,17727107,17730359,3252,0.8110172909763524
7331,591.023633,591.035267,1,17730708,17731058,350,-0.018489331555152668
7332,591.0997,591.103567,1,17732991,17733107,116,0.1727731292518472
7333,591.109467,591.2748,1,17733284,17738244,4960,0.8239527528584337
7334,591.2761,591.444033,1,17738283,17743320,5037,0.7807060015457097
7335,591.448133,591.4532,1,17743443,17743596,153,-0.21265362351235065
7336,591.461833,591.491533,1,17743854,17744745,891,0.11099482676911206
7337,591.493067,591.499767,1,17744792,17744993,201,0.1870065736904669
7338,591.502367,591.5134,1,17745071,17745402,331,0.15079491977061535
7339,591.5245,591.623767,1,17745735,17748713,2978,0.8513633033927754
7340,591.637167,591.641467,1,17749115,17749244,129,-0.11513030515764959
7341,591.6455,591.760567,1,17749365,17752817,3452,0.7748917146231602
7342,591.774067,591.777867,1,17753222,17753336,114,
7343,591.792067,591.855733,1,17753762,17755671,1909,0.501719939136397
7344,591.868867,591.994767,1,17756066,17759843,3777,0.8761429780963763
7345,592.0231,592.201833,1,17760693,17766054,5361,0.7732789979846855
7346,592.258033,592.262933,1,17767740,17767887,147,0.6082117226854975
7347,592.2991,592.305033,1,17768973,17769150,177,0.5976728952846243
7348,592.3103,592.368433,1,17769309,17771052,1743,0.787558048705911
7349,592.3707,592.462267,1,17771121,17773868,2747,0.8198967441674632
7350,592.465267,592.525733,1,17773958,17775771,1813,0.8059808843502199
7351,592.550567,592.5789,1,17776517,17777367,850,0.8216898974804625
7352,592.585033,592.6474,1,17777550,17779422,1872,0.8262455718795051
7353,592.6526,592.669367,1,17779578,17780081,503,0.7217165019141011
7354,592.671667,592.688567,1,17780150,17780657,507,0.4957428506666388
7355,592.691067,592.695,1,17780732,17780850,118,-0.6137461850216279
7356,592.710467,592.733567,1,17781314,17782007,693,0.1544675351170058
7357,592.734867,592.752833,1,17782046,17782584,538,-0.2109389551661878
7358,592.757467,592.763567,1,17782724,17782907,183,-0.16890724628802906
7359,592.776167,592.782333,1,17783285,17783469,184,0.12213834420036132
7360,592.7867,593.038533,1,17783601,17791155,7554,0.7744541043130302
7361,593.044567,593.0786,1,17791337,17792358,1021,0.8315667029204143
7362,593.0808,593.175433,1,17792424,17795262,2838,0.7994903206398649
7363,593.650633,593.663133,1,17809518,17809893,375,0.6680954124177594
7364,593.664433,593.671533,1,17809932,17810145,213,0.5606982907419568
7365,593.6924,593.7113,1,17810772,17811339,567,0.8421186345815463
7366,593.721767,593.7778,1,17811653,17813334,1681,0.806603874165702
7367,593.786967,593.821367,1,17813609,17814641,1032,0.8482193915559475
7368,593.825967,593.930133,1,17814779,17817903,3124,0.8027681883596858
7369,593.944633,594.013233,1,17818338,17820396,2058,0.8272887402539065
7370,594.017433,594.110267,1,17820522,17823308,2786,0.6783323603367726
7371,594.112333,594.1213,1,17823369,17823639,270,0.7629470953888652
7372,594.1229,594.256033,1,17823687,17827680,3993,0.7695100181238118
7373,594.274267,594.301767,1,17828228,17829053,825,-0.1422870920624167
7374,594.315133,594.320933,1,17829453,17829627,174,-0.14420655951263053
7375,594.3264,594.421333,1,17829792,17832639,2847,0.7926698693497359
7376,594.433033,594.436133,1,17832990,17833083,93,0.2571419941303414
7377,594.524433,594.5286,1,17835732,17835858,126,
7378,594.532233,594.650967,1,17835966,17839529,3563,0.8135236117846794
7379,594.682133,594.698433,1,17840463,17840952,489,-0.12604493628995658
7380,594.7016,594.731,1,17841048,17841930,882,0.5010619383338255
7381,594.732067,594.8894,1,17841962,17846682,4720,0.8201935232859223
7382,594.895667,594.9465,1,17846870,17848395,1525,0.8055225752697365
7383,594.949,594.953567,1,17848470,17848607,137,-0.09276542085781786
7384,594.965333,595.006433,1,17848959,17850192,1233,0.7624930465851946
7385,595.011067,595.045467,1,17850332,17851364,1032,-0.033654429328095474
7386,595.0467,595.054833,1,17851401,17851644,243,0.08924930578306689
7387,595.0562,595.069133,1,17851686,17852073,387,0.24614312946484834
7388,595.0848,595.089633,1,17852544,17852688,144,-0.23471828863074753
7389,595.095933,595.206467,1,17852877,17856194,3317,0.8166079288884122
7390,595.227767,595.2469,1,17856833,17857407,574,-0.10201554763550374
7391,595.250033,595.2549,1,17857500,17857647,147,-0.1750333214339284
7392,595.2707,595.395933,1,17858121,17861877,3756,0.8420224479216916
7393,595.447333,595.461267,1,17863419,17863838,419,0.40154331245474845
7394,595.4705,595.4792,1,17864115,17864376,261,-0.042049337475483915
7395,595.4802,595.491333,1,17864406,17864739,333,-0.05704666636208558
7396,595.509133,595.514267,1,17865273,17865428,155,0.6081916153455642
7397,595.7687,595.794967,1,17873061,17873849,788,0.5040036720023269
7398,595.796733,595.8099,1,17873901,17874297,396,0.5829508753054705
7399,595.811067,595.8613,1,17874332,17875839,1507,0.5771127622462596
7400,595.8778,595.8961,1,17876334,17876883,549,0.6436944923735004
7401,595.925,596.022567,1,17877750,17880677,2927,0.7612439355525003
7402,596.0363,596.042833,1,17881089,17881284,195,-0.050899697245950615
7403,596.139633,596.1452,1,17884188,17884356,168,-0.17046794837473025
7404,596.147667,596.151633,1,17884430,17884548,118,0.5480319488399918
7405,596.158467,596.189167,1,17884754,17885675,921,0.7403721479939626
7406,596.190933,596.211167,1,17885727,17886335,608,0.7619255978866118
7407,596.2149,596.2359,1,17886447,17887077,630,0.7098724464241365
7408,596.2375,596.240733,1,17887125,17887221,96,0.6730938262251187
7409,596.2465,596.2698,1,17887395,17888094,699,0.810458551840009
7410,596.2993,596.3114,1,17888979,17889342,363,0.5392454933483413
7411,596.323467,596.380233,1,17889704,17891406,1702,0.06180060051521662
7412,596.393367,596.397067,1,17891801,17891912,111,0.4030594965073572
7413,596.408333,596.614733,1,17892249,17898441,6192,0.8290178888374546
7414,596.616033,596.619867,1,17898480,17898596,116,0.33735707611488774
7415,596.6261,596.646,1,17898783,17899380,597,0.7691725236839589
7416,597.225833,597.249967,1,17916774,17917499,725,0.6522628664056215
7417,597.251467,597.2552,1,17917544,17917656,112,0.2664736175941476
7418,597.2562,597.314467,1,17917686,17919434,1748,0.6690701000371737
7419,597.330933,597.389533,1,17919927,17921685,1758,0.6500912318968003
7420,597.395133,597.474933,1,17921853,17924247,2394,0.7000174124809234
7421,597.480667,597.485333,1,17924420,17924559,139,0.5514702176308754
7422,597.490167,597.503833,1,17924705,17925114,409,0.6229706387550159
7423,597.508867,597.519367,1,17925266,17925581,315,0.6513471990660077
7424,597.532633,597.5375,1,17925978,17926125,147,-0.21032754210054272
7425,597.540433,597.6177,1,17926212,17928531,2319,0.6590598163868447
7426,597.619433,597.770067,1,17928582,17933102,4520,0.7431072545985348
7427,597.8033,597.819,1,17934099,17934570,471,0.2991679749029957
7428,597.8232,597.8565,1,17934696,17935695,999,-0.004716705043265163
7429,597.858833,597.870233,1,17935764,17936106,342,0.1842605103271195
7430,597.8747,597.888933,1,17936241,17936667,426,-0.04154732458135518
7431,597.905833,597.911433,1,17937174,17937342,168,0.653618000657633
7432,597.939267,598.186933,1,17938178,17945607,7429,0.82752880418898
7433,598.213467,598.234033,1,17946404,17947020,616,0.2298183502733727
7434,598.244033,598.264467,1,17947320,17947934,614,0.5367761821746416
7435,598.280433,598.299267,1,17948412,17948978,566,0.6091252572676893
7436,598.301333,598.3658,1,17949039,17950974,1935,0.8189748911834005
7437,598.369833,598.376333,1,17951094,17951289,195,0.4942599019495498
7438,598.378133,598.473233,1,17951343,17954196,2853,0.8398705432379829
7439,598.590367,598.598133,1,17957711,17957943,232,0.4179439185420443
7440,598.607233,598.666067,1,17958216,17959982,1766,0.7824537990521931
7441,598.669067,598.713367,1,17960072,17961401,1329,0.7806126890255453
7442,598.742067,598.747633,1,17962262,17962428,166,0.10520862504898694
7443,598.7639,598.781067,1,17962917,17963432,515,0.06904638193291858
7444,598.782167,598.7948,1,17963465,17963844,379,0.2934171638327209
7445,598.7976,598.808167,1,17963928,17964245,317,0.09280418254006371
7446,598.8096,598.8148,1,17964288,17964444,156,0.16399308041758395
7447,598.8574,598.965633,1,17965722,17968968,3246,0.7365470906396827
7448,598.984833,599.016833,1,17969544,17970504,960,0.06584160967520529
7449,599.0183,599.0321,1,17970549,17970963,414,0.13376233781561506
7450,599.034,599.0436,1,17971020,17971308,288,0.07211761286627835
7451,599.046067,599.051233,1,17971382,17971536,154,0.03023325732906352
7452,599.064867,599.0695,1,17971946,17972085,139,0.41056453318652836
7453,599.106933,599.159633,1,17973207,17974788,1581,0.6325259658364805
7454,599.160633,599.212633,1,17974818,17976378,1560,0.6940410107905104
7455,599.221567,599.262533,1,17976647,17977875,1228,0.04142857844532659
7456,599.264233,599.2903,1,17977926,17978709,783,-0.022182114600083236
7457,599.3,599.310667,1,17979000,17979320,320,-0.13512431566672328
7458,599.312133,599.3184,1,17979363,17979552,189,0.017409860887952943
7459,599.340767,599.355,1,17980223,17980650,427,0.7132944056716026
7460,599.3561,599.4043,1,17980683,17982129,1446,0.8321143074835337
7461,599.411833,599.453533,1,17982354,17983605,1251,0.8576486698714814
7462,599.477167,599.500533,1,17984315,17985015,700,-0.033291376505519166
7463,599.5018,599.5094,1,17985054,17985282,228,-0.02147048021976938
7464,599.516167,599.524767,1,17985485,17985743,258,-0.007623810885493662
7465,599.529567,599.539267,1,17985887,17986178,291,0.14447051443226197
7466,599.547267,599.550933,1,17986418,17986527,109,-0.19347107388627
7467,599.565833,599.5705,1,17986974,17987115,141,0.3666004378355114
7468,599.574667,599.580233,1,17987240,17987406,166,0.48928635463950615
7469,599.582867,599.624533,1,17987486,17988735,1249,0.2360032456407883
7470,599.627833,599.6795,1,17988834,17990385,1551,0.08804649882719119
7471,599.684967,599.800767,1,17990549,17994023,3474,0.8303851769242104
7472,599.8139,599.8562,1,17994417,17995686,1269,0.07537714574187386
7473,599.8573,599.867433,1,17995719,17996022,303,-0.0011440578869262206
7474,599.869133,599.874833,1,17996073,17996244,171,0.07289854049635015
7475,599.890267,599.893733,1,17996708,17996811,103,0.34565930156077634
7476,599.894733,599.9146,1,17996841,17997438,597,0.5566917327055162
7477,599.9184,599.938867,1,17997552,17998166,614,0.015230255179313694
7478,599.945567,600.005,1,17998367,18000150,1783,-0.05088943193450998
7479,600.0343,600.037333,1,18001029,18001119,90,
7480,600.050733,600.2255,1,18001521,18006765,5244,0.7926037132067651
7481,600.228033,600.2359,1,18006840,18007077,237,0.7543998064543166
7482,600.248433,600.3319,1,18007452,18009957,2505,0.7208585683548591
7483,600.3453,600.3517,1,18010359,18010551,192,0.16678425163845434
7484,600.3589,600.3776,1,18010767,18011328,561,-0.027163583442319537
7485,600.382467,600.390633,1,18011474,18011718,244,0.3343663976140542
7486,600.3917,600.402767,1,18011751,18012083,332,0.10271974794825131
7487,600.4068,600.4176,1,18012204,18012528,324,0.21867530006901567
7488,600.451133,600.466733,1,18013533,18014001,468,0.40058452030043507
7489,600.467733,600.480933,1,18014031,18014427,396,0.5739186967337718
7490,600.484133,600.509733,1,18014523,18015291,768,0.2677902405385166
7491,600.517067,600.553433,1,18015512,18016602,1090,0.025591208143160914
7492,600.556033,600.567067,1,18016680,18017012,332,-0.004109247483812372
7493,600.569833,600.573133,1,18017094,18017193,99,0.09050493837658609
7494,600.599033,600.604133,1,18017970,18018123,153,0.7128485008705683
7495,600.611167,600.791167,1,18018335,18023735,5400,0.8552846279081397
7496,600.801567,600.868667,1,18024047,18026060,2013,0.8258440407028845
7497,600.8862,600.9115,1,18026586,18027345,759,0.23433478477683914
7498,600.9133,600.956533,1,18027399,18028695,1296,-0.0806169789039715
7499,600.957733,600.9671,1,18028731,18029013,282,-0.17576987863631358
7500,601.050433,601.073833,1,18031512,18032214,702,0.6930674998369315
7501,601.236233,601.305267,1,18037086,18039158,2072,0.6731196894312035
7502,601.306333,601.309633,1,18039189,18039288,99,
7503,601.3196,601.334867,1,18039588,18040046,458,0.8520679433289486
7504,601.674733,601.746367,1,18050241,18052391,2150,0.8010190174234132
7505,601.748,601.774067,1,18052440,18053222,782,0.8687857463438947
7506,602.0707,602.125067,1,18062121,18063752,1631,0.707604398853915
7507,602.1281,602.1362,1,18063843,18064086,243,0.0551663316439994
7508,602.141967,602.2102,1,18064259,18066306,2047,0.7443074412806615
7509,602.5422,602.647633,1,18076266,18079428,3162,0.823749423498729
7510,602.674233,602.677667,1,18080226,18080330,104,
7511,602.802633,602.8127,1,18084078,18084381,303,0.47274813477612265
7512,602.814233,602.8178,1,18084426,18084534,108,0.4738041463336894
7513,602.819433,602.8903,1,18084582,18086709,2127,0.059359144425373066
7514,602.8921,602.921567,1,18086763,18087647,884,0.056995027996334456
7515,602.939667,603.0203,1,18088190,18090609,2419,0.7020307611979563
7516,603.0245,603.050467,1,18090735,18091514,779,0.6669979560570283
7517,603.067933,603.0712,1,18092037,18092136,99,0.4956669332070373
7518,603.075433,603.098233,1,18092262,18092946,684,0.2975500150555397
7519,603.100567,603.145567,1,18093017,18094367,1350,0.20129298424115438
7520,603.1498,603.164833,1,18094494,18094944,450,-0.04587134589474232
7521,603.187,603.200233,1,18095610,18096006,396,-0.43561350965407675
7522,603.2089,603.268267,1,18096267,18098048,1781,0.15819134395064566
7523,603.270433,603.293467,1,18098112,18098804,692,0.12354883928584737
7524,603.320833,603.323933,1,18099624,18099717,93,0.40376564818835575
7525,603.326167,603.330933,1,18099785,18099927,142,0.21816959665002975
7526,603.341133,603.3757,1,18100233,18101271,1038,0.6918261634295966
7527,603.390667,603.429667,1,18101720,18102890,1170,0.7471485893953935
7528,603.459233,603.495233,1,18103776,18104856,1080,0.7564720272536145
7529,603.523,603.5431,1,18105690,18106293,603,0.5466247096334347
7530,603.557833,603.601533,1,18106734,18108045,1311,0.41398888236994463
7531,603.626767,603.6373,1,18108803,18109119,316,0.553632161823628
7532,603.641833,603.6457,1,18109254,18109371,117,0.5903564916976761
7533,603.649733,603.652933,1,18109491,18109587,96,-0.20517984334563982
7534,603.6762,603.7494,1,18110286,18112482,2196,0.21635724075364013
7535,603.754367,603.758267,1,18112631,18112748,117,-0.016790927034588163
7536,603.7716,603.778933,1,18113148,18113367,219,0.5532126668799
7537,603.8968,604.011033,1,18116904,18120330,3426,0.6930731981412748
7538,604.0292,604.048367,1,18120876,18121451,575,0.23742380291793586
7539,604.054967,604.082033,1,18121649,18122460,811,0.031547991041412114
7540,604.084633,604.097233,1,18122538,18122916,378,0.12721271920832755
7541,604.1011,604.1139,1,18123033,18123417,384,0.14075396958892222
7542,604.154,604.157,1,18124620,18124710,90,
7543,604.1796,604.1831,1,18125388,18125493,105,-0.07075176207072224
7544,604.193267,604.201167,1,18125798,18126035,237,0.6308251659939368
7545,604.204,604.208267,1,18126120,18126248,128,0.04881115148017298
7546,604.259767,604.278633,1,18127793,18128358,565,0.6759677261915138
7547,604.287167,604.306,1,18128615,18129180,565,0.8274764411923105
7548,604.307233,604.3109,1,18129216,18129327,111,-0.4282909555248852
7549,604.3161,604.339867,1,18129483,18130196,713,0.6954032045823967
7550,604.3722,604.376967,1,18131166,18131309,143,0.4676460153392125
7551,604.378233,604.3891,1,18131346,18131673,327,0.40467281427537316
7552,604.4008,604.412433,1,18132024,18132372,348,0.08333670430538613
7553,604.451,604.479133,1,18133530,18134373,843,0.5243800465272958
7554,604.495867,604.539367,1,18134876,18136181,1305,0.5697893405180409
7555,604.576033,604.654033,1,18137280,18139620,2340,0.2902505242444227
7556,604.680533,604.802967,1,18140415,18144089,3674,0.7756639340041767
7557,604.831133,604.877333,1,18144933,18146319,1386,0.15831418281510934
7558,604.881167,604.891667,1,18146435,18146750,315,0.08360126865856782
7559,604.8965,604.907633,1,18146895,18147228,333,0.14795751246353658
7560,604.944833,604.948533,1,18148344,18148455,111,-0.256732795174557
7561,604.9813,604.993533,1,18149439,18149805,366,0.27074530287200066
7562,605.002,605.0147,1,18150060,18150441,381,0.43715178502490126
7563,605.184067,605.2649,1,18155522,18157947,2425,0.6988424688926534
7564,605.271233,605.293033,1,18158136,18158790,654,0.719746301374286
7565,605.2941,605.2974,1,18158823,18158922,99,
7566,605.349833,605.362,1,18160494,18160860,366,-0.1045231287503108
7567,605.734333,605.771967,1,18172029,18173159,1130,0.6963580709733858
7568,605.787033,605.8089,1,18173610,18174267,657,0.4890113801854547
7569,605.813133,605.832933,1,18174393,18174987,594,0.4211156373644878
7570,605.8656,605.873433,1,18175968,18176202,234,0.6653643857911193
7571,605.8784,605.897633,1,18176352,18176928,576,0.5967139530187534
7572,605.918133,605.930367,1,18177543,18177911,368,0.44568246550069984
7573,605.984133,605.9892,1,18179523,18179676,153,0.5406907992823421
7574,605.990933,605.999433,1,18179727,18179982,255,0.6022693742488581
7575,606.024133,606.030967,1,18180723,18180929,206,0.5419675646477322
7576,606.036633,606.0503,1,18181098,18181509,411,0.579779746524527
7577,606.0769,606.1498,1,18182307,18184494,2187,0.3679908775827781
7578,606.1565,606.250767,1,18184695,18187523,2828,0.812607694374991
7579,606.2518,606.311733,1,18187554,18189351,1797,0.8328803154838959
7580,606.3481,606.351667,1,18190443,18190550,107,0.5678559862522763
7581,606.3563,606.362033,1,18190689,18190860,171,-0.05447385155386252
7582,606.622367,606.6488,1,18198671,18199464,793,0.6022769752559181
7583,606.662667,606.681433,1,18199880,18200442,562,0.8076492287254947
7584,606.69,606.724867,1,18200700,18201746,1046,0.8692867747589366
7585,606.729767,606.774567,1,18201893,18203237,1344,0.614216083641845
7586,606.781167,606.7851,1,18203435,18203553,118,0.5501714097420682
7587,606.789233,606.809933,1,18203676,18204297,621,0.83364770098702
7588,606.817467,606.8406,1,18204524,18205218,694,0.7009681639763644
7589,606.846267,606.850533,1,18205388,18205515,127,0.3085603554701939
7590,606.8518,606.906067,1,18205554,18207182,1628,0.6915886616774987
7591,606.9204,606.960467,1,18207612,18208814,1202,0.8042513758316169
7592,607.108067,607.226133,1,18213242,18216783,3541,0.7872016898842298
7593,607.286867,607.292633,1,18218606,18218778,172,-0.035165196703841196
7594,607.4642,607.519933,1,18223926,18225597,1671,0.7399100168211269
7595,607.526467,607.6202,1,18225794,18228606,2812,0.8301345436808714
7596,607.624833,607.628067,1,18228744,18228842,98,-0.04051071010887963
7597,607.649767,607.660433,1,18229493,18229812,319,0.739208669065845
7598,607.662933,607.682333,1,18229887,18230469,582,0.666219250367832
7599,607.6921,607.792967,1,18230763,18233789,3026,0.8242115687948264
7600,607.7942,607.859633,1,18233826,18235788,1962,0.8017462293917762
7601,607.863967,607.8796,1,18235919,18236388,469,0.7448470016964936
7602,607.885133,607.896833,1,18236553,18236904,351,0.5997161494736466
7603,607.9301,607.94,1,18237903,18238200,297,-0.06721938887465222
7604,607.944467,607.951933,1,18238334,18238557,223,0.3617560748818973
7605,607.953767,607.9582,1,18238613,18238746,133,-0.11369733615586024
7606,607.960533,607.966467,1,18238815,18238994,179,0.09795309256101523
7607,607.9732,607.9788,1,18239196,18239364,168,-0.1282915135656123
7608,608.178167,608.206633,1,18245345,18246198,853,0.7344457839729769
7609,608.227333,608.267,1,18246819,18248010,1191,0.7454615836254969
7610,608.2785,608.303867,1,18248355,18249116,761,0.78223411196017
7611,608.311367,608.335133,1,18249341,18250053,712,0.7401684679648203
7612,608.336533,608.362667,1,18250095,18250880,785,0.8325790898587996
7613,608.364533,608.464167,1,18250935,18253925,2990,0.8138391042745355
7614,608.468467,608.4907,1,18254054,18254721,667,0.48320311192218596
7615,608.509033,608.516033,1,18255270,18255480,210,-0.10400032297843899
7616,608.530733,608.5386,1,18255921,18256158,237,0.1123427227231402
7617,608.5489,608.554033,1,18256467,18256620,153,-0.3693513274333724
7618,608.561833,608.5661,1,18256854,18256983,129,-0.5718879013683739
7619,608.5715,608.575167,1,18257145,18257255,110,0.07652201066185592
7620,608.658133,608.793267,1,18259743,18263798,4055,0.7646283865092394
7621,608.795767,608.890233,1,18263873,18266706,2833,0.7365366752936826
7622,608.908233,608.934967,1,18267246,18268049,803,0.05693795401605767
7623,608.936467,608.949667,1,18268094,18268490,396,-0.20397084532267076
7624,608.952067,608.955667,1,18268562,18268670,108,
7625,608.971667,609.182567,1,18269150,18275477,6327,0.7804119007190786
7626,609.2227,609.2344,1,18276681,18277032,351,0.3156799551315105
7627,609.2445,609.249367,1,18277335,18277481,146,
7628,609.352867,609.376,1,18280586,18281280,694,0.42852928739461055
7629,609.386767,609.433333,1,18281603,18282999,1396,0.36072171853666973
7630,609.441733,609.449667,1,18283251,18283490,239,0.011651513079728207
7631,609.468367,609.472033,1,18284051,18284160,109,
7632,609.787433,609.797167,1,18293622,18293915,293,0.4672009713382365
7633,609.8391,609.859167,1,18295173,18295775,602,0.7175278657801342
7634,609.891,609.897333,1,18296730,18296919,189,0.4807324840507399
7635,609.902,609.918933,1,18297060,18297567,507,0.565784842976296
7636,609.921967,609.925633,1,18297659,18297768,109,-0.11592361324530313
7637,609.926667,609.933633,1,18297800,18298008,208,0.9262752486030822
7638,609.974933,609.981433,1,18299247,18299442,195,0.5503264677815682
7639,609.9941,610.006033,1,18299823,18300180,357,0.40708426624221306
7640,610.024167,610.040567,1,18300725,18301217,492,0.4350106614007937
7641,610.0949,610.113233,1,18302847,18303396,549,0.6139414138420629
7642,610.138333,610.146567,1,18304149,18304397,248,0.49525660229540797
7643,610.176067,610.1805,1,18305282,18305415,133,
7644,610.194067,610.2534,1,18305822,18307602,1780,0.14267330793284994
7645,610.254933,610.2589,1,18307647,18307767,120,0.38994573934626514
7646,610.274867,610.285633,1,18308246,18308568,322,0.4728090603232525
7647,610.2879,610.323833,1,18308637,18309714,1077,0.7718189388360528
7648,610.325267,610.383367,1,18309758,18311501,1743,0.7710474565124248
7649,610.406933,610.414233,1,18312207,18312426,219,0.17114202406422185
7650,610.427467,610.431933,1,18312824,18312957,133,-0.01185803590867601
7651,610.4337,610.4376,1,18313011,18313128,117,0.26934887769373045
7652,610.448,610.4523,1,18313440,18313569,129,0.7539127311366187
7653,610.710767,610.835133,1,18321323,18325053,3730,0.5512721946272969
7654,610.840867,610.916433,1,18325226,18327492,2266,0.5524476565461597
7655,610.929467,610.934267,1,18327884,18328028,144,0.16645362762021645
7656,610.9378,610.952567,1,18328134,18328577,443,0.6138903724271316
7657,610.9606,610.967233,1,18328818,18329016,198,0.6050783667388377
7658,610.9853,611.060467,1,18329559,18331814,2255,0.7011427111058672
7659,611.061933,611.066967,1,18331857,18332009,152,-0.07407377691337957
7660,611.068167,611.213167,1,18332045,18336395,4350,0.8202058946580397
7661,611.2243,611.245867,1,18336729,18337376,647,0.09892486975510005
7662,611.2507,611.2637,1,18337521,18337911,390,0.012860128476194055
7663,611.264767,611.2858,1,18337943,18338574,631,0.10278448950660955
7664,611.293267,611.305667,1,18338798,18339170,372,0.20538360147538226
7665,611.325167,611.328833,1,18339755,18339864,109,
7666,611.3414,611.397067,1,18340242,18341912,1670,0.5985771524671017
7667,611.414633,611.428167,1,18342438,18342845,407,0.21237339412609693
7668,611.4326,611.4392,1,18342978,18343176,198,0.09559802085849839
7669,611.492367,611.4997,1,18344771,18344991,220,-0.035948465076934374
7670,611.508233,611.520333,1,18345246,18345609,363,0.8280192173305512
7671,611.521467,611.557567,1,18345644,18346727,1083,0.7433629523000921
7672,611.565233,611.578067,1,18346956,18347342,386,0.8860129203165873
7673,611.590133,611.605267,1,18347703,18348158,455,0.7247411970933612
7674,611.6117,611.615133,1,18348351,18348453,102,-0.017132306020783264
7675,611.617667,611.628833,1,18348530,18348864,334,0.4088109967209294
7676,611.639367,611.647567,1,18349181,18349427,246,0.026978464615148835
7677,611.652467,611.656,1,18349574,18349680,106,0.011630642219883396
7678,611.7064,611.7145,1,18351192,18351435,243,0.09596854680007547
7679,611.735767,611.792767,1,18352073,18353783,1710,0.42535947390237394
7680,611.812133,611.829467,1,18354363,18354884,521,0.33266958839804417
7681,611.888333,611.968467,1,18356649,18359054,2405,0.7225223198429391
7682,611.973733,611.994633,1,18359211,18359838,627,0.75104467892009
7683,612.1187,612.155933,1,18363561,18364677,1116,0.4430666957394088
7684,612.157333,612.161233,1,18364719,18364836,117,0.9179884728593471
7685,612.1905,612.1977,1,18365715,18365931,216,0.30562247661640807
7686,612.201367,612.2082,1,18366041,18366246,205,0.31670794300574606
7687,612.2761,612.4135,1,18368283,18372405,4122,0.79080747658115
7688,612.414733,612.423433,1,18372441,18372702,261,0.4312229543730365
7689,612.428833,612.5038,1,18372864,18375114,2250,0.814685903999216
7690,612.519033,612.524067,1,18375570,18375722,152,0.6953421275714871
7691,612.525533,612.533167,1,18375765,18375995,230,0.44578492034062206
7692,614.6296,614.653033,1,18438888,18439590,702,0.39022837693228846
7693,614.706833,614.7251,1,18441204,18441753,549,0.6359884929235795
7694,614.8135,614.824,1,18444405,18444720,315,0.5902391442902409
7695,614.879333,614.883667,1,18446379,18446510,131,0.5348845132379524
7696,614.885267,614.892967,1,18446558,18446789,231,0.5822668612386707
7697,615.598033,615.616667,1,18467940,18468500,560,0.8706296869605537
7698,615.6183,615.746567,1,18468549,18472397,3848,0.770038195584878
7699,615.752867,615.826367,1,18472586,18474791,2205,0.7460995534539524
7700,615.8363,615.859033,1,18475089,18475770,681,0.7116018025559356
7701,615.866033,615.8819,1,18475980,18476457,477,0.6897435481722585
7702,616.134967,616.243867,1,18484049,18487316,3267,0.8388498108762684
7703,616.363067,616.3678,1,18490892,18491034,142,0.42616638496598563
7704,616.5424,616.567433,1,18496272,18497022,750,0.6421387125560825
7705,616.569433,616.682,1,18497082,18500460,3378,0.7872470598886034
7706,616.719967,616.7357,1,18501599,18502071,472,0.2984570885331988
7707,616.7438,616.765833,1,18502314,18502974,660,0.022534522958232342
7708,616.767567,616.7808,1,18503027,18503424,397,0.14590073694119077
7709,616.782467,616.791067,1,18503474,18503732,258,0.3228883068190202
7710,616.8455,616.8515,1,18505365,18505545,180,0.231286409927089
7711,616.861433,616.897567,1,18505842,18506927,1085,0.4235425518554793
7712,616.900367,616.9313,1,18507011,18507939,928,0.03024954342200928
7713,616.9371,616.951167,1,18508113,18508535,422,-0.048679622623166816
7714,617.000333,617.153967,1,18510009,18514619,4610,0.8190192993225753
7715,617.1679,617.297067,1,18515037,18518912,3875,0.8265106712019057
7716,617.298933,617.370567,1,18518967,18521117,2150,0.6575570147470903
7717,617.3784,617.392833,1,18521352,18521784,432,0.6503624758754297
7718,617.398767,617.445033,1,18521963,18523350,1387,0.7508694339113849
7719,617.4543,617.4582,1,18523629,18523746,117,-0.17376963398878756
7720,617.459467,617.462967,1,18523784,18523889,105,-0.16049314674832477
7721,617.520167,617.542267,1,18525605,18526268,663,0.6567078832579772
7722,617.544433,617.593633,1,18526332,18527808,1476,0.7313529831410398
7723,618.060067,618.064333,1,18541802,18541929,127,
7724,618.073,618.076667,1,18542190,18542300,110,
7725,618.135,618.142767,1,18544050,18544283,233,0.41716006853751764
7726,618.148533,618.251033,1,18544455,18547530,3075,0.8254944116320804
7727,618.355567,618.358967,1,18550667,18550769,102,
7728,618.557867,618.7683,1,18556736,18563049,6313,0.7650751062441031
7729,618.803733,618.808633,1,18564111,18564258,147,-0.052683218826429325
7730,618.8156,618.8221,1,18564468,18564663,195,0.4261212721051266
7731,619.2918,619.303733,1,18578754,18579111,357,0.7002400850467408
7732,619.317933,619.3326,1,18579537,18579978,441,0.6837162349327265
7733,619.338167,619.345567,1,18580145,18580367,222,0.6508917746256924
7734,619.3519,619.3722,1,18580557,18581166,609,0.5715630376805253
7735,619.406733,619.4592,1,18582201,18583776,1575,0.6000720477830263
7736,619.4775,619.496467,1,18584325,18584894,569,0.6369829635008003
7737,619.498967,619.520833,1,18584969,18585624,655,0.598606131308617
7738,619.5318,619.535933,1,18585954,18586077,123,-0.05831606787975504
7739,619.596833,619.607467,1,18587904,18588224,320,-0.21014073857965465
7740,619.610967,619.615833,1,18588329,18588474,145,-0.2197903042323708
7741,619.776867,619.7841,1,18593306,18593523,217,0.5367290429462874
7742,619.7912,619.892767,1,18593736,18596783,3047,0.847429738458939
7743,619.9061,620.068967,1,18597183,18602069,4886,0.6909052396093571
7744,620.298067,620.3928,1,18608942,18611784,2842,0.8249451915720668
7745,620.847267,620.859,1,18625418,18625770,352,0.5601545988221408
7746,620.868367,620.8818,1,18626051,18626454,403,0.264454747563927
7747,620.917867,620.929267,1,18627536,18627878,342,0.06532570295025168
7748,621.0167,621.0205,1,18630501,18630615,114,0.32282636326278685
7749,621.0293,621.0357,1,18630879,18631071,192,0.39251580699253624
7750,621.0485,621.060167,1,18631455,18631805,350,0.45858211049764175
7751,621.077667,621.093833,1,18632330,18632814,484,0.36029992691478063
7752,621.153767,621.157333,1,18634613,18634719,106,0.3650781585787335
7753,621.1603,621.168033,1,18634809,18635040,231,0.539655481642238
7754,621.204267,621.213733,1,18636128,18636411,283,0.5925580883237037
7755,621.2498,621.259767,1,18637494,18637793,299,0.6696878245216022
7756,621.2623,621.2983,1,18637869,18638949,1080,0.08139521714625055
7757,621.300067,621.308067,1,18639002,18639242,240,0.2956893373889149
7758,621.3132,621.318267,1,18639396,18639548,152,
7759,621.3243,621.360567,1,18639729,18640817,1088,0.6089910472456008
7760,621.3641,621.411633,1,18640923,18642348,1425,0.6061340798501865
7761,621.4133,621.448533,1,18642399,18643455,1056,0.764287395933613
7762,621.459467,621.5939,1,18643784,18647817,4033,0.7762421183021994
7763,621.608933,621.6124,1,18648267,18648372,105,-0.2726811435242055
7764,621.791433,621.8006,1,18653742,18654018,276,0.643667235529891
7765,621.801633,621.893133,1,18654048,18656793,2745,0.7260271740084875
7766,621.8981,621.901767,1,18656943,18657053,110,
7767,621.9143,621.9276,1,18657429,18657828,399,-0.009026882226607885
7768,621.931,621.9429,1,18657930,18658287,357,-0.003880735003849768
7769,622.038667,622.047533,1,18661160,18661425,265,0.08257152762486134
7770,622.143133,622.206967,1,18664293,18666209,1916,0.6792822153039557
7771,622.211167,622.305267,1,18666335,18669158,2823,0.6735407773057878
7772,622.3278,622.573667,1,18669834,18677210,7376,0.7221455319283923
7773,622.593733,622.6025,1,18677811,18678075,264,0.01135277793373155
7774,622.604367,622.6201,1,18678131,18678603,472,0.2503071073927673
7775,622.622033,622.6278,1,18678660,18678834,174,0.15983275774895522
7776,622.8557,622.9693,1,18685671,18689079,3408,0.7340837283731252
7777,622.980833,623.056667,1,18689424,18691700,2276,0.7478791855541231
7778,623.061667,623.0871,1,18691850,18692613,763,0.8533960482808077
7779,623.099167,623.105067,1,18692975,18693152,177,0.12672146877553242
7780,623.109,623.1372,1,18693270,18694116,846,-0.06355356135640648
7781,623.138467,623.142767,1,18694154,18694283,129,0.33838691880673555
7782,623.143867,623.168833,1,18694316,18695064,748,0.6465914505183697
7783,623.171933,623.182233,1,18695157,18695466,309,0.03187940420921105
7784,623.183467,623.2557,1,18695504,18697671,2167,0.7775997971647837
7785,623.263333,623.269533,1,18697899,18698085,186,0.0010579222966085183
7786,623.3986,623.4025,1,18701958,18702075,117,
7787,623.413767,623.4406,1,18702413,18703218,805,0.11381237220985134
7788,623.4491,623.4728,1,18703473,18704184,711,-0.03384612222367846
7789,623.474233,623.482467,1,18704226,18704474,248,0.065185584136498
7790,623.494867,623.505233,1,18704846,18705156,310,-0.11306756989856048
7791,623.525833,623.668733,1,18705774,18710061,4287,0.7665729988016063
7792,623.674433,623.705333,1,18710232,18711159,927,0.8043552952757432
7793,623.751867,623.830933,1,18712556,18714927,2371,0.72287922696235
7794,623.832333,623.837567,1,18714969,18715127,158,0.17549695875242555
7795,623.839767,623.844233,1,18715193,18715326,133,0.6225724228838819
7796,623.846367,623.955833,1,18715391,18718674,3283,0.7595889070268529
7797,623.966933,623.973533,1,18719007,18719205,198,-0.08635806980192949
7798,624.004933,624.098133,1,18720147,18722943,2796,0.8051429164057035
7799,624.433567,624.436933,1,18733007,18733107,100,0.3564194949894067
7800,624.441533,624.599333,1,18733245,18737979,4734,0.8219148090028942
7801,624.6069,624.682533,1,18738207,18740475,2268,0.8137720817629903
7802,624.689333,624.727033,1,18740679,18741810,1131,0.7971392403346111
7803,624.765567,624.843033,1,18742967,18745290,2323,0.7932523728020416
7804,624.866533,624.870467,1,18745995,18746114,119,-0.1918310850512292
7805,624.871733,624.8748,1,18746151,18746244,93,
7806,625.3333,625.407567,1,18759999,18762227,2228,0.7992848859611533
7807,625.409733,625.415033,1,18762291,18762450,159,0.0013588735121421432
7808,625.708233,625.7143,1,18771246,18771429,183,0.308451225954285
7809,625.716467,625.719867,1,18771494,18771596,102,0.3994457544632339
7810,625.730433,625.808633,1,18771912,18774258,2346,0.7785247570872327
7811,625.811267,625.817933,1,18774338,18774537,199,0.5967333559948099
7812,625.8252,625.870233,1,18774756,18776106,1350,0.5536680320172058
7813,625.875433,625.9252,1,18776262,18777756,1494,0.48975143859429543
7814,625.931467,625.956833,1,18777944,18778704,760,0.19398772230637565
7815,625.961867,625.9876,1,18778856,18779628,772,0.5420931924534581
7816,625.989267,626.003,1,18779678,18780090,412,0.07423878321062514
7817,626.010833,626.016733,1,18780324,18780501,177,0.49920049510249903
7818,626.025533,626.057067,1,18780765,18781712,947,-0.05684836098169684
7819,626.060067,626.1326,1,18781802,18783978,2176,0.4271434760605079
7820,626.156933,626.274367,1,18784707,18788231,3524,0.8228684739879238
7821,626.2808,626.370333,1,18788424,18791109,2685,0.2965114548935596
7822,626.383933,626.430667,1,18791517,18792920,1403,0.31825458225427955
7823,626.442933,626.483467,1,18793287,18794504,1217,0.0531207832381109
7824,626.533,626.7255,1,18795990,18801765,5775,0.671090096858045
7825,626.760067,626.776767,1,18802802,18803303,501,0.18128323000110963
7826,626.781367,626.7898,1,18803441,18803694,253,0.006057660903391963
7827,626.7917,626.800033,1,18803751,18804000,249,-0.27051401346151904
7828,626.8599,626.866667,1,18805797,18806000,203,0.2520808268302782
7829,626.877233,626.908367,1,18806316,18807251,935,0.4153831101609805
7830,626.922967,626.9616,1,18807689,18808848,1159,-0.03675351535854125
7831,626.994,627.107667,1,18809820,18813230,3410,0.7798550566874096
7832,627.1268,627.130733,1,18813804,18813921,117,0.11959066747057909
7833,627.131967,627.1352,1,18813959,18814056,97,
7834,627.150633,627.160133,1,18814518,18814803,285,0.008519357110399663
7835,627.1617,627.1684,1,18814851,18815052,201,
7836,627.234367,627.3477,1,18817031,18820431,3400,0.785251412319079
7837,627.355267,627.360633,1,18820658,18820818,160,0.16290790243645717
7838,627.361867,627.3739,1,18820856,18821217,361,-0.03649784964634715
7839,627.375833,627.379067,1,18821274,18821372,98,
7840,627.576367,627.5829,1,18827291,18827487,196,0.6363160162463529
7841,627.587133,627.7028,1,18827613,18831084,3471,0.8596293058917127
7842,628.2544,628.259767,1,18847632,18847793,161,0.7417992951134473
7843,628.261133,628.270067,1,18847833,18848102,269,0.6864147488474508
7844,628.3007,628.315567,1,18849021,18849467,446,0.7019883077677356
7845,628.3264,628.379067,1,18849792,18851372,1580,0.7495360250512147
7846,628.3915,628.421067,1,18851745,18852632,887,0.8298612216456838
7847,628.424,628.4929,1,18852720,18854787,2067,0.7582283549309283
7848,628.515333,628.533,1,18855459,18855990,531,0.5360331540048086
7849,628.558667,628.565967,1,18856760,18856979,219,0.15287994010260908
7850,628.567333,628.5745,1,18857019,18857235,216,-0.0625125614984109
7851,628.9128,629.046467,1,18867384,18871394,4010,0.8134103957862244
7852,629.049033,629.155267,1,18871470,18874658,3188,0.8064741232154393
7853,629.158967,629.263867,1,18874769,18877916,3147,0.7980625715645019
7854,629.555067,629.689967,1,18886652,18890699,4047,0.7781791237729503
7855,629.6975,629.7022,1,18890925,18891066,141,-0.22408553463386072
7856,629.735,629.830667,1,18892050,18894920,2870,0.8060954374586609
7857,630.176467,630.184733,1,18905294,18905541,247,0.24123354812384534
7858,630.185833,630.3637,1,18905574,18910911,5337,0.7899696987253504
7859,630.3814,630.397,1,18911442,18911910,468,0.5147333526000114
7860,630.401767,630.406867,1,18912053,18912206,153,0.36117004037704487
7861,630.409933,630.520067,1,18912297,18915602,3305,0.7844710655763149
7862,630.550767,630.568033,1,18916523,18917040,517,0.0926909446349198
7863,630.927833,630.971433,1,18927834,18929142,1308,0.4212284880419463
7864,630.9761,630.999667,1,18929283,18929990,707,0.4249403020993394
7865,631.0521,631.063067,1,18931563,18931892,329,0.7515383216035059
7866,631.093433,631.209933,1,18932802,18936297,3495,0.7796213172035518
7867,631.2203,631.2243,1,18936609,18936729,120,-0.08369972733123127
7868,631.884933,631.897133,1,18956547,18956913,366,0.5461178628419702
7869,631.9057,631.915567,1,18957171,18957467,296,0.5657553411586806
7870,631.975267,631.9892,1,18959258,18959676,418,0.6533974769220672
7871,632.0143,632.023833,1,18960429,18960714,285,0.605959753473386
7872,632.033833,632.045133,1,18961014,18961353,339,0.5856384137656943
7873,632.054733,632.0637,1,18961641,18961911,270,0.8106558832815586
7874,632.093167,632.1092,1,18962795,18963276,481,0.676043625216127
7875,632.132933,632.145333,1,18963987,18964359,372,0.6325635333179332
7876,632.151933,632.159467,1,18964557,18964784,227,0.6387390768472536
7877,632.360833,632.375933,1,18970824,18971277,453,0.7943537277680316
7878,632.3771,632.4687,1,18971313,18974061,2748,0.826726200607527
7879,632.678167,632.849833,1,18980345,18985494,5149,0.8101252837538839
7880,632.864467,632.9076,1,18985934,18987228,1294,0.7901685908215548
7881,632.923167,632.957533,1,18987695,18988725,1030,0.7220473454690867
7882,632.976667,632.980733,1,18989300,18989421,121,0.27280577697759767
7883,632.986267,633.099367,1,18989588,18992981,3393,0.7815292408305038
7884,633.101267,633.1101,1,18993038,18993303,265,-0.19956400290011028
7885,633.185933,633.192633,1,18995577,18995778,201,0.29219773206376176
7886,633.198967,633.389633,1,18995969,19001688,5719,0.7599882396768154
7887,633.7821,633.788433,1,19013463,19013652,189,0.2077506940900298
7888,633.790133,633.8054,1,19013703,19014162,459,0.713151166975278
7889,633.807067,633.813133,1,19014212,19014393,181,0.4230959827053327
7890,633.826067,633.837633,1,19014782,19015128,346,0.669561652194679
7891,633.855867,633.911733,1,19015676,19017351,1675,0.7704729494660183
7892,633.917333,633.9348,1,19017519,19018044,525,0.7533463860534851
7893,633.943033,634.026567,1,19018290,19020797,2507,0.8271773765947339
7894,634.732067,634.738533,1,19041962,19042155,193,0.5677605554908267
7895,634.7565,634.759933,1,19042695,19042797,102,0.5519536149742928
7896,634.788867,634.827033,1,19043666,19044810,1144,0.6723715178550191
7897,634.8482,634.861467,1,19045446,19045844,398,0.6779853950998191
7898,634.8627,634.873267,1,19045881,19046198,317,0.43584584931875203
7899,634.905667,634.9123,1,19047170,19047369,199,0.49153164064543164
7900,634.917167,634.9338,1,19047515,19048014,499,0.5732918237539427
7901,634.954533,634.972167,1,19048635,19049165,530,0.48030553783434227
7902,635.0098,635.0128,1,19050294,19050384,90,
7903,635.0188,635.0365,1,19050564,19051095,531,0.5649872354316509
7904,635.0595,635.067233,1,19051785,19052016,231,0.5179423035624925
7905,635.074,635.080133,1,19052220,19052403,183,0.486940619551095
7906,635.210933,635.218433,1,19056327,19056552,225,0.036467397173933734
7907,635.2244,635.237067,1,19056732,19057112,380,0.7249293011922741
7908,635.2382,635.3247,1,19057146,19059741,2595,0.6481025299076635
7909,635.3764,635.465067,1,19061292,19063952,2660,0.8184936639452087
7910,635.471267,635.557433,1,19064138,19066722,2584,0.8339353452966896
7911,635.575867,635.580667,1,19067276,19067420,144,-0.005818423690489682
7912,635.582467,635.585733,1,19067474,19067571,97,0.04558515704780199
7913,635.591067,635.595,1,19067732,19067850,118,0.5033409834033729
7914,636.202067,636.2069,1,19086062,19086207,145,0.5833333910477609
7915,636.2219,636.2792,1,19086657,19088376,1719,0.7870165266702132
7916,636.2869,636.2983,1,19088607,19088949,342,0.7764655047506186
7917,636.302067,636.405367,1,19089062,19092161,3099,0.7922833032965166
7918,636.410667,636.438233,1,19092320,19093146,826,0.6261004168328238
7919,636.439533,636.466167,1,19093185,19093985,800,0.7631848725498785
7920,636.493,636.5061,1,19094790,19095183,393,0.5531228003291636
7921,636.5095,636.539233,1,19095285,19096176,891,0.6034346961645606
7922,636.540333,636.545967,1,19096209,19096379,170,-0.24216654934528245
7923,636.5713,636.580467,1,19097139,19097414,275,-0.13331199836640828
7924,636.5822,636.598933,1,19097466,19097967,501,-0.10349738836108961
7925,636.600633,636.6044,1,19098018,19098132,114,0.45666767221953025
7926,636.791667,636.8412,1,19103750,19105236,1486,0.6344219053964598
7927,636.8494,636.9295,1,19105482,19107885,2403,0.8322215815037362
7928,636.943867,636.947433,1,19108316,19108422,106,-0.041426460503306624
7929,637.1557,637.338933,1,19114671,19120167,5496,0.7701602354954712
7930,637.3534,637.356933,1,19120602,19120707,105,0.3576723107316568
7931,637.3807,637.388167,1,19121421,19121645,224,0.16113421906399714
7932,637.394733,637.398033,1,19121841,19121940,99,
7933,637.7605,637.7895,1,19132815,19133685,870,0.5364804316622251
7934,637.802333,637.8706,1,19134069,19136118,2049,0.7908907017034084
7935,637.873733,637.9466,1,19136211,19138398,2187,0.6628085976222201
7936,637.950967,638.030033,1,19138529,19140900,2371,0.7432109797196358
7937,638.042233,638.076233,1,19141266,19142286,1020,0.7701061903781421
7938,638.0898,638.1038,1,19142694,19143114,420,0.7885094135749388
7939,638.106567,638.130667,1,19143197,19143920,723,0.4046908935432031
7940,638.140733,638.148933,1,19144221,19144467,246,-0.26454311225079974
7941,638.900267,638.917767,1,19167008,19167533,525,0.6529616182094213
7942,638.9287,638.9486,1,19167861,19168458,597,0.5917137249703351
7943,638.9584,639.000267,1,19168752,19170008,1256,0.7506528695795465
7944,639.0058,639.1636,1,19170174,19174908,4734,0.6649611229478268
7945,639.169333,639.2239,1,19175079,19176717,1638,0.6940302865477612
7946,639.235433,639.250067,1,19177062,19177502,440,0.6017858209878857
7947,639.253333,639.269033,1,19177599,19178070,471,0.6488233248204911
7948,639.308067,639.3147,1,19179242,19179441,199,0.47608262374174987
7949,639.321333,639.331867,1,19179639,19179956,317,-0.10187124914964019
7950,639.347133,639.354167,1,19180413,19180625,212,0.07529521470077902
7951,639.361167,639.3648,1,19180835,19180944,109,-0.021594509640546013
7952,639.419,639.4287,1,19182570,19182861,291,0.5024918281683113
7953,640.274633,640.278367,1,19208238,19208351,113,0.23838093479509603
7954,640.2895,640.351933,1,19208685,19210557,1872,0.8038487242183648
7955,640.3577,640.4226,1,19210731,19212678,1947,0.8615431350306338
7956,640.428633,640.488033,1,19212858,19214640,1782,0.7219138071270853
7957,640.494567,640.5201,1,19214837,19215603,766,0.5598278825979437
7958,640.525433,640.6208,1,19215762,19218624,2862,0.783346285530099
7959,640.623067,640.628033,1,19218692,19218840,148,0.1698538663105655
7960,640.631067,640.634767,1,19218932,19219043,111,
7961,641.1209,641.132367,1,19233627,19233971,344,0.6847186871320955
7962,641.1463,641.172167,1,19234389,19235165,776,0.6647866608660168
7963,641.205967,641.211467,1,19236179,19236344,165,0.8339252216578233
7964,641.2296,641.2398,1,19236888,19237194,306,0.5983852949910137
7965,641.248833,641.2572,1,19237464,19237716,252,0.8236872909047538
7966,641.299567,641.323333,1,19238987,19239699,712,0.6382145002193254
7967,641.354267,641.3577,1,19240628,19240731,103,0.272221420557819
7968,641.373767,641.3837,1,19241213,19241511,298,0.5184057825035797
7969,641.4014,641.414667,1,19242042,19242440,398,0.643986767420693
7970,641.4609,641.471133,1,19243827,19244133,306,0.6280629055988156
7971,641.473867,641.482367,1,19244216,19244471,255,0.6315969823577254
7972,641.516533,641.525733,1,19245495,19245771,276,0.6573791478440256
7973,641.6286,641.649033,1,19248858,19249470,612,0.5943560604030972
7974,641.650467,641.746633,1,19249514,19252398,2884,0.8435770172343596
7975,641.7689,641.775433,1,19253067,19253262,195,0.4554827477176577
7976,641.7854,641.795967,1,19253562,19253879,317,0.3414655402549354
7977,641.796967,641.805067,1,19253909,19254152,243,-0.06362723477696884
7978,641.934367,641.941867,1,19258031,19258256,225,0.6320175951810012
7979,641.949267,642.1026,1,19258478,19263078,4600,0.815188553156868
7980,642.341367,642.359467,1,19270241,19270784,543,0.6622300916989944
7981,642.3705,642.380267,1,19271115,19271408,293,0.7006689980864683
7982,642.4311,642.444533,1,19272933,19273335,402,0.6120355701988855
7983,642.471733,642.517267,1,19274151,19275518,1367,0.683683572633394
7984,642.544933,642.561033,1,19276347,19276830,483,0.733358725202723
7985,642.581433,642.596033,1,19277442,19277880,438,0.7632299287816343
7986,642.597233,642.609867,1,19277916,19278296,380,0.6684680551618494
7987,642.6172,642.631,1,19278516,19278930,414,0.2645872805584142
7988,642.638133,642.6787,1,19279143,19280361,1218,-0.008195073102051378
7989,642.6805,642.692233,1,19280415,19280766,351,0.0033481826774826888
7990,642.705567,642.711633,1,19281167,19281348,181,-0.09781159006279559
7991,642.7159,642.7735,1,19281477,19283205,1728,0.7978426797864134
7992,642.782833,642.8216,1,19283484,19284648,1164,0.7738929238936962
7993,642.833367,642.876133,1,19285001,19286283,1282,-0.014379866548580013
7994,642.899167,643.066633,1,19286975,19291998,5023,0.7987149460344257
7995,643.6158,643.621167,1,19308474,19308635,161,0.6009846597171151
7996,643.625533,643.633433,1,19308765,19309002,237,0.3675573181480489
7997,643.6652,643.7012,1,19309956,19311036,1080,0.7540307379284039
7998,643.730167,643.7504,1,19311905,19312512,607,0.6031617008877559
7999,643.752533,643.7613,1,19312575,19312839,264,0.6082821222275209
8000,643.766133,643.779667,1,19312983,19313390,407,0.8059570783687268
8001,643.816233,643.8345,1,19314486,19315035,549,0.5840501377190835
8002,643.8452,643.888733,1,19315356,19316661,1305,0.6907609582296113
8003,643.890733,643.9087,1,19316721,19317261,540,0.6105858520076045
8004,643.915733,643.924567,1,19317471,19317737,266,0.05176812672286417
8005,643.9711,644.0587,1,19319133,19321761,2628,0.7778696611636804
8006,644.0814,644.084633,1,19322442,19322538,96,
8007,644.087333,644.0907,1,19322619,19322721,102,0.3118998264739705
8008,644.150067,644.1537,1,19324502,19324611,109,0.4084104639794658
8009,644.163133,644.333933,1,19324893,19330017,5124,0.7914733568629093
8010,644.3585,644.3629,1,19330755,19330887,132,0.38129851324327607
8011,644.373633,644.378567,1,19331208,19331357,149,-0.04283638264505469
8012,644.391933,644.413933,1,19331757,19332417,660,0.12391100607680744
8013,644.418133,644.424,1,19332543,19332720,177,-0.06452784232951679
8014,644.449267,644.615567,1,19333478,19338467,4989,0.835351503993382
8015,644.644967,644.6549,1,19339349,19339647,298,0.10455858569767544
8016,644.661467,644.668767,1,19339844,19340063,219,0.418942435585596
8017,645.103633,645.1184,1,19353108,19353552,444,0.5237925547702558
8018,645.137633,645.160767,1,19354128,19354823,695,0.8599737238478504
8019,645.174533,645.185933,1,19355235,19355577,342,0.737285972311839
8020,645.226933,645.256033,1,19356807,19357680,873,0.6926026681952036
8021,645.2591,645.2806,1,19357773,19358418,645,0.6071032839831969
8022,645.2867,645.385367,1,19358601,19361561,2960,0.8137781477439627
8023,645.390333,645.412433,1,19361709,19362372,663,0.6905893047118256
8024,645.4141,645.4345,1,19362423,19363035,612,0.7633814061572979
8025,645.436,645.4608,1,19363080,19363824,744,0.8104551701586359
8026,645.463767,645.522167,1,19363913,19365665,1752,0.7938235155963427
8027,645.5317,645.548367,1,19365951,19366451,500,0.7356505063472766
8028,645.550533,645.561,1,19366515,19366830,315,0.399850995158201
8029,645.5791,645.6004,1,19367373,19368012,639,-0.04483620804962525
8030,645.622433,645.6292,1,19368672,19368876,204,0.26758973870485353
8031,646.0604,646.1549,1,19381812,19384647,2835,0.7922370981641879
8032,646.176633,646.18,1,19385298,19385400,102,
8033,646.571367,646.598533,1,19397141,19397955,814,0.5989073811273801
8034,646.636767,646.647067,1,19399103,19399412,309,0.47269846161244017
8035,646.6659,646.673067,1,19399977,19400192,215,0.6386919389220034
8036,646.692033,646.698767,1,19400760,19400963,203,0.8100108968221726
8037,646.826733,646.837967,1,19404801,19405139,338,0.5788054688084983
8038,646.8446,646.851133,1,19405338,19405533,195,0.6071521894921169
8039,646.8898,646.907933,1,19406694,19407237,543,0.5845409063624799
8040,647.135067,647.140267,1,19414052,19414208,156,0.7469790466273815
8041,647.153033,647.1562,1,19414590,19414686,96,0.6453054892074398
8042,647.161867,647.171933,1,19414856,19415157,301,0.5141560023259328
8043,647.178,647.251,1,19415340,19417530,2190,0.7904364255425664
8044,647.262833,647.2907,1,19417884,19418721,837,0.8060884672745914
8045,647.2944,647.3307,1,19418832,19419921,1089,0.6563965133550733
8046,647.332333,647.385667,1,19419969,19421570,1601,0.6201556833099707
8047,647.401,647.4589,1,19422030,19423767,1737,0.8317667279215722
8048,647.468567,647.484833,1,19424057,19424544,487,0.7492135062493194
8049,647.4901,647.4993,1,19424703,19424979,276,0.5151683512613741
8050,647.734,647.8322,1,19432020,19434966,2946,0.8046985324104756
8051,648.271467,648.4579,1,19448144,19453737,5593,0.7638207033239169
8052,648.4596,648.469167,1,19453788,19454075,287,0.6629215407686007
8053,648.4923,648.5719,1,19454769,19457157,2388,0.7888888344293461
8054,648.600533,648.678767,1,19458015,19460363,2348,0.7710865947868497
8055,649.068933,649.094067,1,19472067,19472822,755,0.5761345229318082
8056,649.0975,649.1054,1,19472925,19473162,237,0.44213886337291913
8057,649.120233,649.143067,1,19473606,19474292,686,0.6304280952263209
8058,649.168933,649.176667,1,19475067,19475300,233,0.8260619499062184
8059,649.193033,649.206533,1,19475790,19476195,405,0.6388029530240524
8060,649.238833,649.249433,1,19477164,19477482,318,0.3777649747109829
8061,649.3253,649.435,1,19479759,19483050,3291,0.7419673705996058
8062,649.466633,649.476367,1,19483998,19484291,293,-0.012607125109318634
8063,649.497433,649.511433,1,19484922,19485342,420,0.08308186233825995
8064,649.5519,649.718167,1,19486557,19491545,4988,0.7976278984173426
8065,649.741267,649.825367,1,19492238,19494761,2523,0.7462702179874021
8066,649.8756,649.951033,1,19496268,19498530,2262,0.786581920765769
8067,650.37,650.3953,1,19511100,19511859,759,0.6973994607487959
8068,650.4057,650.456633,1,19512171,19513698,1527,0.7412746125413611
8069,650.471267,650.5304,1,19514138,19515912,1774,0.7803937048299535
8070,650.535467,650.6101,1,19516064,19518303,2239,0.7219525968006122
8071,650.611867,650.6388,1,19518356,19519164,808,0.43782854422405265
8072,650.64,650.644333,1,19519200,19519329,129,0.5669667252927105
8073,650.654967,650.662,1,19519649,19519860,211,-0.1335728730700929
8074,650.665133,650.707633,1,19519953,19521228,1275,0.10908934774691491
8075,650.732933,650.835767,1,19521987,19525073,3086,0.6202589895755417
8076,650.856633,650.8853,1,19525698,19526559,861,-0.04793099583452193
8077,650.887533,650.892667,1,19526625,19526780,155,0.6769228828928172
8078,650.895633,651.049833,1,19526868,19531494,4626,0.7336376653109188
8079,651.061233,651.0686,1,19531836,19532058,222,0.5006103877883975
8080,651.087033,651.1001,1,19532610,19533003,393,-0.11599437729975262
8081,651.1011,651.1058,1,19533033,19533174,141,-0.12665122649954128
8082,651.111833,651.114867,1,19533354,19533446,92,
8083,651.152067,651.155567,1,19534562,19534667,105,-0.22808827503753995
8084,651.2211,651.2372,1,19536633,19537116,483,0.6585818564752447
8085,651.2395,651.276333,1,19537185,19538289,1104,0.6375986177932726
8086,651.303667,651.3074,1,19539110,19539222,112,0.23436307518607843
8087,651.308833,651.312933,1,19539264,19539387,123,0.7092824053788236
8088,651.5336,651.559667,1,19546008,19546790,782,0.6708664574235685
8089,651.5667,651.6014,1,19547001,19548042,1041,0.7422201575183467
8090,651.605267,651.6598,1,19548158,19549794,1636,0.7833317531172146
8091,651.667067,651.698833,1,19550012,19550964,952,0.7249003048104727
8092,651.7104,651.7633,1,19551312,19552899,1587,0.7808007221753072
8093,651.778833,651.813367,1,19553364,19554401,1037,0.686809392724107
8094,651.815533,651.822267,1,19554465,19554668,203,0.45105308315979836
8095,651.833033,651.8385,1,19554990,19555155,165,-0.07026917108668256
8096,651.844567,651.889833,1,19555337,19556694,1357,-0.003634318281349167
8097,651.9363,652.138967,1,19558089,19564169,6080,0.7454482839462505
8098,652.1481,652.156867,1,19564443,19564706,263,0.31905416669400466
8099,652.158733,652.164,1,19564761,19564920,159,
8100,652.1784,652.1864,1,19565352,19565592,240,0.4301376942541382
8101,652.223767,652.324267,1,19566713,19569728,3015,0.8197904643572017
8102,652.332467,652.337867,1,19569974,19570136,162,0.05735339936945189
8103,652.412767,652.5341,1,19572383,19576023,3640,0.7958579959690086
8104,652.551967,652.623767,1,19576559,19578713,2154,0.8275443072855136
8105,652.630533,652.6744,1,19578915,19580232,1317,0.7941287576708604
8106,652.679733,652.696733,1,19580391,19580901,510,0.6823312180743369
8107,652.697767,652.875867,1,19580933,19586276,5343,0.8118364700740845
8108,652.8875,652.890533,1,19586625,19586715,90,0.5688068493591939
8109,652.895067,652.9481,1,19586852,19588443,1591,0.029753017930110558
8110,652.953867,653.114067,1,19588616,19593422,4806,0.8313562671700466
8111,653.127533,653.177033,1,19593825,19595310,1485,0.1036326206249991
8112,653.1978,653.3075,1,19595934,19599225,3291,0.81020359383313
8113,653.330067,653.344267,1,19599902,19600328,426,-0.00975697183502681
8114,653.3465,653.357033,1,19600395,19600710,315,0.09758099997589491
8115,653.373467,653.488067,1,19601204,19604642,3438,0.8571582489703129
8116,653.790467,653.8968,1,19613714,19616904,3190,0.7828131201412564
8117,653.9102,653.919433,1,19617306,19617582,276,0.7157577123213871
8118,653.922333,653.945067,1,19617669,19618352,683,0.7783055054297057
8119,653.9565,653.965,1,19618695,19618950,255,0.7222335760408454
8120,653.990867,654.002733,1,19619726,19620081,355,-0.05486675365305019
8121,654.008833,654.026833,1,19620264,19620804,540,0.10652448061224647
8122,654.027967,654.036633,1,19620839,19621098,259,0.6121916202046017
8123,654.0599,654.349933,1,19621797,19630497,8700,0.7838642273114521
8124,654.3798,654.392867,1,19631394,19631786,392,0.40035837136748614
8125,654.630867,654.634067,1,19638926,19639022,96,0.24530143919618588
8126,654.643333,654.6551,1,19639299,19639653,354,0.6563839402324566
8127,654.656233,654.7023,1,19639686,19641069,1383,0.7967285851877961
8128,654.7037,654.764567,1,19641111,19642937,1826,0.8326968621800058
8129,654.775967,654.811967,1,19643279,19644359,1080,0.7814205184352724
8130,654.813833,654.844433,1,19644414,19645332,918,0.7197376844876888
8131,654.855567,654.981733,1,19645667,19649451,3784,0.7926970978081466
8132,654.9989,655.002167,1,19649967,19650065,98,
8133,655.0035,655.006633,1,19650105,19650198,93,
8134,655.007667,655.011733,1,19650230,19650351,121,0.003413280255336062
8135,655.018533,655.026967,1,19650555,19650809,254,0.13052541469633383
8136,655.032067,655.0528,1,19650962,19651584,622,0.24102607960370062
8137,655.073533,655.0774,1,19652205,19652322,117,0.5750522377934092
8138,655.082833,655.2453,1,19652484,19657359,4875,0.8520168937198073
8139,655.250667,655.329667,1,19657520,19659890,2370,0.7945008666337418
8140,655.3374,655.341133,1,19660122,19660233,111,0.37413694800354963
8141,655.3439,655.3757,1,19660317,19661271,954,0.7833841043389951
8142,655.393633,655.405133,1,19661808,19662153,345,-0.0935972170044892
8143,655.417067,655.422567,1,19662512,19662677,165,-0.12559199545096755
8144,655.4248,655.427833,1,19662744,19662834,90,
8145,655.431767,655.4395,1,19662953,19663185,232,0.2892709394087615
8146,656.212133,656.215133,1,19686363,19686453,90,
8147,656.347067,656.354933,1,19690412,19690647,235,0.6175608551030047
8148,656.375,656.384433,1,19691250,19691532,282,0.5834860017588194
8149,656.412567,656.4322,1,19692377,19692966,589,0.6355534480911235
8150,656.465367,656.470633,1,19693961,19694118,157,0.26016261126528134
8151,656.4765,656.4899,1,19694295,19694697,402,0.625219635154102
8152,656.493533,656.5106,1,19694805,19695318,513,0.7160409662518666
8153,656.5377,656.541333,1,19696131,19696239,108,0.4601214514538755
8154,656.544633,656.553667,1,19696338,19696610,272,0.5694518491071869
8155,656.578367,656.581867,1,19697351,19697456,105,0.5359800854071165
8156,656.589133,656.601433,1,19697673,19698042,369,0.6214164225450245
8157,656.6589,656.665633,1,19699767,19699968,201,0.011517022804185161
8158,656.713667,657.008967,1,19701410,19710269,8859,0.6638786664537744
8159,657.0607,657.072467,1,19711821,19712174,353,0.38187379345747746
8160,657.080133,657.0834,1,19712403,19712502,99,0.512133181840107
8161,657.0847,657.133167,1,19712541,19713995,1454,0.0526679504477531
8162,657.263467,657.267067,1,19717904,19718012,108,-0.23450680215881428
8163,657.269167,657.275,1,19718075,19718250,175,-0.03608160753179959
8164,657.338733,657.4493,1,19720161,19723479,3318,0.8270899999330052
8165,657.465267,657.47,1,19723958,19724100,142,-0.04224036034586353
8166,657.473833,657.481933,1,19724214,19724457,243,-0.045100513045162306
8167,657.483167,657.489233,1,19724495,19724676,181,-0.09577465487291252
8168,657.492333,657.499033,1,19724769,19724970,201,-0.10169342377147551
8169,657.588733,657.592633,1,19727661,19727778,117,0.510567941560931
8170,657.596367,657.599833,1,19727891,19727994,103,
8171,657.6072,657.645167,1,19728216,19729355,1139,-0.11044198382128592
8172,657.6596,657.666067,1,19729788,19729982,194,-0.22073486190333558
8173,657.6683,657.672133,1,19730049,19730163,114,-0.40878626078673436
8174,657.684767,657.689167,1,19730543,19730675,132,0.00012503790242588707
8175,657.696567,657.8565,1,19730897,19735695,4798,0.8100541797390972
8176,657.861033,657.9081,1,19735830,19737243,1413,0.7374984192929307
8177,657.922767,657.931733,1,19737683,19737951,268,0.3085236205840853
8178,657.972333,658.0806,1,19739169,19742418,3249,0.8110878616097934
8179,658.301133,658.4213,1,19749033,19752639,3606,0.8181375894237229
8180,658.674533,658.933433,1,19760235,19768002,7767,0.8184894518773645
8181,658.934967,659.057933,1,19768049,19771737,3688,0.849017833667529
8182,659.113333,659.205933,1,19773399,19776177,2778,0.7676303705247436
8183,659.213233,659.2163,1,19776396,19776489,93,-0.11630202995714706
8184,659.219167,659.222967,1,19776575,19776689,114,-0.060746802424172255
8185,659.4859,659.496867,1,19784577,19784906,329,0.5513002204586819
8186,659.507933,659.5352,1,19785237,19786056,819,0.7461334389004498
8187,659.536233,659.6002,1,19786086,19788006,1920,0.5827566103488674
8188,659.6181,659.694033,1,19788543,19790820,2277,0.8091626691128664
8189,659.6966,659.7014,1,19790898,19791042,144,0.41649857131444834
8190,659.721267,659.7274,1,19791638,19791822,184,0.6221232720501355
8191,659.735833,659.800033,1,19792074,19794000,1926,0.8298751469450477
8192,659.803033,659.8073,1,19794090,19794219,129,0.44115617415995967
8193,659.816767,659.9068,1,19794503,19797204,2701,0.7845696180525125
8194,659.9164,659.920267,1,19797492,19797608,116,0.05127090290609881
8195,659.921467,659.9402,1,19797644,19798206,562,-0.01744901583561356
8196,659.9443,659.9515,1,19798329,19798545,216,-0.09384493471713909
8197,660.0041,660.017,1,19800123,19800510,387,0.37637561075405207
8198,660.0205,660.0287,1,19800615,19800861,246,0.4293164561501957
8199,660.031333,660.128967,1,19800939,19803869,2930,0.787030460679227
8200,660.145767,660.148867,1,19804373,19804466,93,
8201,660.4068,660.5244,1,19812204,19815732,3528,0.8716228254052624
8202,660.6917,660.717733,1,19820751,19821531,780,0.6365336432912849
8203,660.7278,660.8484,1,19821834,19825452,3618,0.8185926770441373
8204,660.849433,660.9507,1,19825482,19828521,3039,0.7452243216799485
8205,660.9586,660.986667,1,19828758,19829600,842,-0.036793383070888815
8206,660.987967,660.998133,1,19829639,19829943,304,0.2695789797414774
8207,661.001767,661.008833,1,19830053,19830264,211,-0.02332155253978737
8208,661.040033,661.110267,1,19831200,19833308,2108,0.7722156908910126
8209,661.1114,661.253433,1,19833342,19837602,4260,0.8336826994180259
8210,661.2836,661.2869,1,19838508,19838607,99,0.06194763317323416
8211,661.289833,661.297467,1,19838694,19838924,230,0.07862689296664566
8212,661.306667,661.310433,1,19839200,19839312,112,0.0551139446335181
8213,661.465767,661.4748,1,19843973,19844244,271,0.6540776780944088
8214,661.476167,661.537167,1,19844285,19846115,1830,0.7981756083325067
8215,661.5392,661.5576,1,19846176,19846728,552,0.8043285069644671
8216,661.561367,661.602667,1,19846841,19848080,1239,0.8431865352532423
8217,661.6191,661.628433,1,19848573,19848852,279,-0.013277157317579462
8218,661.632433,661.635567,1,19848972,19849067,95,0.18701323925565946
8219,661.636933,661.670933,1,19849107,19850127,1020,-0.106031647078359
8220,661.721033,661.832533,1,19851630,19854975,3345,0.7755862768209635
8221,661.843533,661.855167,1,19855305,19855655,350,-0.08214837513830343
8222,661.8565,661.879567,1,19855695,19856387,692,-0.05086247474041567
8223,661.880967,661.8843,1,19856429,19856529,100,0.38205489050046404
8224,661.8855,661.893267,1,19856565,19856798,233,0.6670793550493028
8225,661.916967,661.923167,1,19857509,19857695,186,0.15909220529999046
8226,661.925833,662.1034,1,19857774,19863102,5328,0.7805103840766023
8227,662.104733,662.159133,1,19863141,19864773,1632,0.5243291227438731
8228,662.1656,662.244967,1,19864968,19867349,2381,0.8253986253804865
8229,662.2462,662.253233,1,19867386,19867596,210,0.3270261916610665
8230,662.255233,662.263567,1,19867656,19867907,251,-0.09655415880351985
8231,662.264567,662.2681,1,19867937,19868043,106,
8232,662.272033,662.2817,1,19868160,19868451,291,-0.1404761029949007
8233,662.287067,662.294533,1,19868612,19868835,223,-0.1814904450937952
8234,662.296133,662.302,1,19868883,19869060,177,-0.0496557978373796
8235,662.526467,662.8282,1,19875794,19884846,9052,0.7125109603431142
8236,662.86,662.8655,1,19885800,19885965,165,
8237,663.3993,663.412533,1,19901979,19902375,396,-0.0180161154518359
8238,663.423833,663.4288,1,19902714,19902864,150,-0.11437828750496074
8239,663.463367,663.471867,1,19903901,19904156,255,0.5811272920820209
8240,663.5032,663.516133,1,19905096,19905483,387,0.5956793448614045
8241,663.521467,663.5394,1,19905644,19906182,538,0.8183465724148912
8242,663.560967,663.5649,1,19906829,19906947,118,-0.15706191522949842
8243,663.569967,663.581067,1,19907099,19907432,333,0.5649991530892907
8244,663.582067,663.588333,1,19907462,19907649,187,0.2946734152380101
8245,663.6535,663.659533,1,19909605,19909785,180,0.15138176125567337
8246,663.671967,663.683333,1,19910159,19910499,340,0.5491556698106903
8247,663.739133,663.742133,1,19912173,19912263,90,0.657106434563032
8248,663.743267,663.7541,1,19912298,19912623,325,0.6021037101472534
8249,663.794867,663.8053,1,19913846,19914159,313,0.5103220996222496
8250,663.9479,664.062333,1,19918437,19921869,3432,0.4295432832801446
8251,664.088267,664.103933,1,19922648,19923117,469,0.3933537761403136
8252,664.105267,664.1093,1,19923158,19923279,121,
8253,664.112633,664.226667,1,19923378,19926800,3422,0.8641111869767887
8254,664.229167,664.2355,1,19926875,19927065,190,-0.10647050397078453
8255,664.402567,664.407033,1,19932077,19932210,133,-0.2277841117892271
8256,664.419133,664.542333,1,19932573,19936269,3696,0.833935242822112
8257,664.938133,664.944833,1,19948143,19948344,201,0.7026279553816835
8258,664.947,665.063933,1,19948410,19951917,3507,0.6505494169792534
8259,665.0702,665.090833,1,19952106,19952724,618,0.6887840002261343
8260,665.0922,665.153933,1,19952766,19954617,1851,0.6492591987380885
8261,665.1677,665.188433,1,19955031,19955652,621,0.6835868069210734
8262,665.1906,665.210033,1,19955718,19956300,582,0.5722094517972683
8263,665.237233,665.246533,1,19957116,19957395,279,0.49512781868685585
8264,665.247967,665.2678,1,19957439,19958034,595,0.5753203993790803
8265,665.283867,665.307867,1,19958516,19959236,720,0.6367820972893014
8266,665.329667,665.372433,1,19959890,19961172,1282,0.2123384808560863
8267,665.3736,665.381333,1,19961208,19961439,231,-0.03570403290549038
8268,665.392167,665.566033,1,19961765,19966980,5215,0.8370754176806693
8269,665.593567,665.597133,1,19967807,19967913,106,0.8924737512958429
8270,665.5996,665.802333,1,19967988,19974069,6081,0.7510776584415421
8271,665.8246,665.827633,1,19974738,19974828,90,
8272,665.830533,665.842033,1,19974915,19975260,345,0.10025865956865197
8273,666.237,666.2409,1,19987110,19987227,117,0.643014124123629
8274,666.244467,666.259433,1,19987334,19987782,448,0.6745225653960518
8275,666.282433,666.290533,1,19988472,19988715,243,0.49911027316686957
8276,666.308067,666.333233,1,19989242,19989996,754,0.8445956519505735
8277,666.334567,666.363367,1,19990037,19990901,864,0.696149729774786
8278,666.3717,666.391733,1,19991151,19991751,600,0.8134425154697199
8279,666.3954,666.472,1,19991862,19994160,2298,0.7832829367529607
8280,666.4751,666.550233,1,19994253,19996506,2253,0.7631525560153951
8281,666.554167,666.565833,1,19996625,19996974,349,0.7416436573329565
8282,666.5728,666.5796,1,19997184,19997388,204,0.9242924423562017
8283,666.587167,666.659867,1,19997615,19999796,2181,0.8133731572098907
8284,666.6942,666.7076,1,20000826,20001228,402,-0.08760329067611203
8285,666.713033,666.7195,1,20001390,20001585,195,-0.18039418554662423
8286,666.720733,666.731733,1,20001621,20001951,330,-0.04697537094336446
8287,666.7391,666.742167,1,20002173,20002265,92,
8288,666.868933,667.0601,1,20006067,20011803,5736,0.8139230416865884
8289,667.087367,667.095867,1,20012621,20012876,255,0.020217493827343017
8290,667.583033,667.6178,1,20027490,20028534,1044,0.5864026617206204
8291,667.650867,667.690433,1,20029526,20030712,1186,0.6957177082128838
8292,668.207933,668.248667,1,20046237,20047460,1223,0.5762373961692214
8293,668.2566,668.3071,1,20047698,20049213,1515,0.6565783341991461
8294,668.485367,668.499467,1,20054561,20054984,423,0.6283963416299121
8295,668.503233,668.5115,1,20055096,20055345,249,0.6092636927691703
8296,668.553,668.561967,1,20056590,20056859,269,0.8036330821788421
8297,668.563567,668.5706,1,20056907,20057118,211,0.6574200110847546
8298,668.708567,668.885367,1,20061257,20066561,5304,0.8325853870130782
8299,668.8864,668.976867,1,20066592,20069306,2714,0.8324396651011704
8300,669.000367,669.003533,1,20070011,20070105,94,-0.1430328637716856
8301,669.022633,669.0266,1,20070678,20070798,120,
8302,669.110633,669.1695,1,20073318,20075085,1767,0.66501130884862
8303,669.177233,669.2217,1,20075316,20076651,1335,0.7621462834908126
8304,669.2451,669.249067,1,20077353,20077472,119,0.4300405691840191
8305,669.2508,669.2553,1,20077524,20077659,135,-0.17952804492557042
8306,669.271933,669.276333,1,20078157,20078289,132,0.09318293918818839
8307,669.3271,669.3321,1,20079813,20079963,150,0.46751014149562725
8308,669.333133,669.5437,1,20079993,20086311,6318,0.8215169460286286
8309,669.558967,669.5641,1,20086769,20086923,154,-0.06750389746818448
8310,669.566067,669.5719,1,20086982,20087157,175,-0.07443819586088926
8311,669.5736,669.577167,1,20087208,20087315,107,0.04726561909470402
8312,669.588633,669.594667,1,20087658,20087840,182,-0.11802864764073526
8313,669.884567,669.8962,1,20096537,20096886,349,0.6924158524818219
8314,669.904333,669.9342,1,20097129,20098026,897,0.7532623544525725
8315,669.957267,669.974267,1,20098718,20099228,510,0.8158469184143575
8316,669.988033,670.037433,1,20099640,20101122,1482,0.6146723411285627
8317,670.042433,670.0663,1,20101272,20101989,717,0.6810500640235486
8318,670.082333,670.098733,1,20102469,20102961,492,0.7619404865034582
8319,670.115567,670.1353,1,20103467,20104059,592,0.789358685284851
8320,670.137767,670.149967,1,20104133,20104499,366,0.6844548191462895
8321,670.164,670.169267,1,20104920,20105078,158,0.05814678799999022
8322,670.173967,670.229467,1,20105219,20106884,1665,0.03680087823126246
8323,670.2586,670.358733,1,20107758,20110761,3003,0.6858994307261017
8324,670.369933,670.477767,1,20111097,20114333,3236,0.8150400314986543
8325,670.722533,670.7415,1,20121675,20122245,570,0.7002336095498711
8326,670.7425,670.746733,1,20122275,20122401,126,0.040002062750087004
8327,670.9762,670.994467,1,20129286,20129834,548,0.561428355095047
8328,670.996267,671.0288,1,20129888,20130864,976,0.7651905143382477
8329,671.0298,671.0329,1,20130894,20130987,93,0.6828816833043994
8330,671.0341,671.0845,1,20131023,20132535,1512,0.7596531615252835
8331,671.105,671.113067,1,20133150,20133392,242,-0.09239592844778165
8332,671.133667,671.139667,1,20134010,20134190,180,0.042274353891675436
8333,671.152233,671.1574,1,20134566,20134722,156,0.16382090447866426
8334,671.2414,671.3588,1,20137242,20140764,3522,0.8189787882491643
8335,671.372333,671.381567,1,20141169,20141447,278,0.258912346842914
8336,671.382567,671.3922,1,20141477,20141766,289,-0.01642739502916747
8337,672.5242,672.560633,1,20175726,20176818,1092,0.6467235874593765
8338,672.5836,672.600533,1,20177508,20178015,507,0.5860246376634523
8339,673.1685,673.204467,1,20195055,20196134,1079,0.6224217891582677
8340,673.2403,673.2481,1,20197209,20197443,234,0.5610399277499593
8341,673.256767,673.261133,1,20197703,20197833,130,0.24365401143296672
8342,673.2667,673.277567,1,20198001,20198327,326,0.763011903428526
8343,673.304267,673.3096,1,20199128,20199288,160,0.4344350925254925
8344,673.3159,673.3299,1,20199477,20199897,420,0.6073283367339682
8345,673.335933,673.364733,1,20200077,20200941,864,0.6614296440290106
8346,673.387733,673.426167,1,20201631,20202785,1154,0.7579599117499539
8347,673.439633,673.442933,1,20203188,20203287,99,0.455974058809874
8348,673.444033,673.4589,1,20203320,20203767,447,0.49293185937964784
8349,673.508067,673.536767,1,20205242,20206103,861,0.7654266286442035
8350,673.5455,673.557233,1,20206365,20206716,351,0.8340834017519207
8351,673.566,673.577933,1,20206980,20207337,357,0.624978235138717
8352,673.600833,673.655133,1,20208024,20209653,1629,0.30186699013018053
8353,673.684733,673.696067,1,20210541,20210882,341,0.6533782331613902
8354,673.6973,673.7471,1,20210919,20212413,1494,0.8635674971466928
8355,673.748367,673.7938,1,20212451,20213814,1363,0.8165978821757595
8356,673.811767,673.839233,1,20214353,20215176,823,0.039644186238717224
8357,673.8404,673.8632,1,20215212,20215896,684,0.23237403828136458
8358,673.927833,673.941967,1,20217834,20218259,425,0.44287163024027876
8359,673.955,674.0659,1,20218650,20221977,3327,0.7381612242434182
8360,674.0691,674.144367,1,20222073,20224331,2258,0.8208939326975256
8361,674.153133,674.1578,1,20224593,20224734,141,0.32155847815183
8362,674.159333,674.162767,1,20224779,20224883,104,0.12268455595439086
8363,674.164867,674.1703,1,20224946,20225109,163,0.07653846621329154
8364,674.173733,674.177267,1,20225211,20225318,107,
8365,674.539,674.545667,1,20236170,20236370,200,0.6418766843994512
8366,674.547133,674.554933,1,20236413,20236647,234,0.7541571029341275
8367,674.581933,674.600467,1,20237457,20238014,557,0.7764197595904384
8368,674.609767,674.660433,1,20238293,20239812,1519,0.7910603162946874
8369,674.668567,674.6941,1,20240057,20240823,766,0.8166766295477843
8370,674.708667,674.7644,1,20241260,20242932,1672,0.7994185080383648
8371,674.776433,674.8121,1,20243292,20244363,1071,0.6751570995744165
8372,674.8301,674.880233,1,20244903,20246406,1503,-0.008920679723055026
8373,674.910333,675.042433,1,20247309,20251272,3963,0.7610965147453634
8374,675.054233,675.0627,1,20251626,20251881,255,0.5779205127412032
8375,675.0669,675.1556,1,20252007,20254668,2661,0.819352909968321
8376,675.188767,675.194233,1,20255663,20255826,163,0.11759900556999217
8377,675.204233,675.207833,1,20256126,20256234,108,-0.14093661381932585
8378,675.209733,675.217267,1,20256291,20256518,227,0.0673316596727539
8379,675.4837,675.5099,1,20264511,20265297,786,0.6288572563007765
8380,675.5289,675.6636,1,20265867,20269908,4041,0.8069986656693826
8381,675.672167,675.6793,1,20270165,20270379,214,0.4120936479828544
8382,675.683367,675.6881,1,20270501,20270643,142,-0.12130104862592336
8383,675.692067,675.7293,1,20270762,20271879,1117,0.734166975248272
8384,675.7504,675.754767,1,20272512,20272643,131,0.3356811711387643
8385,675.7563,675.759667,1,20272689,20272790,101,
8386,675.765033,675.794333,1,20272950,20273829,879,-0.16049503615870214
8387,675.795667,675.814,1,20273870,20274420,550,-0.07859597987006323
8388,675.8306,675.996067,1,20274918,20279882,4964,0.8387361079860242
8389,676.216733,676.222133,1,20286501,20286663,162,0.2626508694745756
8390,676.3686,676.373133,1,20291058,20291193,135,0.5518636399823335
8391,676.471933,676.478533,1,20294157,20294355,198,0.7397825646963848
8392,676.482633,676.487333,1,20294478,20294619,141,0.5512545664161974
8393,676.495467,676.5775,1,20294864,20297325,2461,0.8280474231920918
8394,676.582733,676.660367,1,20297481,20299811,2330,0.667453690988158
8395,676.661367,676.664633,1,20299841,20299938,97,0.5962412147403382
8396,676.6715,676.708467,1,20300145,20301254,1109,0.7045666273120177
8397,676.7255,676.7648,1,20301765,20302944,1179,0.7606277293939057
8398,676.7749,676.786533,1,20303247,20303595,348,0.6081401661016872
8399,676.798167,676.807067,1,20303945,20304212,267,0.3938484016206241
8400,676.816667,676.8846,1,20304500,20306538,2038,0.3406958827530318
8401,676.920533,676.995433,1,20307615,20309862,2247,0.702612927489477
8402,677.0071,677.031967,1,20310213,20310959,746,0.6940534181085469
8403,677.0332,677.041633,1,20310996,20311248,252,0.26639432326993623
8404,677.042867,677.049633,1,20311286,20311488,202,0.028503140097845766
8405,677.051767,677.138433,1,20311553,20314152,2599,0.497798545426505
8406,677.1473,677.166667,1,20314419,20315000,581,-0.0061965052710471315
8407,677.176233,677.214,1,20315286,20316420,1134,0.058932295954232806
8408,677.2208,677.226433,1,20316624,20316792,168,0.29352271878983816
8409,677.239467,677.2497,1,20317184,20317491,307,-0.07106992105639325
8410,677.255033,677.278,1,20317650,20318340,690,0.3631462075868781
8411,677.2812,677.347433,1,20318436,20320422,1986,-0.10279549956871646
8412,677.352833,677.373667,1,20320584,20321210,626,0.2882447190870036
8413,677.382,677.4265,1,20321460,20322795,1335,0.39787862296377546
8414,677.431867,677.462367,1,20322956,20323871,915,0.5936869082189924
8415,677.465667,677.475,1,20323970,20324250,280,0.1683924471461935
8416,677.4813,677.494367,1,20324439,20324831,392,0.5538526562896526
8417,677.508367,677.525467,1,20325251,20325764,513,0.4762473118100991
8418,677.5309,677.557067,1,20325927,20326712,785,0.6814438104604842
8419,677.579033,677.5829,1,20327370,20327487,117,0.23890026051491403
8420,677.592267,677.5971,1,20327768,20327913,145,0.6421554947701217
8421,677.599667,677.613233,1,20327990,20328396,406,0.4680652340812788
8422,677.623567,677.651967,1,20328707,20329559,852,0.1043766397179656
8423,677.653,677.6706,1,20329590,20330118,528,0.1554797665652376
8424,677.6725,677.6829,1,20330175,20330487,312,0.10315483290541055
8425,677.691,677.6951,1,20330730,20330853,123,0.43118742345415634
8426,677.713333,677.7194,1,20331399,20331582,183,0.3888871443101704
8427,677.745967,677.763767,1,20332379,20332913,534,0.26922640136842835
8428,677.779467,677.786467,1,20333384,20333594,210,0.020842587558292002
8429,677.7962,677.802033,1,20333886,20334060,174,
8430,677.803533,677.8133,1,20334105,20334399,294,0.29442101942413657
8431,677.866133,677.975767,1,20335983,20339273,3290,0.7776647352665507
8432,677.9779,677.995267,1,20339337,20339858,521,0.2451921441872095
8433,677.998367,678.0579,1,20339951,20341737,1786,0.12423696103786645
8434,678.065233,678.0694,1,20341956,20342082,126,-0.1813583611351835
8435,678.092133,678.103667,1,20342763,20343110,347,0.3731921599109947
8436,678.1149,678.143167,1,20343447,20344295,848,0.420823580640639
8437,678.149167,678.199767,1,20344475,20345993,1518,0.04649061577868988
8438,678.2365,678.335733,1,20347095,20350071,2976,0.7963461551415765
8439,678.355333,678.368833,1,20350659,20351064,405,0.5483196280837168
8440,678.384,678.406667,1,20351520,20352200,680,-0.10692953147064446
8441,678.4954,678.5003,1,20354862,20355009,147,0.4515890235386917
8442,678.6697,678.6868,1,20360091,20360604,513,0.7328843395814045
8443,678.6921,678.717433,1,20360763,20361522,759,0.7726329535188672
8444,678.720867,678.7468,1,20361626,20362404,778,0.7050203241161036
8445,678.772167,678.7894,1,20363165,20363682,517,0.5734057583476361
8446,678.798767,678.807467,1,20363963,20364224,261,0.6490768525007287
8447,678.8468,678.8571,1,20365404,20365713,309,0.6394030899657335
8448,678.858167,678.865267,1,20365745,20365958,213,0.3734141664485408
8449,678.889767,678.8968,1,20366693,20366904,211,0.47236487252863046
8450,678.8992,678.906933,1,20366976,20367207,231,0.4891788055237711
8451,678.913567,678.9313,1,20367407,20367939,532,0.569593006243366
8452,678.944233,678.9522,1,20368326,20368566,240,0.5377852498280126
8453,678.976633,678.981067,1,20369298,20369432,134,0.2116279999734364
8454,678.991267,679.014433,1,20369738,20370432,694,-0.0030403452548315685
8455,679.015767,679.040533,1,20370473,20371215,742,0.23334438451164616
8456,679.041733,679.045667,1,20371251,20371370,119,-0.00904411661587574
8457,679.054933,679.168033,1,20371647,20375040,3393,0.7281716996469199
8458,679.209667,679.219,1,20376290,20376570,280,0.3813935034387544
8459,679.2203,679.2424,1,20376609,20377272,663,-0.00659961427577179
8460,679.2444,679.253033,1,20377332,20377590,258,0.17918001383839008
8461,679.2544,679.2739,1,20377632,20378217,585,0.07998680474726172
8462,679.4641,679.591667,1,20383923,20387750,3827,0.7938593531927197
8463,679.595933,679.689567,1,20387877,20390687,2810,0.8154493008039011
8464,679.6942,679.7035,1,20390826,20391105,279,0.6887969120838002
8465,679.7172,679.7777,1,20391516,20393331,1815,0.8542042841510384
8466,679.797667,679.834833,1,20393930,20395044,1114,0.7863152367248569
8467,679.881,679.884467,1,20396430,20396534,104,0.41153090652329705
8468,679.8869,679.9549,1,20396607,20398647,2040,0.7832188064091197
8469,679.970533,679.976467,1,20399115,20399294,179,-0.06342378660022448
8470,680.191033,680.335967,1,20405730,20410079,4349,0.824240848952778
8471,680.3421,680.4122,1,20410263,20412366,2103,0.7905861693529607
8472,680.4223,680.5104,1,20412669,20415312,2643,0.7931779822099396
8473,680.523333,680.532033,1,20415699,20415960,261,-0.11266891606297516
8474,680.540433,680.553733,1,20416212,20416611,399,0.23594568834257343
8475,680.557433,680.570167,1,20416722,20417105,383,0.08589366671177895
8476,680.887667,680.9291,1,20426630,20427873,1243,0.44057712934645377
8477,680.9303,680.981633,1,20427909,20429448,1539,0.5164677067487509
8478,681.0053,681.0997,1,20430159,20432991,2832,0.8127098054456073
8479,681.131367,681.1351,1,20433941,20434053,112,0.4425469967813987
8480,681.143667,681.152333,1,20434310,20434569,259,-0.04600381621835809
8481,681.204567,681.211867,1,20436137,20436356,219,0.009782154151523953
8482,681.218467,681.3237,1,20436554,20439711,3157,0.815206669464206
8483,681.334067,681.3484,1,20440022,20440452,430,-0.089070950699733
8484,681.3589,681.362233,1,20440767,20440866,99,0.06547207159128918
8485,681.374333,681.3809,1,20441229,20441427,198,0.3737586647791248
8486,681.421567,681.447767,1,20442647,20443433,786,0.7228509865897547
8487,681.449267,681.579833,1,20443478,20447394,3916,0.81527995190322
8488,681.5906,681.6983,1,20447718,20450949,3231,0.7619130234747093
8489,681.7072,681.715267,1,20451216,20451458,242,0.505447711681535
8490,681.723033,681.756833,1,20451690,20452704,1014,-0.03516473587880805
8491,681.7579,681.7667,1,20452737,20453001,264,0.08446196939197408
8492,681.768567,681.895333,1,20453057,20456859,3802,0.8051088385300463
8493,681.913533,681.924567,1,20457405,20457737,332,-0.06041508142259842
8494,681.929433,681.934133,1,20457882,20458023,141,
8495,681.9355,681.954733,1,20458065,20458641,576,0.10025033947490118
8496,681.988033,682.005267,1,20459640,20460158,518,0.805926929901605
8497,682.007967,682.092933,1,20460239,20462787,2548,0.7637015854624892
8498,682.100133,682.123967,1,20463003,20463719,716,0.754619924945708
8499,682.133467,682.14,1,20464004,20464200,196,-0.08375450929876008
8500,682.1423,682.297833,1,20464269,20468934,4665,0.783501735871261
8501,682.351033,682.355733,1,20470530,20470671,141,0.09755241354821895
8502,682.710867,682.738867,1,20481326,20482166,840,0.669147916500798
8503,682.750167,682.803967,1,20482505,20484119,1614,0.8449849850537356
8504,682.808733,682.815633,1,20484261,20484468,207,0.4913050244795491
8505,682.8178,682.848833,1,20484534,20485464,930,0.760824700289976
8506,682.8704,682.953167,1,20486112,20488595,2483,0.6429934907905801
8507,682.9574,683.114167,1,20488722,20493425,4703,0.7649906793171957
8508,683.1494,683.154033,1,20494482,20494620,138,0.9266875940783269
8509,683.2107,683.3149,1,20496321,20499447,3126,0.780984980041637
8510,683.325167,683.330767,1,20499755,20499923,168,0.7354989191503849
8511,683.338667,683.350067,1,20500160,20500502,342,-0.0030706255056090963
8512,683.3517,683.3572,1,20500551,20500716,165,0.019579255964999924
8513,683.368467,683.3743,1,20501054,20501229,175,0.34791898278961253
8514,683.375533,683.382133,1,20501265,20501463,198,0.5756483710763518
8515,683.386367,683.413133,1,20501591,20502393,802,0.6863934666425587
8516,683.4155,683.614767,1,20502465,20508443,5978,0.8005300546168763
8517,683.618633,683.6718,1,20508558,20510154,1596,0.6654491261956054
8518,683.6842,683.6987,1,20510526,20510961,435,0.5576860903712199
8519,683.7026,683.7196,1,20511078,20511588,510,0.5384323198392411
8520,683.745967,683.763133,1,20512379,20512893,514,-0.08979497274455986
8521,683.764233,683.773333,1,20512926,20513199,273,-0.14160305183438648
8522,683.787,683.904833,1,20513610,20517144,3534,0.8105855627168356
8523,683.912667,683.921067,1,20517380,20517632,252,0.5366915915888378
8524,683.9272,683.9775,1,20517816,20519325,1509,-0.02269439440544009
8525,683.996733,684.049567,1,20519901,20521487,1586,0.6576008055041678
8526,684.0579,684.1024,1,20521737,20523072,1335,0.7322252548250009
8527,684.107033,684.116033,1,20523210,20523480,270,0.3756986773712964
8528,684.1234,684.134567,1,20523702,20524037,335,-0.015878365508873386
8529,684.1356,684.139233,1,20524068,20524176,108,-0.11100332543009148
8530,684.183267,684.436167,1,20525498,20533085,7587,0.7758102243383077
8531,684.745033,684.750167,1,20542350,20542505,155,0.7635748755461047
8532,684.753933,684.7615,1,20542617,20542845,228,0.48271263240906226
8533,684.773167,684.7769,1,20543195,20543307,112,0.3185020295765039
8534,684.7807,684.7917,1,20543421,20543751,330,0.1608586259417883
8535,684.794767,684.805,1,20543843,20544150,307,0.32076000919385833
8536,684.807167,684.8236,1,20544215,20544708,493,0.2047770515406648
8537,684.861067,684.871567,1,20545832,20546147,315,0.1631641804738369
8538,684.888633,684.9048,1,20546658,20547144,486,0.01348691918281962
8539,684.906167,684.919633,1,20547185,20547588,403,0.3896630464618818
8540,684.924167,685.003367,1,20547725,20550101,2376,0.7965058947687026
8541,685.004867,685.126867,1,20550146,20553806,3660,0.719128044606265
8542,685.1282,685.141133,1,20553846,20554233,387,0.6075655238409938
8543,685.158267,685.2398,1,20554748,20557194,2446,0.7608947949670193
8544,685.2409,685.3194,1,20557227,20559582,2355,0.7828893141758454
8545,685.320967,685.3273,1,20559629,20559819,190,0.19589125926714612
8546,685.3291,685.362067,1,20559873,20560862,989,0.7137386085520777
8547,685.373067,685.414933,1,20561192,20562447,1255,-0.02630069966121881
8548,685.427067,685.431333,1,20562812,20562939,127,0.7880604718109312
8549,685.432467,685.551333,1,20562974,20566539,3565,0.7329481004357351
8550,685.574833,685.578167,1,20567244,20567345,101,
8551,685.596067,685.599267,1,20567882,20567978,96,
8552,685.6007,685.719533,1,20568021,20571585,3564,0.8729609091302238
8553,685.7211,685.787167,1,20571633,20573615,1982,0.7723277756840932
8554,685.808867,685.813067,1,20574266,20574392,126,0.0001576904225924636
8555,685.8158,685.819533,1,20574474,20574585,111,
8556,685.821467,685.8272,1,20574644,20574816,172,0.13472532391060998
8557,685.831433,685.8346,1,20574942,20575038,96,-0.494549625829206
8558,686.376067,686.3856,1,20591282,20591568,286,0.5117890710358102
8559,686.387333,686.3933,1,20591619,20591799,180,0.6017297739823081
8560,686.433767,686.456367,1,20593013,20593691,678,0.6097280202132714
8561,686.4841,686.491833,1,20594523,20594754,231,0.48160886852932544
8562,686.493433,686.5341,1,20594802,20596023,1221,0.5997688290992409
8563,686.564767,686.576567,1,20596943,20597297,354,0.5092729682521001
8564,686.5788,686.598833,1,20597364,20597964,600,0.4668869221211763
8565,686.618467,686.631933,1,20598554,20598957,403,0.556164680899318
8566,686.685467,686.691,1,20600564,20600730,166,0.7174645217547819
8567,686.693333,686.703267,1,20600799,20601098,299,0.5769994801577102
8568,686.724067,686.732933,1,20601722,20601987,265,0.5757343772782741
8569,686.739867,686.7567,1,20602196,20602701,505,0.7260182410275149
8570,686.799133,686.8094,1,20603973,20604282,309,-0.09015517940069577
8571,686.810633,686.838533,1,20604318,20605155,837,0.12238806761978867
8572,686.8607,686.866467,1,20605821,20605994,173,-0.27124558900517304
8573,686.8727,687.033033,1,20606181,20610990,4809,0.7402282904855217
8574,687.048133,687.132567,1,20611443,20613977,2534,0.7904031869658534
8575,687.133633,687.191667,1,20614008,20615750,1742,0.7787996294551797
8576,687.228733,687.234567,1,20616861,20617037,176,0.0974596305305407
8577,687.235933,687.246867,1,20617077,20617406,329,0.29013406617723425
8578,687.2917,687.307367,1,20618751,20619221,470,0.8081940333729416
8579,687.309767,687.343533,1,20619293,20620305,1012,0.7423615127568433
8580,687.344867,687.351467,1,20620346,20620544,198,0.3889002918637748
8581,687.355133,687.396633,1,20620653,20621898,1245,0.669866938810966
8582,687.411233,687.4247,1,20622336,20622741,405,-0.08982353877000845
8583,687.442767,687.447167,1,20623283,20623415,132,
8584,687.453433,687.5745,1,20623602,20627235,3633,0.8248459640508143
8585,687.597733,687.664367,1,20627931,20629931,2000,0.8064835277149853
8586,687.6802,687.6891,1,20630406,20630673,267,0.695783978525859
8587,687.6913,687.717967,1,20630739,20631539,800,0.6227730693102282
8588,688.044267,688.0979,1,20641328,20642937,1609,0.7646107359270986
8589,688.099267,688.1046,1,20642978,20643138,160,0.5925388664120866
8590,688.106167,688.117933,1,20643185,20643537,352,0.14969759043533337
8591,688.603133,688.608367,1,20658093,20658251,158,0.6447821158112881
8592,688.6306,688.666533,1,20658918,20659995,1077,0.697364966207695
8593,688.6977,688.714433,1,20660931,20661432,501,0.6634914650805817
8594,688.7213,688.726367,1,20661639,20661791,152,0.7948987083722205
8595,688.733,688.7764,1,20661990,20663292,1302,0.39464058093408644
8596,688.785767,688.792367,1,20663573,20663771,198,0.5454927425719344
8597,688.799767,688.809,1,20663993,20664270,277,0.5264934882581288
8598,688.812933,688.8188,1,20664387,20664564,177,0.5463255788669363
8599,688.837867,688.841367,1,20665136,20665241,105,0.34799282136231635
8600,688.842467,688.846667,1,20665274,20665400,126,0.03386457205994628
8601,688.858033,688.874667,1,20665740,20666240,500,-0.018826408179962117
8602,688.876,688.886967,1,20666280,20666609,329,0.21429283718008918
8603,688.892533,688.9063,1,20666775,20667189,414,0.2200977929846222
8604,688.9208,688.929,1,20667624,20667870,246,0.29973526158933256
8605,688.93,689.065233,1,20667900,20671956,4056,0.5912881583253844
8606,689.0787,689.1944,1,20672361,20675832,3471,0.603981592006942
8607,689.198933,689.269833,1,20675967,20678094,2127,0.7327108666102474
8608,689.281633,689.3288,1,20678448,20679864,1416,0.5837527335785618
8609,689.340933,689.358733,1,20680227,20680761,534,0.167794433426073
8610,689.360567,689.3888,1,20680817,20681664,847,0.12652180199729612
8611,689.3933,689.422167,1,20681799,20682665,866,0.6902543575767502
8612,689.4238,689.545733,1,20682714,20686371,3657,0.8027577406234783
8613,689.564633,689.5889,1,20686938,20687667,729,0.7637587021364837
8614,689.590167,689.6238,1,20687705,20688714,1009,0.714335981184635
8615,689.643267,689.705933,1,20689298,20691177,1879,0.8632007733220393
8616,689.7101,689.716833,1,20691303,20691504,201,0.5472928665530132
8617,689.726033,689.729667,1,20691780,20691890,110,-0.041200131535816
8618,689.7309,689.7588,1,20691927,20692764,837,0.7708457423887701
8619,689.762033,689.8455,1,20692860,20695365,2505,0.5485828209071856
8620,689.861,689.8714,1,20695830,20696142,312,-0.022281714563142787
8621,689.872967,689.8776,1,20696189,20696328,139,-0.08712008150895022
8622,689.889667,689.902333,1,20696690,20697069,379,-0.07417839340293685
8623,689.918233,690.038533,1,20697546,20701155,3609,0.8158440433697026
8624,690.090867,690.210567,1,20702726,20706317,3591,0.8030388533808981
8625,690.212067,690.216033,1,20706362,20706480,118,0.49055757320915244
8626,690.221667,690.227333,1,20706650,20706819,169,0.09814296840200669
8627,690.2314,690.234467,1,20706942,20707034,92,0.026397143710080638
8628,690.748767,690.777933,1,20722463,20723337,874,0.5816635480329829
8629,690.838733,690.845133,1,20725161,20725353,192,0.5019847896173896
8630,691.225367,691.249533,1,20736761,20737485,724,0.6787251117450229
8631,691.2528,691.2568,1,20737584,20737704,120,-0.20112748173058723
8632,691.258833,691.2621,1,20737764,20737863,99,
8633,691.2755,691.359667,1,20738265,20740790,2525,0.7423328181799747
8634,691.7847,691.795233,1,20753541,20753856,315,0.6952985272753028
8635,691.8018,691.831067,1,20754054,20754932,878,0.7055700959384353
8636,691.854133,691.871833,1,20755623,20756154,531,0.6911309121615231
8637,691.884933,691.898867,1,20756547,20756966,419,0.3910836906843161
8638,691.909067,691.9504,1,20757272,20758512,1240,0.5286469612834267
8639,691.974733,691.9933,1,20759241,20759799,558,0.7452143621212394
8640,692.012133,692.045167,1,20760363,20761355,992,0.7710010913485911
8641,692.072667,692.090233,1,20762180,20762706,526,-0.025391529065815262
8642,692.0926,692.121133,1,20762778,20763633,855,0.14832892907609802
8643,692.1412,692.1444,1,20764236,20764332,96,
8644,692.146867,692.164733,1,20764406,20764941,535,0.3591199979667657
8645,692.165967,692.2471,1,20764979,20767413,2434,0.765293015624842
8646,692.2528,692.256333,1,20767584,20767689,105,0.6010793054997662
8647,692.272633,692.293067,1,20768178,20768792,614,-0.03284072919875364
8648,692.301133,692.306167,1,20769033,20769185,152,0.23468237428625124
8649,692.335033,692.401033,1,20770050,20772030,1980,0.5621963777327035
8650,692.481467,692.485,1,20774444,20774550,106,-0.011814181367998566
8651,692.489333,692.703667,1,20774679,20781110,6431,0.7859587085372824
8652,693.135433,693.1604,1,20794062,20794812,750,0.8035184343764363
8653,693.172367,693.2219,1,20795171,20796657,1486,0.778198204848153
8654,693.2248,693.264467,1,20796744,20797934,1190,0.6334057502999959
8655,693.266467,693.2714,1,20797994,20798142,148,0.11009380115413565
8656,693.273633,693.280567,1,20798208,20798417,209,0.8114438859935291
8657,693.299233,693.355867,1,20798976,20800676,1700,0.6542303558063335
8658,693.3601,693.381433,1,20800803,20801442,639,0.6387909160162318
8659,693.382533,693.388033,1,20801475,20801640,165,0.2310271238498439
8660,693.389033,693.441767,1,20801670,20803253,1583,0.5586815758920671
8661,693.4452,693.497067,1,20803356,20804912,1556,0.5447171757269009
8662,693.513067,693.518567,1,20805392,20805557,165,0.6381362832431032
8663,693.519733,693.5299,1,20805591,20805897,306,0.6290038785219296
8664,693.532,693.552,1,20805960,20806560,600,0.6641621636551546
8665,693.563967,693.571667,1,20806919,20807150,231,0.6411892335336402
8666,693.636033,693.6509,1,20809080,20809527,447,0.07813802370944725
8667,693.6858,693.825333,1,20810574,20814759,4185,0.81358987780478
8668,693.8356,693.943333,1,20815068,20818299,3231,0.7902307238011413
8669,693.9453,693.9549,1,20818359,20818647,288,0.36286279888643036
8670,693.9743,693.9778,1,20819229,20819334,105,
8671,693.984867,693.989967,1,20819546,20819699,153,-0.014919373182524965
8672,694.041067,694.066133,1,20821232,20821983,751,0.22153578210701697
8673,694.0673,694.102133,1,20822019,20823063,1044,0.7659740195604361
8674,694.103367,694.153733,1,20823101,20824611,1510,0.7907581417375049
8675,694.166033,694.209433,1,20824980,20826282,1302,0.012630587953640325
8676,694.228167,694.4354,1,20826845,20833062,6217,0.8036262176016958
8677,694.454033,694.4602,1,20833620,20833806,186,0.4821749750755583
8678,694.470367,694.496567,1,20834111,20834897,786,0.005938417860933214
8679,694.499033,694.6037,1,20834970,20838111,3141,0.7821161176806308
8680,694.6053,694.6333,1,20838159,20838999,840,0.8638699572635233
8681,694.638233,694.649233,1,20839146,20839476,330,0.21704545730262767
8682,694.659133,694.668267,1,20839773,20840048,275,-0.010127632656957125
8683,694.670567,694.6985,1,20840117,20840955,838,0.20059323335489065
8684,694.728767,694.866967,1,20841863,20846009,4146,0.8049874025595527
8685,694.8929,694.898867,1,20846787,20846966,179,-0.0834572815150944
8686,695.043067,695.1368,1,20851292,20854104,2812,0.8077826156978539
8687,695.161067,695.165133,1,20854832,20854953,121,-0.09626009516027316
8688,695.1776,695.2193,1,20855328,20856579,1251,0.7444983244326872
8689,695.227633,695.236867,1,20856828,20857106,278,0.5701550676217381
8690,695.239433,695.243967,1,20857182,20857319,137,0.38353734287964975
8691,695.246067,695.252067,1,20857382,20857562,180,0.3808868339844904
8692,695.2937,695.302133,1,20858811,20859063,252,-0.060440699907621104
8693,695.306933,695.310767,1,20859207,20859323,116,0.47075295723297744
8694,695.324733,695.3313,1,20859741,20859939,198,0.4288680378312642
8695,695.337133,695.545033,1,20860113,20866350,6237,0.8263989272045946
8696,695.553733,695.6072,1,20866611,20868216,1605,0.72172618308675
8697,695.609667,695.652667,1,20868290,20869580,1290,0.7382532424100182
8698,695.674367,695.733267,1,20870231,20871998,1767,0.814378986398083
8699,695.741667,695.747767,1,20872250,20872433,183,0.25833295543884954
8700,695.761733,695.775667,1,20872851,20873270,419,-0.05297393286850267
8701,695.777367,695.785967,1,20873321,20873579,258,-0.08339663218520461
8702,695.803233,695.8145,1,20874096,20874435,339,-0.0644937295548367
8703,695.839833,695.871533,1,20875194,20876145,951,0.15103564766164723
8704,695.8893,696.150067,1,20876679,20884502,7823,0.8345911682112083
8705,696.151067,696.159467,1,20884532,20884784,252,0.708332182849602
8706,696.1623,696.2386,1,20884869,20887158,2289,0.7876930467485473
8707,696.2398,696.252267,1,20887194,20887568,374,0.5585078544229446
8708,696.253733,696.264467,1,20887611,20887934,323,0.7524591054804713
8709,696.265633,696.3639,1,20887968,20890917,2949,0.8260237305334481
8710,696.3664,696.373867,1,20890992,20891216,224,0.7658720345537184
8711,696.377133,696.4704,1,20891313,20894112,2799,0.8112379895022113
8712,696.471733,696.497833,1,20894151,20894934,783,0.7644482842777708
8713,696.4996,696.591433,1,20894988,20897742,2754,0.8459860315438299
8714,696.5934,696.615167,1,20897802,20898455,653,0.616939335401674
8715,696.622167,696.7145,1,20898665,20901435,2770,0.7550047607138738
8716,696.717067,696.738767,1,20901512,20902163,651,0.5840850463055006
8717,696.740267,696.743733,1,20902208,20902311,103,0.6372825236846387
8718,696.745867,696.839933,1,20902376,20905197,2821,0.8219284339831757
8719,696.842667,696.865167,1,20905280,20905955,675,0.8631912157322258
8720,696.8716,696.984933,1,20906148,20909547,3399,0.8426374959400658
8721,696.9871,696.996567,1,20909613,20909897,284,0.7653887343770198
8722,696.999633,697.093267,1,20909988,20912798,2810,0.8642152025834257
8723,697.095533,697.121367,1,20912865,20913641,776,0.7995973495719864
8724,697.124733,697.221233,1,20913741,20916636,2895,0.8258885213847201
8725,697.223467,697.249533,1,20916704,20917485,781,0.8173914637047741
8726,697.2529,697.350033,1,20917587,20920500,2913,0.8041818052912422
8727,697.351533,697.3786,1,20920545,20921358,813,0.8322180431548393
8728,697.382467,697.474367,1,20921474,20924231,2757,0.8145104067107761
8729,697.480733,697.492267,1,20924421,20924768,347,0.8079724224765095
8730,697.509733,697.564433,1,20925291,20926932,1641,0.7731893552371047
8731,697.585733,697.600233,1,20927571,20928006,435,0.8045232996399043
8732,697.607867,697.621433,1,20928236,20928642,406,0.473344481603957
8733,697.6244,697.6309,1,20928732,20928927,195,0.17050063691080067
8734,697.635733,697.692867,1,20929071,20930786,1715,0.5607433903887497
8735,697.696067,697.7267,1,20930882,20931801,919,0.7459517030545004
8736,697.731667,697.750367,1,20931950,20932511,561,0.6956141743866635
8737,697.7618,697.798967,1,20932854,20933969,1115,0.7726869225699725
8738,697.800833,697.815367,1,20934024,20934461,437,0.710016038225131
8739,697.8363,697.8503,1,20935089,20935509,420,0.7754249445784676
8740,697.856033,697.859833,1,20935680,20935794,114,0.665151371375835
8741,697.867333,697.878467,1,20936019,20936354,335,0.5260984946144736
8742,697.8797,697.9553,1,20936391,20938659,2268,0.7434753567822102
8743,697.975033,697.980367,1,20939250,20939411,161,-0.07867369741838794
8744,697.982033,697.993833,1,20939460,20939814,354,-0.12262870862207999
8745,697.9949,698.002667,1,20939847,20940080,233,-0.14407362609022442
8746,698.305667,698.3236,1,20949170,20949708,538,0.6943281929989704
8747,698.324667,698.3335,1,20949740,20950005,265,0.4524993289326656
8748,698.363567,698.380167,1,20950907,20951405,498,0.6099507049021268
8749,698.409833,698.413033,1,20952294,20952390,96,0.694542854245075
8750,698.744033,698.923067,1,20962320,20967692,5372,0.7832514615935655
8751,698.929033,698.985633,1,20967870,20969568,1698,0.826336392430882
8752,698.996067,699.001367,1,20969882,20970041,159,0.8836473397467592
8753,699.0044,699.035467,1,20970132,20971064,932,0.7663582611424556
8754,699.0684,699.0717,1,20972052,20972151,99,-0.2547151213999939
8755,699.0745,699.081867,1,20972235,20972456,221,0.01740483874293975
8756,699.439433,699.4493,1,20983182,20983479,297,0.5746130552820938
8757,699.4522,699.485267,1,20983566,20984558,992,0.5286601711383426
8758,699.503733,699.604533,1,20985111,20988135,3024,0.8239032000297989
8759,699.9715,699.986967,1,20999145,20999609,464,0.7230267818210874
8760,699.9922,699.995967,1,20999766,20999879,113,0.3878054368968491
8761,700.0088,700.048467,1,21000264,21001454,1190,0.7001487922758558
8762,700.0526,700.062233,1,21001578,21001866,288,0.6712674843789316
8763,700.085067,700.123,1,21002552,21003690,1138,0.778767929378299
8764,700.143467,700.193033,1,21004304,21005790,1486,0.6381085781285477
8765,700.208667,700.227967,1,21006260,21006839,579,0.8208156475649212
8766,700.234533,700.262767,1,21007035,21007883,848,0.38472709630460583
8767,700.2673,700.288267,1,21008019,21008648,629,0.4021502296740934
8768,700.297533,700.314233,1,21008925,21009426,501,0.42482963467173557
8769,700.336367,700.353867,1,21010091,21010616,525,0.18502880919984702
8770,700.375933,700.388267,1,21011277,21011648,371,0.7732592455580393
8771,700.399033,700.4143,1,21011970,21012429,459,0.755753883784865
8772,700.434067,700.444833,1,21013022,21013344,322,0.015240998944027468
8773,700.446467,700.46,1,21013394,21013800,406,0.07142135058731798
8774,700.461133,700.4819,1,21013833,21014457,624,0.12093386732414489
8775,700.5037,700.6059,1,21015111,21018177,3066,0.6596024578254488
8776,700.620167,700.645333,1,21018605,21019359,754,0.6847202955795769
8777,700.650867,700.755067,1,21019526,21022652,3126,0.7577212843238456
8778,700.7751,700.841133,1,21023253,21025233,1980,0.5165263867822241
8779,700.853067,700.9648,1,21025592,21028944,3352,0.780759484061554
8780,700.988233,700.996633,1,21029646,21029898,252,-0.0086927622332642
8781,701.009,701.176233,1,21030270,21035286,5016,0.8087839493501785
8782,701.199133,701.208567,1,21035973,21036257,284,-0.045088936665151395
8783,701.209567,701.221433,1,21036287,21036642,355,-0.09027777386657171
8784,701.2243,701.2433,1,21036729,21037299,570,0.06983150740404652
8785,701.2464,701.252033,1,21037392,21037560,168,-0.1296070232270218
8786,701.287233,701.4165,1,21038616,21042495,3879,0.7646281440229562
8787,701.435533,701.557833,1,21043065,21046734,3669,0.7939721773681669
8788,702.422933,702.428033,1,21072687,21072840,153,0.46261704038887386
8789,702.472767,702.489167,1,21074183,21074675,492,0.7945938419131824
8790,702.495133,702.5128,1,21074853,21075384,531,0.7340432004177246
8791,702.516767,702.520933,1,21075503,21075627,124,0.690986223128312
8792,702.525867,702.572833,1,21075776,21077184,1408,0.7604277843341731
8793,702.589467,702.702567,1,21077684,21081077,3393,0.8000103635425025
8794,702.707867,702.7777,1,21081236,21083331,2095,0.7862960838425301
8795,702.789633,702.7977,1,21083688,21083931,243,0.5727951944881313
8796,702.8037,702.8271,1,21084111,21084813,702,0.7618455512376346
8797,702.8418,702.845033,1,21085254,21085350,96,
8798,702.851867,702.8999,1,21085556,21086997,1441,0.01930285628264506
8799,702.9109,702.914533,1,21087327,21087435,108,0.40635743927653784
8800,702.921233,703.132867,1,21087636,21093986,6350,0.7497087970205224
8801,703.1554,703.164067,1,21094662,21094922,260,-0.06525052167020523
8802,703.165767,703.170233,1,21094973,21095106,133,0.009187264881644185
8803,703.1765,703.179667,1,21095295,21095390,95,0.6290852739881386
8804,703.245867,703.250067,1,21097376,21097502,126,0.518754950490353
8805,703.2537,703.3852,1,21097611,21101556,3945,0.7818850355797885
8806,703.417133,703.431233,1,21102513,21102936,423,-0.03016876610896949
8807,703.4323,703.4589,1,21102969,21103767,798,0.08646463004731778
8808,703.716767,703.724433,1,21111503,21111732,229,0.45629359475388626
8809,703.735033,703.761667,1,21112050,21112850,800,0.605829703638692
8810,703.7776,703.822067,1,21113328,21114662,1334,0.7199574020610755
8811,703.8408,703.873467,1,21115224,21116204,980,0.7821452247149301
8812,703.905333,703.920233,1,21117159,21117606,447,0.6720848132913662
8813,703.940667,703.981333,1,21118220,21119439,1219,0.596145666703287
8814,704.006467,704.017667,1,21120194,21120530,336,0.620199652782106
8815,704.0197,704.026367,1,21120591,21120791,200,0.5199209846455994
8816,704.045667,704.0527,1,21121370,21121581,211,0.7452313538373833
8817,704.060633,704.081867,1,21121818,21122456,638,0.044945071619958296
8818,704.0833,704.0902,1,21122499,21122706,207,0.13172253271194606
8819,704.092233,704.104533,1,21122766,21123135,369,0.2356285514914392
8820,704.115133,704.1201,1,21123453,21123603,150,-0.07192838206102345
8821,704.124933,704.2308,1,21123747,21126924,3177,0.7760374350251307
8822,704.251133,704.283667,1,21127533,21128510,977,-0.003393407625064429
8823,704.2857,704.294867,1,21128571,21128846,275,-0.13097078936858397
8824,704.307,704.518633,1,21129210,21135558,6348,0.7783531912216939
8825,704.5235,704.5417,1,21135705,21136251,546,0.7895060351755115
8826,704.563867,704.571067,1,21136916,21137132,216,-0.047591331729846684
8827,704.574333,704.577367,1,21137229,21137321,92,-0.28518029009743073
8828,704.582867,704.5872,1,21137486,21137616,130,-0.2012210808283761
8829,704.720733,704.7822,1,21141621,21143466,1845,0.7985083912720722
8830,704.785033,704.798733,1,21143550,21143961,411,0.47561412436540645
8831,705.571333,705.5832,1,21167139,21167496,357,0.6821961677318283
8832,705.593767,705.600267,1,21167813,21168008,195,0.46454241910619637
8833,705.632567,705.6388,1,21168977,21169164,187,0.6314430903993705
8834,705.674167,705.686733,1,21170225,21170601,376,0.7411885546935828
8835,705.6946,705.7048,1,21170838,21171144,306,0.7054162628456243
8836,705.740067,705.762133,1,21172202,21172863,661,0.6285451182754099
8837,705.7958,705.7999,1,21173874,21173997,123,0.38128572105422187
8838,705.841933,705.8543,1,21175257,21175629,372,0.4690433570433087
8839,705.9101,705.926833,1,21177303,21177804,501,0.6985489339497255
8840,705.957767,705.9663,1,21178733,21178989,256,0.5749485199193969
8841,705.972933,705.980133,1,21179187,21179403,216,0.500372372876705
8842,706.124933,706.131533,1,21183747,21183945,198,0.40499877516418026
8843,706.149467,706.204433,1,21184484,21186132,1648,0.7910537751322315
8844,706.218667,706.2513,1,21186560,21187539,979,0.7446447532526879
8845,706.263767,706.267467,1,21187913,21188024,111,0.6409609113023707
8846,706.354633,706.364867,1,21190638,21190946,308,0.359333925322312
8847,706.393167,706.397967,1,21191795,21191939,144,0.23246256464554238
8848,706.493867,706.497133,1,21194816,21194913,97,-0.10619190443567232
8849,706.498167,706.617667,1,21194945,21198530,3585,0.8707020603789172
8850,706.9014,706.905067,1,21207042,21207152,110,0.7197956071981807
8851,706.917533,706.974367,1,21207525,21209231,1706,0.8473775680319724
8852,706.9768,707.033833,1,21209304,21211014,1710,0.8274022754261796
8853,707.035533,707.083967,1,21211065,21212519,1454,0.7792572956131947
8854,707.105133,707.1233,1,21213153,21213699,546,-0.053415246757869315
8855,707.1293,707.140233,1,21213879,21214206,327,-0.06034113922100401
8856,707.1461,707.1518,1,21214383,21214554,171,-0.21124657724345605
8857,707.227133,707.338033,1,21216813,21220140,3327,0.7120901175253629
8858,707.510867,707.688433,1,21225326,21230652,5326,0.8421089215016907
8859,707.6953,707.749033,1,21230859,21232470,1611,0.8355661248436875
8860,707.753467,707.768967,1,21232604,21233069,465,0.747838537416474
8861,707.7731,707.782667,1,21233193,21233480,287,0.3494497185384244
8862,707.8204,707.824233,1,21234612,21234726,114,-0.1569357931594587
8863,707.830767,707.835533,1,21234923,21235065,142,0.23271747590132152
8864,707.8492,707.853633,1,21235476,21235608,132,
8865,708.036233,708.111967,1,21241086,21243359,2273,0.8011655379711635
8866,708.126933,708.262467,1,21243807,21247874,4067,0.824700094594261
8867,708.283167,708.336833,1,21248495,21250104,1609,0.7506387751620557
8868,708.3479,708.381167,1,21250437,21251435,998,0.6542136327169104
8869,708.4057,708.4165,1,21252171,21252495,324,-0.0925059722082725
8870,708.4195,708.456067,1,21252585,21253682,1097,-0.011050188798533402
8871,708.469567,708.473767,1,21254087,21254213,126,0.4616292824604299
8872,708.478267,708.723133,1,21254348,21261693,7345,0.8249406389631138
8873,709.107333,709.133533,1,21273219,21274005,786,0.3350181292054783
8874,709.161167,709.1801,1,21274835,21275403,568,0.45275682798262423
8875,709.229233,709.232333,1,21276876,21276969,93,0.06712647794854726
8876,709.309033,709.319433,1,21279270,21279582,312,0.53132198736675
8877,709.320433,709.4571,1,21279612,21283713,4101,0.8244931360119986
8878,709.4706,709.536267,1,21284118,21286088,1970,0.8026675595621318
8879,709.539533,709.5648,1,21286185,21286944,759,0.7758796922005832
8880,709.6049,709.696667,1,21288147,21290900,2753,0.764187025595344
8881,709.714367,709.7189,1,21291431,21291567,136,0.11210438229563006
8882,709.7248,709.729433,1,21291744,21291882,138,-0.16347452362822093
8883,709.803433,709.808067,1,21294102,21294242,140,0.8046618311492907
8884,709.810967,709.990867,1,21294329,21299726,5397,0.8100174563993479
8885,710.385433,710.4169,1,21311562,21312507,945,0.6414709166262554
8886,710.451933,710.465533,1,21313557,21313965,408,0.7610351427866752
8887,710.7772,710.8709,1,21323316,21326127,2811,0.8170906664826432
8888,710.8875,710.902333,1,21326625,21327069,444,-0.08293764216027498
8889,710.905067,710.918167,1,21327152,21327545,393,-0.1522177168731138
8890,710.9192,710.924033,1,21327576,21327720,144,-0.23462678502912254
8891,711.059567,711.0859,1,21331787,21332577,790,0.49391453791368
8892,711.099,711.173667,1,21332970,21335210,2240,0.8042489483173837
8893,711.187533,711.192033,1,21335625,21335760,135,0.09332194049386636
8894,711.4229,711.4334,1,21342687,21343002,315,0.32017378045784567
8895,711.441933,711.515733,1,21343257,21345471,2214,0.800293209622411
8896,711.520933,711.5685,1,21345627,21347055,1428,0.8081030428355555
8897,711.5979,711.6205,1,21347937,21348615,678,0.798597961574735
8898,711.623533,711.630967,1,21348705,21348929,224,0.4561180292297136
8899,711.639467,711.6983,1,21349184,21350949,1765,0.7872317376556579
8900,711.719867,711.745,1,21351596,21352350,754,0.4379440270358199
8901,711.760567,711.768133,1,21352817,21353043,226,-0.062370795621238685
8902,711.770067,711.780267,1,21353102,21353408,306,0.07529520310089853
8903,711.783933,711.8167,1,21353517,21354501,984,0.0716584441752502
8904,711.8521,711.9866,1,21355563,21359598,4035,0.8127951812556836
8905,711.996667,712.0076,1,21359900,21360228,328,0.3910302568605729
8906,712.0113,712.099133,1,21360339,21362973,2634,0.7859943701602724
8907,712.136733,712.1524,1,21364101,21364572,471,0.07193921414850316
8908,712.154233,712.161833,1,21364626,21364854,228,-0.028094509324825448
8909,712.164333,712.176433,1,21364929,21365292,363,0.33499261896168625
8910,712.7469,712.7572,1,21382407,21382716,309,0.2444939818084051
8911,712.779867,712.799333,1,21383396,21383979,583,0.8109120914668982
8912,712.826,712.8492,1,21384780,21385476,696,0.8255471601842564
8913,712.852667,712.8742,1,21385580,21386226,646,0.7134295288811549
8914,712.880967,712.935967,1,21386429,21388079,1650,0.7118639824154164
8915,712.938233,713.0176,1,21388146,21390528,2382,0.7579577722298085
8916,713.0261,713.1026,1,21390783,21393078,2295,0.8019088664738079
8917,713.116933,713.120567,1,21393507,21393617,110,0.9699284861562377
8918,713.122567,713.147667,1,21393677,21394430,753,0.658071388702019
8919,713.163433,713.171867,1,21394902,21395156,254,0.07907381248849375
8920,713.176133,713.185733,1,21395283,21395571,288,0.11173692237574144
8921,713.191933,713.2147,1,21395757,21396441,684,-0.0138349097937716
8922,713.215733,713.222367,1,21396471,21396671,200,
8923,713.302267,713.309267,1,21399068,21399278,210,-0.3544173434914363
8924,713.311567,713.353133,1,21399347,21400593,1246,0.6434044877367813
8925,713.354433,713.393867,1,21400632,21401816,1184,0.7722439754050574
8926,713.419667,713.434567,1,21402590,21403037,447,-0.040936359619143985
8927,713.436167,713.4415,1,21403085,21403245,160,
8928,713.458133,713.469767,1,21403743,21404093,350,0.3072623863759343
8929,713.603867,713.631967,1,21408116,21408959,843,0.6993212192140509
8930,713.6341,713.647833,1,21409023,21409434,411,0.6239456431997324
8931,713.6525,713.735733,1,21409575,21412071,2496,0.7907114338505883
8932,713.911933,713.932333,1,21417357,21417969,612,0.4288383859919227
8933,713.933767,713.936767,1,21418013,21418103,90,0.22791856592241058
8934,713.953167,713.9605,1,21418595,21418815,220,-0.004991962010208265
8935,714.178833,714.187133,1,21425364,21425613,249,0.6243620045113959
8936,714.1927,714.200933,1,21425781,21426027,246,0.5103095552622543
8937,714.228667,714.2495,1,21426860,21427485,625,0.5607849321006798
8938,714.2852,714.319333,1,21428556,21429579,1023,0.5051034048679128
8939,714.3302,714.3641,1,21429906,21430923,1017,0.6133511585435584
8940,714.389233,714.476033,1,21431676,21434280,2604,0.5778217337094291
8941,714.4951,714.512467,1,21434853,21435374,521,0.579954600903964
8942,714.5154,714.538967,1,21435462,21436169,707,0.5050059313668087
8943,714.562767,714.569567,1,21436883,21437087,204,0.5699663816972071
8944,714.572633,714.593367,1,21437178,21437801,623,0.6091482873761197
8945,714.607233,714.624233,1,21438216,21438726,510,0.42146827713158364
8946,714.651033,714.6672,1,21439530,21440016,486,-0.05639556258070107
8947,714.670167,714.702967,1,21440105,21441089,984,0.13478408258364893
8948,714.7062,714.878633,1,21441186,21446358,5172,0.6827221209038107
8949,714.882033,714.966933,1,21446460,21449007,2547,0.7967756153886036
8950,714.9931,714.9977,1,21449793,21449931,138,-0.06618497886433454
8951,715.000433,715.007667,1,21450012,21450230,218,0.04835396490512757
8952,715.077167,715.082733,1,21452315,21452481,166,-0.01696061704368166
8953,715.085967,715.142867,1,21452579,21454286,1707,0.7732604862805329
8954,715.144833,715.166233,1,21454344,21454986,642,0.6785637994992936
8955,715.167567,715.2034,1,21455027,21456102,1075,0.8253526286886942
8956,715.2249,715.431567,1,21456747,21462947,6200,0.7772400420236516
8957,715.437467,715.620567,1,21463124,21468617,5493,0.8083316538741582
8958,715.622967,715.705967,1,21468689,21471179,2490,0.7187927664426198
8959,715.707467,715.7326,1,21471224,21471978,754,0.37749619813294805
8960,715.735033,715.8239,1,21472050,21474717,2667,0.6283592874314418
8961,715.8269,715.851833,1,21474807,21475554,747,0.3710420940191827
8962,715.8549,715.944333,1,21475647,21478329,2682,0.8142448861349322
8963,715.947067,715.9739,1,21478412,21479217,805,0.8040082348422861
8964,715.976567,716.067,1,21479297,21482010,2713,0.8301340178229605
8965,716.069867,716.0948,1,21482096,21482844,748,0.8784144720439966
8966,716.097633,716.216833,1,21482928,21486504,3576,0.810923887257371
8967,716.220533,716.313733,1,21486615,21489411,2796,0.8607459465145098
8968,716.316067,716.322267,1,21489482,21489668,186,0.8136309645001072
8969,716.324633,716.343133,1,21489738,21490293,555,0.7424143236973286
8970,716.346533,716.444367,1,21490395,21493331,2936,0.8141667737772641
8971,716.445967,716.473533,1,21493379,21494205,826,0.831092697341557
8972,716.4766,716.578467,1,21494298,21497354,3056,0.8469421473207435
8973,716.5799,716.6081,1,21497397,21498243,846,0.8617977700079055
8974,716.611833,716.700867,1,21498354,21501026,2672,0.7815073031211974
8975,716.7056,716.814233,1,21501168,21504426,3258,0.8015875043079993
8976,716.828333,716.841533,1,21504849,21505245,396,-0.003803507412092465
8977,716.851533,716.857767,1,21505545,21505733,188,-0.05228050381338045
8978,716.8631,716.875233,1,21505893,21506256,363,0.3081915601782169
8979,716.880533,716.884967,1,21506415,21506549,134,0.5639675201647729
8980,717.047167,717.141933,1,21511415,21514257,2842,0.7838851093978477
8981,717.1444,717.147833,1,21514332,21514434,102,0.27327300902671464
8982,717.6918,717.719833,1,21530754,21531594,840,0.44901360723510003
8983,717.780067,717.785633,1,21533402,21533568,166,0.5612710501534364
8984,717.933567,717.951567,1,21538007,21538547,540,0.47259504078882625
8985,717.952633,717.960633,1,21538578,21538818,240,0.2062169765285063
8986,717.996367,718.0142,1,21539891,21540426,535,0.6437125697055366
8987,718.137433,718.1421,1,21544122,21544263,141,0.17348196122020365
8988,718.146833,718.161167,1,21544404,21544835,431,0.3415784073858056
8989,718.210533,718.218933,1,21546315,21546567,252,0.6166249562818777
8990,718.220733,718.2253,1,21546621,21546759,138,0.4736416572140021
8991,718.300367,718.316467,1,21549011,21549494,483,-0.050729374038776635
8992,718.318367,718.403567,1,21549551,21552107,2556,0.5182587065446982
8993,718.419767,718.441333,1,21552593,21553239,646,0.42871840448310683
8994,718.691667,718.9403,1,21560750,21568209,7459,0.7431860155497905
8995,718.958233,718.965133,1,21568746,21568953,207,0.01724809514497892
8996,719.607233,719.610533,1,21588216,21588315,99,0.6296951511678673
8997,719.6197,719.6361,1,21588591,21589083,492,0.5245883501364056
8998,719.680567,719.686433,1,21590417,21590592,175,0.5213771729233816
8999,719.692167,719.711767,1,21590765,21591353,588,0.7635162139496173
9000,719.880367,719.890133,1,21596411,21596703,292,0.09839119973798767
9001,719.895333,719.9239,1,21596859,21597717,858,-0.38783111653534075
9002,719.925133,719.976333,1,21597753,21599289,1536,0.35208851758606674
9003,719.9776,720.003933,1,21599328,21600117,789,0.11813323482828043
9004,720.014633,720.0628,1,21600438,21601884,1446,0.5337423835110126
9005,720.079667,720.0982,1,21602390,21602946,556,0.4766431568935387
9006,720.1073,720.116933,1,21603219,21603507,288,0.4622922806733602
9007,720.125733,720.167833,1,21603771,21605034,1263,0.055822956539724286
9008,720.169633,720.173633,1,21605088,21605208,120,-0.20696591076417337
9009,720.194367,720.237333,1,21605831,21607119,1288,0.6473047651794815
9010,720.238367,720.288067,1,21607151,21608642,1491,0.8266235362395548
9011,720.3125,720.411433,1,21609375,21612342,2967,0.8246655175103798
9012,720.457467,720.4605,1,21613724,21613815,91,
9013,720.4845,720.4936,1,21614535,21614808,273,0.1268135435226707
9014,720.5053,720.669767,1,21615159,21620093,4934,0.8193915911579283
9015,720.692,720.7051,1,21620760,21621153,393,0.7996636670422781
9016,720.706133,720.720333,1,21621183,21621609,426,0.7664004008311528
9017,720.722567,720.7857,1,21621677,21623571,1894,0.7927013134879218
9018,720.7947,720.7997,1,21623841,21623991,150,0.6045377999203604
9019,720.8149,720.823567,1,21624447,21624707,260,-0.07462555105719612
9020,720.827733,720.8448,1,21624831,21625344,513,0.048951541540863716
9021,720.8494,720.857467,1,21625482,21625724,242,0.11744508324105836
9022,720.858967,720.863367,1,21625769,21625901,132,0.12629448255502415
9023,720.8879,720.998033,1,21626637,21629940,3303,0.8064528583575505
9024,721.000567,721.006733,1,21630017,21630201,184,0.5473458087332493
9025,721.0207,721.029933,1,21630621,21630897,276,-0.09619425203317798
9026,721.037233,721.0412,1,21631116,21631236,120,0.9182825336589269
9027,721.050067,721.220233,1,21631502,21636606,5104,0.8548710423148358
9028,721.240367,721.243433,1,21637211,21637302,91,0.3486364059097372
9029,721.2661,721.2755,1,21637983,21638265,282,0.011852662284917883
9030,721.2796,721.2836,1,21638388,21638508,120,0.0535645822313646
9031,721.3172,721.6099,1,21639516,21648297,8781,0.7591381768210145
9032,721.649633,721.660367,1,21649488,21649811,323,0.33843811348499164
9033,721.663367,721.668833,1,21649901,21650064,163,0.4289547955451434
9034,721.727733,721.7341,1,21651831,21652023,192,0.6747766199896909
9035,721.738267,721.9931,1,21652148,21659793,7645,0.7794548483535602
9036,721.996467,722.0697,1,21659894,21662091,2197,0.7793621165262806
9037,722.072733,722.084967,1,21662181,21662549,368,0.6915688599105242
9038,722.086933,722.1587,1,21662607,21664761,2154,0.7732377359716046
9039,722.1628,722.1828,1,21664884,21665484,600,0.7662680929649915
9040,722.184767,722.208867,1,21665543,21666266,723,0.7893122046146056
9041,722.2121,722.3032,1,21666363,21669096,2733,0.7950958662877823
9042,722.3063,722.319833,1,21669189,21669594,405,0.8195978651396617
9043,722.3238,722.3305,1,21669714,21669915,201,0.7403766361060702
9044,722.333867,722.425267,1,21670016,21672758,2742,0.7945316660874817
9045,722.427933,722.4534,1,21672837,21673602,765,0.7268033760240524
9046,722.456767,722.580033,1,21673703,21677400,3697,0.7929759576796999
9047,722.5837,722.7062,1,21677511,21681186,3675,0.7570324953111767
9048,722.7096,722.805933,1,21681288,21684177,2889,0.7922081701474887
9049,722.808467,722.835067,1,21684254,21685052,798,0.3822404016863681
9050,722.838667,722.918267,1,21685160,21687548,2388,0.6270595231879714
9051,722.9245,722.9358,1,21687735,21688074,339,0.8128905415535771
9052,722.939167,722.9601,1,21688175,21688803,628,0.8277591532641456
9053,722.968267,723.063933,1,21689048,21691917,2869,0.813665906482954
9054,723.067633,723.093233,1,21692028,21692796,768,0.8416967941108301
9055,723.096367,723.193467,1,21692891,21695804,2913,0.8190187576336204
9056,723.196333,723.2235,1,21695889,21696705,816,0.7882012246595521
9057,723.225233,723.235833,1,21696756,21697074,318,0.6321396737537756
9058,723.236833,723.314333,1,21697104,21699429,2325,0.8087768761924102
9059,723.3328,723.3378,1,21699984,21700134,150,-0.05874276939398715
9060,723.3463,723.3496,1,21700389,21700488,99,0.07195540793613224
9061,723.6256,723.648967,1,21708768,21709469,701,0.5796752599374023
9062,723.6989,723.7218,1,21710967,21711654,687,0.5239963659658364
9063,724.016533,724.0449,1,21720495,21721347,852,0.7046949268843947
9064,724.048,724.1706,1,21721440,21725118,3678,0.8263579744525761
9065,724.190233,724.250367,1,21725706,21727511,1805,0.7626232590193082
9066,724.284267,724.307033,1,21728528,21729210,682,0.7525462145671847
9067,724.7879,724.796167,1,21743637,21743885,248,0.7715517975233338
9068,724.7975,724.802533,1,21743925,21744075,150,0.4408802208358435
9069,724.8063,724.824133,1,21744189,21744723,534,0.5864660768540931
9070,724.825167,724.865667,1,21744755,21745970,1215,0.588177155263964
9071,724.8667,725.029067,1,21746001,21750872,4871,0.769987852734166
9072,725.032667,725.049667,1,21750980,21751490,510,0.29781903157659545
9073,725.051367,725.069767,1,21751541,21752093,552,0.3022124815112961
9074,725.087633,725.095367,1,21752628,21752861,233,0.15247936332977782
9075,725.1006,725.1467,1,21753018,21754401,1383,0.031001594920729503
9076,725.1567,725.3926,1,21754701,21761778,7077,0.8226889639461413
9077,725.396267,725.4575,1,21761888,21763725,1837,0.7873839310860998
9078,725.461333,725.477467,1,21763839,21764324,485,0.7511231390320742
9079,725.4796,725.495267,1,21764388,21764858,470,0.5328642389709038
9080,725.519833,725.5248,1,21765594,21765744,150,0.047541645172800254
9081,725.5286,725.5459,1,21765858,21766377,519,0.0875712199082349
9082,725.562967,725.6694,1,21766889,21770082,3193,0.8661961670091719
9083,725.693133,725.7382,1,21770793,21772146,1353,0.04628805458826172
9084,725.762233,725.776,1,21772866,21773280,414,0.4011056192260198
9085,725.7777,725.7842,1,21773331,21773526,195,0.4406876992327461
9086,725.785433,725.866433,1,21773562,21775992,2430,0.8089429073511657
9087,725.879,725.8951,1,21776370,21776853,483,0.10470949006460105
9088,725.898333,725.904267,1,21776949,21777128,179,0.2083950054005766
9089,725.909833,725.915133,1,21777294,21777453,159,-0.0263200210949324
9090,725.930767,726.103667,1,21777923,21783110,5187,0.7906967506166223
9091,726.144867,726.148667,1,21784346,21784460,114,-0.1285594744940995
9092,726.465567,726.469667,1,21793967,21794090,123,0.7218525103567561
9093,726.4864,726.5644,1,21794592,21796932,2340,0.7480089965150948
9094,726.567733,726.712033,1,21797031,21801360,4329,0.7816955041662725
9095,726.713067,726.717433,1,21801392,21801522,130,0.6613418142717693
9096,726.727067,726.751767,1,21801812,21802553,741,0.6604659191639465
9097,726.768533,726.775533,1,21803055,21803265,210,-0.12337004191935785
9098,726.7819,726.796267,1,21803457,21803888,431,0.11963753461331897
9099,726.8033,726.810167,1,21804099,21804305,206,-0.11562839136479282
9100,726.811933,726.815,1,21804357,21804450,93,0.22857961282783446
9101,726.8649,726.881333,1,21805947,21806439,492,0.6140483553638235
9102,726.900667,726.906467,1,21807020,21807194,174,-0.13161443207673285
9103,726.907467,726.913333,1,21807224,21807399,175,-0.11702381020747443
9104,726.9266,726.930167,1,21807798,21807905,107,
9105,726.975567,727.142267,1,21809267,21814268,5001,0.835626351471853
9106,727.146633,727.149933,1,21814398,21814497,99,0.047024435760730926
9107,727.1578,727.175533,1,21814734,21815265,531,0.7732609369194564
9108,727.1781,727.184567,1,21815343,21815537,194,0.6096718441991358
9109,727.1856,727.219633,1,21815568,21816588,1020,0.6713452485247959
9110,727.235233,727.3002,1,21817056,21819006,1950,0.8261257025080109
9111,727.327633,727.352133,1,21819828,21820563,735,0.670046090684286
9112,727.354933,727.447867,1,21820647,21823436,2789,0.774922755454869
9113,727.449367,727.458333,1,21823481,21823749,268,0.7747893710557946
9114,727.461333,727.583,1,21823839,21827490,3651,0.8145502393812771
9115,727.5851,727.680133,1,21827553,21830403,2850,0.8501842980206163
9116,727.681733,727.6977,1,21830451,21830931,480,0.5741190835823845
9117,727.711367,727.7678,1,21831341,21833034,1693,0.8173683137589837
9118,727.7692,727.801767,1,21833076,21834053,977,0.8059422020575423
9119,727.805733,727.8126,1,21834171,21834378,207,0.6662737164291986
9120,727.836033,727.9273,1,21835080,21837819,2739,0.7924849632501594
9121,727.940967,727.949233,1,21838229,21838476,247,0.8420698071515151
9122,727.9617,728.030733,1,21838851,21840921,2070,0.8097826349967469
9123,728.0362,728.054,1,21841086,21841620,534,0.7627252744467973
9124,728.066267,728.072067,1,21841988,21842162,174,0.391751411026488
9125,728.087967,728.1238,1,21842639,21843714,1075,0.7963751677097284
9126,728.127267,728.1431,1,21843818,21844293,475,0.7244977364228042
9127,728.157967,728.178,1,21844739,21845340,601,0.7806989019853326
9128,728.184433,728.188267,1,21845532,21845648,116,-0.26704774264487585
9129,728.2144,728.2523,1,21846432,21847569,1137,0.7912868037890547
9130,728.2549,728.2686,1,21847647,21848058,411,0.6433988648390325
9131,728.289867,728.303133,1,21848696,21849093,397,0.7766536300489046
9132,728.306333,728.327733,1,21849189,21849831,642,0.5931088092764378
9133,728.328833,728.3727,1,21849864,21851181,1317,0.6252744541002953
9134,728.373733,728.392067,1,21851211,21851762,551,0.5907728693695008
9135,728.425633,728.435433,1,21852768,21853062,294,-0.10514370548144861
9136,728.5474,728.560033,1,21856422,21856800,378,0.6580451314570106
9137,728.567933,728.571933,1,21857037,21857157,120,0.23570123368849677
9138,728.613233,728.622033,1,21858396,21858660,264,0.6671109091262397
9139,728.624367,728.6296,1,21858731,21858888,157,0.6140894267512768
9140,728.9876,729.015567,1,21869628,21870467,839,0.5080157918073036
9141,729.016567,729.028067,1,21870497,21870842,345,0.4340343286414063
9142,729.0341,729.059433,1,21871023,21871782,759,0.5992542573522548
9143,729.060533,729.084967,1,21871815,21872549,734,0.6370979810131061
9144,729.103167,729.119167,1,21873095,21873575,480,0.5674608501048258
9145,729.2944,729.297467,1,21878832,21878924,92,
9146,729.2986,729.312233,1,21878958,21879366,408,0.07666270233852382
9147,729.318967,729.342067,1,21879569,21880262,693,0.21778675801604597
9148,729.349267,729.362633,1,21880478,21880878,400,0.07747920641331967
9149,729.369033,729.382533,1,21881070,21881475,405,0.3469065988560027
9150,729.383633,729.518333,1,21881508,21885549,4041,0.8327910482881961
9151,729.5344,729.625533,1,21886032,21888765,2733,0.7759779460991431
9152,729.6409,729.647067,1,21889227,21889412,185,0.04508583746074602
9153,729.648533,729.652667,1,21889455,21889580,125,-0.23274753925060587
9154,730.052333,730.082167,1,21901569,21902465,896,0.7358490517485605
9155,730.094833,730.109667,1,21902844,21903290,446,0.7327589424334127
9156,730.117867,730.188967,1,21903536,21905669,2133,0.764106213306158
9157,730.2149,730.250367,1,21906447,21907511,1064,0.6648854079751921
9158,730.2549,730.306567,1,21907647,21909197,1550,0.5889406307521442
9159,730.324733,730.3467,1,21909741,21910401,660,0.7785698909350677
9160,730.3633,730.3796,1,21910899,21911388,489,0.7285458443203341
9161,730.3839,730.3977,1,21911517,21911931,414,0.6842284664674121
9162,730.409333,730.451733,1,21912279,21913551,1272,0.07629539066139476
9163,730.4849,730.582133,1,21914547,21917463,2916,0.8516264546116813
9164,730.590533,730.596567,1,21917715,21917897,182,0.07390772886789819
9165,730.597933,730.620667,1,21917937,21918620,683,0.7916033671812074
9166,730.632667,730.636067,1,21918980,21919082,102,0.09549352867238754
9167,730.6421,730.6562,1,21919263,21919686,423,0.01333598976704222
9168,730.6741,730.677633,1,21920223,21920328,105,
9169,730.744033,730.7473,1,21922320,21922419,99,
9170,730.992433,731.076233,1,21929772,21932286,2514,0.8282410873450741
9171,731.0924,731.097567,1,21932772,21932927,155,-0.11475327755305885
9172,731.098733,731.1072,1,21932961,21933216,255,-0.084938273883091
9173,731.2282,731.3462,1,21936846,21940386,3540,0.8270829982384756
9174,731.3566,731.388633,1,21940698,21941658,960,0.8276774534210602
9175,731.389733,731.452867,1,21941691,21943586,1895,0.8278767053513975
9176,731.472867,731.512733,1,21944186,21945381,1195,0.6854255692043432
9177,731.5255,731.559,1,21945765,21946770,1005,0.08944245725510994
9178,731.576467,731.738067,1,21947294,21952142,4848,0.8297161179836312
9179,731.743667,731.835667,1,21952310,21955070,2760,0.8509576187984648
9180,731.885067,731.898733,1,21956552,21956961,409,0.018123351117775667
9181,731.9009,731.912633,1,21957027,21957378,351,0.013340366732122109
9182,731.928233,732.0446,1,21957846,21961338,3492,0.7907713001728324
9183,732.0618,732.0672,1,21961854,21962016,162,0.08738157778569622
9184,732.235167,732.238633,1,21967055,21967158,103,
9185,732.2403,732.372533,1,21967209,21971175,3966,0.8820035103876106
9186,732.376367,732.3832,1,21971291,21971496,205,0.15379212663444217
9187,732.622067,732.630233,1,21978662,21978906,244,0.4449497808321836
9188,732.635333,732.6878,1,21979059,21980634,1575,0.7212417475590066
9189,732.6898,732.8157,1,21980694,21984471,3777,0.8363877488877781
9190,732.821133,732.8523,1,21984633,21985569,936,0.6755572826019218
9191,732.854067,732.901833,1,21985622,21987054,1432,0.7994310865968912
9192,732.9059,732.948733,1,21987177,21988461,1284,0.7092481829468613
9193,732.957967,733.2443,1,21988739,21997329,8590,0.38547663060182463
9194,733.251433,733.291567,1,21997542,21998747,1205,0.7913223772263189
9195,733.294167,733.3901,1,21998825,22001703,2878,0.8049975643923464
9196,733.3944,733.418867,1,22001832,22002566,734,0.7084419439051788
9197,733.420533,733.424767,1,22002615,22002743,128,-0.4669374350592065
9198,733.431033,733.441467,1,22002930,22003244,314,-0.1634293824314691
9199,733.443067,733.488767,1,22003292,22004663,1371,0.1461220259934602
9200,733.5124,733.7438,1,22005372,22012314,6942,0.7877039539040799
9201,733.759533,733.7647,1,22012785,22012941,156,0.03354567145923242
9202,733.769967,733.775533,1,22013099,22013265,166,0.30767989471092294
9203,734.234867,734.239967,1,22027046,22027199,153,0.443033631913335
9204,734.241667,734.247467,1,22027250,22027424,174,0.6550319519017109
9205,734.2923,734.315667,1,22028769,22029470,701,0.7172508945186797
9206,734.341867,734.397367,1,22030256,22031921,1665,0.6028624714802595
9207,734.426433,734.454367,1,22032792,22033631,839,0.5424475241772437
9208,734.458733,734.4628,1,22033761,22033884,123,0.4339904026249924
9209,734.4707,734.5131,1,22034121,22035393,1272,0.5471526585339114
9210,734.54,734.543467,1,22036200,22036304,104,0.42196284416827057
9211,734.5468,734.5571,1,22036404,22036713,309,0.605223982991337
9212,734.579467,734.586433,1,22037384,22037592,208,0.5535278727952734
9213,734.596667,734.613567,1,22037900,22038407,507,0.7685457091917554
9214,734.653633,734.663,1,22039608,22039890,282,0.09055431063732405
9215,734.665967,734.6771,1,22039979,22040313,334,0.10588851031237563
9216,734.678867,734.701733,1,22040366,22041051,685,0.09761005105083509
9217,734.730433,734.851333,1,22041912,22045539,3627,0.8084403891060289
9218,735.008133,735.175533,1,22050243,22055265,5022,0.8324196300177101
9219,735.1789,735.182367,1,22055367,22055471,104,0.6591329741910886
9220,735.1836,735.266967,1,22055508,22058009,2501,0.8373437133814211
9221,735.294533,735.314933,1,22058835,22059447,612,0.05892350757757063
9222,735.316633,735.327867,1,22059498,22059836,338,0.22208653535783945
9223,735.328933,735.3353,1,22059867,22060059,192,0.18023550522134857
9224,735.380133,735.39,1,22061403,22061700,297,0.6036096547053963
9225,735.3961,735.432133,1,22061883,22062963,1080,0.7926042285888759
9226,735.440233,735.487267,1,22063206,22064618,1412,0.8024814983364308
9227,735.504067,735.533,1,22065122,22065990,868,0.05156652104060995
9228,735.535767,735.558267,1,22066073,22066748,675,0.12580493966890954
9229,735.583833,735.8749,1,22067514,22076247,8733,0.7857295637901188
9230,735.887433,735.8912,1,22076622,22076736,114,-0.1725504119874194
9231,735.917433,735.930267,1,22077522,22077908,386,-0.005425844202075682
9232,735.931667,735.937767,1,22077950,22078133,183,
9233,735.989067,736.018467,1,22079672,22080554,882,0.7142647567312812
9234,736.0201,736.069033,1,22080603,22082070,1467,0.6561430018151808
9235,736.0747,736.098667,1,22082241,22082960,719,0.6541236197581564
9236,736.141933,736.208133,1,22084257,22086243,1986,0.5965380568441295
9237,736.240467,736.2714,1,22087214,22088142,928,0.8297612657806319
9238,736.273567,736.322533,1,22088207,22089675,1468,0.6906152235190997
9239,736.324267,736.329233,1,22089728,22089876,148,
9240,736.336367,736.416567,1,22090091,22092497,2406,0.6035295315182315
9241,736.4491,736.515333,1,22093473,22095459,1986,0.7964801663429861
9242,736.5174,736.559567,1,22095522,22096787,1265,0.8209828616392338
9243,736.5734,736.764033,1,22097202,22102920,5718,0.6301158757985633
9244,736.788733,736.801633,1,22103661,22104048,387,0.46748917393218997
9245,736.810533,736.8657,1,22104315,22105971,1656,0.33853741271400734
9246,736.875167,737.096167,1,22106255,22112885,6630,0.7947189742923655
9247,737.0987,737.1145,1,22112961,22113435,474,0.7584794837359278
9248,737.1166,737.136833,1,22113498,22114104,606,0.5754853658337414
9249,737.160033,737.173233,1,22114800,22115196,396,-0.041587497349244704
9250,737.177,737.206967,1,22115310,22116209,899,0.09073665723645379
9251,737.2495,737.258167,1,22117485,22117745,260,0.6199601039458617
9252,737.260033,737.538333,1,22117800,22126149,8349,0.7298555253543418
9253,737.762733,737.849733,1,22132881,22135491,2610,0.8064751117631591
9254,737.852567,737.992367,1,22135577,22139771,4194,0.7759635211310173
9255,738.006567,738.064033,1,22140197,22141920,1723,0.8114128713527254
9256,738.0751,738.0955,1,22142253,22142865,612,0.7103290471638025
9257,738.096567,738.112333,1,22142897,22143369,472,0.3713391639628275
9258,738.113633,738.117167,1,22143408,22143515,107,0.5962056491076658
9259,738.123567,738.144433,1,22143707,22144332,625,-0.023373249689421432
9260,738.146567,738.1643,1,22144397,22144929,532,0.11190758372964806
9261,738.166,738.1711,1,22144980,22145133,153,0.6761612473065356
9262,738.204067,738.209767,1,22146122,22146293,171,-0.1008655227861807
9263,738.217767,738.232367,1,22146533,22146971,438,0.6030466786907962
9264,738.233767,738.3605,1,22147013,22150815,3802,0.8127072046331733
9265,738.369633,738.3744,1,22151088,22151232,144,0.8464768339879575
9266,738.378333,738.467533,1,22151349,22154025,2676,0.835554852572939
9267,738.4908,738.496567,1,22154724,22154897,173,0.16452402181982886
9268,738.5059,738.520933,1,22155177,22155627,450,-0.048890411480616076
9269,738.522267,738.551633,1,22155668,22156548,880,-0.10394845123005923
9270,738.6012,738.813,1,22158036,22164390,6354,0.8460340428113923
9271,738.8164,738.913833,1,22164492,22167414,2922,0.8331683433619828
9272,738.917433,738.921233,1,22167522,22167636,114,-0.22056580856927893
9273,738.941733,738.961233,1,22168251,22168836,585,-0.010528441377011264
9274,738.9623,738.999833,1,22168869,22169994,1125,0.11574134281186324
9275,739.044833,739.1683,1,22171344,22175049,3705,0.8721012956424905
9276,739.1843,739.247867,1,22175529,22177436,1907,0.0012118455836688086
9277,739.3175,739.442633,1,22179525,22183278,3753,0.8545894759920656
9278,739.444267,739.448767,1,22183328,22183463,135,0.18022766626564396
9279,739.462867,739.527933,1,22183886,22185837,1951,0.11941693276515045
9280,739.529533,739.533767,1,22185885,22186013,128,0.1481545607806624
9281,739.552767,739.5729,1,22186583,22187187,604,0.8546987590705045
9282,739.574033,739.668933,1,22187220,22190067,2847,0.7924144449895769
9283,739.678267,739.688633,1,22190348,22190658,310,0.4428373050435639
9284,739.6898,739.6933,1,22190694,22190799,105,
9285,739.694467,739.6978,1,22190834,22190934,100,0.3591180258800503
9286,739.699333,739.702533,1,22190979,22191075,96,0.5351922366269176
9287,739.7037,739.7585,1,22191111,22192755,1644,0.11153907560219217
9288,739.769367,739.941467,1,22193081,22198244,5163,0.7986919230144637
9289,739.960733,739.9881,1,22198821,22199643,822,-0.2249115639017617
9290,740.014033,740.0171,1,22200420,22200513,93,-0.24927264262500645
9291,740.018933,740.022,1,22200567,22200660,93,0.5877816774518511
9292,740.024133,740.030967,1,22200723,22200929,206,0.49357052254215705
9293,740.237467,740.326167,1,22207124,22209785,2661,0.83755985426149
9294,740.329833,740.3845,1,22209894,22211535,1641,0.8884258263218474
9295,740.403433,740.415,1,22212102,22212450,348,-0.07281058281410951
9296,740.4161,740.421233,1,22212483,22212636,153,-0.22896678547582427
9297,740.422267,740.434333,1,22212668,22213029,361,0.08101027379312081
9298,740.440133,740.448233,1,22213203,22213446,243,0.03811686524830125
9299,740.548233,740.5538,1,22216446,22216614,168,0.250643412838141
9300,740.5665,740.573367,1,22216995,22217201,206,0.38944809209469583
9301,740.5895,740.6993,1,22217685,22220979,3294,0.7735098046933436
9302,740.710367,740.7151,1,22221311,22221453,142,0.5464378236652014
9303,740.7166,740.782333,1,22221498,22223469,1971,0.22936210013411612
9304,740.7841,740.797533,1,22223523,22223925,402,0.14844393743619255
9305,740.813233,740.828533,1,22224396,22224855,459,0.19165576570800116
9306,740.832867,740.8471,1,22224986,22225413,427,-0.0766321879815883
9307,740.858033,740.864,1,22225740,22225920,180,
9308,740.8685,741.014033,1,22226055,22230420,4365,0.6829206291433881
9309,741.033033,741.056067,1,22230990,22231682,692,0.08715160024098446
9310,741.057167,741.101167,1,22231715,22233035,1320,0.22729418436713483
9311,741.1213,741.158067,1,22233639,22234742,1103,0.4983066482253645
9312,741.1606,741.2264,1,22234818,22236792,1974,0.07592466207583844
9313,741.227733,741.230933,1,22236831,22236927,96,
9314,741.234933,741.3737,1,22237047,22241211,4164,0.8232673301384805
9315,741.380133,741.494167,1,22241403,22244825,3422,0.7719326984118644
9316,741.497833,741.567667,1,22244934,22247030,2096,0.8101160357543981
9317,741.7236,741.816833,1,22251708,22254504,2796,0.8547844619750591
9318,741.818,741.930133,1,22254540,22257903,3363,0.7776999273244108
9319,741.9406,741.9453,1,22258218,22258359,141,0.3670941826753167
9320,741.959833,741.981533,1,22258794,22259445,651,-0.016049743783386826
9321,741.9831,741.9901,1,22259493,22259703,210,0.13886607093566725
9322,741.992667,742.016867,1,22259780,22260506,726,0.058841594875956325
9323,742.0751,742.235667,1,22262253,22267070,4817,0.7820161163199991
9324,742.242267,742.320967,1,22267268,22269629,2361,0.8079280776696524
9325,742.323733,742.328767,1,22269711,22269863,152,0.6378972037833758
9326,742.336633,742.340567,1,22270098,22270217,119,
9327,742.353167,742.382567,1,22270595,22271477,882,0.023688164617971363
9328,742.3873,742.412167,1,22271619,22272365,746,0.08190045003230481
9329,742.438767,742.550533,1,22273163,22276515,3352,0.8623558864208808
9330,742.553433,742.600867,1,22276602,22278026,1424,0.8388281785436755
9331,742.6057,742.705367,1,22278171,22281161,2990,0.8343753026483415
9332,742.7197,742.805433,1,22281591,22284162,2571,0.5575183814995611
9333,742.859667,742.867533,1,22285790,22286025,235,0.7893675707498197
9334,742.8709,743.0283,1,22286127,22290849,4722,0.8297190907235215
9335,743.0367,743.071667,1,22291101,22292150,1049,0.7114321240944894
9336,743.111067,743.116333,1,22293332,22293489,157,-0.18040329725218912
9337,743.117367,743.145067,1,22293521,22294352,831,-0.15834429782769155
9338,743.215333,743.3387,1,22296459,22300161,3702,0.8164109574343563
9339,743.344467,743.349067,1,22300334,22300472,138,0.33885599237542946
9340,743.3597,743.4018,1,22300791,22302054,1263,0.0943472004868102
9341,743.4043,743.428333,1,22302129,22302849,720,0.08846593948464009
9342,743.459233,743.4662,1,22303776,22303986,210,0.34769026128833114
9343,743.4711,743.563267,1,22304133,22306898,2765,0.17371401540031453
9344,743.5863,743.710433,1,22307589,22311312,3723,0.7806609752367393
9345,743.736767,743.779867,1,22312103,22313396,1293,0.22447236251034738
9346,743.7812,743.817767,1,22313436,22314533,1097,-0.04451705494816253
9347,743.848433,743.8567,1,22315452,22315701,249,0.5096811555393284
9348,743.861033,743.900333,1,22315830,22317009,1179,0.15517674157672093
9349,743.9015,743.956,1,22317045,22318680,1635,0.09005314892097173
9350,743.976933,744.1151,1,22319307,22323453,4146,0.7277336776252759
9351,744.1165,744.130533,1,22323495,22323915,420,0.7224607451290895
9352,744.1445,744.1698,1,22324335,22325094,759,0.6379725304593945
9353,744.173833,744.2067,1,22325214,22326201,987,0.5202226859962182
9354,744.208,744.2683,1,22326240,22328049,1809,0.6032677345732766
9355,744.2803,744.296267,1,22328409,22328888,479,0.4347797430578184
9356,744.3163,744.3687,1,22329489,22331061,1572,0.4280286288915589
9357,744.377833,744.3837,1,22331334,22331511,177,0.544857546051302
9358,744.391033,744.4031,1,22331730,22332093,363,0.6357818357750017
9359,744.4048,744.414767,1,22332144,22332443,299,0.6258548421185016
9360,744.4321,744.4417,1,22332963,22333251,288,0.17531504763353106
9361,744.442933,744.496867,1,22333287,22334906,1619,0.21048024766588969
9362,744.4992,744.516933,1,22334976,22335507,531,0.124423205037509
9363,744.573167,744.734367,1,22337195,22342031,4836,0.6865422550737708
9364,744.737533,744.8182,1,22342125,22344546,2421,0.6655275487152391
9365,744.835933,744.951133,1,22345077,22348533,3456,0.5133274415249545
9366,744.961233,744.982833,1,22348836,22349484,648,0.6826796665310553
9367,745.0031,745.069533,1,22350093,22352085,1992,0.20916266345176554
9368,745.0716,745.086467,1,22352148,22352594,446,-0.24211593607796897
9369,745.130867,745.134867,1,22353926,22354046,120,0.20823203575929816
9370,745.1359,745.258,1,22354077,22357740,3663,0.8339246225348804
9371,745.2911,745.3096,1,22358733,22359288,555,0.2916151441493672
9372,745.3234,745.351033,1,22359702,22360530,828,0.03491750524174799
9373,745.353333,745.363867,1,22360599,22360916,317,-0.19439997214350938
9374,745.372467,745.377333,1,22361174,22361319,145,-0.2546129000296766
9375,745.394433,745.403533,1,22361832,22362105,273,-0.17987553705250423
9376,745.4218,745.425467,1,22362654,22362764,110,-0.5281908844502249
9377,745.433533,745.462367,1,22363005,22363871,866,0.39665002089415774
9378,745.476133,745.491833,1,22364283,22364754,471,-0.038642117395572204
9379,745.505367,745.510633,1,22365161,22365318,157,-0.006684054877928619
9380,745.5123,745.519167,1,22365369,22365575,206,0.20255836609906822
9381,745.534867,745.541867,1,22366046,22366256,210,0.6587931129668556
9382,745.5432,745.548967,1,22366296,22366469,173,0.4202833895491763
9383,745.561333,745.595667,1,22366839,22367870,1031,0.5831538878190291
9384,745.6106,745.629867,1,22368318,22368896,578,0.8200392981848008
9385,745.6459,745.7083,1,22369377,22371249,1872,0.7010256905463712
9386,745.7111,745.767,1,22371333,22373010,1677,0.21622277824252564
9387,745.7731,745.858167,1,22373193,22375745,2552,0.8118400221829267
9388,745.879067,745.8853,1,22376372,22376559,187,-0.047273551460170635
9389,745.942733,746.0584,1,22378281,22381752,3471,0.8078131576983164
9390,746.0729,746.076733,1,22382187,22382301,114,
9391,746.084,746.087467,1,22382520,22382624,104,-0.23074207575060934
9392,746.108467,746.111633,1,22383254,22383348,94,-0.35628211310586794
9393,746.1538,746.156833,1,22384614,22384704,90,0.4990586760857577
9394,746.161533,746.221133,1,22384845,22386633,1788,0.8366523023611558
9395,746.226067,746.355,1,22386782,22390650,3868,0.7755310213485066
9396,746.364067,746.455467,1,22390922,22393664,2742,0.7564055592927539
9397,746.4599,746.473,1,22393797,22394190,393,0.5843526960070036
9398,746.482267,746.490967,1,22394468,22394729,261,0.5801234347295374
9399,746.495267,746.506767,1,22394858,22395203,345,0.4815402188781875
9400,746.507767,746.5451,1,22395233,22396353,1120,0.8291732021780052
9401,746.564233,746.670667,1,22396926,22400120,3194,0.7755642908623922
9402,746.6722,746.758333,1,22400166,22402749,2583,0.8296574090696142
9403,746.760233,746.783433,1,22402806,22403502,696,0.840201548129421
9404,746.784667,746.871167,1,22403540,22406135,2595,0.874354722888584
9405,746.8753,746.8983,1,22406259,22406949,690,0.8418923209087755
9406,746.901,746.985367,1,22407030,22409561,2531,0.8573496882231938
9407,746.9967,747.0921,1,22409901,22412763,2862,0.8069211655597119
9408,747.0974,747.103967,1,22412922,22413119,197,0.29278662093545554
9409,747.1102,747.1239,1,22413306,22413717,411,-0.0796734815821901
9410,747.125233,747.133133,1,22413756,22413993,237,-0.12258784025158215
9411,747.140367,747.1511,1,22414211,22414533,322,-0.04125856183409854
9412,747.1559,747.16,1,22414677,22414800,123,-0.12249369481920062
9413,747.161,747.1666,1,22414830,22414998,168,0.3464105352447464
9414,747.208033,747.3294,1,22416240,22419882,3642,0.8299628640242921
9415,747.341067,747.374767,1,22420232,22421243,1011,0.8255860837925414
9416,747.381367,747.508633,1,22421441,22425258,3817,0.6659112517857961
9417,747.510967,747.581667,1,22425329,22427450,2121,0.8134619545563336
9418,747.5995,747.639,1,22427985,22429170,1185,0.7958550358928901
9419,747.6418,747.658333,1,22429254,22429749,495,0.8757475452416033
9420,747.668333,747.684733,1,22430049,22430541,492,0.6948271470277217
9421,747.685867,747.701567,1,22430576,22431047,471,0.5965704841158354
9422,747.720267,747.7373,1,22431608,22432119,511,0.03688977239573559
9423,747.739,747.7422,1,22432170,22432266,96,
9424,747.7475,747.755033,1,22432425,22432650,225,0.08268357355175451
9425,747.7611,747.7678,1,22432833,22433034,201,0.3075277993724528
9426,747.7697,747.7756,1,22433091,22433268,177,-0.187027338146079
9427,747.909767,748.079233,1,22437293,22442376,5083,0.7584686787204039
9428,748.0971,748.113067,1,22442913,22443392,479,0.6451794695522832
9429,748.1161,748.120833,1,22443483,22443624,141,0.899666109919085
9430,748.1263,748.188667,1,22443789,22445660,1871,0.8448381476090028
9431,748.195133,748.2031,1,22445853,22446093,240,0.5764910105448982
9432,748.2279,748.235233,1,22446837,22447056,219,-0.03321994435019564
9433,748.238167,748.241267,1,22447145,22447238,93,-0.35525488376837777
9434,748.245667,748.2496,1,22447370,22447488,118,-0.21754018799902616
9435,748.395067,748.5159,1,22451852,22455477,3625,0.8185070515105999
9436,748.612133,748.6973,1,22458363,22460919,2556,0.783514292145673
9437,748.757533,748.760833,1,22462725,22462824,99,
9438,748.765833,748.7749,1,22462974,22463247,273,-0.08204965199758309
9439,748.8216,748.9917,1,22464648,22469751,5103,0.8025823150084358
9440,748.995733,749.0175,1,22469871,22470525,654,0.5459136685512661
9441,749.028233,749.081,1,22470846,22472430,1584,-0.019802498996091534
9442,749.0926,749.2731,1,22472778,22478193,5415,0.8520506962733253
9443,749.311067,749.322967,1,22479332,22479689,357,0.3654699675873051
9444,749.3253,749.3913,1,22479759,22481739,1980,0.7681876586813723
9445,749.399967,749.4047,1,22481999,22482141,142,0.7589869915431998
9446,749.4174,749.446267,1,22482522,22483388,866,0.8302045856899201
9447,749.451633,749.542367,1,22483548,22486271,2723,0.7594278212645655
9448,749.5585,749.582733,1,22486755,22487481,726,-0.026020444237503503
9449,749.596433,749.606133,1,22487892,22488183,291,-0.07022991645880322
9450,749.610967,749.618033,1,22488329,22488540,211,0.14409549225236135
9451,749.6195,749.625267,1,22488585,22488758,173,0.18086971186616443
9452,749.662367,749.682167,1,22489871,22490465,594,0.6416142383780802
9453,749.696267,749.707767,1,22490888,22491233,345,0.2638996238773635
9454,749.829,749.832967,1,22494870,22494989,119,
9455,749.834033,750.0582,1,22495020,22501746,6726,0.7763286253312316
9456,750.405567,750.4434,1,22512167,22513302,1135,0.6001687866133819
9457,750.4601,750.482733,1,22513803,22514481,678,0.6454494324647001
9458,750.4882,750.495333,1,22514646,22514859,213,0.7513350960308137
9459,750.508167,750.515767,1,22515245,22515473,228,0.8603079804251579
9460,750.530633,750.546033,1,22515918,22516380,462,0.7918018811583245
9461,750.573967,750.582567,1,22517219,22517477,258,0.5791781552184252
9462,750.591167,750.599567,1,22517735,22517987,252,0.009782607536129828
9463,750.604167,750.622767,1,22518125,22518683,558,-0.001628833475158486
9464,750.626033,750.633067,1,22518780,22518992,212,0.2892326567967732
9465,750.710367,750.830533,1,22521311,22524915,3604,0.45331583045247453
9466,750.875867,750.8827,1,22526276,22526481,205,0.48557728992946003
9467,750.891533,751.053867,1,22526745,22531616,4871,0.8394453456952978
9468,751.272633,751.358967,1,22538178,22540769,2591,0.7822350156640056
9469,751.366167,751.404633,1,22540985,22542138,1153,0.8163944111488949
9470,751.415933,751.428333,1,22542477,22542849,372,-0.04936310891742425
9471,751.429967,751.436333,1,22542899,22543089,190,-0.09265682204735268
9472,751.443533,751.450533,1,22543305,22543515,210,0.051156712144809394
9473,752.016,752.0252,1,22560480,22560756,276,0.7576175121494494
9474,752.028667,752.0646,1,22560860,22561938,1078,0.5802933785027375
9475,752.065633,752.092167,1,22561968,22562765,797,0.494217423794309
9476,752.0979,752.124467,1,22562937,22563734,797,0.5795941425090376
9477,752.155933,752.186233,1,22564677,22565586,909,0.45612530125838197
9478,752.187233,752.209733,1,22565616,22566291,675,0.5759553818757673
9479,752.230967,752.248767,1,22566929,22567463,534,0.5804460901883742
9480,752.249967,752.270767,1,22567499,22568123,624,0.6184080145922727
9481,752.283033,752.291833,1,22568490,22568754,264,0.6269558255978619
9482,752.339733,752.389767,1,22570191,22571693,1502,0.018279787669781323
9483,752.3979,752.5422,1,22571937,22576266,4329,0.7946588809960013
9484,752.560967,752.643067,1,22576829,22579292,2463,0.8095838318727109
9485,752.6591,752.6622,1,22579773,22579866,93,-0.09272252869551166
9486,752.6652,752.6688,1,22579956,22580064,108,-0.02021115613357459
9487,752.670567,752.676933,1,22580117,22580307,190,0.20026032931387439
9488,752.732633,752.7436,1,22581978,22582308,330,0.32625186938191847
9489,752.746433,752.861467,1,22582392,22585844,3452,0.7990826933665223
9490,752.8708,752.943133,1,22586124,22588293,2169,0.7886296821656879
9491,752.9658,753.026633,1,22588974,22590798,1824,0.8196750890301666
9492,753.034833,753.050133,1,22591044,22591503,459,0.6167007464749049
9493,753.054567,753.0666,1,22591637,22591998,361,0.5491784525000437
9494,753.084333,753.1006,1,22592529,22593018,489,0.2508854577898762
9495,753.1043,753.126833,1,22593129,22593804,675,-0.023502434313070766
9496,753.1464,753.358833,1,22594392,22600764,6372,0.7921036454893202
9497,753.3995,753.4112,1,22601985,22602336,351,0.027635082684694254
9498,753.4144,753.427467,1,22602432,22602824,392,0.27316012340562906
9499,753.433233,753.448633,1,22602996,22603458,462,0.5102209699948732
9500,753.466267,753.469367,1,22603988,22604081,93,0.38059975436335375
9501,753.471967,753.587967,1,22604159,22607639,3480,0.788808852710061
9502,753.599833,753.6168,1,22607994,22608504,510,-0.11499925691938824
9503,753.6187,753.622233,1,22608561,22608666,105,-0.04573728238926601
9504,753.6278,753.6359,1,22608834,22609077,243,0.4951825454252712
9505,753.638833,753.8383,1,22609164,22615149,5985,0.830108868835015
9506,753.861033,753.866833,1,22615830,22616004,174,-0.02306059278880817
9507,753.869967,753.886767,1,22616099,22616603,504,0.007157855390517738
9508,753.9003,753.904867,1,22617009,22617146,137,-0.18958939464678295
9509,754.090433,754.0977,1,22622712,22622931,219,0.7528550446615563
9510,754.098733,754.1103,1,22622961,22623309,348,0.6239872352464751
9511,754.116067,754.230667,1,22623482,22626920,3438,0.8109334749739604
9512,754.256,754.259,1,22627680,22627770,90,-0.05872888134768438
9513,754.262567,754.2669,1,22627877,22628007,130,-0.13185894938363135
9514,754.272033,754.2751,1,22628160,22628253,93,0.3233897003537345
9515,754.636933,754.661567,1,22639107,22639847,740,0.749727278794054
9516,754.674867,754.698667,1,22640246,22640960,714,0.8465399625777862
9517,754.6997,754.729033,1,22640991,22641870,879,0.7850248638793943
9518,754.730567,754.790033,1,22641917,22643700,1783,0.6823528127648387
9519,754.794667,754.837067,1,22643840,22645112,1272,0.6441334742009079
9520,754.844867,754.931033,1,22645346,22647930,2584,0.7286014983464913
9521,754.935467,754.941133,1,22648064,22648233,169,0.5657121248894287
9522,754.949533,754.974567,1,22648485,22649237,752,0.739015269403746
9523,754.990333,755.000967,1,22649709,22650029,320,-0.08859150081038732
9524,755.0061,755.024833,1,22650183,22650744,561,0.009078642599952962
9525,755.026533,755.037867,1,22650795,22651136,341,0.4844251657281432
9526,755.051233,755.055867,1,22651536,22651676,140,0.10644270866697399
9527,755.0569,755.310067,1,22651707,22659302,7595,0.7472487114601383
9528,755.344,755.356433,1,22660320,22660692,372,0.2426028760858883
9529,755.405167,755.408367,1,22662155,22662251,96,0.4140800199163751
9530,755.412933,755.430533,1,22662387,22662915,528,0.7574611582790952
9531,755.433067,755.601333,1,22662992,22668039,5047,0.7279159451958801
9532,755.622067,755.6321,1,22668662,22668963,301,0.6907626364305344
9533,755.633633,755.837333,1,22669008,22675119,6111,0.6140715933613502
9534,755.8392,755.959367,1,22675176,22678781,3605,0.7604329216471791
9535,755.962067,756.056667,1,22678862,22681700,2838,0.8015808874728174
9536,756.059167,756.0855,1,22681775,22682565,790,0.7048813551514963
9537,756.087967,756.2097,1,22682639,22686291,3652,0.7672205601552894
9538,756.2129,756.3382,1,22686387,22690146,3759,0.78704264648639
9539,756.340533,756.4384,1,22690215,22693152,2937,0.7959316269678621
9540,756.445333,756.4693,1,22693359,22694079,720,0.6474106593267469
9541,756.472233,756.568967,1,22694166,22697069,2903,0.784899016864629
9542,756.570567,756.5932,1,22697117,22697796,679,0.761473795198446
9543,756.6019,756.727067,1,22698057,22701812,3755,0.7775093665514812
9544,756.728933,756.828967,1,22701867,22704869,3002,0.8100505455740928
9545,756.832867,756.858667,1,22704986,22705760,774,0.4648272718506112
9546,756.8605,756.9513,1,22705815,22708539,2724,0.5237501353915879
9547,756.952933,756.9753,1,22708587,22709259,672,0.3294100068420229
9548,756.9831,757.054567,1,22709493,22711637,2144,0.8189130063053611
9549,757.059667,757.0939,1,22711790,22712817,1027,0.6737359093255009
9550,757.103367,757.107967,1,22713101,22713239,138,0.4793097057098743
9551,757.111733,757.1286,1,22713351,22713858,507,-0.05629888611300985
9552,757.131,757.154433,1,22713930,22714632,702,-0.013945837811710498
9553,757.160833,757.172533,1,22714824,22715175,351,0.18956548909690565
9554,757.184833,757.237467,1,22715544,22717124,1580,0.8078452105249915
9555,757.265667,757.269067,1,22717970,22718072,102,
9556,757.805767,757.816633,1,22734173,22734498,325,0.5751744501019724
9557,757.820533,757.834267,1,22734615,22735028,413,0.45550202635399833
9558,757.8982,757.9065,1,22736946,22737195,249,0.6277838902762092
9559,758.126533,758.129867,1,22743795,22743896,101,0.5137777377697715
9560,758.131367,758.149567,1,22743941,22744487,546,0.6194055478808724
9561,758.193167,758.202833,1,22745795,22746084,289,0.6721908607715915
9562,758.203967,758.216033,1,22746119,22746480,361,0.770600642517205
9563,758.370333,758.374133,1,22751109,22751223,114,
9564,758.466833,758.470567,1,22754004,22754117,113,
9565,758.4718,758.4759,1,22754154,22754277,123,-0.2836595530581422
9566,758.478367,758.772133,1,22754351,22763163,8812,0.6377993705561703
9567,758.793833,758.7996,1,22763814,22763988,174,0.1100900691610277
9568,758.8035,758.814467,1,22764105,22764434,329,0.5571632344354442
9569,758.815533,758.8244,1,22764465,22764732,267,0.8480896634294229
9570,759.189267,759.212633,1,22775678,22776378,700,0.7065141626190048
9571,759.2361,759.2416,1,22777083,22777248,165,0.4856881831491233
9572,759.258233,759.288467,1,22777746,22778654,908,0.7551790637904444
9573,759.290733,759.302533,1,22778721,22779075,354,0.6064678514608374
9574,759.3082,759.338033,1,22779246,22780140,894,0.7334772919859577
9575,759.353633,759.400967,1,22780608,22782029,1421,0.5850641760820378
9576,759.402867,759.462033,1,22782086,22783860,1774,0.6110816911551041
9577,759.470033,759.481067,1,22784100,22784432,332,0.40042059455697415
9578,759.492367,759.498533,1,22784771,22784955,184,0.6489402617724505
9579,759.5071,759.531967,1,22785213,22785959,746,0.5646088604902367
9580,759.557067,759.6101,1,22786712,22788303,1591,0.1323740252786671
9581,759.624467,759.751833,1,22788734,22792554,3820,0.8358638133693669
9582,759.760633,759.7913,1,22792818,22793739,921,0.7721907954118497
9583,759.8337,759.855133,1,22795011,22795653,642,0.5649991062964923
9584,759.857733,759.9222,1,22795731,22797666,1935,0.6641814719575538
9585,759.924167,759.986067,1,22797725,22799582,1857,0.5666192006664362
9586,760.0059,760.038833,1,22800177,22801164,987,0.35366023967924487
9587,760.051967,760.0595,1,22801559,22801785,226,0.3009355577593924
9588,760.066133,760.085233,1,22801983,22802556,573,0.11427566927153877
9589,760.100033,760.2225,1,22803000,22806675,3675,0.8316267078687745
9590,760.282667,760.4831,1,22808480,22814493,6013,0.7966747789572419
9591,760.528167,760.534167,1,22815845,22816025,180,-0.05502209689711834
9592,760.535433,760.539933,1,22816062,22816197,135,0.8452831956343775
9593,761.182067,761.213267,1,22835462,22836398,936,0.5099259906059909
9594,761.238267,761.256233,1,22837148,22837686,538,0.6158496840100313
9595,761.262267,761.2658,1,22837868,22837974,106,0.5910880317886564
9596,761.663167,761.704967,1,22849895,22851149,1254,0.6476846967647482
9597,761.716567,761.817933,1,22851497,22854537,3040,0.796720554083643
9598,761.940433,761.955533,1,22858212,22858665,453,0.492899689300677
9599,761.956767,761.9942,1,22858703,22859826,1123,0.7998556063076872
9600,762.0041,762.0452,1,22860123,22861356,1233,0.6896889150045779
9601,762.0615,762.074567,1,22861845,22862237,392,0.01100595559542241
9602,762.075933,762.081733,1,22862277,22862451,174,0.24471436723584283
9603,762.110867,762.220633,1,22863326,22866618,3292,0.8431324456803275
9604,762.443633,762.462667,1,22873308,22873880,572,0.5730321704784094
9605,762.4688,762.473133,1,22874064,22874193,129,0.31831274877241916
9606,763.0348,763.040333,1,22891044,22891209,165,0.49359391998849084
9607,763.053433,763.068033,1,22891602,22892040,438,0.4834003957072689
9608,763.069267,763.075967,1,22892078,22892279,201,0.7149718272760807
9609,763.088133,763.1105,1,22892643,22893315,672,0.5252805759420328
9610,763.112867,763.117567,1,22893386,22893527,141,0.669473414274658
9611,763.1274,763.139933,1,22893822,22894197,375,0.6337518945577149
9612,763.7572,763.895967,1,22912716,22916879,4163,0.8004928640089916
9613,763.921067,763.927367,1,22917632,22917821,189,0.0607662867612208
9614,764.492567,764.504233,1,22934777,22935126,349,0.6169844535319747
9615,764.514533,764.527667,1,22935435,22935830,395,0.5249815829361847
9616,764.5507,764.570533,1,22936521,22937115,594,0.6345152177808512
9617,764.599167,764.612767,1,22937975,22938383,408,0.6726574044682831
9618,764.617933,764.6344,1,22938537,22939032,495,0.7489611287889978
9619,764.680433,764.6993,1,22940412,22940979,567,0.7189330161294943
9620,764.729267,764.733933,1,22941878,22942017,139,0.18752367389146637
9621,764.786967,764.7951,1,22943609,22943853,244,0.728943251542872
9622,764.799467,764.8052,1,22943984,22944156,172,0.5790676046760987
9623,764.8381,764.856467,1,22945143,22945694,551,0.7114750499683602
9624,764.860433,764.878767,1,22945812,22946363,551,0.8155107055612882
9625,764.909267,764.924833,1,22947278,22947744,466,0.7919731973218783
9626,764.9489,764.962967,1,22948467,22948889,422,0.6129241365502008
9627,764.9694,764.9793,1,22949082,22949379,297,0.5820046980193534
9628,764.993833,764.9984,1,22949814,22949952,138,0.5415858983585525
9629,764.999567,765.004533,1,22949987,22950135,148,0.3707992930886478
9630,765.009567,765.0179,1,22950287,22950537,250,0.4605848851118757
9631,765.0243,765.056467,1,22950729,22951694,965,0.017189922813777504
9632,765.057833,765.0681,1,22951734,22952043,309,-0.13074176001642193
9633,765.1016,765.107867,1,22953048,22953236,188,0.6827191513150571
9634,765.109233,765.197567,1,22953276,22955927,2651,0.7681571910701119
9635,765.2125,765.220133,1,22956375,22956603,228,-0.06252035037206781
9636,765.2224,765.2367,1,22956672,22957101,429,0.14045343790365258
9637,765.286433,765.2901,1,22958592,22958703,111,0.886353046175117
9638,765.409267,765.4417,1,22962278,22963251,973,0.6816970198502011
9639,765.445,765.456533,1,22963350,22963695,345,0.49460990730570215
9640,765.462467,765.545633,1,22963874,22966368,2494,0.7809784913729977
9641,765.5866,765.5907,1,22967598,22967721,123,0.6333337111711695
9642,765.595433,765.609667,1,22967862,22968290,428,-0.06679447095011191
9643,765.611167,765.6162,1,22968335,22968486,151,
9644,765.658133,765.6615,1,22969743,22969845,102,0.4347748108108856
9645,765.6684,765.755567,1,22970052,22972667,2615,0.8096631909698949
9646,765.757433,765.795567,1,22972722,22973867,1145,0.8514108645892748
9647,765.853567,765.858867,1,22975607,22975766,159,0.8289457692502759
9648,766.230033,766.2469,1,22986900,22987407,507,0.7211553102375375
9649,766.273,766.283967,1,22988190,22988519,329,0.49598062194962017
9650,766.307467,766.321967,1,22989224,22989659,435,0.8609006277185526
9651,766.333767,766.363467,1,22990013,22990904,891,0.7545276210716444
9652,766.365733,766.3876,1,22990971,22991628,657,0.7495474000120252
9653,766.395967,766.400667,1,22991879,22992020,141,0.5408475367786058
9654,766.405333,766.4416,1,22992159,22993248,1089,0.8468054400347499
9655,766.443633,766.476233,1,22993308,22994286,978,0.8285606313894689
9656,766.488367,766.5636,1,22994651,22996908,2257,0.8041573559230931
9657,766.568233,766.580867,1,22997046,22997426,380,0.2593439188375443
9658,766.584467,766.606933,1,22997534,22998207,673,0.6390386645177978
9659,766.622267,766.6267,1,22998668,22998801,133,-0.057114475975796886
9660,766.633267,766.647933,1,22998998,22999437,439,0.03921219879489377
9661,766.6506,766.6832,1,22999518,23000496,978,0.08885029857363683
9662,766.729867,766.7374,1,23001896,23002122,226,0.7422999210207791
9663,766.7385,766.831033,1,23002155,23004930,2775,0.817793209630509
9664,766.861967,766.8704,1,23005859,23006112,253,-0.015663722714889385
9665,766.8761,766.889367,1,23006283,23006681,398,-0.008219487713534146
9666,766.894,766.898133,1,23006820,23006943,123,-0.16003474421316427
9667,766.8996,766.911367,1,23006988,23007341,353,-0.07704804698253644
9668,766.9215,766.924967,1,23007645,23007749,104,-0.3184121582220455
9669,767.010733,767.180433,1,23010321,23015412,5091,0.8014948119380152
9670,767.215967,767.219167,1,23016479,23016575,96,-0.07096921980424925
9671,767.222567,767.229133,1,23016677,23016873,196,0.24793532763317647
9672,767.239267,767.246433,1,23017178,23017392,214,-0.004007476905569596
9673,768.0337,768.045867,1,23041011,23041376,365,0.5694834377951774
9674,768.0491,768.063133,1,23041473,23041893,420,0.04683121455673083
9675,768.0978,768.178033,1,23042934,23045340,2406,0.7753008651458386
9676,768.186933,768.1946,1,23045607,23045838,231,0.1363730881256075
9677,768.429533,768.616867,1,23052885,23058506,5621,0.785249331765882
9678,768.628033,768.6562,1,23058840,23059686,846,0.7832175868634926
9679,768.6594,768.721433,1,23059782,23061642,1860,0.684471054977431
9680,768.7237,768.7335,1,23061711,23062005,294,0.8401487416595831
9681,769.0304,769.067567,1,23070912,23072027,1115,0.6647581588874696
9682,769.093067,769.104467,1,23072792,23073134,342,0.6095586211348896
9683,769.1103,769.115067,1,23073309,23073452,143,0.6471383769973231
9684,769.127867,769.136767,1,23073836,23074103,267,0.7962459576925968
9685,769.151667,769.1654,1,23074550,23074962,412,0.6419900584623232
9686,769.193267,769.199033,1,23075798,23075970,172,0.0561823526799039
9687,769.208333,769.2209,1,23076249,23076627,378,0.03344106466384253
9688,769.226867,769.238433,1,23076806,23077152,346,0.09007966754173298
9689,769.241333,769.2529,1,23077239,23077587,348,-0.07178603346863856
9690,769.294133,769.405167,1,23078823,23082155,3332,0.7313465371569413
9691,769.638067,769.859867,1,23089142,23095796,6654,0.8039235482478893
9692,769.905167,769.908267,1,23097155,23097248,93,
9693,769.9101,769.913167,1,23097303,23097395,92,-0.38748512666911994
9694,769.936467,770.0256,1,23098094,23100768,2674,0.8072426922520456
9695,770.042433,770.048567,1,23101272,23101457,185,-0.050065882112595154
9696,770.4634,770.4825,1,23113902,23114475,573,0.7042639445198433
9697,770.485433,770.4918,1,23114562,23114754,192,0.6462842737121102
9698,770.530367,770.558233,1,23115911,23116746,835,0.8778213275161931
9699,770.568,770.6269,1,23117040,23118807,1767,0.6407453612891196
9700,770.6522,770.676067,1,23119566,23120282,716,0.6019356742706508
9701,770.6779,770.703867,1,23120337,23121116,779,0.6660682059745974
9702,770.7182,770.771133,1,23121546,23123133,1587,0.6849164930090641
9703,770.779033,770.7953,1,23123370,23123859,489,0.4759576158110913
9704,770.8012,770.8074,1,23124036,23124222,186,0.7628554809100666
9705,770.816467,770.827233,1,23124494,23124816,322,0.8399340927001773
9706,770.828533,770.8351,1,23124855,23125053,198,0.7257896824519099
9707,770.865,770.877567,1,23125950,23126327,377,-0.1734963002922163
9708,770.879033,770.8865,1,23126370,23126595,225,-0.129651906408681
9709,770.888233,770.907433,1,23126646,23127222,576,0.00314523932052967
9710,770.922233,770.926067,1,23127666,23127782,116,0.6053954254610282
9711,770.931267,771.0836,1,23127938,23132508,4570,0.8112608700067233
9712,771.085033,771.089433,1,23132550,23132682,132,-0.13396319673855192
9713,771.0993,771.1197,1,23132979,23133591,612,0.7633022955286102
9714,771.124333,771.160367,1,23133729,23134811,1082,0.7556635517854593
9715,771.181233,771.251967,1,23135436,23137559,2123,0.7772294719575319
9716,771.265133,771.295133,1,23137953,23138853,900,0.8083767057143092
9717,771.298867,771.365733,1,23138966,23140971,2005,0.7581892855357935
9718,771.367133,771.385333,1,23141013,23141559,546,0.6792582178633644
9719,771.3881,771.391633,1,23141643,23141748,105,-0.1250515812826378
9720,771.413733,771.4169,1,23142411,23142507,96,
9721,771.974567,771.9829,1,23159237,23159487,250,0.7304017742481252
9722,771.988167,772.0204,1,23159645,23160612,967,0.21034933897899102
9723,772.030633,772.053167,1,23160918,23161595,677,0.4287514810950943
9724,772.077333,772.081033,1,23162319,23162430,111,0.6072421087741574
9725,772.1039,772.111633,1,23163117,23163348,231,0.7975421213896706
9726,772.247167,772.260933,1,23167415,23167827,412,0.4793868013168192
9727,772.266733,772.273967,1,23168001,23168219,218,0.2756625064075895
9728,772.3146,772.3244,1,23169438,23169732,294,0.6285248567070709
9729,772.326167,772.3314,1,23169785,23169942,157,0.6696015553836167
9730,772.575733,772.594967,1,23177271,23177849,578,0.7389682225145291
9731,772.596867,772.649767,1,23177906,23179493,1587,0.8410039414655798
9732,772.651667,772.746733,1,23179550,23182401,2851,0.8199507658306091
9733,772.756733,772.838567,1,23182701,23185157,2456,0.8481549349168106
9734,772.8422,772.8959,1,23185266,23186877,1611,0.8070230804676584
9735,772.934167,772.938533,1,23188025,23188155,130,-0.037246434605638805
9736,772.9399,772.9463,1,23188197,23188389,192,0.6406839117273333
9737,773.504433,773.5172,1,23205132,23205516,384,0.6869780378581625
9738,773.526233,773.534833,1,23205786,23206044,258,0.6210395183619744
9739,773.577433,773.5883,1,23207322,23207649,327,0.9108411500197979
9740,773.609867,773.613733,1,23208296,23208411,115,0.21582466083802807
9741,773.621167,773.665367,1,23208635,23209961,1326,0.5638692530491918
9742,773.692133,773.708967,1,23210763,23211269,506,0.718906064320626
9743,773.724567,773.784367,1,23211737,23213531,1794,0.6553816409337974
9744,773.797633,773.818133,1,23213928,23214543,615,0.6451901172914702
9745,773.8217,773.824767,1,23214651,23214743,92,0.09397323966752029
9746,773.877967,773.883433,1,23216339,23216502,163,0.4981284171263129
9747,773.920767,773.937067,1,23217623,23218112,489,0.6515119476395662
9748,773.994967,774.013867,1,23219849,23220416,567,0.6747091602574173
9749,774.035833,774.040633,1,23221074,23221218,144,0.6292651602730417
9750,774.0469,774.062633,1,23221407,23221878,471,0.5690784804542851
9751,774.197933,774.201933,1,23225937,23226057,120,0.5958230535055972
9752,774.2032,774.2076,1,23226096,23226228,132,0.3720440930841188
9753,774.212767,774.224467,1,23226383,23226734,351,0.42905020748453315
9754,774.2263,774.3206,1,23226789,23229618,2829,0.8014001989690936
9755,774.563067,774.571833,1,23236892,23237154,262,0.5646857105620621
9756,774.5745,774.8752,1,23237235,23246256,9021,0.7612008923937937
9757,775.2717,775.278933,1,23258151,23258367,216,0.5313488739142266
9758,775.28,775.2976,1,23258400,23258928,528,0.6839576967354809
9759,775.3078,775.342033,1,23259234,23260260,1026,0.7975107471296041
9760,775.346033,775.404433,1,23260380,23262132,1752,0.8071226263655853
9761,775.4118,775.527867,1,23262354,23265836,3482,0.8273197969735303
9762,775.530567,775.6063,1,23265917,23268189,2272,0.7513298647379911
9763,775.609467,775.6631,1,23268284,23269893,1609,0.6874311610495044
9764,775.680333,775.713767,1,23270409,23271413,1004,0.646450428321151
9765,775.7281,775.753333,1,23271843,23272599,756,0.7577424775514559
9766,775.7665,775.771267,1,23272995,23273138,143,0.3701359654376473
9767,775.787733,775.797533,1,23273631,23273925,294,0.14531488718249236
9768,775.798833,775.809067,1,23273964,23274272,308,0.02966139522911467
9769,775.812367,775.8172,1,23274371,23274516,145,-0.11473489971263343
9770,775.897167,775.902933,1,23276915,23277087,172,-0.13869297949352064
9771,775.9047,776.033267,1,23277141,23280998,3857,0.8525853741383778
9772,776.368867,776.4406,1,23291066,23293218,2152,0.8388587711353075
9773,776.442433,776.524233,1,23293272,23295726,2454,0.831791906429229
9774,776.542833,776.6651,1,23296284,23299953,3669,0.7663003819469143
9775,776.667467,776.729967,1,23300024,23301899,1875,0.787629110019928
9776,776.735,776.7527,1,23302050,23302581,531,0.6919183015429385
9777,776.7555,776.8083,1,23302665,23304249,1584,0.7415753089287339
9778,776.8106,776.820367,1,23304318,23304611,293,-0.03818137534489506
9779,777.1253,777.251933,1,23313759,23317557,3798,0.7652865249921225
9780,777.253167,777.312633,1,23317595,23319378,1783,0.7894002142870054
9781,777.319467,777.355333,1,23319584,23320659,1075,0.7774855770758855
9782,777.378733,777.5783,1,23321361,23327349,5988,0.6707519244999884
9783,777.631133,777.727233,1,23328933,23331816,2883,0.7910091208711647
9784,777.748367,777.751667,1,23332451,23332550,99,
9785,778.1628,778.459733,1,23344884,23353791,8907,0.7553480639059852
9786,778.489767,778.494867,1,23354693,23354846,153,0.3123664809408
9787,778.509567,778.518467,1,23355287,23355554,267,0.20774867338750488
9788,778.520133,778.529033,1,23355603,23355870,267,-0.06957311370450919
9789,778.7972,778.9525,1,23363916,23368575,4659,0.8239256796388863
9790,778.976067,778.988367,1,23369282,23369651,369,0.7028402807577497
9791,778.9907,778.994367,1,23369721,23369831,110,0.578793419499103
9792,779.001567,779.080933,1,23370047,23372427,2380,0.8538580603965055
9793,779.1785,779.2006,1,23375355,23376018,663,0.5859786795871349
9794,779.217367,779.3068,1,23376521,23379204,2683,0.7918824145154298
9795,779.328333,779.334833,1,23379849,23380044,195,-0.2189907702258048
9796,779.5954,779.810467,1,23387862,23394314,6452,0.8035556014382621
9797,779.834133,779.838267,1,23395023,23395148,125,
9798,779.844467,779.876267,1,23395334,23396288,954,0.0034463958663457713
9799,779.8812,779.885067,1,23396436,23396552,116,
9800,780.131367,780.137867,1,23403941,23404136,195,0.5496934549495194
9801,780.1417,780.144933,1,23404251,23404347,96,0.3576015379581901
9802,780.155567,780.1976,1,23404667,23405928,1261,0.6152543068549576
9803,780.21,780.246133,1,23406300,23407383,1083,0.7057043739309403
9804,780.258867,780.3491,1,23407766,23410473,2707,0.7478901410166487
9805,780.353633,780.470067,1,23410608,23414102,3494,0.6998355950269416
9806,780.485933,780.533367,1,23414577,23416001,1424,0.6886543404953995
9807,780.534733,780.570167,1,23416041,23417105,1064,0.6771253878846489
9808,780.5911,780.5946,1,23417733,23417838,105,
9809,780.596733,780.602033,1,23417901,23418060,159,0.09581433489160253
9810,780.606433,780.613567,1,23418192,23418407,215,0.219144975156783
9811,780.6185,780.622933,1,23418555,23418687,132,0.25498933701940035
9812,780.6296,780.6334,1,23418888,23419002,114,-0.19940700236090145
9813,780.640633,780.7414,1,23419218,23422242,3024,0.8009329892520202
9814,780.751867,780.757733,1,23422556,23422731,175,0.1254262977878522
9815,781.4204,781.424867,1,23442612,23442746,134,0.3288976580308395
9816,781.449733,781.455333,1,23443491,23443659,168,0.44550599404074465
9817,781.4862,781.489567,1,23444586,23444687,101,0.5683214884031457
9818,781.4913,781.502,1,23444739,23445060,321,0.5653515915056161
9819,781.551667,781.563733,1,23446550,23446911,361,0.5469675298308585
9820,781.567933,781.575367,1,23447037,23447261,224,0.3955129354801083
9821,781.611067,781.6222,1,23448332,23448666,334,0.5775067518093231
9822,781.6561,781.668833,1,23449683,23450064,381,0.525889009621407
9823,781.791867,781.901033,1,23453756,23457030,3274,0.8058936121317721
9824,782.161333,782.246567,1,23464839,23467397,2558,0.7419405923329622
9825,782.248533,782.378267,1,23467455,23471348,3893,0.8218082316976928
9826,782.380867,782.396667,1,23471426,23471900,474,0.7462473657549431
9827,782.4041,782.484733,1,23472123,23474541,2418,0.8155318316162564
9828,782.512667,782.5273,1,23475380,23475819,439,0.22702312058541374
9829,782.927833,782.966933,1,23487834,23489007,1173,0.5486102800449043
9830,782.976133,783.003333,1,23489283,23490099,816,0.6442341320939133
9831,783.211667,783.2311,1,23496350,23496933,583,0.1901258063318725
9832,783.233233,783.322433,1,23496996,23499672,2676,0.7847596902812649
9833,783.337567,783.341767,1,23500127,23500253,126,-0.06886633207853499
9834,783.3432,783.353,1,23500296,23500590,294,-0.10041785486119192
9835,783.359033,783.372267,1,23500770,23501168,398,0.08015460748388352
9836,783.376233,783.380033,1,23501286,23501400,114,0.385563578823753
9837,783.561967,783.593467,1,23506859,23507804,945,0.7116936748171926
9838,783.597833,783.604667,1,23507934,23508140,206,0.19808648296146944
9839,783.720267,783.7863,1,23511608,23513589,1981,0.7779556494157431
9840,783.788133,783.9808,1,23513643,23519424,5781,0.7903226820573571
9841,784.555233,784.562133,1,23536656,23536863,207,0.5228455735368823
9842,784.598,784.6451,1,23537940,23539353,1413,0.5783701954801345
9843,784.667567,784.690567,1,23540027,23540717,690,0.589440297356781
9844,784.7286,784.7323,1,23541858,23541969,111,0.33381300831619026
9845,784.739867,784.756767,1,23542196,23542703,507,0.6595276162604238
9846,784.7735,784.7914,1,23543205,23543742,537,0.6288953187828565
9847,784.7924,784.817033,1,23543772,23544510,738,0.7015572294161426
9848,784.840567,784.858967,1,23545217,23545769,552,0.593596891182345
9849,784.880367,784.8905,1,23546411,23546715,304,0.5819117546141278
9850,784.899567,784.905267,1,23546987,23547158,171,0.571639100944379
9851,784.944133,784.948567,1,23548323,23548457,134,0.4110963048586306
9852,784.956633,784.963967,1,23548698,23548919,221,-0.15682470259302334
9853,784.965467,784.9911,1,23548964,23549733,769,0.16323943859721948
9854,784.995433,785.0022,1,23549862,23550066,204,0.20947294253560617
9855,785.022267,785.1325,1,23550668,23553975,3307,0.7782916564408645
9856,785.134533,785.137767,1,23554035,23554133,98,0.33483849145391514
9857,785.1699,785.176333,1,23555097,23555289,192,0.001232870288107455
9858,785.178233,785.191033,1,23555346,23555730,384,-0.03736655721944508
9859,785.195,785.2039,1,23555850,23556117,267,-0.18906729724240143
9860,785.384167,785.393533,1,23561525,23561805,280,0.452283355733561
9861,785.398133,785.5437,1,23561943,23566311,4368,0.8201754873988878
9862,785.5566,785.643367,1,23566698,23569301,2603,0.7587713865570966
9863,785.644967,785.6482,1,23569349,23569446,97,0.5078395505420781
9864,785.6494,785.7012,1,23569482,23571036,1554,0.7920842831405227
9865,785.703067,785.7063,1,23571092,23571189,97,0.5761143627745348
9866,785.7163,785.7226,1,23571489,23571678,189,-0.015763078388557856
9867,786.275933,786.2805,1,23588277,23588415,138,0.5497265142188625
9868,786.301,786.333133,1,23589030,23589993,963,0.7936996680015505
9869,786.3459,786.363867,1,23590377,23590916,539,0.846575664749416
9870,786.3741,786.434733,1,23591223,23593041,1818,0.7486805959872143
9871,786.4415,786.446167,1,23593245,23593385,140,0.526556785242925
9872,786.456933,786.480833,1,23593707,23594424,717,0.7021310763213161
9873,786.506133,786.516967,1,23595183,23595509,326,-0.11320476411387335
9874,786.519167,786.525333,1,23595575,23595759,184,0.040288568267207836
9875,786.527267,786.543,1,23595818,23596290,472,0.1370930809993783
9876,786.544433,786.550067,1,23596332,23596502,170,0.025234683252276936
9877,786.569933,786.678033,1,23597097,23600340,3243,0.7724081112011043
9878,786.706133,786.709733,1,23601183,23601291,108,0.3486005497271479
9879,786.7189,786.721967,1,23601567,23601659,92,
9880,786.728733,786.734633,1,23601861,23602038,177,0.2224550242359747
9881,786.740933,786.747,1,23602227,23602410,183,-0.06607558224918786
9882,786.755467,786.7619,1,23602664,23602857,193,-0.05765423739279544
9883,786.7691,786.7735,1,23603073,23603205,132,
9884,786.775067,786.7839,1,23603252,23603517,265,0.10360506542035901
9885,786.7907,786.802967,1,23603721,23604089,368,-0.009545358618330205
9886,786.8616,786.890867,1,23605848,23606726,878,0.707186476617566
9887,786.893233,786.906967,1,23606796,23607209,413,0.6258954492778063
9888,786.913733,786.9866,1,23607411,23609598,2187,0.775541141755211
9889,786.9929,786.998767,1,23609787,23609963,176,-0.10467433282517327
9890,787.3729,787.582533,1,23621187,23627475,6288,0.7545961724679858
9891,787.790767,787.806167,1,23633723,23634185,462,0.6903824666170025
9892,787.808433,787.8523,1,23634252,23635569,1317,0.6348132545024546
9893,787.8548,787.8696,1,23635644,23636088,444,-0.13491003238238133
9894,787.8715,787.8855,1,23636145,23636565,420,0.45924522595763884
9895,787.9733,787.9837,1,23639199,23639511,312,0.4820639902461945
9896,787.984867,788.036867,1,23639546,23641106,1560,0.4896676190147097
9897,788.039167,788.067033,1,23641175,23642010,835,0.7413949929802465
9898,788.087967,788.0957,1,23642639,23642871,232,-0.1674552322108652
9899,788.101133,788.117633,1,23643033,23643528,495,0.4060144571292025
9900,788.123067,788.168833,1,23643692,23645064,1372,0.10329001657872508
9901,788.170267,788.186167,1,23645108,23645585,477,0.07038166692196342
9902,788.221733,788.3774,1,23646651,23651322,4671,0.7843686369457368
9903,788.3828,788.386533,1,23651484,23651595,111,0.582467011823572
9904,788.399833,788.4479,1,23651994,23653437,1443,0.7813691751845712
9905,788.449567,788.521833,1,23653487,23655654,2167,0.7259427307064213
9906,788.535233,788.541767,1,23656056,23656253,197,-0.044740823856209574
9907,788.547533,788.5555,1,23656425,23656665,240,0.28789537015123123
9908,788.579767,788.590267,1,23657393,23657708,315,0.2519688835696012
9909,788.607067,788.610467,1,23658212,23658314,102,-0.1434631066448551
9910,788.617267,788.624233,1,23658518,23658726,208,0.5347908977841325
9911,788.6359,789.055433,1,23659077,23671662,12585,0.3113605796889814
9912,789.0579,789.102333,1,23671737,23673069,1332,0.8060244788121431
9913,789.104633,789.146867,1,23673138,23674406,1268,0.8049487096374589
9914,789.149367,789.369233,1,23674481,23681076,6595,0.17311189113349593
9915,789.392567,789.438867,1,23681777,23683166,1389,0.7537182184501116
9916,789.440633,789.4861,1,23683218,23684583,1365,0.553745602548169
9917,789.487733,789.5039,1,23684631,23685117,486,0.576789120267698
9918,789.535033,789.6062,1,23686050,23688186,2136,0.16644752908906724
9919,789.609467,789.6161,1,23688284,23688483,199,0.46428377218026223
9920,789.623667,789.734333,1,23688710,23692029,3319,0.8355675145830556
9921,789.7411,789.747367,1,23692233,23692421,188,0.029851899925032212
9922,789.748533,789.753833,1,23692455,23692614,159,
9923,789.756267,789.806033,1,23692688,23694180,1492,0.8469334354811159
9924,789.8071,789.8446,1,23694213,23695338,1125,0.728747667794846
9925,789.8466,789.853233,1,23695398,23695596,198,0.33339269642309577
9926,789.854833,789.873967,1,23695644,23696219,575,0.6980298018775755
9927,790.017967,790.0241,1,23700539,23700723,184,-0.03587313425281439
9928,790.082233,790.0918,1,23702466,23702754,288,0.28086068658655483
9929,790.093267,790.1001,1,23702798,23703003,205,0.2804570750879539
9930,790.1138,790.135233,1,23703414,23704056,642,0.36991080145808697
9931,790.153933,790.166033,1,23704617,23704980,363,0.14084925833215023
9932,790.246833,790.2509,1,23707404,23707527,123,0.4721511777288914
9933,790.271467,790.277967,1,23708144,23708339,195,0.36121463709612706
9934,790.279767,790.319333,1,23708393,23709579,1186,0.5656944493300855
9935,790.325233,790.332967,1,23709756,23709989,233,0.014016053756805043
9936,790.3345,790.354167,1,23710035,23710625,590,0.6729801062280565
9937,790.378533,790.420633,1,23711355,23712618,1263,0.06480827287240348
9938,790.427867,790.439033,1,23712836,23713170,334,-0.17304328530758004
9939,790.461467,790.4758,1,23713844,23714274,430,0.5456088836362468
9940,790.490767,790.5075,1,23714723,23715225,502,0.21004625449092076
9941,790.516867,790.5527,1,23715506,23716581,1075,0.04414313276097812
9942,790.578967,790.693567,1,23717369,23720807,3438,0.8276030145500453
9943,790.737333,790.744933,1,23722119,23722347,228,0.03590549050062412
9944,790.747233,790.756767,1,23722416,23722703,287,0.014384139664272417
9945,790.758467,790.768267,1,23722754,23723048,294,-0.12430138170148697
9946,790.770633,790.778433,1,23723118,23723352,234,-0.16412374737332158
9947,790.9549,790.978833,1,23728647,23729364,717,0.7037654840066732
9948,790.982633,790.9985,1,23729478,23729955,477,0.7171717831274044
9949,791.011033,791.025667,1,23730330,23730770,440,0.2940159191405881
9950,791.044733,791.061667,1,23731341,23731850,509,0.7710528700420332
9951,791.083267,791.0918,1,23732498,23732754,256,0.540247131740434
9952,791.093833,791.139467,1,23732814,23734184,1370,0.728456535076432
9953,791.156167,791.16,1,23734685,23734800,115,-0.0018891972936024945
9954,791.165367,791.1792,1,23734961,23735376,415,0.7549590847872257
9955,791.198467,791.232033,1,23735954,23736960,1006,0.7408883118410092
9956,791.251967,791.3182,1,23737559,23739546,1987,0.13538411918199897
9957,791.338667,791.342467,1,23740160,23740274,114,0.018667981994582545
9958,791.355067,791.461167,1,23740652,23743835,3183,0.8169211538340976
9959,791.471467,791.482833,1,23744144,23744484,340,0.574047435253295
9960,791.4852,791.537667,1,23744556,23746130,1574,0.3098946212769031
9961,791.538667,791.550833,1,23746160,23746524,364,0.15424321827232393
9962,791.560967,791.5701,1,23746829,23747103,274,-0.03119650142088501
9963,791.581833,791.5854,1,23747454,23747562,108,
9964,791.587833,791.602533,1,23747634,23748075,441,0.5784825035442135
9965,791.604767,791.632267,1,23748143,23748968,825,0.2743441071019286
9966,791.633633,791.636667,1,23749008,23749100,92,0.5162031687423316
9967,791.6382,791.6842,1,23749146,23750526,1380,0.07909054678664906
9968,791.691867,791.8485,1,23750756,23755455,4699,0.7985480160806925
9969,791.849633,791.855567,1,23755488,23755667,179,0.6773142682949636
9970,791.8702,791.908167,1,23756106,23757245,1139,0.6672009167908641
9971,791.916767,791.950967,1,23757503,23758529,1026,0.08917340144905456
9972,791.9535,791.9759,1,23758605,23759277,672,0.13326896070373104
9973,792.039133,792.0925,1,23761173,23762775,1602,0.10004677901653476
9974,792.0949,792.122767,1,23762847,23763683,836,0.20247625982151762
9975,792.129033,792.2344,1,23763870,23767032,3162,0.7887810524030004
9976,792.239633,792.261433,1,23767188,23767842,654,0.3363426717669828
9977,792.263067,792.317767,1,23767892,23769533,1641,0.08639020262615944
9978,792.358733,792.369167,1,23770761,23771075,314,0.33598934990453494
9979,792.382867,792.408367,1,23771486,23772251,765,0.34642010663367
9980,792.4132,792.467467,1,23772396,23774024,1628,0.05761534992609766
9981,792.484767,792.571433,1,23774543,23777142,2599,0.7537241591848713
9982,792.573733,792.617133,1,23777211,23778513,1302,0.7172198667851079
9983,792.6384,792.660567,1,23779152,23779817,665,-0.06600068246003855
9984,792.662433,792.6714,1,23779872,23780142,270,0.005421498763576538
9985,792.678967,792.6892,1,23780369,23780676,307,0.12750567330671497
9986,792.6982,792.7021,1,23780946,23781063,117,-0.1515077825320218
9987,792.791967,792.796533,1,23783759,23783895,136,0.9565532800797676
9988,792.801233,792.917633,1,23784036,23787528,3492,0.725189600301251
9989,792.927533,792.9308,1,23787825,23787924,99,0.13051426285049697
9990,792.932767,792.944233,1,23787983,23788326,343,-0.03662821478252163
9991,792.959533,793.004267,1,23788785,23790128,1343,0.11377537570888262
9992,793.060067,793.132267,1,23791802,23793968,2166,0.13225225941207622
9993,793.136167,793.1512,1,23794085,23794536,451,0.13692718896234787
9994,793.152433,793.1559,1,23794572,23794677,105,-0.28247555233956634
9995,793.187367,793.1932,1,23795621,23795796,175,0.4340684259460104
9996,793.2024,793.205533,1,23796072,23796165,93,0.6004485019691621
9997,793.210433,793.260433,1,23796312,23797812,1500,0.6866909524350513
9998,793.261433,793.294567,1,23797842,23798837,995,0.7548238410354908
9999,793.3048,793.3312,1,23799144,23799936,792,0.779481944808564
10000,793.332467,793.3572,1,23799974,23800716,742,-0.020688158852077053
10001,793.375033,793.3957,1,23801250,23801871,621,-0.08097949088427456
10002,793.3999,793.4282,1,23801997,23802846,849,0.07946801781620842
10003,793.5003,793.601833,1,23805009,23808054,3045,0.14039111928615117
10004,793.639133,793.644067,1,23809173,23809322,149,0.36381243684487
10005,793.650367,793.6543,1,23809511,23809629,118,
10006,793.657433,793.674,1,23809722,23810220,498,0.41144754621377383
10007,793.706567,793.7339,1,23811197,23812017,820,0.7084994562282357
10008,793.7395,793.7655,1,23812185,23812965,780,0.49120436313180005
10009,793.806233,793.8114,1,23814186,23814342,156,0.08160594147225725
10010,793.8394,793.864533,1,23815182,23815935,753,0.7319216077732891
10011,793.866033,793.910767,1,23815980,23817323,1343,0.7523512713610433
10012,793.917,793.948233,1,23817510,23818446,936,0.8227358944309249
10013,793.968433,793.9787,1,23819052,23819361,309,0.26217179187465217
10014,793.9964,794.011933,1,23819892,23820357,465,-0.0013451506184200032
10015,794.022167,794.0397,1,23820665,23821191,526,-0.05685605726685255
10016,794.041833,794.083467,1,23821254,23822504,1250,0.14755503524446045
10017,794.086433,794.1507,1,23822592,23824521,1929,0.5692802079449065
10018,794.182367,794.186767,1,23825471,23825603,132,0.599849158707056
10019,794.1898,794.197367,1,23825694,23825921,227,0.14572183547681006
10020,794.2025,794.223033,1,23826075,23826690,615,-0.042526885076465265
10021,794.226,794.330233,1,23826780,23829906,3126,0.48138240838589397
10022,794.344467,794.347533,1,23830334,23830425,91,
10023,794.4552,794.4826,1,23833656,23834478,822,0.47705507255964724
10024,794.4841,794.491767,1,23834523,23834753,230,0.6190288159539177
10025,794.493133,794.499,1,23834793,23834970,177,0.8687864473862977
10026,794.503367,794.544667,1,23835101,23836340,1239,0.613830547475839
10027,794.557533,794.567233,1,23836725,23837016,291,-0.0924152654300115
10028,794.570233,794.586033,1,23837106,23837580,474,0.015860657827055646
10029,794.593867,794.6024,1,23837816,23838072,256,-0.04129444993478307
10030,794.612,794.616033,1,23838360,23838480,120,0.7156043208776107
10031,794.668967,794.675067,1,23840069,23840252,183,0.43241702737013116
10032,794.6843,794.740333,1,23840529,23842209,1680,0.3798936617460139
10033,794.746867,794.859367,1,23842406,23845781,3375,0.810542848249087
10034,795.808,795.8268,1,23874240,23874804,564,0.7268913817265509
10035,795.827867,795.837833,1,23874836,23875134,298,0.5123134694907794
10036,795.839233,795.845867,1,23875176,23875376,200,0.7164747268007713
10037,795.8673,795.8764,1,23876019,23876292,273,0.62233637649371
10038,796.1216,796.172167,1,23883648,23885165,1517,0.7631336588440023
10039,796.176633,796.184733,1,23885298,23885541,243,0.2987776037334124
10040,796.185867,796.196433,1,23885576,23885892,316,0.6532861886583441
10041,796.205033,796.2287,1,23886150,23886861,711,0.7730399616896517
10042,796.621133,796.634833,1,23898633,23899044,411,0.679709330367383
10043,796.6368,796.6428,1,23899104,23899284,180,0.3828160574341027
10044,796.649833,796.659967,1,23899494,23899799,305,0.3137616406046571
10045,796.6618,796.666367,1,23899854,23899991,137,0.4027913281116253
10046,796.6715,796.696067,1,23900145,23900882,737,0.39669055466121145
10047,796.698533,796.718133,1,23900955,23901543,588,0.5536886872654411
10048,796.744933,796.7573,1,23902347,23902719,372,0.5753531083989122
10049,796.7813,796.8075,1,23903439,23904225,786,0.5822165414994205
10050,796.828467,796.836667,1,23904854,23905100,246,0.6048672256393297
10051,796.840167,796.846833,1,23905205,23905404,199,0.4859061182988829
10052,796.847867,796.869533,1,23905436,23906085,649,0.45098309330402275
10053,796.889467,796.9075,1,23906684,23907225,541,0.44881779197970045
10054,796.954567,796.958333,1,23908637,23908749,112,0.6423823461928041
10055,796.959633,796.971567,1,23908788,23909147,359,0.4783617945634555
10056,796.992833,796.999333,1,23909784,23909979,195,0.6739358376558091
10057,797.0071,797.027267,1,23910213,23910818,605,0.6310790370993181
10058,797.062567,797.1099,1,23911877,23913297,1420,0.08162456694374844
10059,797.120233,797.1259,1,23913606,23913777,171,-0.03777563806515891
10060,797.1313,797.262367,1,23913939,23917871,3932,0.8174178650329205
10061,797.328967,797.333133,1,23919869,23919993,124,
10062,797.6478,797.6515,1,23929434,23929545,111,0.13800276977340198
10063,797.653433,797.759467,1,23929602,23932784,3182,0.7264596273588377
10064,797.779267,797.782733,1,23933378,23933481,103,-0.07388833789401397
10065,797.803833,797.8115,1,23934114,23934345,231,-0.03869478517651993
10066,797.8372,797.840333,1,23935116,23935209,93,
10067,797.8458,797.849367,1,23935374,23935481,107,0.0663545359905316
10068,797.8508,797.858633,1,23935524,23935758,234,0.3644204276373738
10069,797.863667,797.867967,1,23935910,23936039,129,0.2666805708411757
10070,797.871667,797.8793,1,23936150,23936379,229,0.14081422747608482
10071,797.8905,797.965267,1,23936715,23938958,2243,0.37851349261692024
10072,798.160567,798.279933,1,23944817,23948397,3580,0.7232995793854784
10073,798.363233,798.4011,1,23950896,23952033,1137,0.05155767758069565
10074,798.404733,798.4136,1,23952141,23952408,267,0.12248851568233836
10075,798.4218,798.475933,1,23952654,23954277,1623,0.44600754958309236
10076,798.688867,798.8874,1,23960666,23966622,5956,0.8132160276598915
10077,798.8912,798.967567,1,23966736,23969027,2291,0.7174989460812943
10078,798.975933,799.025833,1,23969277,23970774,1497,0.7316433323880563
10079,799.035967,799.047733,1,23971079,23971431,352,-0.03516684779916637
10080,799.049633,799.094567,1,23971488,23972837,1349,0.4527844917770783
10081,799.098833,799.1034,1,23972964,23973102,138,0.2963862538591461
10082,799.1134,799.2624,1,23973402,23977872,4470,0.8162218044974624
10083,799.278767,799.321067,1,23978363,23979632,1269,0.7901972959578544
10084,799.345133,799.375833,1,23980353,23981274,921,0.794541286700792
10085,799.386533,799.394467,1,23981595,23981834,239,-0.0812848940427418
10086,799.403833,799.410733,1,23982114,23982321,207,-0.12638745784040226
10087,799.433567,799.5045,1,23983007,23985135,2128,0.6044635333141928
10088,799.884967,799.8907,1,23996549,23996721,172,0.5604251329245271
10089,799.935367,799.954833,1,23998061,23998644,583,0.686216917142105
10090,799.985833,799.9932,1,23999574,23999796,222,0.2606584895918826
10091,799.994833,800.005367,1,23999844,24000161,317,0.5002644730396486
10092,800.0651,800.0739,1,24001953,24002217,264,0.47657943714498063
10093,800.079367,800.093633,1,24002381,24002808,427,0.6296522200850561
10094,800.1086,800.126533,1,24003258,24003795,537,0.5637695222461266
10095,800.1753,800.181933,1,24005259,24005457,198,0.6012990187520214
10096,800.184067,800.193367,1,24005522,24005801,279,0.49700448869203223
10097,800.2169,800.223333,1,24006507,24006699,192,0.5983547219381137
10098,800.229467,800.2461,1,24006884,24007383,499,0.6673681032298493
10099,800.2765,800.280033,1,24008295,24008400,105,
10100,800.286333,800.2942,1,24008589,24008826,237,-0.042736335145075736
10101,800.297167,800.3342,1,24008915,24010026,1111,0.15509093553742503
10102,800.3716,800.479033,1,24011148,24014370,3222,0.7815329724927361
10103,800.725033,800.9567,1,24021750,24028701,6951,0.768789808169968
10104,800.9606,801.0398,1,24028818,24031194,2376,0.814085358278967
10105,801.159933,801.172333,1,24034797,24035169,372,0.7556501470620889
10106,801.173667,801.2072,1,24035210,24036216,1006,0.3773569330127274
10107,801.456267,801.478133,1,24043688,24044343,655,0.7457094107992326
10108,801.4971,801.523267,1,24044913,24045698,785,0.7476678865137374
10109,801.5276,801.594033,1,24045828,24047820,1992,0.7875661342693551
10110,801.5951,801.611533,1,24047853,24048345,492,0.8264582385687953
10111,801.614667,801.7822,1,24048440,24053466,5026,0.7237243891006939
10112,801.784367,801.8089,1,24053531,24054267,736,0.7442433073839351
10113,801.8277,801.874833,1,24054831,24056244,1413,0.7398225593125757
10114,801.876567,801.9111,1,24056297,24057333,1036,0.6361409117105327
10115,801.9206,801.925,1,24057618,24057750,132,
10116,802.0514,802.056467,1,24061542,24061694,152,0.26911360269836554
10117,802.057733,802.121733,1,24061731,24063651,1920,0.3681048013294339
10118,802.171433,802.1783,1,24065142,24065349,207,0.5350439570963593
10119,802.450933,802.457033,1,24073527,24073710,183,0.6809736096764559
10120,802.461333,802.470633,1,24073839,24074118,279,0.3428392202497981
10121,802.502,802.543133,1,24075060,24076293,1233,0.5569382653421763
10122,802.569133,802.588767,1,24077073,24077663,590,0.6395774763837724
10123,802.593333,802.600067,1,24077799,24078002,203,0.23041351113209765
10124,802.6018,802.6481,1,24078054,24079443,1389,0.6765453193434707
10125,802.658933,802.6631,1,24079767,24079893,126,0.4908874352234659
10126,802.6717,802.680333,1,24080151,24080409,258,0.5940510942381749
10127,802.687067,802.702933,1,24080612,24081087,475,0.6107024495359428
10128,802.706467,802.7698,1,24081194,24083094,1900,0.32578725571191813
10129,802.779833,802.782967,1,24083394,24083489,95,-0.2120384102008603
10130,802.784567,802.791033,1,24083537,24083730,193,0.7169626856885934
10131,802.7945,802.916933,1,24083835,24087507,3672,0.8284735997290296
10132,802.918267,802.948333,1,24087548,24088449,901,0.7698758671729227
10133,802.989667,802.9968,1,24089690,24089904,214,0.623384433395432
10134,803.073733,803.0779,1,24092211,24092337,126,0.43881899322851514
10135,803.079633,803.131767,1,24092388,24093953,1565,0.4717385157213122
10136,803.4166,803.443133,1,24102498,24103293,795,0.7261394395687828
10137,803.457567,803.5558,1,24103727,24106674,2947,0.7109983959263226
10138,803.579133,803.6102,1,24107373,24108306,933,0.6041179419493083
10139,803.621333,803.6768,1,24108639,24110304,1665,0.6303256542290707
10140,803.6803,803.721033,1,24110409,24111630,1221,0.6463483506785345
10141,803.723767,803.8159,1,24111713,24114477,2764,0.6502687649023782
10142,803.8621,803.928767,1,24115863,24117863,2000,0.3768007448993078
10143,803.935367,803.946967,1,24118061,24118409,348,-0.11183877059662624
10144,803.948,803.951333,1,24118440,24118539,99,0.1920914620737921
10145,803.952333,803.956233,1,24118569,24118686,117,0.12696807000001245
10146,804.022667,804.0824,1,24120680,24122472,1792,0.6808737894967027
10147,804.086767,804.140733,1,24122603,24124221,1618,0.6578325829751732
10148,804.142133,804.189833,1,24124263,24125694,1431,0.8047876156516359
10149,804.2064,804.2426,1,24126192,24127278,1086,0.559796739171431
10150,804.249367,804.258133,1,24127481,24127743,262,0.4695239625804646
10151,804.271467,804.319733,1,24128144,24129591,1447,0.07936370716974486
10152,804.378767,804.485567,1,24131363,24134567,3204,0.7740268925591033
10153,804.497233,804.507667,1,24134916,24135230,314,0.12133468108688779
10154,804.5088,804.5124,1,24135264,24135372,108,0.7030478980821598
10155,804.5135,804.524733,1,24135405,24135741,336,0.638460690871191
10156,804.525967,804.558533,1,24135779,24136755,976,0.23130762609404784
10157,804.5635,804.575467,1,24136905,24137264,359,0.1445104860555901
10158,804.576533,804.590767,1,24137295,24137723,428,0.2640153864085474
10159,804.604333,804.641633,1,24138129,24139248,1119,0.28107305937091354
10160,804.6438,804.6589,1,24139314,24139767,453,0.3544539307909345
10161,804.6656,804.780033,1,24139968,24143400,3432,0.5866236775355681
10162,804.796033,804.923033,1,24143880,24147690,3810,0.7270193944315356
10163,804.925233,804.928267,1,24147756,24147848,92,-0.13646276287189188
10164,804.9508,805.0072,1,24148524,24150216,1692,0.7654283385393569
10165,805.014967,805.029967,1,24150449,24150899,450,0.6591291767054376
10166,805.035833,805.0457,1,24151074,24151371,297,0.19863174286688687
10167,805.0478,805.0582,1,24151434,24151746,312,-0.11588712364369388
10168,805.066433,805.116167,1,24151992,24153485,1493,0.2937678336113954
10169,805.118733,805.1295,1,24153561,24153885,324,-0.008785236366785219
10170,805.156767,805.161233,1,24154703,24154836,133,0.27314344573793303
10171,805.191067,805.377267,1,24155732,24161318,5586,0.538375983746168
10172,805.378433,805.381533,1,24161352,24161445,93,0.23775795696362517
10173,805.385633,805.519333,1,24161568,24165579,4011,0.3157812093547605
10174,805.528633,805.553967,1,24165858,24166619,761,0.41008717103021
10175,805.563067,805.712767,1,24166892,24171383,4491,0.3054571261520394
10176,805.722967,805.731367,1,24171689,24171941,252,0.014072318880445758
10177,805.9159,805.9774,1,24177477,24179322,1845,0.6734581352758696
10178,805.980667,806.013367,1,24179420,24180401,981,0.7484623796202166
10179,806.016167,806.040967,1,24180485,24181229,744,0.6280609230331258
10180,806.0503,806.089467,1,24181509,24182684,1175,0.7418336680778546
10181,806.091967,806.103267,1,24182759,24183098,339,0.7489564068910973
10182,806.106833,806.134967,1,24183204,24184049,845,0.7044314332055956
10183,806.137333,806.1481,1,24184119,24184443,324,0.43761547207807827
10184,806.173467,806.256267,1,24185204,24187688,2484,0.7518436749210845
10185,806.280133,806.312767,1,24188403,24189383,980,-0.0671547482480298
10186,806.318933,806.330667,1,24189567,24189920,353,0.22958097800305705
10187,806.3947,806.526667,1,24191841,24195800,3959,0.5731448334298486
10188,806.572,806.5997,1,24197160,24197991,831,-0.06405654488244236
10189,806.675833,806.679467,1,24200274,24200384,110,-0.2468639514066518
10190,806.702767,806.7255,1,24201083,24201765,682,-0.03741200076868255
10191,806.727467,806.736867,1,24201824,24202106,282,-0.02289638446433871
10192,806.739233,806.7423,1,24202176,24202269,93,
10193,806.743567,806.748433,1,24202307,24202452,145,-0.0427503151224718
10194,806.7896,806.818767,1,24203688,24204563,875,0.7197777989413123
10195,806.819767,806.98,1,24204593,24209400,4807,0.8000528600835471
10196,806.994867,807.0009,1,24209846,24210027,181,0.6014057394401527
10197,807.0042,807.033933,1,24210126,24211017,891,0.6682596230341774
10198,807.045033,807.0682,1,24211350,24212046,696,-0.040844290383310625
10199,807.070367,807.075167,1,24212111,24212255,144,-0.011463546201402055
10200,807.076367,807.0841,1,24212291,24212523,232,0.12536956796128962
10201,807.148867,807.154,1,24214466,24214620,154,0.7289661048124327
10202,807.1606,807.182533,1,24214818,24215475,657,0.0567818543721337
10203,807.1856,807.248333,1,24215568,24217449,1881,0.11597691602431806
10204,807.285767,807.329167,1,24218573,24219875,1302,0.7367622308436332
10205,807.3394,807.5487,1,24220182,24226461,6279,0.6416826880094945
10206,807.554433,807.620167,1,24226632,24228605,1973,0.5073971608314167
10207,807.6325,807.666833,1,24228975,24230004,1029,0.7054662709709931
10208,807.684933,807.6997,1,24230547,24230991,444,0.6514912994024711
10209,807.703333,807.715833,1,24231099,24231474,375,0.7397356684213363
10210,807.7285,807.733567,1,24231855,24232007,152,-0.06772982232916491
10211,807.736033,807.7404,1,24232080,24232212,132,0.44676035538800096
10212,807.7422,807.755567,1,24232266,24232667,401,0.3319973864196459
10213,807.7758,807.784933,1,24233274,24233547,273,-0.007557644882832734
10214,807.7982,807.806667,1,24233946,24234200,254,-0.03996319111316667
10215,807.8154,807.819433,1,24234462,24234582,120,
10216,808.1624,808.176867,1,24244872,24245306,434,0.5513222044442709
10217,808.178133,808.192733,1,24245343,24245781,438,0.4508059477886951
10218,808.228733,808.237133,1,24246861,24247113,252,0.5393328194197654
10219,808.2622,808.266,1,24247866,24247980,114,0.7231895845026147
10220,808.286867,808.298067,1,24248606,24248942,336,0.7996925611620646
10221,808.438067,808.464233,1,24253142,24253926,784,0.7063060119736404
10222,808.466767,808.549133,1,24254003,24256473,2470,0.7953454622104866
10223,808.6015,808.608033,1,24258045,24258240,195,0.13688594915601243
10224,808.628867,808.6429,1,24258866,24259287,421,0.22070872280223913
10225,809.296433,809.3091,1,24278892,24279273,381,0.6842714965283947
10226,809.3632,809.381767,1,24280896,24281453,557,0.6159036241567466
10227,809.4739,809.482367,1,24284217,24284471,254,0.4699334563902683
10228,809.533267,809.540833,1,24285998,24286224,226,0.5574751812199057
10229,809.543067,809.548933,1,24286292,24286467,175,0.6075745262209682
10230,809.6838,809.821567,1,24290514,24294647,4133,0.7960373300910298
10231,809.837767,809.9615,1,24295133,24298845,3712,0.8005479166988083
10232,809.969333,810.045933,1,24299079,24301377,2298,0.7688086628424761
10233,810.055067,810.209567,1,24301652,24306287,4635,0.7292435706805184
10234,810.2108,810.2141,1,24306324,24306423,99,0.4791733287305035
10235,810.215333,810.219567,1,24306459,24306587,128,0.3623199858265738
10236,810.226133,810.238467,1,24306783,24307154,371,0.041171469883791195
10237,810.541767,810.547833,1,24316253,24316434,181,0.5098225768771999
10238,810.5496,810.564133,1,24316488,24316923,435,0.7133290764705904
10239,810.565333,810.568467,1,24316959,24317054,95,0.4736791537060814
10240,810.574667,810.609,1,24317240,24318270,1030,0.5968576164776472
10241,810.617833,810.7437,1,24318534,24322311,3777,0.7186121685766803
10242,810.744733,810.7988,1,24322341,24323964,1623,0.7925642386921078
10243,810.801133,810.8336,1,24324033,24325008,975,0.7637107581595345
10244,811.413,811.443567,1,24342390,24343307,917,0.5207818000629867
10245,811.507,811.512833,1,24345210,24345384,174,0.36268769218662417
10246,811.6114,811.6193,1,24348342,24348579,237,0.16860260755104167
10247,811.625633,811.6322,1,24348768,24348966,198,-0.12319920541288666
10248,811.6671,811.685233,1,24350013,24350556,543,0.6014950363151396
10249,811.806567,811.916033,1,24354197,24357480,3283,0.7783861896360218
10250,811.9233,811.9858,1,24357699,24359574,1875,0.7685930357624388
10251,812.008067,812.093467,1,24360242,24362804,2562,0.7855061390455906
10252,812.371333,812.493333,1,24371139,24374799,3660,0.7790029678845736
10253,812.776333,812.785267,1,24383289,24383558,269,0.43777085973015684
10254,812.788167,813.048267,1,24383645,24391448,7803,0.7702807313062231
10255,813.059733,813.064233,1,24391791,24391926,135,-0.03203268416390869
10256,813.069233,813.073433,1,24392076,24392202,126,0.16742805271984731
10257,813.211133,813.217033,1,24396333,24396510,177,0.41906825700915196
10258,813.286967,813.3664,1,24398609,24400992,2383,0.7703896868455683
10259,813.3675,813.4319,1,24401025,24402957,1932,0.7549434885022706
10260,813.659533,813.833367,1,24409785,24415001,5216,0.7433320702005582
10261,814.111667,814.116433,1,24423350,24423492,142,-0.14055758087083933
10262,814.125733,814.136233,1,24423771,24424086,315,0.7220081931268649
10263,814.1379,814.2266,1,24424137,24426798,2661,0.6707169375245323
10264,814.2286,814.274733,1,24426858,24428241,1383,0.7989382741541626
10265,814.276267,814.346333,1,24428288,24430389,2101,0.8044249679501152
10266,814.543967,814.637933,1,24436319,24439137,2818,0.747949413189146
10267,814.640433,814.849267,1,24439212,24445478,6266,0.7582501031438611
10268,814.868567,814.8724,1,24446057,24446172,115,0.0162156378152553
10269,815.1585,815.214367,1,24454755,24456431,1676,0.7225835281682975
10270,815.216267,815.222867,1,24456488,24456686,198,0.7530010315293996
10271,815.2241,815.2569,1,24456723,24457707,984,0.7925296030909426
10272,815.5171,815.639533,1,24465513,24469185,3672,0.7076715685430863
10273,815.6425,815.706367,1,24469275,24471191,1916,0.8012101474423481
10274,815.723533,815.745533,1,24471705,24472365,660,0.7462640415761331
10275,815.750133,815.7635,1,24472503,24472905,402,0.7839740671805139
10276,815.808433,815.913633,1,24474252,24477408,3156,0.694921051080457
10277,815.918367,815.922267,1,24477551,24477668,117,0.36911430668985973
10278,816.0961,816.183667,1,24482883,24485510,2627,0.06042509955278905
10279,816.185,816.299633,1,24485550,24488988,3438,0.8280647948020919
10280,816.323267,816.342267,1,24489698,24490268,570,0.0463142656807651
10281,816.3535,816.390533,1,24490605,24491715,1110,-0.032443609799157884
10282,816.391567,816.3959,1,24491747,24491877,130,
10283,816.4584,816.4616,1,24493752,24493848,96,
10284,816.473667,816.4972,1,24494210,24494916,706,0.2519768073142339
10285,816.511667,816.5257,1,24495350,24495771,421,0.06941453785041515
10286,816.539167,816.647267,1,24496175,24499418,3243,0.8340896598049539
10287,816.656967,816.662633,1,24499709,24499878,169,-0.2108291119358742
10288,816.687533,816.693133,1,24500625,24500793,168,0.5065736435660769
10289,816.7068,816.713,1,24501204,24501390,186,0.009969938481132526
10290,816.7165,816.723767,1,24501495,24501713,218,0.5878096211803525
10291,816.800533,816.805867,1,24504015,24504176,161,-0.21431482223290252
10292,816.8303,816.849933,1,24504909,24505497,588,0.2638881580249535
10293,816.892033,816.897033,1,24506760,24506910,150,0.1370104419019474
10294,817.026067,817.031433,1,24510782,24510942,160,0.5252436083242656
10295,817.053667,817.121633,1,24511610,24513648,2038,0.7693403688830015
10296,817.123933,817.138533,1,24513717,24514155,438,0.7552127964209041
10297,817.147267,817.180833,1,24514418,24515424,1006,0.7324782721111118
10298,817.1821,817.224533,1,24515463,24516735,1272,0.7352462644843791
10299,817.226167,817.231333,1,24516785,24516939,154,0.1506757767678834
10300,817.244033,817.3383,1,24517320,24520149,2829,0.7902390612959712
10301,817.7628,817.771467,1,24532884,24533144,260,0.37007435407953415
10302,817.777567,817.807033,1,24533327,24534210,883,0.39088368960463676
10303,817.808333,817.812733,1,24534249,24534381,132,0.3898812499975426
10304,817.834,817.8471,1,24535020,24535413,393,-0.04677167755902159
10305,817.927967,818.033033,1,24537839,24540990,3151,0.7498423342512115
10306,818.034867,818.042567,1,24541046,24541277,231,0.6390594523928922
10307,818.057333,818.079467,1,24541719,24542384,665,-0.014946453500638657
10308,818.081933,818.111067,1,24542457,24543332,875,-0.034410846486508856
10309,818.1121,818.116033,1,24543363,24543480,117,-0.22454937901706234
10310,818.1664,818.173433,1,24544992,24545202,210,0.46273420682221306
10311,818.186733,818.2087,1,24545601,24546261,660,0.35061037137901285
10312,818.2158,818.2356,1,24546474,24547068,594,-0.03401947432796263
10313,818.244533,818.254667,1,24547335,24547640,305,-0.004505767240038891
10314,818.256233,818.260767,1,24547686,24547823,137,0.4119845593625914
10315,818.2648,818.3843,1,24547944,24551529,3585,0.8218739510950092
10316,818.3891,818.395267,1,24551673,24551858,185,0.07062490242515697
10317,818.705967,818.710567,1,24561179,24561317,138,0.5564773112070359
10318,818.727633,818.731133,1,24561828,24561933,105,0.6159571745593102
10319,818.747967,818.755533,1,24562439,24562665,226,0.5963343146481508
10320,818.7699,818.790333,1,24563097,24563709,612,0.684808637865471
10321,818.7932,818.805,1,24563796,24564150,354,0.30848874774269375
10322,818.828133,818.852733,1,24564843,24565581,738,0.6286892802740975
10323,818.885867,818.891733,1,24566576,24566751,175,0.33238596093607514
10324,818.900133,818.915133,1,24567003,24567453,450,0.38487601669991406
10325,818.9405,818.948833,1,24568215,24568464,249,0.2301477928002606
10326,818.999733,819.0075,1,24569991,24570225,234,0.6529563928900266
10327,819.0092,819.020833,1,24570276,24570624,348,0.5154266906629015
10328,819.074033,819.080067,1,24572220,24572402,182,0.2954199442789065
10329,819.092667,819.099933,1,24572780,24572997,217,
10330,819.102133,819.112967,1,24573063,24573389,326,0.0682988019231173
10331,819.114067,819.1184,1,24573422,24573552,130,-0.028652947716975862
10332,819.155267,819.337467,1,24574658,24580124,5466,0.7997577836495393
10333,819.3603,819.499967,1,24580809,24584999,4190,0.696741680464472
10334,819.794567,819.803267,1,24593837,24594098,261,0.03856451152565307
10335,819.8084,819.862433,1,24594252,24595872,1620,0.7700083029957916
10336,819.866667,819.907933,1,24596000,24597237,1237,0.8545759544253091
10337,820.164,820.233733,1,24604920,24607011,2091,0.8240485716960024
10338,820.246,820.3802,1,24607380,24611406,4026,0.7892052462778542
10339,820.4005,820.459867,1,24612015,24613796,1781,0.7232286706261782
10340,820.464533,820.478733,1,24613935,24614361,426,0.7952698834164315
10341,820.485167,820.561933,1,24614555,24616857,2302,0.7483142232681307
10342,820.8361,820.904633,1,24625083,24627138,2055,0.8176776156618634
10343,820.906833,820.9609,1,24627204,24628827,1623,0.8277803338032063
10344,821.251233,821.304967,1,24637536,24639149,1613,0.6887695123938743
10345,821.3098,821.346133,1,24639294,24640383,1089,0.7643993756603675
10346,821.353567,821.507,1,24640607,24645210,4603,0.7230735918847945
10347,821.5149,821.614067,1,24645447,24648422,2975,0.7578683564423205
10348,821.619767,821.6284,1,24648593,24648852,259,0.7547824920803314
10349,821.6308,821.635233,1,24648924,24649056,132,-0.19226145705502293
10350,821.929633,821.934333,1,24657888,24658029,141,0.21548337752638272
10351,821.940833,822.078733,1,24658224,24662361,4137,0.8352654964251307
10352,822.450767,822.4546,1,24673523,24673638,115,0.49475910786412103
10353,822.4624,822.606367,1,24673872,24678191,4319,0.8316775178669984
10354,822.7002,822.7337,1,24681006,24682011,1005,0.7206932309297208
10355,822.7349,822.741433,1,24682047,24682242,195,0.22127388721844013
10356,822.763233,822.8474,1,24682896,24685422,2526,0.800020185892665
10357,823.1117,823.230267,1,24693351,24696908,3557,0.8689437533065639
10358,823.436033,823.4656,1,24703080,24703968,888,0.731414930650511
10359,823.467567,823.551333,1,24704027,24706539,2512,0.8438577463427896
10360,823.563667,823.567667,1,24706910,24707030,120,-0.02632873863768934
10361,823.8026,823.816467,1,24714078,24714494,416,0.6736595758951421
10362,823.817467,823.882933,1,24714524,24716487,1963,0.8196187482144719
10363,823.8842,823.966,1,24716526,24718980,2454,0.8315591705534745
10364,823.969533,824.001933,1,24719085,24720057,972,0.7660689466272604
10365,824.0366,824.043333,1,24721098,24721299,201,0.025469971314444197
10366,824.303467,824.3103,1,24729104,24729309,205,0.8184476728387775
10367,824.319833,824.350133,1,24729594,24730503,909,0.6021686772325453
10368,824.359667,824.363067,1,24730790,24730892,102,0.5967854095247223
10369,824.369967,824.3771,1,24731099,24731313,214,0.5100713574440545
10370,824.380367,824.405733,1,24731411,24732171,760,0.6352427955366394
10371,824.438567,824.445667,1,24733157,24733370,213,0.47712093754507884
10372,824.4479,824.465367,1,24733437,24733961,524,0.5177566428983361
10373,824.5075,824.532633,1,24735225,24735978,753,0.6079964846582535
10374,824.556067,824.559667,1,24736682,24736790,108,0.668140995501173
10375,824.5657,824.5958,1,24736971,24737874,903,0.5671650288541394
10376,824.614433,824.629633,1,24738432,24738888,456,0.5656893061591357
10377,824.630833,824.657267,1,24738924,24739718,794,0.6510185072041125
10378,824.6802,824.685867,1,24740406,24740576,170,0.6998231766140144
10379,824.6872,824.6971,1,24740616,24740913,297,0.6156346374186819
10380,824.7196,824.730867,1,24741588,24741926,338,0.6802039431851395
10381,824.740133,824.745367,1,24742203,24742361,158,0.6192620683601928
10382,824.789767,824.800533,1,24743693,24744015,322,-0.15500270013765635
10383,824.802333,824.805333,1,24744069,24744159,90,0.16889057849795286
10384,824.8067,824.8249,1,24744201,24744747,546,0.2727726173990325
10385,824.826033,824.836433,1,24744780,24745092,312,-0.09539314857126627
10386,824.8646,824.973067,1,24745938,24749192,3254,0.7675528397699665
10387,825.2942,825.300467,1,24758826,24759014,188,0.5877743940984045
10388,825.306833,825.358333,1,24759204,24760749,1545,0.8207584699418685
10389,825.3595,825.446667,1,24760785,24763400,2615,0.837470736864295
10390,825.4535,825.510667,1,24763605,24765320,1715,0.7663186346551917
10391,825.536333,825.5643,1,24766089,24766929,840,0.7992935872402311
10392,825.567967,825.5745,1,24767039,24767235,196,-0.2751699105804078
10393,825.577333,825.7325,1,24767319,24771975,4656,0.7882035569771488
10394,825.743333,825.746833,1,24772299,24772404,105,0.4170357759149162
10395,826.1294,826.133767,1,24783882,24784013,131,0.7173524974370671
10396,826.1357,826.141833,1,24784071,24784254,183,0.1979937653090354
10397,826.1507,826.1858,1,24784521,24785574,1053,0.7736598995475636
10398,826.200333,826.216333,1,24786009,24786489,480,0.7806647647397852
10399,826.2262,826.287133,1,24786786,24788613,1827,0.7647803185124024
10400,826.2968,826.3006,1,24788904,24789018,114,0.584696570762242
10401,826.310633,826.338067,1,24789318,24790142,824,0.825624144955716
10402,826.3738,826.377433,1,24791214,24791322,108,-0.09712925780342212
10403,826.3827,826.387333,1,24791481,24791619,138,0.3703895907703859
10404,826.3889,826.4155,1,24791667,24792465,798,0.10478431926707898
10405,826.416567,826.4207,1,24792497,24792621,124,
10406,826.4432,826.578933,1,24793296,24797367,4071,0.7913415664502942
10407,826.855633,826.867533,1,24805668,24806025,357,-0.1372345568103537
10408,826.869333,826.888467,1,24806079,24806654,575,0.7833469943825973
10409,826.890333,826.988467,1,24806709,24809654,2945,0.824185599813876
10410,826.992333,827.006433,1,24809769,24810192,423,-0.021857098255626987
10411,827.016667,827.087367,1,24810500,24812621,2121,0.790809819834993
10412,827.422067,827.4816,1,24822662,24824448,1786,0.7932036668817946
10413,827.4866,827.5027,1,24824598,24825081,483,0.8149983644244736
10414,827.519367,827.560067,1,24825581,24826802,1221,0.8121828776489788
10415,827.581367,827.6783,1,24827441,24830349,2908,0.7840547261188058
10416,827.6904,827.695133,1,24830712,24830853,141,-0.35070086303887
10417,827.7022,827.7218,1,24831066,24831654,588,-0.007317133873469566
10418,827.7253,827.7511,1,24831759,24832533,774,0.22724384028866104
10419,827.790833,827.804033,1,24833724,24834120,396,0.7496191492704585
10420,827.805033,827.948833,1,24834150,24838464,4314,0.7191500613523445
10421,827.949967,827.978267,1,24838499,24839348,849,0.7737278142877667
10422,827.980967,827.9852,1,24839429,24839556,127,-0.3270169129117698
10423,827.993333,828.006567,1,24839799,24840197,398,0.323962021413065
10424,828.018733,828.021933,1,24840561,24840657,96,-0.09141176291245916
10425,828.039133,828.049367,1,24841173,24841481,308,0.5483019428384847
10426,828.058433,828.061833,1,24841752,24841854,102,
10427,828.0734,828.081367,1,24842202,24842441,239,0.04249774904134887
10428,828.082433,828.087433,1,24842472,24842622,150,0.1708560368407907
10429,828.0913,828.0985,1,24842739,24842955,216,0.14423456746884827
10430,828.1031,828.106567,1,24843093,24843197,104,
10431,828.298933,828.3096,1,24848967,24849288,321,0.3519229328685803
10432,828.418167,828.619033,1,24852545,24858570,6025,0.7814946277594399
10433,828.6423,828.6992,1,24859269,24860976,1707,0.7867254673646741
10434,828.709433,828.731767,1,24861282,24861953,671,0.65572466200791
10435,828.734267,828.8106,1,24862028,24864318,2290,0.7862953059881808
10436,828.825633,828.831433,1,24864768,24864942,174,-0.0099053290280775
10437,829.2963,829.305067,1,24878889,24879152,263,0.4991812254451488
10438,829.3251,829.329833,1,24879753,24879894,141,0.4227826024556373
10439,829.424433,829.4376,1,24882732,24883128,396,0.6061085331956609
10440,829.4914,829.503933,1,24884742,24885117,375,0.6479082097959905
10441,829.535767,829.546933,1,24886073,24886407,334,0.6547348096636331
10442,829.6807,829.6839,1,24890421,24890517,96,
10443,829.697967,829.8116,1,24890939,24894348,3409,0.7795904740728258
10444,829.8178,829.8535,1,24894534,24895605,1071,0.8027831957648014
10445,829.855233,829.996233,1,24895656,24899886,4230,0.749559393573085
10446,829.9984,830.032533,1,24899952,24900975,1023,0.7161133052663589
10447,830.048567,830.051733,1,24901457,24901551,94,
10448,830.259433,830.319467,1,24907782,24909584,1802,0.7447038099868372
10449,830.3216,830.404567,1,24909648,24912137,2489,0.8358468528584032
10450,830.670867,830.8526,1,24920126,24925578,5452,0.8496379395253503
10451,830.875867,830.893633,1,24926276,24926808,532,0.7910140515812898
10452,830.9049,830.909867,1,24927147,24927296,149,0.8311590517197012
10453,830.911433,830.9148,1,24927342,24927444,102,0.6873412568684095
10454,830.915867,830.9231,1,24927476,24927693,217,0.8211945647167634
10455,830.924767,831.041967,1,24927743,24931259,3516,0.7758443980394077
10456,831.0652,831.095667,1,24931956,24932870,914,0.7195360088247877
10457,831.111467,831.122267,1,24933344,24933668,324,-0.10861868672186331
10458,831.124,831.128833,1,24933720,24933864,144,0.06906402382079016
10459,831.130233,831.156333,1,24933906,24934689,783,0.06748106362275681
10460,831.1923,831.206167,1,24935769,24936185,416,0.6862427866993323
10461,831.2087,831.333833,1,24936261,24940014,3753,0.8238181381033487
10462,831.350667,831.442467,1,24940520,24943274,2754,0.8161258669882684
10463,831.9467,831.955133,1,24958401,24958653,252,0.6816374077167926
10464,831.9563,831.9711,1,24958689,24959133,444,0.5796535966585936
10465,831.972767,831.9857,1,24959183,24959571,388,0.6822549310655927
10466,832.0019,832.019433,1,24960057,24960582,525,0.7174914706933042
10467,832.0457,832.054567,1,24961371,24961637,266,0.854026344989051
10468,832.068833,832.086433,1,24962064,24962592,528,0.764103589613251
10469,832.199467,832.2808,1,24965984,24968424,2440,0.8073758577207073
10470,832.2827,832.2974,1,24968481,24968922,441,0.7851622951980447
10471,832.2989,832.421667,1,24968967,24972650,3683,0.8204215408924933
10472,832.7581,832.768133,1,24982743,24983043,300,0.7170021611436949
10473,832.7794,832.814167,1,24983382,24984425,1043,0.7879637759905405
10474,832.8393,832.848133,1,24985179,24985443,264,0.7648197903609707
10475,832.849167,832.859733,1,24985475,24985791,316,0.6957488713386131
10476,832.873733,832.893333,1,24986211,24986799,588,0.6138513248030187
10477,832.899033,832.9207,1,24986970,24987621,651,0.62617672261009
10478,832.933133,832.946167,1,24987993,24988385,392,0.650807147492651
10479,832.973633,832.990467,1,24989208,24989714,506,0.8091050864717609
10480,833.015067,833.0277,1,24990452,24990831,379,0.7267108192275555
10481,833.031467,833.044333,1,24990944,24991329,385,0.7153934163850446
10482,833.0612,833.068767,1,24991836,24992063,227,0.36037710472902074
10483,833.0817,833.124267,1,24992451,24993728,1277,0.06883429469244987
10484,833.1267,833.129767,1,24993801,24993893,92,
10485,833.1634,833.168567,1,24994902,24995057,155,-0.27052853318761483
10486,833.171767,833.1812,1,24995153,24995436,283,0.44381999451577514
10487,833.183333,833.228633,1,24995499,24996858,1359,0.8166289248759703
10488,833.230133,833.270733,1,24996903,24998121,1218,0.734933616470253
10489,833.416167,833.419567,1,25002485,25002587,102,0.4958902919925938
10490,833.520267,833.5438,1,25005608,25006314,706,0.6214105415030076
10491,833.5816,833.648233,1,25007448,25009446,1998,0.7747985155763071
10492,833.6521,833.660733,1,25009563,25009821,258,-0.1415972676445349
10493,834.036267,834.047567,1,25021088,25021427,339,0.6733951646354546
10494,834.056133,834.064,1,25021683,25021920,237,-0.12224950377085278
10495,834.110133,834.134867,1,25023303,25024046,743,0.2568489567292217
10496,834.148733,834.152067,1,25024461,25024562,101,-0.1653969976631208
10497,834.1818,834.1893,1,25025454,25025679,225,0.4563420531495611
10498,834.209467,834.217867,1,25026284,25026536,252,0.36098570954644427
10499,834.221,834.2279,1,25026630,25026837,207,0.1290911852649865
10500,834.2556,834.258767,1,25027668,25027763,95,0.48592158795789364
10501,834.261567,834.302033,1,25027847,25029060,1213,0.7159269274215028
10502,834.3323,834.337233,1,25029969,25030116,147,0.5246960883070951
10503,834.338567,834.348633,1,25030157,25030458,301,0.7657037149359298
10504,834.384367,834.397133,1,25031531,25031913,382,0.7998546993851646
10505,834.788533,834.923533,1,25043655,25047705,4050,0.7945211093078377
10506,834.925833,834.940167,1,25047774,25048205,431,0.6418152267779519
10507,834.957833,834.984267,1,25048734,25049528,794,0.566508644981645
10508,834.987667,835.049533,1,25049630,25051485,1855,0.7985138497533185
10509,835.050567,835.060067,1,25051517,25051802,285,0.27325349844807956
10510,835.2357,835.239367,1,25057071,25057181,110,-0.08634292473895439
10511,835.4026,835.483867,1,25062078,25064516,2438,0.6216131709153776
10512,835.501,835.518267,1,25065030,25065548,518,0.532871928977816
10513,835.523467,835.591133,1,25065704,25067733,2029,0.5352014118510214
10514,835.5967,835.612367,1,25067901,25068371,470,0.6365721027343179
10515,835.614333,835.687,1,25068429,25070610,2181,0.5891620847110896
10516,835.699233,835.718067,1,25070976,25071542,566,0.5819428589860188
10517,835.721933,835.727867,1,25071657,25071836,179,0.5492520660061168
10518,835.730967,835.775633,1,25071929,25073268,1339,0.6301332063106948
10519,835.7866,835.790333,1,25073598,25073709,111,0.29669137666421763
10520,835.7965,835.810233,1,25073895,25074306,411,0.6405396259091038
10521,835.812433,835.824067,1,25074372,25074722,350,0.5404351636202512
10522,835.856733,835.906333,1,25075701,25077189,1488,0.5419723037073562
10523,835.932,836.046733,1,25077960,25081401,3441,0.7890478591679833
10524,836.071233,836.075267,1,25082136,25082258,122,0.015580633842685918
10525,836.1047,836.228267,1,25083141,25086848,3707,0.8260862622422848
10526,836.397733,836.423267,1,25091931,25092698,767,0.23138371745985134
10527,836.426967,836.435267,1,25092809,25093058,249,0.16938203272442176
10528,836.443167,836.470167,1,25093295,25094105,810,0.054660408619894775
10529,836.472067,836.483233,1,25094162,25094496,334,0.09026724991246227
10530,836.488433,836.4933,1,25094652,25094799,147,-0.08991588056882949
10531,836.522367,836.5849,1,25095671,25097547,1876,0.7714392517466732
10532,836.590333,836.676167,1,25097709,25100285,2576,0.7786513303977346
10533,836.678233,836.6864,1,25100346,25100592,246,0.26101014398821687
10534,836.692933,836.737167,1,25100787,25102115,1328,0.8134333940540122
10535,836.766333,836.7806,1,25102989,25103418,429,0.8376349318303575
10536,836.7826,836.7903,1,25103478,25103709,231,0.7975083291440067
10537,836.7962,836.8506,1,25103886,25105518,1632,0.7907887899923353
10538,836.861167,836.877467,1,25105835,25106324,489,0.7985887931588751
10539,836.880333,836.8971,1,25106409,25106913,504,0.7583677289719386
10540,836.921333,836.932233,1,25107639,25107966,327,-0.08252175890324134
10541,836.936367,836.945033,1,25108091,25108350,259,-0.05412494855140793
10542,836.954033,836.960967,1,25108620,25108829,209,-0.04778541003809756
10543,836.966667,836.973433,1,25109000,25109202,202,-0.23581398879527138
10544,836.9882,837.2017,1,25109646,25116051,6405,0.8271200916802011
10545,837.222633,837.226433,1,25116678,25116792,114,-0.1693014891228904
10546,837.227633,837.238033,1,25116828,25117140,312,0.0916847071158496
10547,837.250933,837.257367,1,25117527,25117721,194,-0.03168781862237673
10548,837.499167,837.5258,1,25124975,25125774,799,0.6634455330456842
10549,837.538933,837.581267,1,25126167,25127438,1271,0.7172869890872325
10550,837.616967,837.636667,1,25128509,25129100,591,0.7409996652506992
10551,837.647233,837.653133,1,25129416,25129593,177,-0.08632073263406287
10552,837.687167,837.7134,1,25130615,25131402,787,0.8169648984686616
10553,837.740967,837.781633,1,25132229,25133448,1219,0.6919466057324462
10554,837.7986,837.8045,1,25133958,25134135,177,0.7997811069726973
10555,837.8067,837.814633,1,25134201,25134438,237,0.7733624716006926
10556,837.829833,837.8491,1,25134894,25135473,579,0.6923495201811403
10557,837.8596,837.911033,1,25135788,25137330,1542,0.5786062939435265
10558,837.931367,837.944967,1,25137941,25138349,408,0.7142917964220293
10559,837.965967,837.980467,1,25138979,25139414,435,0.7653785455576383
10560,837.9826,838.007433,1,25139478,25140222,744,0.7486099368942258
10561,838.027233,838.0377,1,25140816,25141131,315,-0.10601203336107538
10562,838.039467,838.046933,1,25141184,25141407,223,0.10649889943078937
10563,838.048933,838.082367,1,25141467,25142471,1004,0.11180415755815283
10564,838.098367,838.103167,1,25142951,25143095,144,0.33651867939268715
10565,838.1151,838.125467,1,25143453,25143764,311,0.7251263565477178
10566,838.127533,838.217833,1,25143825,25146534,2709,0.7519386118831782
10567,838.377167,838.551033,1,25151315,25156530,5215,0.8095633133924972
10568,838.554133,838.6622,1,25156623,25159866,3243,0.7647446270954453
10569,838.689267,838.6965,1,25160678,25160895,217,-0.08495936830899234
10570,838.859067,838.872833,1,25165772,25166184,412,0.8478613526084601
10571,838.874333,838.955667,1,25166229,25168670,2441,0.8161890643218195
10572,838.9623,839.044567,1,25168869,25171337,2468,0.8253796739005536
10573,839.077067,839.090367,1,25172312,25172711,399,-0.13246730273310645
10574,839.0954,839.1033,1,25172862,25173099,237,-0.15345210336454113
10575,839.106167,839.118533,1,25173185,25173555,370,0.17822157314027262
10576,839.120433,839.1267,1,25173612,25173801,189,0.35264147059686307
10577,839.15,839.175933,1,25174500,25175277,777,0.5963450441528676
10578,839.177033,839.2748,1,25175310,25178244,2934,0.8460911168756611
10579,839.277233,839.315033,1,25178316,25179450,1134,0.8399964762165444
10580,839.335267,839.3508,1,25180058,25180524,466,-0.013799395782890878
10581,839.353567,839.370167,1,25180607,25181105,498,0.1523412387849037
10582,839.372633,839.3832,1,25181178,25181496,318,-0.097255935849732
10583,839.4056,839.420667,1,25182168,25182620,452,0.6287303333458498
10584,839.421767,839.508233,1,25182653,25185246,2593,0.7533562743667022
10585,839.535733,839.546133,1,25186071,25186383,312,-0.103509477194489
10586,839.681333,839.7371,1,25190439,25192113,1674,0.7247359139743517
10587,839.740067,839.818433,1,25192202,25194552,2350,0.8260788814166811
10588,839.8437,839.8483,1,25195311,25195449,138,0.007071581136026965
10589,839.8512,839.8585,1,25195536,25195755,219,-0.07456575563036238
10590,839.8622,839.867433,1,25195866,25196022,156,0.16022664515472015
10591,839.9345,840.091967,1,25198035,25202759,4724,0.8130911307848901
10592,840.102633,840.179233,1,25203078,25205376,2298,0.7831455531754311
10593,840.190067,840.195333,1,25205702,25205859,157,-0.10964476804066339
10594,840.196733,840.224133,1,25205901,25206723,822,0.4706565952836044
10595,840.2472,840.2587,1,25207416,25207761,345,-0.06747414196246138
10596,840.2622,840.2705,1,25207866,25208115,249,0.15497592762517734
10597,840.271767,840.293133,1,25208153,25208793,640,-0.04141706427517515
10598,840.312267,840.449333,1,25209368,25213479,4111,0.8242098612270878
10599,840.450833,840.504067,1,25213524,25215122,1598,0.8452258614044867
10600,840.540767,840.545367,1,25216223,25216361,138,-0.060684601772331086
10601,840.555567,840.563467,1,25216667,25216904,237,-0.039669185193429664
10602,840.568767,840.580367,1,25217063,25217411,348,-0.0007656332075958246
10603,840.626467,840.745667,1,25218794,25222370,3576,0.8070925777110112
10604,840.763633,840.768633,1,25222908,25223058,150,0.20420455957918263
10605,840.7701,840.780367,1,25223103,25223411,308,-0.009901193121910365
10606,840.781567,840.791633,1,25223447,25223748,301,-0.08189294388695346
10607,840.811967,840.882767,1,25224359,25226483,2124,0.8144973264975032
10608,840.885433,840.9439,1,25226562,25228317,1755,0.5010104601719357
10609,840.9575,840.976567,1,25228725,25229297,572,-0.05395566649626431
10610,840.9786,840.986467,1,25229358,25229594,236,0.0895361619860054
10611,840.988667,840.998933,1,25229660,25229967,307,-0.1308728887122522
10612,841.005633,841.012267,1,25230168,25230368,200,0.4486528257950288
10613,841.0327,841.160733,1,25230981,25234821,3840,0.8159552710751773
10614,841.173533,841.191233,1,25235205,25235736,531,-0.03350079456207209
10615,841.198233,841.218733,1,25235946,25236561,615,0.05194730321219481
10616,841.2199,841.228433,1,25236597,25236852,255,0.09890462017118576
10617,841.254067,841.391167,1,25237622,25241735,4113,0.767226276528517
10618,841.405367,841.498533,1,25242161,25244955,2794,0.8222497425715735
10619,841.5136,841.5183,1,25245408,25245549,141,-0.04747039165742676
10620,841.6231,841.6284,1,25248693,25248852,159,0.7911825105349424
10621,841.635667,841.757433,1,25249070,25252722,3652,0.790645898849159
10622,842.399067,842.433867,1,25271972,25273016,1044,0.6626094902154067
10623,842.497267,842.505233,1,25274918,25275156,238,0.4140098173745395
10624,842.609767,842.628067,1,25278293,25278842,549,0.3608646558330319
10625,842.630467,842.6349,1,25278914,25279047,133,0.2379913199346693
10626,842.6749,842.691833,1,25280247,25280754,507,0.5597147847782563
10627,842.846733,843.040467,1,25285401,25291214,5813,0.7597552823569056
10628,843.043267,843.0866,1,25291298,25292598,1300,0.7294786882805512
10629,843.104333,843.187333,1,25293129,25295619,2490,0.8028116135771214
10630,843.209833,843.2824,1,25296294,25298472,2178,0.7985682792798947
10631,843.306533,843.317133,1,25299195,25299513,318,0.10276975776789858
10632,843.3944,843.400233,1,25301832,25302006,174,0.20415658567635037
10633,843.4028,843.418167,1,25302084,25302545,461,0.7053898753327622
10634,843.4198,843.457033,1,25302594,25303710,1116,0.8015997410785716
10635,843.458033,843.513,1,25303740,25305390,1650,0.7933836036137174
10636,843.518933,843.524533,1,25305567,25305735,168,-0.0036214721996998345
10637,843.526,843.536133,1,25305780,25306083,303,0.11005848696355797
10638,843.538,843.548467,1,25306140,25306454,314,0.018809847731028
10639,843.5629,843.566233,1,25306887,25306986,99,0.17660002564759056
10640,843.569133,843.680367,1,25307073,25310411,3338,0.8580765448846415
10641,843.996533,844.032967,1,25319895,25320989,1094,0.6028916301608667
10642,844.0408,844.0911,1,25321224,25322733,1509,0.6105330604065359
10643,844.106867,844.127733,1,25323206,25323831,625,0.7895049985651278
10644,844.2069,844.211633,1,25326207,25326348,141,0.4475576431709181
10645,844.239167,844.2489,1,25327175,25327467,292,-0.060908238589374296
10646,844.285733,844.2894,1,25328571,25328682,111,-0.015741456351742397
10647,844.290533,844.4172,1,25328715,25332516,3801,0.747558642677274
10648,844.4376,844.451133,1,25333128,25333533,405,-0.015676005498298985
10649,844.454333,844.463367,1,25333629,25333901,272,0.07776877288701665
10650,844.469433,844.476567,1,25334082,25334297,215,0.1886782681553169
10651,844.640067,844.673067,1,25339202,25340192,990,0.7650337719874963
10652,844.674667,844.691267,1,25340240,25340738,498,0.6830630325760071
10653,844.696867,844.7798,1,25340906,25343394,2488,0.7675823689819644
10654,844.793867,844.8005,1,25343816,25344015,199,-0.05012461965467276
10655,845.055267,845.2191,1,25351658,25356573,4915,0.8124248180304021
10656,845.235233,845.2561,1,25357056,25357683,627,0.7669448101311946
10657,845.2629,845.294933,1,25357887,25358847,960,0.6984171629235144
10658,845.317167,845.3872,1,25359515,25361616,2101,0.7985398641851447
10659,845.3963,845.437733,1,25361889,25363131,1242,0.7879161588222852
10660,845.4856,845.495,1,25364568,25364850,282,-0.17999284954614814
10661,845.503733,845.5089,1,25365111,25365267,156,-0.20716221713009658
10662,845.609467,845.614867,1,25368284,25368446,162,0.656574177811523
10663,845.618133,845.851967,1,25368543,25375559,7016,0.8074084588946548
10664,845.900733,845.908,1,25377021,25377240,219,-0.11907483703785753
10665,846.380167,846.386033,1,25391405,25391580,175,0.6958727582249921
10666,846.388033,846.392967,1,25391640,25391789,149,0.39350091552092203
10667,846.400033,846.431133,1,25392000,25392933,933,0.8048273224434096
10668,846.438933,846.4705,1,25393167,25394115,948,0.7685263337839063
10669,846.4717,846.476867,1,25394151,25394306,155,-0.19356521545593014
10670,846.489867,846.6256,1,25394696,25398768,4072,0.7876091827603415
10671,846.632567,846.689133,1,25398977,25400673,1696,0.818670681487572
10672,846.699667,846.715367,1,25400990,25401461,471,0.7477144772310109
10673,846.721333,846.734567,1,25401639,25402037,398,0.5374651082006286
10674,846.7575,846.7699,1,25402725,25403097,372,-0.02957826582361745
10675,846.772167,846.777433,1,25403165,25403322,157,0.11303214509026493
10676,846.7863,846.791533,1,25403589,25403745,156,-0.09598395247218654
10677,846.793367,846.9184,1,25403801,25407552,3751,0.7864506679829097
10678,846.928933,846.934367,1,25407867,25408031,164,-0.07438333882136577
10679,847.018733,847.0333,1,25410561,25410999,438,0.7846140048435547
10680,847.035267,847.1334,1,25411058,25414002,2944,0.8060617999255889
10681,847.1773,847.183433,1,25415319,25415502,183,-0.14962795155471914
10682,847.21,847.328233,1,25416300,25419846,3546,0.7922661863234877
10683,847.3474,847.415667,1,25420422,25422470,2048,0.7480664513366264
10684,847.439967,847.473367,1,25423199,25424201,1002,0.40554979454156925
10685,847.504267,847.5102,1,25425128,25425306,178,-0.11047124619359285
10686,847.547833,847.595267,1,25426434,25427858,1424,0.35011998168639735
10687,847.6,847.606733,1,25428000,25428201,201,0.4410961972516745
10688,847.608033,847.765967,1,25428240,25432979,4739,0.8080345601409044
10689,847.777233,847.791767,1,25433316,25433753,437,0.31615260741911855
10690,847.794367,847.9053,1,25433831,25437159,3328,0.5430178981896822
10691,847.907067,847.980267,1,25437212,25439408,2196,0.7532990119950175
10692,847.982167,848.0062,1,25439465,25440186,721,0.5848234337904408
10693,848.009033,848.0895,1,25440270,25442685,2415,0.8282867948282489
10694,848.092733,848.107733,1,25442781,25443231,450,0.7989336506213847
10695,848.1088,848.115967,1,25443264,25443479,215,0.6369325900431503
10696,848.117633,848.234067,1,25443528,25447022,3494,0.7930406770670839
10697,848.239233,848.3313,1,25447176,25449939,2763,0.8358783105383399
10698,848.332667,848.354033,1,25449980,25450620,640,0.8168541969483898
10699,848.3602,848.436033,1,25450806,25453080,2274,0.8321314005929261
10700,848.437333,848.453433,1,25453119,25453602,483,0.8538606909598977
10701,848.455233,848.460067,1,25453656,25453802,146,0.09214698506100163
10702,848.462467,848.470833,1,25453874,25454124,250,0.8829195894828394
10703,848.485867,848.577833,1,25454576,25457334,2758,0.8162858626633833
10704,848.5797,848.701267,1,25457391,25461038,3647,0.8426439672823368
10705,848.7034,848.729867,1,25461102,25461896,794,0.8327023912814393
10706,848.732767,848.829667,1,25461983,25464890,2907,0.7975546763385577
10707,848.8309,848.855767,1,25464927,25465673,746,0.6400578369360707
10708,848.8625,848.955367,1,25465875,25468661,2786,0.8397098250633653
10709,848.958167,848.977567,1,25468745,25469327,582,0.6057679208619301
10710,848.9903,849.047033,1,25469709,25471410,1701,0.7777722781123911
10711,849.0594,849.079133,1,25471782,25472373,591,0.7352493370110327
10712,849.083267,849.088267,1,25472498,25472648,150,0.03628680652534897
10713,849.105567,849.1744,1,25473167,25475232,2065,0.813809228867946
10714,849.188233,849.1979,1,25475646,25475937,291,-0.054482961886861726
10715,849.209767,849.213367,1,25476293,25476401,108,
10716,849.595733,849.601467,1,25487871,25488044,173,0.46327130559356533
10717,849.871467,849.874533,1,25496144,25496235,91,
10718,850.061233,850.0905,1,25501836,25502715,879,0.5649681086923288
10719,850.091967,850.1017,1,25502759,25503051,292,0.6944244762153797
10720,850.352333,850.3581,1,25510569,25510743,174,0.24872815113281066
10721,850.359267,850.519033,1,25510778,25515570,4792,0.7758435001285107
10722,850.5203,850.524,1,25515609,25515720,111,0.01143181076342569
10723,850.5446,850.547833,1,25516338,25516434,96,
10724,850.5797,850.583333,1,25517391,25517499,108,
10725,850.589567,850.675867,1,25517687,25520276,2589,0.8117402309107228
10726,850.704233,850.7076,1,25521126,25521228,102,
10727,851.2694,851.2781,1,25538082,25538343,261,0.6265007935870702
10728,851.288233,851.292767,1,25538646,25538783,137,0.6341810655084117
10729,851.3376,851.350167,1,25540128,25540505,377,0.8600801547492456
10730,851.3958,851.414567,1,25541874,25542437,563,0.6606928444962739
10731,851.434267,851.438667,1,25543028,25543160,132,0.524544622806774
10732,851.4474,851.451733,1,25543422,25543551,129,0.38425218557658514
10733,851.469767,851.4767,1,25544093,25544301,208,0.32164430771540653
10734,851.495133,851.507567,1,25544853,25545227,374,0.5391228854999803
10735,851.562067,851.5653,1,25546862,25546959,97,0.3160471326784823
10736,851.567633,851.5771,1,25547028,25547313,285,0.6476784712806487
10737,851.611867,851.623833,1,25548356,25548714,358,0.5975516037893179
10738,851.767633,851.880967,1,25553028,25556429,3401,0.7820185267022105
10739,851.8999,851.909533,1,25556997,25557285,288,-0.05970206332246163
10740,851.921033,851.931833,1,25557630,25557954,324,-0.06139096986256796
10741,852.177167,852.439933,1,25565315,25573197,7882,0.7570174345505831
10742,852.458633,852.4636,1,25573758,25573908,150,-0.07014158853591626
10743,852.7476,852.906767,1,25582428,25587203,4775,0.792494099977852
10744,852.920667,852.943333,1,25587620,25588299,679,0.7399452243421153
10745,852.951133,852.984467,1,25588533,25589534,1001,0.6987015006139884
10746,853.006433,853.064267,1,25590192,25591928,1736,0.7981595311808103
10747,853.075,853.1244,1,25592250,25593732,1482,0.7041319872763239
10748,853.126067,853.1434,1,25593782,25594302,520,0.6192144287750652
10749,853.149533,853.1723,1,25594485,25595169,684,0.5855439117706329
10750,853.1744,853.1993,1,25595232,25595979,747,0.8023926997600574
10751,853.204067,853.289167,1,25596122,25598675,2553,0.8030357331730591
10752,853.293167,853.303333,1,25598795,25599099,304,-0.00791077816527074
10753,853.314267,853.338233,1,25599428,25600146,718,0.055255421908016585
10754,853.3719,853.610033,1,25601157,25608300,7143,0.7941155230380323
10755,853.920167,853.976233,1,25617605,25619286,1681,0.7521170276801455
10756,853.9793,853.9826,1,25619379,25619478,99,0.4000666722165834
10757,853.991433,853.995333,1,25619742,25619859,117,0.03745665259347666
10758,854.7568,854.7653,1,25642704,25642959,255,0.6808918474885702
10759,854.791867,854.827267,1,25643756,25644818,1062,0.7113970588988401
10760,854.861767,854.866867,1,25645853,25646006,153,0.22115899975876477
10761,854.869133,854.883633,1,25646073,25646508,435,0.7327716860406588
10762,854.8877,854.8907,1,25646631,25646721,90,0.699280426537555
10763,854.905567,854.9144,1,25647167,25647432,265,0.7422279004063322
10764,854.950033,854.973167,1,25648500,25649195,695,0.5311060539030673
10765,855.004933,855.0112,1,25650147,25650336,189,0.38928504278633247
10766,855.018367,855.030967,1,25650551,25650929,378,0.6703381050846838
10767,855.052633,855.075133,1,25651578,25652253,675,0.49368752329371873
10768,855.1186,855.138633,1,25653558,25654158,600,0.5707569823336728
10769,855.161767,855.170567,1,25654853,25655117,264,0.5593055049757722
10770,855.175433,855.1877,1,25655262,25655631,369,0.6595228039552351
10771,855.209133,855.214433,1,25656273,25656432,159,0.11207418934195414
10772,855.2215,855.267633,1,25656645,25658028,1383,0.13736340401335295
10773,855.3328,855.532233,1,25659984,25665966,5982,0.8020363166338833
10774,855.5404,855.585867,1,25666212,25667576,1364,0.7757029071610025
10775,855.588167,855.615433,1,25667645,25668462,817,0.8205575916567186
10776,855.624467,855.730133,1,25668734,25671903,3169,0.7878034544352506
10777,855.737,855.742667,1,25672110,25672280,170,0.005765530277748234
10778,855.760667,855.7681,1,25672820,25673043,223,0.35139788606634964
10779,855.819133,855.9296,1,25674573,25677888,3315,0.78221919820006
10780,855.937467,855.965767,1,25678124,25678973,849,0.0069602445999170735
10781,855.9742,855.9793,1,25679226,25679379,153,0.12073270694629891
10782,855.982367,856.094733,1,25679471,25682841,3370,0.8610219580535883
10783,856.476267,856.502,1,25694288,25695060,772,0.7063988910603783
10784,856.503767,856.513767,1,25695113,25695413,300,0.6343159713724641
10785,856.5289,856.5496,1,25695867,25696488,621,0.638116846826044
10786,856.582867,856.5888,1,25697486,25697664,178,0.8159643735691317
10787,856.606733,856.6215,1,25698201,25698645,444,0.6971325537796615
10788,856.692933,856.714567,1,25700787,25701437,650,0.4239724724251883
10789,856.7633,856.772167,1,25702899,25703165,266,0.18330293071764242
10790,856.775267,856.8866,1,25703258,25706598,3340,0.7874078151582121
10791,856.963133,857.0911,1,25708893,25712733,3840,0.8065228759369579
10792,857.6736,857.746533,1,25730208,25732395,2187,0.5652359449412153
10793,857.7489,857.825,1,25732467,25734750,2283,0.8090958686044484
10794,857.843533,857.964233,1,25735305,25738926,3621,0.7637678746191079
10795,857.969033,858.137,1,25739070,25744110,5040,0.7469255484044798
10796,858.156733,858.165033,1,25744701,25744950,249,-0.014920399700403248
10797,858.2521,858.338533,1,25747563,25750155,2592,0.7583588343235411
10798,858.6619,858.6671,1,25759857,25760013,156,0.6545727090110135
10799,858.691033,858.7037,1,25760730,25761111,381,0.8329484187608318
10800,858.731133,858.7481,1,25761933,25762443,510,0.5018989022776537
10801,858.7519,858.771867,1,25762557,25763156,599,0.6967996945293321
10802,858.775133,858.778633,1,25763253,25763358,105,0.5298332814955868
10803,858.782267,858.807167,1,25763468,25764215,747,0.635373017287301
10804,858.815033,858.840033,1,25764450,25765200,750,0.8362255392115316
10805,858.846167,858.8905,1,25765385,25766715,1330,0.7794205413718729
10806,858.8915,858.925433,1,25766745,25767762,1017,0.7761131632678958
10807,858.938933,859.0184,1,25768167,25770552,2385,0.8185716949567515
10808,859.025667,859.032433,1,25770770,25770972,202,0.22122893971578766
10809,859.0382,859.061233,1,25771146,25771836,690,0.715744158692558
10810,859.082533,859.092933,1,25772475,25772787,312,-0.12283558586786249
10811,859.096133,859.1189,1,25772883,25773567,684,0.14116599998338106
10812,859.12,859.128967,1,25773600,25773869,269,-0.22742354885938976
10813,859.2917,859.395267,1,25778751,25781858,3107,0.764265577832879
10814,859.411767,859.4287,1,25782353,25782861,508,-0.025953859939363128
10815,859.438233,859.441767,1,25783146,25783253,107,
10816,859.443933,859.449267,1,25783317,25783478,161,-0.16461564625764075
10817,859.4738,859.4775,1,25784214,25784325,111,
10818,859.576,859.5816,1,25787280,25787448,168,0.6094082351972876
10819,859.632933,859.642233,1,25788987,25789266,279,0.5828517953095962
10820,859.674833,859.679433,1,25790244,25790382,138,0.12836856998811863
10821,859.821,859.9059,1,25794630,25797177,2547,0.7550929020829713
10822,859.907033,860.085433,1,25797210,25802562,5352,0.7659056106646736
10823,860.090867,860.168067,1,25802726,25805042,2316,0.7505796889274161
10824,860.169167,860.195833,1,25805075,25805874,799,0.5730065954130358
10825,860.2017,860.2054,1,25806051,25806162,111,0.43697588805832416
10826,860.216867,860.221033,1,25806506,25806630,124,-0.023037725625616574
10827,860.222033,860.265533,1,25806660,25807965,1305,0.09037558266593256
10828,860.284767,860.294033,1,25808543,25808820,277,0.6875661172389768
10829,860.295133,860.561867,1,25808853,25816856,8003,0.7462529611611074
10830,860.589,860.595533,1,25817670,25817865,195,0.07757135167871541
10831,860.6019,860.605733,1,25818057,25818171,114,-0.5427081340445231
10832,860.606933,860.611733,1,25818207,25818351,144,
10833,861.7721,861.785667,1,25853163,25853570,407,0.6936814790079714
10834,861.841567,861.855167,1,25855247,25855655,408,0.6805963975672061
10835,861.953467,861.9647,1,25858604,25858941,337,0.5343699673904434
10836,861.9665,861.9701,1,25858995,25859103,108,0.041818976256942184
10837,862.0153,862.0215,1,25860459,25860645,186,0.6066036794912816
10838,862.025,862.0317,1,25860750,25860951,201,0.6455111233012447
10839,862.226267,862.2859,1,25866788,25868577,1789,0.7555517444047273
10840,862.2877,862.3403,1,25868631,25870209,1578,0.8500181877815098
10841,862.635167,862.639233,1,25879055,25879176,121,0.4447841377044145
10842,862.649967,862.6532,1,25879499,25879596,97,0.5463211840158272
10843,862.654267,862.663,1,25879628,25879890,262,0.6843714623748938
10844,862.664267,862.688533,1,25879928,25880655,727,0.7899762970235588
10845,862.6934,862.755733,1,25880802,25882671,1869,0.8306896276353696
10846,862.762233,862.7889,1,25882866,25883667,801,0.7892832552152265
10847,862.823867,862.830867,1,25884716,25884926,210,0.4141308592337885
10848,862.847033,862.859933,1,25885410,25885797,387,0.2518339587656463
10849,863.050167,863.172933,1,25891505,25895187,3682,0.7911406498616996
10850,863.2204,863.2247,1,25896612,25896741,129,0.3443835571785259
10851,863.242433,863.2537,1,25897272,25897611,339,-0.018518717920706536
10852,863.257433,863.262333,1,25897722,25897869,147,0.2991387166063886
10853,863.462633,863.540567,1,25903878,25906217,2339,0.7943749742598385
10854,863.553133,863.5731,1,25906593,25907193,600,0.7934742515148538
10855,863.578567,863.582767,1,25907357,25907483,126,0.47759479685402617
10856,863.584767,863.613133,1,25907543,25908393,850,0.81192755043022
10857,863.616333,863.668333,1,25908489,25910049,1560,0.7306674809543552
10858,863.6715,863.694533,1,25910145,25910835,690,0.5962655573149251
10859,863.6961,863.728267,1,25910883,25911848,965,0.7190466461360275
10860,863.747433,863.790567,1,25912422,25913717,1295,0.7865578706848475
10861,863.793367,863.842967,1,25913801,25915289,1488,0.6925920152211372
10862,863.860767,863.8781,1,25915823,25916343,520,0.7108119205960808
10863,863.897967,863.909133,1,25916939,25917273,334,0.7917060263471388
10864,863.9217,863.938267,1,25917651,25918148,497,0.823408911781209
10865,863.9452,864.0306,1,25918356,25920918,2562,0.5323566557852919
10866,864.056433,864.1744,1,25921692,25925232,3540,0.797955935373025
10867,864.215267,864.2263,1,25926458,25926789,331,-0.0843741066325319
10868,864.2451,864.2512,1,25927353,25927536,183,0.1338028916835933
10869,864.254433,864.2667,1,25927632,25928001,369,0.07705337535196216
10870,866.489567,866.497433,1,25994687,25994922,235,0.44711087149532475
10871,867.151567,867.158567,1,26014547,26014757,210,0.5467907174636287
10872,867.1792,867.187433,1,26015376,26015622,246,0.5321339015306091
10873,867.218533,867.2366,1,26016555,26017098,543,0.46634965721686894
10874,867.268433,867.292933,1,26018052,26018787,735,0.6097880756053758
10875,867.350433,867.364467,1,26020512,26020934,422,0.7400955807449698
10876,867.388733,867.397133,1,26021661,26021913,252,0.5960629284172722
10877,867.402267,867.4111,1,26022068,26022333,265,0.5449619132571139
10878,867.9965,868.1317,1,26039895,26043951,4056,0.8012690520823341
10879,868.1555,868.2815,1,26044665,26048445,3780,0.8043894171367167
10880,868.289,868.313633,1,26048670,26049408,738,0.6104458438239089
10881,868.325133,868.3609,1,26049753,26050827,1074,0.6628329830491646
10882,868.3888,868.412,1,26051664,26052360,696,0.5433807944266028
10883,868.4543,868.457867,1,26053629,26053736,107,-0.33850856676585983
10884,868.772167,868.8796,1,26063165,26066388,3223,0.6814030765222937
10885,868.912567,868.9344,1,26067377,26068032,655,0.5631592984000542
10886,868.937533,868.941567,1,26068125,26068247,122,
10887,868.943033,869.0716,1,26068290,26072148,3858,0.7087385938994194
10888,869.073233,869.080233,1,26072196,26072406,210,0.32526831433711706
10889,869.101633,869.1189,1,26073048,26073567,519,0.25825442960077916
10890,869.119933,869.124533,1,26073597,26073735,138,
10891,869.218467,869.221633,1,26076554,26076648,94,-0.059507858368837936
10892,869.406733,869.4099,1,26082201,26082297,96,0.4793517013293846
10893,869.410967,869.449,1,26082329,26083470,1141,0.5139579968262393
10894,869.450267,869.461033,1,26083508,26083830,322,-0.04133592412807196
10895,869.863933,869.867133,1,26095917,26096013,96,
10896,869.9774,870.183433,1,26099322,26105502,6180,0.7618680377152512
10897,870.186833,870.2078,1,26105604,26106234,630,0.741695861376396
10898,870.209167,870.3352,1,26106275,26110056,3781,0.7556206640494901
10899,870.338667,870.3484,1,26110160,26110452,292,0.12673233745278187
10900,870.350467,870.354267,1,26110514,26110628,114,0.19619186342018302
10901,870.356367,870.361233,1,26110691,26110836,145,0.054684732749718724
10902,870.3664,870.372433,1,26110992,26111172,180,0.25565209320031695
10903,870.889733,870.9934,1,26126691,26129802,3111,0.7443607384098616
10904,870.994667,871.025033,1,26129840,26130750,910,0.835770915256872
10905,871.030533,871.152233,1,26130915,26134566,3651,0.7896299020994196
10906,871.1549,871.158233,1,26134647,26134746,99,0.2526069778215382
10907,871.160467,871.167267,1,26134814,26135018,204,-0.03385842365420162
10908,871.1684,871.1744,1,26135052,26135232,180,0.05313644414410928
10909,871.580667,871.585967,1,26147420,26147579,159,0.6787248418349137
10910,871.600867,871.607833,1,26148026,26148234,208,0.31113379614841663
10911,871.609733,871.6914,1,26148291,26150742,2451,0.7702235787932885
10912,871.697,871.7482,1,26150910,26152446,1536,0.8052614055855994
10913,871.773967,871.795133,1,26153219,26153853,634,0.6676886210617455
10914,871.796367,871.799433,1,26153891,26153982,91,0.877441893684261
10915,871.8043,871.8518,1,26154129,26155554,1425,0.7184896962050437
10916,871.853833,871.867067,1,26155614,26156012,398,0.7429570660806452
10917,871.878233,871.885467,1,26156346,26156564,218,0.8454383427324467
10918,871.920633,871.954033,1,26157618,26158620,1002,0.7593173174982456
10919,871.960767,871.965533,1,26158823,26158965,142,-0.10409522009427041
10920,871.9694,871.972967,1,26159082,26159189,107,0.5348024477035311
10921,871.9764,872.029767,1,26159292,26160893,1601,0.6122131089101293
10922,872.0396,872.042967,1,26161188,26161289,101,0.41227937981997476
10923,872.051367,872.064733,1,26161541,26161941,400,0.7067928676999794
10924,872.066467,872.074633,1,26161994,26162238,244,0.6074302522278751
10925,872.504567,872.696333,1,26175137,26180889,5752,0.7867327223826602
10926,872.6976,872.745033,1,26180928,26182350,1422,0.7088515201932112
10927,872.7578,872.821967,1,26182734,26184659,1925,0.8008987620377899
10928,872.846367,872.873433,1,26185391,26186202,811,0.7090830938808784
10929,872.8772,872.923167,1,26186316,26187695,1379,0.7126185857827456
10930,872.926333,872.9696,1,26187789,26189088,1299,0.7638118094641132
10931,872.977433,873.092333,1,26189322,26192769,3447,0.8247900845158631
10932,873.1275,873.1401,1,26193825,26194203,378,0.025622017637919867
10933,873.1411,873.1442,1,26194233,26194326,93,
10934,873.4034,873.4292,1,26202102,26202876,774,0.5996798677800116
10935,873.464467,873.5237,1,26203934,26205711,1777,0.7417786476722137
10936,873.528967,873.5332,1,26205869,26205996,127,-0.26333462367428945
10937,873.921233,874.0174,1,26217636,26220522,2886,0.8270898939619357
10938,874.0197,874.025133,1,26220591,26220753,162,-0.07287554153857992
10939,874.0299,874.033533,1,26220897,26221005,108,0.1599943132262226
10940,874.310833,874.416667,1,26229324,26232500,3176,0.8201709129807206
10941,874.418133,874.423367,1,26232543,26232701,158,-0.18860014515975249
10942,874.998333,875.008467,1,26249949,26250254,305,0.7139195724540573
10943,875.009733,875.024567,1,26250291,26250737,446,0.45716818642168444
10944,875.026767,875.031467,1,26250803,26250944,141,0.6045953345055244
10945,875.0364,875.046033,1,26251092,26251380,288,0.018863335041638712
10946,875.048067,875.143767,1,26251442,26254313,2871,0.8150499892580544
10947,875.156867,875.162833,1,26254706,26254884,178,-0.05567330511515543
10948,875.4867,875.4902,1,26264601,26264706,105,0.3798417151705191
10949,875.491967,875.6462,1,26264759,26269386,4627,0.7843662397450635
10950,875.651933,875.6561,1,26269557,26269683,126,0.5918320347079746
10951,875.663633,875.748067,1,26269908,26272442,2534,0.8168161286441157
10952,875.7499,875.8146,1,26272497,26274438,1941,0.8164093962285508
10953,876.306667,876.320967,1,26289200,26289629,429,0.7591729937055672
10954,876.327233,876.3396,1,26289816,26290188,372,0.5624998664812866
10955,876.340633,876.383967,1,26290218,26291519,1301,0.7425663108793681
10956,876.393633,876.401833,1,26291808,26292054,246,0.49967623554864804
10957,876.417233,876.481667,1,26292516,26294450,1934,0.6860958600503632
10958,876.485533,876.5069,1,26294565,26295207,642,0.6607960349733321
10959,876.509867,876.567233,1,26295296,26297016,1720,0.6535202269814195
10960,876.5753,876.6286,1,26297259,26298858,1599,0.6154106025999916
10961,876.660667,876.6908,1,26299820,26300724,904,0.5662626605107964
10962,876.702,876.7586,1,26301060,26302758,1698,0.6684662278387261
10963,876.779767,876.7859,1,26303393,26303577,184,0.7114821615859154
10964,876.7876,876.812133,1,26303628,26304363,735,0.7935605135674872
10965,876.814967,876.8258,1,26304449,26304774,325,0.7537039692706335
10966,876.835867,876.8547,1,26305076,26305641,565,0.6662211820144868
10967,877.195733,877.2033,1,26315871,26316099,228,0.4684947784898123
10968,877.2043,877.219933,1,26316129,26316597,468,0.7080828495702257
10969,877.226633,877.389133,1,26316798,26321673,4875,0.7981513714934515
10970,877.3926,877.396667,1,26321778,26321900,122,0.4049684832679292
10971,877.4066,877.547667,1,26322198,26326430,4232,0.7611273223310574
10972,877.598067,877.6018,1,26327942,26328054,112,-0.2994672417932095
10973,878.085467,878.1258,1,26342564,26343774,1210,0.5719026070752143
10974,878.136033,878.171233,1,26344080,26345136,1056,0.5625841681507098
10975,878.1737,878.1867,1,26345211,26345601,390,0.6875102460808726
10976,878.346567,878.366667,1,26350397,26351000,603,0.6973484085205824
10977,878.4093,878.4331,1,26352279,26352993,714,0.5713057751156713
10978,878.5515,878.554567,1,26356545,26356637,92,0.33100924304458007
10979,878.565367,878.7645,1,26356961,26362935,5974,0.784007923936885
10980,878.793033,878.7993,1,26363790,26363979,189,-0.10900761553059467
10981,878.807133,878.813,1,26364213,26364390,177,0.18313473788241727
10982,879.0118,879.0247,1,26370354,26370741,387,0.7385678043761953
10983,879.026067,879.059567,1,26370782,26371787,1005,0.799172978517457
10984,879.0651,879.0682,1,26371953,26372046,93,0.8351795811449467
10985,879.069433,879.110833,1,26372082,26373324,1242,0.5609937418577332
10986,879.162133,879.1661,1,26374863,26374983,120,0.14986404503806053
10987,879.2544,879.305167,1,26377632,26379155,1523,0.8077606546595861
10988,879.314,879.393467,1,26379420,26381804,2384,0.8713357913801852
10989,879.412233,879.498,1,26382366,26384940,2574,0.8687808809121593
10990,879.981233,880.000233,1,26399436,26400006,570,0.6933463121551735
10991,880.001367,880.046467,1,26400041,26401394,1353,0.7442782668769705
10992,880.051367,880.128933,1,26401541,26403867,2326,0.5079357499792433
10993,880.1478,880.212933,1,26404434,26406387,1953,0.642075506926305
10994,880.244567,880.272567,1,26407337,26408177,840,0.8930370141691661
10995,880.567967,880.642367,1,26417039,26419271,2232,0.7844449784426488
10996,880.6551,880.758267,1,26419653,26422748,3095,0.7371867249919365
10997,880.7604,880.7886,1,26422812,26423658,846,0.1262646499149524
10998,880.801433,880.858033,1,26424042,26425740,1698,0.6932653827876071
10999,880.860233,880.8636,1,26425806,26425908,102,0.22528625016288056
11000,880.867367,880.8843,1,26426021,26426529,508,0.7331625962099481
11001,880.890033,880.962367,1,26426700,26428871,2171,0.7593677108050467
11002,881.197833,881.374267,1,26435934,26441228,5294,0.7986674770295029
11003,881.403133,881.410167,1,26442093,26442305,212,0.3671586912663424
11004,881.4517,881.570533,1,26443551,26447115,3564,0.8193714818062324
11005,881.573367,881.585533,1,26447201,26447565,364,0.38996555641635594
11006,881.586533,881.590767,1,26447595,26447723,128,-0.0536466492703084
11007,881.594133,881.6011,1,26447823,26448033,210,-0.09017526041537659
11008,881.837567,882.0424,1,26455127,26461272,6145,0.8051283595301091
11009,882.463933,882.493667,1,26473917,26474810,893,0.6304504133101678
11010,882.497,882.5056,1,26474910,26475168,258,0.46777814685232505
11011,882.5088,882.520367,1,26475264,26475611,347,0.5657608113084376
11012,882.540633,882.640333,1,26476218,26479209,2991,0.7518518055976824
11013,882.643733,882.653733,1,26479311,26479611,300,-0.08964574831303787
11014,882.673667,882.716833,1,26480210,26481504,1294,0.715075235540528
11015,883.020433,883.0259,1,26490612,26490777,165,0.5714749486286727
11016,883.0461,883.074733,1,26491383,26492241,858,0.768929804934975
11017,883.084733,883.178733,1,26492541,26495361,2820,0.7831520524331456
11018,883.186433,883.2727,1,26495592,26498181,2589,0.7900613196392928
11019,883.2738,883.279067,1,26498214,26498372,158,0.801770901734019
11020,883.2832,883.3091,1,26498496,26499273,777,0.7778505690676425
11021,883.311833,883.3155,1,26499354,26499465,111,-0.04923375723395038
11022,883.3319,883.346733,1,26499957,26500401,444,-0.0851931070866562
11023,883.349633,883.371767,1,26500488,26501153,665,-0.004928369291342039
11024,883.373067,883.3819,1,26501192,26501457,265,0.15050777188851122
11025,883.394433,883.397967,1,26501832,26501939,107,0.5072423176457485
11026,883.401833,883.5498,1,26502054,26506494,4440,0.8172169284942125
11027,883.558733,883.563067,1,26506761,26506892,131,0.23378757652781337
11028,883.564367,883.6767,1,26506931,26510301,3370,0.8176507212417763
11029,883.704867,883.711667,1,26511146,26511350,204,-0.0005478547716887197
11030,883.716433,883.719933,1,26511492,26511597,105,
11031,884.167633,884.174,1,26525028,26525220,192,0.6524559277043028
11032,884.175733,884.1837,1,26525271,26525511,240,0.5419380013832515
11033,884.188167,884.268867,1,26525645,26528066,2421,0.6324704186088087
11034,884.2905,884.325933,1,26528715,26529777,1062,0.7675296209066815
11035,884.334067,884.3591,1,26530022,26530773,751,0.7614136768723893
11036,884.383633,884.3947,1,26531508,26531841,333,-0.12706890026742607
11037,884.3966,884.4067,1,26531898,26532201,303,0.00035584934246405276
11038,884.408867,884.436333,1,26532266,26533089,823,0.17948983466723178
11039,884.454467,884.580733,1,26533634,26537421,3787,0.68169476071068
11040,884.613433,884.654267,1,26538402,26539628,1226,0.8060976767037962
11041,884.656633,884.688167,1,26539698,26540645,947,0.7342769005319576
11042,884.698967,884.730133,1,26540969,26541903,934,0.7560572150766923
11043,884.734967,884.818233,1,26542049,26544546,2497,0.762780763738594
11044,884.844,884.851467,1,26545320,26545544,224,0.46807392629333056
11045,884.8579,884.868867,1,26545737,26546066,329,-0.042663140313984646
11046,884.872367,884.878967,1,26546171,26546369,198,0.167052784269845
11047,884.888533,884.899267,1,26546655,26546978,323,0.14673793952745307
11048,884.903833,884.9073,1,26547114,26547219,105,
11049,884.944567,885.376667,1,26548337,26561300,12963,0.24681898512555775
11050,885.405767,885.413767,1,26562173,26562413,240,-0.08616512782889131
11051,885.422267,885.426833,1,26562668,26562804,136,-0.11255445633012112
11052,885.934067,885.975567,1,26578022,26579267,1245,0.6103841237912679
11053,886.2821,886.382233,1,26588463,26591466,3003,0.782881512710792
11054,886.414733,886.418833,1,26592441,26592564,123,0.1115071317815924
11055,886.700733,886.720967,1,26601021,26601629,608,0.5323006686080721
11056,886.7221,886.8327,1,26601663,26604981,3318,0.7953212873009623
11057,886.864967,886.869167,1,26605949,26606075,126,-0.08878290234747802
11058,886.872567,886.879667,1,26606177,26606390,213,0.426091726669766
11059,887.175067,887.180333,1,26615252,26615409,157,0.7487357954047157
11060,887.1847,887.3435,1,26615541,26620305,4764,0.8505493686899833
11061,887.3683,887.4749,1,26621049,26624247,3198,0.8187854680497234
11062,887.4802,887.485367,1,26624406,26624561,155,0.3367120575828304
11063,887.523633,887.527233,1,26625708,26625816,108,0.3879333775939568
11064,887.945733,887.959933,1,26638371,26638797,426,0.5532336871678519
11065,887.968733,887.981033,1,26639061,26639430,369,0.5766911518485
11066,888.017433,888.027333,1,26640522,26640819,297,0.054388562667399276
11067,888.072967,888.091733,1,26642189,26642751,562,0.9017200027272971
11068,888.095433,888.103067,1,26642862,26643092,230,0.1945801735399063
11069,888.140167,888.147167,1,26644205,26644415,210,0.3398574013204066
11070,888.167867,888.2074,1,26645036,26646222,1186,0.6436993082426354
11071,888.2172,888.220267,1,26646516,26646608,92,0.532117787434235
11072,888.233333,888.238767,1,26646999,26647163,164,0.7052592413586297
11073,888.2405,888.248033,1,26647215,26647440,225,0.6387562738294342
11074,888.410633,888.422033,1,26652318,26652660,342,0.6199468399624808
11075,888.429367,888.444467,1,26652881,26653334,453,0.8725542528797476
11076,888.460167,888.4748,1,26653805,26654244,439,0.7531246461585401
11077,888.519967,888.525533,1,26655599,26655765,166,0.7412863213985122
11078,888.568367,888.578,1,26657051,26657340,289,0.7256953527105235
11079,888.625067,888.637533,1,26658752,26659125,373,0.6455208094385926
11080,888.682133,888.6873,1,26660463,26660619,156,0.8988874175243666
11081,888.7399,888.748467,1,26662197,26662454,257,0.8136365712311989
11082,888.802,888.809867,1,26664060,26664296,236,-0.22382170704792048
11083,888.848567,888.8599,1,26665457,26665797,340,0.3974187253209843
11084,888.892467,888.9117,1,26666774,26667351,577,0.7855139421336319
11085,888.929867,888.9489,1,26667896,26668467,571,0.883943430487743
11086,888.98,888.996367,1,26669400,26669891,491,0.6572075674374824
11087,889.032467,889.0431,1,26670974,26671293,319,0.7314079207719063
11088,889.078667,889.0882,1,26672360,26672646,286,0.3537298462200451
11089,889.147867,889.1516,1,26674436,26674548,112,-0.5091118466010855
11090,889.341367,889.348467,1,26680241,26680454,213,0.5340749028181853
11091,889.697833,889.7303,1,26690934,26691909,975,0.7959215918746448
11092,889.800433,889.806167,1,26694012,26694185,173,0.8659859952473313
11093,889.811333,889.833867,1,26694339,26695016,677,0.45872109523280336
11094,889.8918,889.9022,1,26696754,26697066,312,-0.3718639485639832
11095,889.932333,889.962667,1,26697969,26698880,911,0.43875725140562044
11096,891.5,891.5212,1,26745000,26745636,636,0.7402065939159546
11097,891.578567,891.5832,1,26747357,26747496,139,0.37341833695667964
11098,891.588933,891.609767,1,26747667,26748293,626,0.2657564201751602
11099,891.9308,891.936133,1,26757924,26758083,159,-0.1667093211374683
11100,891.988767,892.001067,1,26759663,26760032,369,0.5590554153952153
11101,892.0581,892.092267,1,26761743,26762768,1025,0.4875078417893147
11102,892.1516,892.1593,1,26764548,26764779,231,0.43327801083832834
11103,892.1633,892.215267,1,26764899,26766458,1559,0.5192062179991577
11104,892.847067,892.8513,1,26785412,26785539,127,-0.15129907964322298
11105,892.858567,892.8738,1,26785757,26786214,457,0.6235653552409468
11106,892.945133,892.9554,1,26788353,26788662,309,0.6355674670037028
11107,893.671967,893.6761,1,26810159,26810283,124,0.07570297223423447
11108,893.692967,893.696767,1,26810789,26810903,114,0.6112016367880682
11109,893.703167,893.7062,1,26811095,26811186,91,0.05322780500055014
11110,893.7155,893.720067,1,26811465,26811602,137,0.426867065891744
11111,893.723733,893.730833,1,26811711,26811924,213,0.5688089801525479
11112,893.742667,893.747267,1,26812280,26812418,138,0.6452961972282223
11113,893.8009,893.805367,1,26814027,26814161,134,0.4373038377980677
11114,893.993467,894.006533,1,26819804,26820195,391,0.6218498201731459
11115,897.843067,897.846267,1,26935292,26935388,96,0.2686660706550491
11116,897.8713,897.876133,1,26936139,26936283,144,-0.11562520363517433
11117,897.936067,897.940233,1,26938082,26938206,124,0.1282494119723697
11118,898.651933,898.6607,1,26959557,26959821,264,0.7785047491276018
11119,898.679833,898.6955,1,26960394,26960865,471,0.8918285545353578
11120,898.7488,898.7569,1,26962464,26962707,243,0.5954281547746814
11121,898.994033,899.0054,1,26969820,26970162,342,0.7219509557106141
11122,899.0232,899.038667,1,26970696,26971160,464,0.45717136700627126
11123,899.049233,899.057633,1,26971476,26971728,252,
11124,899.063667,899.081,1,26971910,26972430,520,0.6298358056047176
11125,899.087667,899.0979,1,26972630,26972937,307,0.4214444833440181
11126,899.102867,899.118333,1,26973086,26973549,463,0.5381561622394138
11127,899.128633,899.1397,1,26973858,26974191,333,0.5760187362284359
11128,899.1485,899.163833,1,26974455,26974914,459,0.7271539987591801
11129,900.0084,900.022933,1,27000252,27000687,435,0.6700030226823078
11130,900.0697,900.082867,1,27002091,27002486,395,0.7274808583781897
11131,900.084033,900.087367,1,27002520,27002621,101,0.7316330917295573
11132,901.768967,901.773967,1,27053069,27053219,150,0.5380090502447618
11133,901.9158,901.923233,1,27057474,27057696,222,0.3794865181554607
11134,902.478267,902.4837,1,27074348,27074511,163,0.11739403852407622
11135,902.503067,902.506433,1,27075092,27075192,100,
11136,902.8544,902.861167,1,27085632,27085835,203,0.5985778746344284
11137,902.863733,902.878367,1,27085911,27086351,440,0.6952754826173517
11138,902.902633,902.9184,1,27087078,27087552,474,0.018310049694114355
11139,903.1527,903.1562,1,27094581,27094686,105,0.031005024515977777
11140,903.220333,903.230067,1,27096609,27096902,293,0.7274419523070725
11141,903.256133,903.2619,1,27097683,27097857,174,0.7443133083637575
11142,903.2807,903.286433,1,27098421,27098592,171,0.2333619150960344
11143,903.457567,903.461167,1,27103727,27103835,108,0.7233897059958075
11144,903.480333,903.483367,1,27104409,27104501,92,0.9513621103897245
11145,903.512433,903.521033,1,27105372,27105630,258,0.5818451846817286
11146,903.541133,903.556567,1,27106233,27106697,464,0.25920511354634285
11147,903.5819,903.598133,1,27107457,27107943,486,0.6736776087243848
11148,903.604,903.610767,1,27108120,27108323,203,-0.3538867779460929
11149,903.6239,903.638,1,27108717,27109140,423,0.8832530836785932
11150,903.650633,903.6564,1,27109518,27109692,174,0.6776030723620863
11151,903.986933,904.001733,1,27119607,27120051,444,0.009782718440151189
11152,904.017967,904.023767,1,27120539,27120713,174,0.6023184586299419
11153,904.073367,904.080733,1,27122201,27122421,220,0.5794741871917313
11154,904.1055,904.116867,1,27123165,27123506,341,0.18817030211247163
11155,904.512267,904.5163,1,27135368,27135489,121,0.18990319286402382
11156,904.520567,904.539,1,27135617,27136170,553,0.10626342904704844
11157,904.5589,904.6621,1,27136767,27139863,3096,0.7915356902045368
11158,904.954333,904.958667,1,27148629,27148760,131,0.3906486369425969
11159,904.9675,904.980667,1,27149025,27149420,395,0.7243567544068993
11160,904.9827,904.990533,1,27149481,27149715,234,0.37639618949990916
11161,905.024833,905.054233,1,27150744,27151626,882,0.7096405026958659
11162,905.059567,905.184667,1,27151787,27155540,3753,0.7519567588937823
11163,905.1951,905.210133,1,27155853,27156303,450,0.4631640467592048
11164,905.213367,905.223533,1,27156401,27156705,304,0.34807191636773394
11165,905.411133,905.4142,1,27162333,27162426,93,0.30794691871818924
11166,905.471767,905.519933,1,27164153,27165597,1444,0.7936174304322555
11167,905.5213,905.5371,1,27165639,27166113,474,0.7754270315509701
11168,905.549433,905.578533,1,27166482,27167355,873,0.849415392083478
11169,905.616333,905.634933,1,27168489,27169047,558,0.6852324834351003
11170,905.6493,905.653333,1,27169479,27169599,120,0.6754712659476724
11171,905.654867,905.7119,1,27169646,27171357,1711,0.7676448528694433
11172,905.7253,905.730167,1,27171759,27171905,146,0.2425425343354845
11173,905.731767,905.760733,1,27171953,27172821,868,0.7150264889126932
11174,905.784,905.789033,1,27173520,27173670,150,0.12983126273790266
11175,905.797667,905.8055,1,27173930,27174165,235,0.021829247166056637
11176,905.810633,905.8297,1,27174318,27174891,573,0.21490309105185765
11177,905.832633,905.862733,1,27174978,27175881,903,0.07495981964573975
11178,905.940467,906.046667,1,27178214,27181400,3186,0.8403353017038
11179,906.074533,906.0868,1,27182235,27182604,369,0.17062862747775304
11180,906.1025,906.110367,1,27183075,27183311,236,-0.1091958833306151
11181,906.1124,906.121433,1,27183372,27183642,270,-0.013558392757793582
11182,906.123067,906.126633,1,27183692,27183798,106,
11183,906.279033,906.360667,1,27188370,27190820,2450,0.7756327561535302
11184,906.366,906.495867,1,27190980,27194876,3896,0.7386528218140344
11185,906.5122,906.573467,1,27195366,27197204,1838,0.8086019359300708
11186,906.5801,906.611967,1,27197403,27198359,956,0.7012061247581771
11187,906.639667,906.6685,1,27199190,27200055,865,-0.0449664418339441
11188,906.672767,906.679733,1,27200183,27200391,208,0.5610733247380367
11189,906.849833,907.02,1,27205494,27210600,5106,0.8403995013947703
11190,907.3109,907.318933,1,27219327,27219567,240,0.6576679997947855
11191,907.319967,907.3375,1,27219599,27220125,526,0.7889210820944164
11192,907.3496,907.399133,1,27220488,27221973,1485,0.7735155510158408
11193,907.404533,907.408267,1,27222135,27222248,113,0.6151028772343876
11194,907.4094,907.449067,1,27222282,27223472,1190,0.6255437806493302
11195,907.463467,907.514167,1,27223904,27225425,1521,0.5586774401966491
11196,907.515567,907.574533,1,27225467,27227235,1768,0.6673524501955226
11197,907.596633,907.632833,1,27227898,27228984,1086,0.6357649960268609
11198,907.666167,907.712167,1,27229985,27231365,1380,0.0034380625670145802
11199,907.7355,907.8503,1,27232065,27235509,3444,0.7725220159859617
11200,908.0775,908.281467,1,27242325,27248444,6119,0.732556960195775
11201,908.305133,908.312033,1,27249153,27249360,207,-0.023054114100855602
11202,908.316567,908.322567,1,27249497,27249677,180,-0.2775991795883601
11203,908.386833,908.391667,1,27251604,27251750,146,-3.887492389717853e-06
11204,908.3973,908.499767,1,27251919,27254993,3074,0.8351943078142147
11205,908.503233,908.5067,1,27255096,27255201,105,0.27257919801471386
11206,909.048767,909.0557,1,27271463,27271671,208,0.04449316459298199
11207,909.058633,909.062433,1,27271758,27271872,114,-0.28888989136044957
11208,909.079133,909.085367,1,27272373,27272561,188,0.4979207232515956
11209,909.118867,909.150067,1,27273566,27274502,936,0.6887577843691263
11210,909.1731,909.196467,1,27275193,27275894,701,0.7130304695333652
11211,909.2252,909.232367,1,27276756,27276971,215,0.6264962797246456
11212,909.246667,909.260467,1,27277400,27277814,414,0.5483286152623544
11213,909.274933,909.319833,1,27278247,27279594,1347,0.7099786129296213
11214,909.3416,909.347167,1,27280248,27280415,167,0.6409443504683611
11215,909.349967,909.359033,1,27280499,27280770,271,0.6499272555216435
11216,909.382467,909.393667,1,27281474,27281810,336,0.4925927026668721
11217,909.401233,909.414333,1,27282036,27282429,393,0.467107139654688
11218,909.4322,909.439,1,27282966,27283170,204,0.2745409306487669
11219,909.466967,909.475033,1,27284009,27284250,241,0.2812840483025603
11220,909.624767,909.7284,1,27288743,27291852,3109,0.8402896161074054
11221,909.946033,910.024867,1,27298380,27300746,2366,0.47839695206653376
11222,910.026233,910.1486,1,27300786,27304458,3672,0.7823643497565237
11223,910.1696,910.169933,1,27305088,27305097,9,
11224,910.366433,910.424,1,27310992,27312720,1728,0.7562766817963917
11225,910.425133,910.4506,1,27312753,27313518,765,0.6800608540727583
11226,910.4556,910.4682,1,27313668,27314046,378,0.38779807684156836
11227,910.5034,910.506633,1,27315102,27315198,96,-0.12307396569641058
11228,910.6491,910.796667,1,27319473,27323900,4427,0.797106987425803
11229,910.9185,911.0954,1,27327555,27332862,5307,0.6838586973454412
11230,911.513933,911.547667,1,27345417,27346430,1013,0.7516183677265692
11231,911.572767,911.608333,1,27347183,27348249,1066,0.7977923641936041
11232,911.614533,911.6239,1,27348435,27348717,282,0.8269287308211356
11233,911.632633,911.677067,1,27348978,27350312,1334,0.6916649628450928
11234,911.693633,911.749933,1,27350808,27352497,1689,0.6859598036141797
11235,911.753267,911.799133,1,27352598,27353973,1375,0.5735843946432296
11236,911.805067,911.887667,1,27354152,27356630,2478,0.749148787067137
11237,911.897567,911.901633,1,27356927,27357048,121,0.4831959934732219
11238,911.905633,911.919167,1,27357168,27357575,407,-0.057803038661457536
11239,911.974733,911.9863,1,27359241,27359589,348,0.05852601762415261
11240,911.9906,912.0991,1,27359718,27362973,3255,0.7921359383559485
11241,912.1038,912.118767,1,27363114,27363563,449,0.5664997058464285
11242,912.3409,912.431367,1,27370227,27372941,2714,0.8177270885200183
11243,912.4341,912.565967,1,27373023,27376979,3956,0.7774337993929334
11244,912.581033,912.637567,1,27377430,27379127,1697,0.8116628335155088
11245,912.646367,912.661867,1,27379391,27379856,465,0.6940332162695102
11246,912.669333,912.6922,1,27380079,27380766,687,0.3524897918938035
11247,912.697133,912.717633,1,27380913,27381528,615,-0.0018890700828558592
11248,912.722533,912.7409,1,27381675,27382227,552,-0.17683169696419485
11249,912.745467,912.752233,1,27382364,27382566,202,0.08644299388213289
11250,912.782667,912.7874,1,27383480,27383622,142,0.7511200397774561
11251,912.7898,912.9961,1,27383694,27389883,6189,0.8395160025007279
11252,913.009867,913.015367,1,27390296,27390461,165,-0.04843613436582161
11253,913.016933,913.025467,1,27390507,27390764,257,0.29388316233365464
11254,913.038233,913.0421,1,27391146,27391263,117,
11255,913.142433,913.230133,1,27394272,27396903,2631,0.7147900869066246
11256,913.231167,913.255067,1,27396935,27397652,717,0.8525440963328668
11257,913.288533,913.2929,1,27398655,27398787,132,0.548624737567409
11258,913.500667,913.6924,1,27405020,27410772,5752,0.7493697458831997
11259,913.703967,913.7412,1,27411119,27412236,1117,0.7927042838409576
11260,913.7574,913.793733,1,27412722,27413811,1089,0.7609190939649044
11261,913.8081,913.815067,1,27414243,27414452,209,0.3069520945068549
11262,913.828067,913.846533,1,27414842,27415395,553,-0.3872194894638804
11263,913.854567,913.8966,1,27415637,27416898,1261,0.408045545985438
11264,913.899567,913.9081,1,27416987,27417243,256,-0.06454524215476527
11265,913.928967,913.933167,1,27417869,27417995,126,0.7230294869821411
11266,913.9381,914.088167,1,27418143,27422645,4502,0.7984708179445423
11267,914.0943,914.207767,1,27422829,27426233,3404,0.7972216580963642
11268,914.686333,914.691433,1,27440589,27440742,153,0.5326388314992452
11269,914.694067,914.7047,1,27440822,27441141,319,0.7252027731009871
11270,914.7231,914.816533,1,27441693,27444495,2802,0.7957691636624454
11271,914.823567,914.909067,1,27444707,27447272,2565,0.7730307204697272
11272,914.912,914.915767,1,27447360,27447473,113,0.8441613295464753
11273,914.9237,914.9441,1,27447711,27448323,612,0.6305821199410224
11274,914.969367,914.9731,1,27449081,27449193,112,0.3036242998780562
11275,914.981367,915.0,1,27449441,27450000,559,-0.007111649116587724
11276,915.010167,915.0137,1,27450305,27450411,106,-0.18301984701955656
11277,915.016333,915.020833,1,27450489,27450624,135,-0.025142967260786294
11278,915.0374,915.043733,1,27451122,27451311,189,0.45574279860715383
11279,915.0448,915.268867,1,27451344,27458066,6722,0.39749477607668665
11280,915.2774,915.3543,1,27458322,27460629,2307,0.7906614695092572
11281,915.361067,915.399367,1,27460832,27461981,1149,0.769013417494229
11282,915.420133,915.442533,1,27462603,27463275,672,0.07424616945635985
11283,915.443867,915.467067,1,27463316,27464012,696,0.11303710563700288
11284,915.5028,915.5179,1,27465084,27465537,453,0.7831193940767057
11285,915.519867,915.605733,1,27465596,27468171,2575,0.7938821306896396
11286,915.6409,915.650933,1,27469227,27469527,300,0.06978662834318056
11287,915.838467,915.979267,1,27475154,27479378,4224,0.8142488812148081
11288,916.076667,916.24,1,27482300,27487200,4900,0.8394801641170535
11289,916.2418,916.246433,1,27487254,27487392,138,-0.11956499322945856
11290,916.2523,916.3642,1,27487569,27490926,3357,0.7987639590738764
11291,916.390533,916.414233,1,27491715,27492426,711,0.7688727166928183
11292,916.417967,916.507233,1,27492539,27495216,2677,0.346895273368482
11293,916.53,916.533567,1,27495900,27496007,107,-0.10470756159026114
11294,916.535133,916.5401,1,27496053,27496203,150,
11295,916.5411,916.560233,1,27496233,27496806,573,0.3299316105149483
11296,916.5626,916.567767,1,27496878,27497033,155,0.551258925640811
11297,916.594567,916.709733,1,27497837,27501291,3454,0.8244417108762824
11298,916.776367,916.9398,1,27503291,27508194,4903,0.8433354413970127
11299,917.369433,917.373733,1,27521082,27521211,129,-0.08948802390793142
11300,917.381667,917.441767,1,27521450,27523253,1803,0.7783742889233842
11301,917.4446,917.523533,1,27523338,27525705,2367,0.828935829417132
11302,917.546333,917.732233,1,27526389,27531966,5577,0.7702711863375038
11303,917.7433,917.770633,1,27532299,27533118,819,0.8730493825287552
11304,917.781,917.794033,1,27533430,27533820,390,0.11389520222825417
11305,917.813767,917.834033,1,27534413,27535020,607,0.6305865259374835
11306,917.850433,917.867233,1,27535512,27536016,504,0.5496139775702603
11307,917.870367,917.934767,1,27536111,27538043,1932,0.7761041604473858
11308,917.939833,917.943833,1,27538194,27538314,120,0.33890610505317387
11309,917.966733,917.972067,1,27539001,27539162,161,0.11001774489200408
11310,917.977033,917.9827,1,27539310,27539481,171,0.41219176341250596
11311,918.152,918.155,1,27544560,27544650,90,-0.07408013456986605
11312,918.1616,918.2787,1,27544848,27548361,3513,0.5370976349605617
11313,918.3338,918.340167,1,27550014,27550205,191,-0.08093625806985376
11314,918.349833,918.459,1,27550494,27553770,3276,0.8713278926689904
11315,918.870733,918.881733,1,27566121,27566451,330,0.7010878894550676
11316,918.904467,918.918467,1,27567134,27567554,420,0.622993125324281
11317,918.926,918.938,1,27567780,27568140,360,0.6755002769592776
11318,918.970167,918.9804,1,27569105,27569412,307,0.3607959389886938
11319,918.9817,919.003767,1,27569451,27570113,662,0.6178383463364265
11320,919.016767,919.040733,1,27570503,27571221,718,0.5351785537536555
11321,919.0844,919.1017,1,27572532,27573051,519,0.6307770291741148
11322,919.1261,919.136367,1,27573783,27574091,308,0.5972291328144044
11323,919.1442,919.151067,1,27574326,27574532,206,0.4714602430370808
11324,919.186133,919.201867,1,27575583,27576056,473,0.09866487227460519
11325,919.2039,919.237267,1,27576117,27577118,1001,-0.1094335126920837
11326,919.2442,919.249933,1,27577326,27577497,171,0.47389424405645225
11327,919.2895,919.2925,1,27578685,27578775,90,0.22063659899442284
11328,919.302933,919.3402,1,27579087,27580206,1119,0.7888644272732593
11329,919.3427,919.424833,1,27580281,27582744,2463,0.7472577638633028
11330,919.45,919.552467,1,27583500,27586574,3074,0.8085604403631638
11331,919.5582,919.561967,1,27586746,27586859,113,0.17282483271637575
11332,919.571967,919.5754,1,27587159,27587262,103,0.01650523509656396
11333,919.685733,919.804533,1,27590571,27594135,3564,0.805664509991362
11334,919.806167,919.840367,1,27594185,27595211,1026,0.6954718497024526
11335,919.843333,919.872033,1,27595299,27596160,861,0.7638127952215648
11336,919.8811,919.9528,1,27596433,27598584,2151,0.8581135409256677
11337,919.966133,919.977733,1,27598983,27599331,348,0.27256333269885197
11338,919.985433,920.0137,1,27599562,27600411,849,0.05457848658950142
11339,920.0148,920.052233,1,27600444,27601566,1122,0.8388686519906101
11340,920.0541,920.145133,1,27601623,27604353,2730,0.7852177433548397
11341,920.165733,920.177367,1,27604971,27605321,350,0.08766727436432052
11342,920.192533,920.198833,1,27605775,27605964,189,-0.1260387854002445
11343,920.2012,920.312833,1,27606036,27609384,3348,0.8652759282360087
11344,920.780433,920.793967,1,27623412,27623819,407,0.05054220606284178
11345,920.796767,920.815033,1,27623903,27624450,547,0.5984313193442655
11346,920.816667,920.819733,1,27624500,27624591,91,-0.15236040201317116
11347,920.8218,920.825333,1,27624654,27624759,105,0.23999091320358623
11348,921.0724,921.229067,1,27632172,27636872,4700,0.7713088636756023
11349,921.2371,921.272333,1,27637113,27638169,1056,0.8071231103498067
11350,921.276533,921.2925,1,27638295,27638775,480,0.7529351712986567
11351,921.2935,921.301967,1,27638805,27639059,254,0.7998853999630189
11352,921.3209,921.401367,1,27639627,27642041,2414,0.7706031218077875
11353,921.420933,921.490533,1,27642627,27644715,2088,0.7901720942110937
11354,921.498333,921.5109,1,27644949,27645327,378,0.11263528836031068
11355,922.260867,922.2881,1,27667826,27668643,817,0.5306761196578185
11356,922.3181,922.335333,1,27669543,27670059,516,0.6429039729633903
11357,922.5923,922.599367,1,27677769,27677981,212,0.4343034165865034
11358,922.602567,922.6379,1,27678077,27679137,1060,0.8415739188073487
11359,922.6398,922.644767,1,27679194,27679343,149,0.6820408143886458
11360,922.647933,922.686133,1,27679437,27680583,1146,0.7984002217586836
11361,922.708267,922.722067,1,27681248,27681662,414,-0.013963229499869442
11362,922.9594,922.998567,1,27688782,27689957,1175,0.557933785450854
11363,923.201,923.205967,1,27696030,27696179,149,0.5426788622807666
11364,923.208967,923.268333,1,27696269,27698049,1780,0.8173199538777902
11365,923.2695,923.371867,1,27698085,27701156,3071,0.8182507905779886
11366,923.3781,923.421633,1,27701343,27702648,1305,0.7815584529161068
11367,923.447167,923.473033,1,27703415,27704190,775,0.7823047204954184
11368,923.4763,923.531133,1,27704289,27705933,1644,0.7877620717136176
11369,923.533667,923.5378,1,27706010,27706134,124,
11370,923.539,923.555933,1,27706170,27706677,507,0.6453842264373126
11371,923.5621,923.646,1,27706863,27709380,2517,0.7940328540686934
11372,923.6678,923.678433,1,27710034,27710352,318,0.12637544496146963
11373,923.695133,923.698333,1,27710853,27710949,96,
11374,923.8935,924.087433,1,27716805,27722622,5817,0.7979055643719587
11375,924.109533,924.128067,1,27723285,27723842,557,0.8219727502461328
11376,924.129067,924.182433,1,27723872,27725472,1600,0.7430761003220657
11377,924.184367,924.2785,1,27725531,27728355,2824,0.7793438721186194
11378,924.2834,924.317267,1,27728502,27729518,1016,0.7487444298992068
11379,924.320467,924.410367,1,27729614,27732311,2697,0.7947225707048369
11380,924.447,924.451767,1,27733410,27733553,143,-0.04760838959523436
11381,924.570867,924.733333,1,27737126,27741999,4873,0.7877419633790785
11382,924.7348,924.7889,1,27742044,27743667,1623,0.7875113384018592
11383,924.815,924.841367,1,27744450,27745241,791,0.7483832012087722
11384,924.845067,924.9446,1,27745352,27748338,2986,0.80085530203216
11385,924.946033,925.056333,1,27748380,27751689,3309,0.7091268630873081
11386,925.0595,925.1483,1,27751785,27754449,2664,0.5118818577014502
11387,925.149633,925.171867,1,27754488,27755156,668,0.7931072903910983
11388,925.178067,925.269933,1,27755342,27758097,2755,0.8293396656477073
11389,925.272733,925.296533,1,27758181,27758895,714,0.7932001510891037
11390,925.299067,925.356567,1,27758972,27760697,1725,0.7857646738020854
11391,925.3579,925.3889,1,27760737,27761667,930,0.7996437121389971
11392,925.392167,925.4089,1,27761765,27762267,502,0.34426147035890053
11393,925.411667,925.416833,1,27762350,27762504,154,0.04347743208530757
11394,925.420967,925.5115,1,27762629,27765345,2716,0.7925931857341142
11395,925.5145,925.5184,1,27765435,27765552,117,0.6128051464821845
11396,925.519433,925.532433,1,27765582,27765972,390,0.8971172231015917
11397,925.5431,925.6219,1,27766293,27768657,2364,0.8428442487545489
11398,925.625967,925.6414,1,27768779,27769242,463,0.848584983053046
11399,925.6438,925.664467,1,27769314,27769934,620,0.8199999833888505
11400,925.6708,925.792733,1,27770124,27773781,3657,0.7980642516575266
11401,925.795567,925.890633,1,27773867,27776718,2851,0.8485820709578784
11402,925.894233,925.915233,1,27776826,27777456,630,0.9322142091225502
11403,925.9232,926.018633,1,27777696,27780558,2862,0.8399553059109136
11404,926.022467,926.037833,1,27780674,27781134,460,0.38222780123952094
11405,926.053133,926.091267,1,27781593,27782738,1145,0.7805705482654559
11406,926.092967,926.1086,1,27782789,27783258,469,0.8174993850003518
11407,926.113433,926.144333,1,27783402,27784329,927,0.7647133266227231
11408,926.1495,926.1648,1,27784485,27784944,459,0.5847087907357522
11409,926.175667,926.240167,1,27785270,27787205,1935,0.6682670305612227
11410,926.2534,926.268733,1,27787602,27788061,459,0.07619654602658558
11411,926.4453,926.543,1,27793359,27796290,2931,0.7963726278892393
11412,926.5638,926.569933,1,27796914,27797097,183,-0.001978900264049053
11413,926.9489,926.954767,1,27808467,27808643,176,0.65506548533086
11414,927.025267,927.031167,1,27810758,27810935,177,0.49959382935391555
11415,927.0763,927.084833,1,27812289,27812544,255,0.3989443206345592
11416,927.140667,927.157067,1,27814220,27814712,492,0.5625451676316678
11417,927.1918,927.203633,1,27815754,27816108,354,0.631415774526091
11418,927.3202,927.3254,1,27819606,27819762,156,0.6017566844905096
11419,927.3272,927.3454,1,27819816,27820362,546,0.6328252953953697
11420,927.3468,927.447967,1,27820404,27823439,3035,0.8438576186671668
11421,927.455067,927.464167,1,27823652,27823925,273,0.2720639038150642
11422,927.490033,927.496433,1,27824700,27824892,192,-0.20448072901610576
11423,927.6952,927.733633,1,27830856,27832008,1152,0.7006226986892536
11424,927.987433,927.994567,1,27839622,27839837,215,0.5859558876984389
11425,928.005667,928.0095,1,27840170,27840285,115,0.5496370169242415
11426,928.023533,928.0517,1,27840705,27841551,846,0.7494924449637878
11427,928.061867,928.181,1,27841856,27845430,3574,0.7526115084072514
11428,928.1825,928.291167,1,27845475,27848735,3260,0.7877419118755021
11429,928.295133,928.318933,1,27848853,27849567,714,0.7244168031641519
11430,928.320067,928.435067,1,27849602,27853052,3450,0.7687831459642479
11431,928.463867,928.478533,1,27853916,27854355,439,0.07698008522374274
11432,928.983533,929.0116,1,27869505,27870348,843,0.8086648869512443
11433,929.016367,929.061967,1,27870491,27871859,1368,0.8105422450981501
11434,929.068533,929.0954,1,27872055,27872862,807,0.8025110201538111
11435,929.107367,929.188367,1,27873221,27875651,2430,0.8249306165252666
11436,929.195567,929.2196,1,27875867,27876588,721,0.5240042807810172
11437,929.249833,929.270867,1,27877494,27878126,632,0.10546626364410489
11438,929.281367,929.285433,1,27878441,27878562,121,0.8408595733146953
11439,929.291367,929.318333,1,27878741,27879549,808,0.6702311141821067
11440,929.330433,929.405733,1,27879912,27882171,2259,0.7909022853332187
11441,929.422367,929.430433,1,27882671,27882912,241,0.07780291143298375
11442,929.532733,929.536533,1,27885981,27886095,114,0.6639709326341859
11443,929.547033,929.652633,1,27886410,27889578,3168,0.7488789306170004
11444,929.655933,929.726533,1,27889677,27891795,2118,0.8034258298877691
11445,929.727567,929.7583,1,27891827,27892749,922,0.8141488157682581
11446,929.762,929.766567,1,27892860,27892997,137,0.5488582346421204
11447,929.788767,929.833233,1,27893663,27894996,1333,0.10295723537432169
11448,929.8423,929.9466,1,27895269,27898398,3129,0.7092815272471014
11449,929.960833,929.991833,1,27898824,27899754,930,0.1537302413539674
11450,930.003267,930.1189,1,27900098,27903567,3469,0.8427524047358298
11451,930.474567,930.487867,1,27914237,27914636,399,0.6976410606349949
11452,930.494133,930.502667,1,27914823,27915080,257,0.6855409864432144
11453,930.536267,930.572733,1,27916088,27917181,1093,0.7156480677057779
11454,930.575,930.64,1,27917250,27919200,1950,0.7274197415950938
11455,930.646967,930.652833,1,27919409,27919584,175,0.5275235182487874
11456,930.668833,930.6721,1,27920064,27920163,99,0.30690714983668466
11457,930.678467,930.6905,1,27920354,27920715,361,0.7936660570772364
11458,930.8371,930.845633,1,27925113,27925368,255,0.2274970019279674
11459,930.855067,930.8669,1,27925652,27926007,355,0.7230673450664914
11460,930.8842,930.899567,1,27926526,27926987,461,0.7686405026187546
11461,930.9109,930.916833,1,27927327,27927504,177,-0.4943580261123164
11462,931.1633,931.166767,1,27934899,27935003,104,0.5206959861568438
11463,931.1783,931.1901,1,27935349,27935703,354,0.016133592253917202
11464,931.3452,931.3524,1,27940356,27940572,216,0.7194513030013806
11465,931.371767,931.381967,1,27941153,27941459,306,0.8639874990619397
11466,931.4052,931.414333,1,27942156,27942429,273,0.1774669823898156
11467,931.443167,931.458933,1,27943295,27943767,472,0.1492640597267901
11468,931.468,931.478267,1,27944040,27944348,308,0.6303185074923766
11469,931.4805,931.499267,1,27944415,27944978,563,-0.11697882160156393
11470,931.5087,931.5162,1,27945261,27945486,225,0.41717453064053645
11471,931.528367,931.540467,1,27945851,27946214,363,0.8122385767393566
11472,931.5552,931.560333,1,27946656,27946809,153,0.78927190183089
11473,931.750533,931.776267,1,27952515,27953288,773,0.903404147188727
11474,932.2401,932.244767,1,27967203,27967343,140,0.14151469719336343
11475,933.942633,933.954533,1,28018278,28018635,357,0.6896747875838806
11476,933.963167,933.966867,1,28018895,28019006,111,0.4487136758664538
11477,933.969567,933.978567,1,28019087,28019357,270,0.380989571100623
11478,934.004,934.017033,1,28020120,28020510,390,0.6275342688832247
11479,934.038833,934.076033,1,28021164,28022280,1116,0.6215449803007613
11480,934.976633,934.986467,1,28049298,28049594,296,0.47923071374473547
11481,934.988467,935.020433,1,28049654,28050612,958,0.683660761768493
11482,935.0433,935.105633,1,28051299,28053168,1869,0.6605889509386595
11483,935.116433,935.1324,1,28053492,28053972,480,0.6733463573387134
11484,935.139167,935.192867,1,28054175,28055786,1611,0.6060025436780377
11485,935.214733,935.238067,1,28056441,28057142,701,0.6319562301574748
11486,935.4185,935.473867,1,28062555,28064216,1661,0.7901983740874878
11487,935.476533,935.5229,1,28064295,28065687,1392,0.8225781919648374
11488,935.549667,935.560067,1,28066490,28066802,312,-0.002706440947501896
11489,935.564033,935.567267,1,28066920,28067018,98,
11490,935.585133,935.5902,1,28067553,28067706,153,-0.03599736690782001
11491,935.768633,935.8506,1,28073058,28075518,2460,0.781325501339217
11492,935.855633,935.9626,1,28075668,28078878,3210,0.7962967184388275
11493,935.963867,935.988433,1,28078916,28079652,736,0.5133974015273445
11494,936.009267,936.060067,1,28080278,28081802,1524,0.7789876388484434
11495,936.075167,936.0923,1,28082255,28082769,514,0.6987827860023388
11496,936.101467,936.1046,1,28083044,28083138,94,0.7163064106232317
11497,936.114733,936.1189,1,28083441,28083567,126,0.5426606071061032
11498,936.1372,936.153533,1,28084116,28084605,489,0.04171891555784228
11499,936.159867,936.166,1,28084796,28084980,184,-0.06030079061582908
11500,936.310833,936.5334,1,28089324,28096002,6678,0.7858111781448649
11501,936.536633,936.5554,1,28096098,28096662,564,0.4065806443624682
11502,936.638667,936.646433,1,28099160,28099392,232,-0.09440294872421738
11503,936.6535,936.751267,1,28099605,28102538,2933,0.7988232555070066
11504,936.769933,936.776067,1,28103097,28103282,185,-0.40516498975225
11505,937.085767,937.114867,1,28112573,28113446,873,0.5226911534100964
11506,937.164467,937.1698,1,28114934,28115094,160,0.6086625761184511
11507,937.2136,937.224167,1,28116408,28116725,317,0.48146945055410617
11508,937.232367,937.2495,1,28116971,28117485,514,0.05500222979234874
11509,937.250667,937.272467,1,28117520,28118174,654,0.1885669528978586
11510,937.273867,937.284967,1,28118216,28118549,333,0.1739545693501078
11511,937.2878,937.2911,1,28118634,28118733,99,
11512,937.316533,937.3805,1,28119495,28121415,1920,0.8220489436014387
11513,937.382833,937.425933,1,28121484,28122777,1293,0.5626468311428809
11514,937.433767,937.442933,1,28123013,28123287,274,0.7031314438597875
11515,937.472433,937.516833,1,28124172,28125504,1332,0.8007124119887324
11516,937.5292,937.543967,1,28125876,28126319,443,0.7180125153092811
11517,937.585367,937.606533,1,28127561,28128195,634,0.04960232715705338
11518,937.609867,937.6183,1,28128296,28128549,253,0.14649391772098228
11519,937.970867,938.048833,1,28139126,28141464,2338,0.48901082434700377
11520,938.0507,938.078533,1,28141521,28142355,834,0.49359144167613495
11521,938.104467,938.1138,1,28143134,28143414,280,0.5148308347333566
11522,938.115433,938.134367,1,28143462,28144031,569,0.6401199851289293
11523,938.1396,938.156233,1,28144188,28144686,498,0.691345661059794
11524,938.187233,938.2202,1,28145616,28146606,990,0.5618876225068917
11525,938.235067,938.252033,1,28147052,28147560,508,0.5315086007511722
11526,938.2991,938.3063,1,28148973,28149189,216,0.6384764161391481
11527,938.309133,938.318867,1,28149273,28149566,293,0.5951354929465762
11528,938.3436,938.347533,1,28150308,28150425,117,0.14064564078176894
11529,938.354133,938.366967,1,28150623,28151009,386,0.4827955478196549
11530,938.388167,938.398633,1,28151645,28151958,313,0.17297788226418262
11531,938.4043,938.432967,1,28152129,28152989,860,0.21097085136300447
11532,938.434767,938.456267,1,28153043,28153688,645,0.14988037830073445
11533,938.4711,938.477667,1,28154133,28154330,197,0.48542088401548467
11534,938.4789,938.4824,1,28154367,28154472,105,-0.4099016476680326
11535,938.487333,938.573367,1,28154619,28157201,2582,0.7783695361447163
11536,938.574633,938.6143,1,28157238,28158429,1191,0.772047825696627
11537,938.641133,938.726833,1,28159233,28161804,2571,0.651536986786455
11538,938.7348,938.741633,1,28162044,28162248,204,0.6949989984222416
11539,938.743733,938.846533,1,28162311,28165395,3084,0.6455390082702198
11540,938.847833,938.854567,1,28165434,28165637,203,0.6092923309536928
11541,938.861567,938.865167,1,28165847,28165955,108,0.35066400586097446
11542,938.868267,938.871567,1,28166048,28166147,99,-0.04301544669181384
11543,938.876033,938.8811,1,28166280,28166433,153,-0.3636287652499848
11544,938.8822,938.8977,1,28166466,28166931,465,-0.06063814819943748
11545,938.900867,938.9085,1,28167026,28167255,229,-0.016654482017575245
11546,938.9146,938.9177,1,28167438,28167531,93,
11547,938.925967,938.9312,1,28167779,28167936,157,0.055640145674314856
11548,938.933567,939.0279,1,28168007,28170837,2830,0.7895923726439195
11549,939.184133,939.191167,1,28175523,28175735,212,0.4065803200293539
11550,939.192867,939.264967,1,28175786,28177949,2163,0.8247262247859288
11551,939.2661,939.3449,1,28177983,28180347,2364,0.7951391306991866
11552,939.346167,939.352133,1,28180385,28180563,178,-0.015080434988418986
11553,939.3655,939.4486,1,28180965,28183458,2493,0.812889892833949
11554,940.089067,940.099,1,28202672,28202970,298,0.6868283853022303
11555,940.100167,940.1102,1,28203005,28203306,301,0.6706455047480686
11556,940.117467,940.127067,1,28203524,28203812,288,0.5391283716387266
11557,940.138333,940.160767,1,28204149,28204823,674,0.6227105226539867
11558,940.2146,940.2258,1,28206438,28206774,336,0.6351706846453782
11559,940.349,940.368733,1,28210470,28211061,591,0.5544996907699142
11560,940.370067,940.3792,1,28211102,28211376,274,0.32408319440614924
11561,940.417933,940.4285,1,28212537,28212855,318,0.7051161326399167
11562,940.429567,940.4351,1,28212887,28213053,166,0.5786885224468765
11563,940.506567,940.5162,1,28215197,28215486,289,-0.08536393384890117
11564,940.520367,940.538833,1,28215611,28216164,553,0.45599572827702656
11565,940.550767,940.572167,1,28216523,28217165,642,0.03516789812893076
11566,940.573267,940.585067,1,28217198,28217552,354,-0.091914069680744
11567,940.588833,940.657233,1,28217664,28219716,2052,0.8123094766432876
11568,940.6587,940.792533,1,28219761,28223775,4014,0.812847858265289
11569,940.7978,940.8012,1,28223934,28224036,102,0.6616832042291536
11570,940.811867,940.815033,1,28224356,28224450,94,-0.037059497046196814
11571,940.989633,940.992967,1,28229688,28229789,101,
11572,941.003233,941.034667,1,28230096,28231040,944,0.3844394606340193
11573,941.0448,941.0699,1,28231344,28232097,753,0.07744621189609713
11574,941.071633,941.087533,1,28232148,28232625,477,0.16805790792397876
11575,941.089367,941.101533,1,28232681,28233045,364,0.04732773927573293
11576,941.155633,941.1735,1,28234668,28235205,537,0.4918475343703054
11577,941.180267,941.202067,1,28235408,28236062,654,0.3863722513805879
11578,941.212667,941.2523,1,28236380,28237569,1189,0.07332392133347528
11579,941.258567,941.281,1,28237757,28238430,673,0.19532329695530976
11580,941.301367,941.315667,1,28239041,28239470,429,0.6999146534088495
11581,941.3305,941.349733,1,28239915,28240491,576,0.7465079511356205
11582,941.3587,941.393533,1,28240761,28241805,1044,0.6960900724342258
11583,941.4042,941.424733,1,28242126,28242741,615,0.6310092523513501
11584,941.427533,941.433333,1,28242825,28242999,174,0.2637684424376113
11585,941.442933,941.453433,1,28243287,28243602,315,0.7197492418003041
11586,941.490667,941.509233,1,28244720,28245276,556,0.6270158159529815
11587,941.535467,941.541233,1,28246064,28246236,172,0.5558536734559777
11588,941.5484,941.5534,1,28246452,28246602,150,0.35879991244125786
11589,941.5566,941.576,1,28246698,28247280,582,0.6319819090241124
11590,941.5978,941.6146,1,28247934,28248438,504,0.47157821166347536
11591,941.630233,941.633267,1,28248906,28248998,92,0.4826341604141523
11592,941.6667,941.682533,1,28250001,28250475,474,0.667149849153731
11593,941.707567,941.7192,1,28251227,28251576,349,0.5399150038777895
11594,941.7252,941.7328,1,28251756,28251984,228,0.5009535040346795
11595,941.8416,941.9198,1,28255248,28257594,2346,0.7479232804035637
11596,941.926333,942.076067,1,28257789,28262282,4493,0.42593335224824763
11597,942.137233,942.155967,1,28264116,28264679,563,0.7422787151762607
11598,942.1623,942.192967,1,28264869,28265789,920,0.765813034824257
11599,942.205067,942.248233,1,28266152,28267446,1294,0.7480711685516978
11600,942.2516,942.254733,1,28267548,28267641,93,0.6860887013745466
11601,942.2569,942.3196,1,28267707,28269588,1881,0.7416353521758992
11602,942.3219,942.355533,1,28269657,28270665,1008,0.6213684414867275
11603,942.368267,942.388267,1,28271048,28271648,600,0.6970064991274558
11604,942.3893,942.402067,1,28271679,28272062,383,0.4400135412425691
11605,942.4233,942.4839,1,28272699,28274517,1818,0.14596137510953447
11606,942.4954,942.499433,1,28274862,28274982,120,0.06335734129443177
11607,942.506,942.5211,1,28275180,28275633,453,0.7855378286422131
11608,942.5254,942.654767,1,28275762,28279643,3881,0.8067150066451902
11609,942.658033,942.852833,1,28279740,28285584,5844,0.7713309428627361
11610,942.9031,942.907067,1,28287093,28287212,119,
11611,943.398567,943.4184,1,28301957,28302552,595,0.5757446693734287
11612,943.4767,943.486567,1,28304301,28304597,296,0.9359844723982971
11613,943.5429,943.567067,1,28306287,28307012,725,0.3923710041866976
11614,943.589933,943.595933,1,28307697,28307877,180,0.6359683336478447
11615,943.602633,943.606433,1,28308078,28308192,114,0.5620132570005928
11616,943.621833,943.629367,1,28308654,28308881,227,0.36438866355873456
11617,943.649833,943.6691,1,28309494,28310073,579,0.5736824094628925
11618,943.711333,943.719667,1,28311339,28311590,251,0.581717101956989
11619,943.721067,943.731533,1,28311632,28311945,313,0.5735101365875515
11620,943.771167,943.778767,1,28313135,28313363,228,0.41200628859577215
11621,943.807,943.8104,1,28314210,28314312,102,-0.16478269008413401
11622,943.815967,943.827067,1,28314479,28314812,333,0.2820041185585161
11623,943.838567,943.861333,1,28315157,28315839,682,-0.0962892987648181
11624,943.869133,943.878933,1,28316073,28316367,294,-0.00608913239209462
11625,943.8898,943.897633,1,28316694,28316928,234,0.17316736358460824
11626,943.959267,944.032467,1,28318778,28320974,2196,0.6917902157033132
11627,944.038133,944.059833,1,28321143,28321794,651,0.6861504711587862
11628,944.0782,944.088033,1,28322346,28322640,294,0.21364796940846173
11629,944.0896,944.154,1,28322688,28324620,1932,0.5827639562635452
11630,944.155633,944.215967,1,28324668,28326479,1811,0.17639386204575816
11631,944.217133,944.424233,1,28326513,28332726,6213,0.2560513934239144
11632,944.4303,944.448567,1,28332909,28333457,548,0.6120928878235334
11633,944.450767,944.4628,1,28333523,28333884,361,0.6808801947382914
11634,944.470133,944.496167,1,28334103,28334885,782,0.6405061211425641
11635,944.4977,944.5131,1,28334931,28335393,462,0.7181370897142825
11636,944.528867,944.543633,1,28335866,28336308,442,0.7162814528429671
11637,944.552033,944.560533,1,28336560,28336815,255,0.5027207926196043
11638,944.6991,944.703133,1,28340973,28341093,120,
11639,944.722467,944.736067,1,28341674,28342082,408,0.27810059367623713
11640,944.7397,944.752433,1,28342191,28342572,381,0.6521275193421624
11641,944.8035,944.8121,1,28344105,28344363,258,0.23900545525066935
11642,944.871,944.8741,1,28346130,28346223,93,
11643,944.8798,944.978833,1,28346394,28349364,2970,0.7902272648202623
11644,944.9808,944.984833,1,28349424,28349544,120,0.15127751386422741
11645,944.999433,945.015667,1,28349982,28350470,488,0.003734641175588191
11646,945.018667,945.0239,1,28350560,28350717,157,0.03776506874950779
11647,945.028867,945.041667,1,28350866,28351250,384,-0.03252485213368919
11648,945.046333,945.054233,1,28351389,28351626,237,-0.18770680209191995
11649,945.0837,945.103033,1,28352511,28353090,579,0.38690903010732197
11650,945.1054,945.1654,1,28353162,28354962,1800,0.10676476627934597
11651,945.1737,945.1946,1,28355211,28355838,627,0.09376812019078007
11652,945.204533,945.212267,1,28356135,28356368,233,-0.022766979403741904
11653,945.257067,945.336933,1,28357712,28360107,2395,0.7447070406500491
11654,945.347667,945.365633,1,28360430,28360968,538,0.7648346750704575
11655,945.383867,945.3907,1,28361516,28361721,205,0.6268747929105137
11656,945.530367,945.5411,1,28365911,28366233,322,0.3065049064309197
11657,945.543133,945.562,1,28366293,28366860,567,0.2675686192134454
11658,945.572233,945.635667,1,28367166,28369070,1904,0.18372157672805428
11659,945.6388,945.654133,1,28369164,28369623,459,0.15706155581702452
11660,945.655233,945.663467,1,28369656,28369904,248,0.24416989171698297
11661,945.675533,945.701667,1,28370265,28371050,785,0.6443865864034284
11662,945.7184,945.729367,1,28371552,28371881,329,0.8494282340062137
11663,945.7567,945.760733,1,28372701,28372821,120,0.3701513327284614
11664,945.7622,945.779833,1,28372866,28373394,528,0.7184707340183221
11665,945.787,945.808667,1,28373610,28374260,650,0.5997337821105906
11666,945.818367,945.8238,1,28374551,28374714,163,0.45613083158575657
11667,945.8387,945.843833,1,28375161,28375314,153,-0.29689086297251827
11668,945.8533,945.859833,1,28375599,28375794,195,0.7588598876847623
11669,945.8629,945.883,1,28375887,28376490,603,0.6727475586397519
11670,945.8899,945.897933,1,28376697,28376937,240,-0.009399332029190742
11671,945.9017,945.920033,1,28377051,28377600,549,0.4997796633931688
11672,945.921533,945.934567,1,28377645,28378037,392,0.7052019663873432
11673,945.940933,945.979833,1,28378227,28379394,1167,0.6576663574316879
11674,945.9818,946.0036,1,28379454,28380108,654,0.5999205922178954
11675,946.0251,946.033467,1,28380753,28381004,251,0.27784918284280574
11676,946.059833,946.0657,1,28381794,28381971,177,0.15986551813561348
11677,946.066767,946.07,1,28382003,28382100,97,
11678,946.0745,946.115933,1,28382235,28383477,1242,0.03958828553495348
11679,946.117633,946.141633,1,28383528,28384248,720,0.1906153669353979
11680,946.199933,946.202967,1,28385997,28386089,92,-0.05786531047112862
11681,946.220467,946.2275,1,28386614,28386825,211,0.08380111304594778
11682,946.229233,946.249067,1,28386876,28387472,596,0.6983568306463591
11683,946.251167,946.3488,1,28387535,28390464,2929,0.8302184805025289
11684,946.5346,946.5408,1,28396038,28396224,186,0.5395764762270797
11685,947.018967,947.030733,1,28410569,28410921,352,0.2276568922916001
11686,947.036733,947.136567,1,28411101,28414097,2996,0.7984098652494954
11687,947.163033,947.241767,1,28414890,28417253,2363,0.07800482528733813
11688,947.2782,947.288233,1,28418346,28418646,300,0.12143526970337709
11689,947.2919,947.312367,1,28418757,28419371,614,0.3881101392394438
11690,947.3134,947.321867,1,28419402,28419656,254,0.4276164335386284
11691,947.323467,947.363067,1,28419704,28420892,1188,0.17454220932028025
11692,947.3664,947.369933,1,28420992,28421097,105,
11693,947.384967,947.593,1,28421549,28427790,6241,0.837164103995945
11694,947.598367,947.670733,1,28427951,28430121,2170,0.701782821957453
11695,947.6777,947.704267,1,28430331,28431128,797,0.7336228479867354
11696,947.706067,947.722767,1,28431182,28431683,501,0.7119955742703145
11697,947.7526,947.776033,1,28432578,28433280,702,-0.002957046751662737
11698,947.784167,947.7916,1,28433525,28433748,223,0.06664228966421169
11699,947.893933,947.9781,1,28436817,28439343,2526,0.8025694358891315
11700,947.979133,948.033467,1,28439373,28441004,1631,0.8070506893359972
11701,948.063633,948.0753,1,28441908,28442259,351,0.49905534631297893
11702,948.084833,948.105533,1,28442544,28443165,621,0.028404633529572267
11703,948.108567,948.124333,1,28443257,28443729,472,0.059944973036141394
11704,948.1267,948.135033,1,28443801,28444050,249,0.17766791219467987
11705,948.252033,948.2754,1,28447560,28448262,702,0.7207587676874693
11706,948.276667,948.305567,1,28448300,28449167,867,0.7265132027917109
11707,948.306633,948.3632,1,28449198,28450896,1698,0.67101538287984
11708,948.3776,948.404467,1,28451328,28452134,806,0.7211771171346438
11709,948.413767,948.4696,1,28452413,28454088,1675,0.682016041176221
11710,948.485733,948.519733,1,28454571,28455591,1020,0.7447045798070397
11711,948.534567,948.542467,1,28456037,28456274,237,0.6011750893665202
11712,948.546567,948.569367,1,28456397,28457081,684,0.01122122014580617
11713,948.5705,948.6028,1,28457115,28458084,969,0.16924637331633824
11714,948.615033,948.622167,1,28458450,28458665,215,-0.02015231356993616
11715,948.6243,948.637733,1,28458729,28459131,402,0.697994792661613
11716,948.639367,948.8375,1,28459181,28465125,5944,0.7383494657216204
11717,948.842333,948.862233,1,28465269,28465866,597,0.711933662395952
11718,948.900233,948.903967,1,28467006,28467119,113,
11719,948.9651,949.007333,1,28468953,28470219,1266,0.5795646726361097
11720,949.0336,949.036833,1,28471008,28471104,96,0.38726371443980545
11721,949.2725,949.275867,1,28478175,28478276,101,0.8866642861535207
11722,949.277167,949.310533,1,28478315,28479315,1000,0.7694570850634392
11723,949.314133,949.3419,1,28479423,28480257,834,-0.04004978694960961
11724,949.358,949.392333,1,28480740,28481769,1029,0.8198756261535274
11725,949.3957,949.480033,1,28481871,28484400,2529,0.7308084965749212
11726,949.482767,949.488967,1,28484483,28484669,186,
11727,949.504933,949.523367,1,28485147,28485701,554,-0.040531958873168655
11728,949.530967,949.534167,1,28485929,28486025,96,
11729,949.5375,949.5425,1,28486125,28486275,150,0.5558857250708964
11730,949.6534,949.662867,1,28489602,28489886,284,0.6950727931836667
11731,949.664433,949.723967,1,28489932,28491719,1787,0.539251612277256
11732,949.7387,949.742433,1,28492161,28492272,111,-0.09941386678197671
11733,949.754467,949.7654,1,28492634,28492962,328,0.19202765958968443
11734,949.771733,949.775367,1,28493151,28493261,110,0.5760216493874591
11735,949.8233,949.892267,1,28494699,28496768,2069,0.513800780790385
11736,949.893533,949.8985,1,28496805,28496955,150,0.5590767637112899
11737,949.904733,949.927567,1,28497141,28497827,686,0.743382133725089
11738,949.9588,949.988233,1,28498764,28499646,882,0.7274556110051681
11739,950.003967,950.059167,1,28500119,28501775,1656,0.46171586325937225
11740,950.066433,950.0811,1,28501992,28502433,441,0.3969550904097052
11741,950.091767,950.188333,1,28502753,28505649,2896,0.3016817382260908
11742,950.193333,950.202733,1,28505799,28506081,282,-0.08843000050464525
11743,950.210967,950.214567,1,28506329,28506437,108,-0.10437438620611904
11744,950.215767,950.225333,1,28506473,28506759,286,-0.09165720967656453
11745,950.294167,950.304967,1,28508825,28509149,324,0.3880467539324695
11746,950.3073,950.3336,1,28509219,28510008,789,0.2317440436935985
11747,950.3412,950.3858,1,28510236,28511574,1338,0.02404261112905821
11748,950.3868,950.391733,1,28511604,28511751,147,0.04129237280311543
11749,950.417,950.490167,1,28512510,28514705,2195,0.7966462281442247
11750,950.493,950.500267,1,28514790,28515008,218,0.7335848620522658
11751,950.502033,950.509867,1,28515060,28515296,236,0.841352186680309
11752,950.512233,950.564033,1,28515366,28516920,1554,0.7736358044695196
11753,950.5653,950.623933,1,28516959,28518717,1758,0.7497651191999786
11754,950.6468,950.653067,1,28519404,28519592,188,-0.18571119223742868
11755,950.666233,950.676367,1,28519986,28520291,305,0.48291680056150127
11756,950.681767,950.687333,1,28520453,28520619,166,-0.17532868790010578
11757,950.6889,950.721433,1,28520667,28521642,975,-0.03203934426450989
11758,950.7261,950.733633,1,28521783,28522008,225,0.06346502413636852
11759,950.748633,950.751667,1,28522458,28522550,92,0.04992312259752174
11760,950.783567,950.7885,1,28523507,28523655,148,0.12361037044730215
11761,950.8073,950.8128,1,28524219,28524384,165,0.4683807048317826
11762,950.8194,950.871867,1,28524582,28526156,1574,0.7493402204302094
11763,950.8736,950.979833,1,28526208,28529394,3186,0.6643510481188686
11764,950.9877,951.0465,1,28529631,28531395,1764,0.44795553714478803
11765,951.058267,951.079067,1,28531748,28532372,624,0.4714387718721504
11766,951.0838,951.116167,1,28532514,28533485,971,0.4854061474123129
11767,951.121233,951.1497,1,28533636,28534491,855,0.21230785128330792
11768,951.1518,951.286033,1,28534554,28538580,4026,0.26244549700576636
11769,951.329333,951.3325,1,28539879,28539975,96,0.09873693919336463
11770,951.3376,951.341433,1,28540128,28540242,114,0.21949227551305336
11771,951.580067,951.583333,1,28547402,28547499,97,
11772,952.039833,952.058333,1,28561194,28561749,555,0.5271637932219077
11773,952.060967,952.075267,1,28561829,28562258,429,0.4144430386429278
11774,952.128667,952.139233,1,28563860,28564176,316,0.67844130242156
11775,952.1632,952.168667,1,28564896,28565060,164,0.41919083862171447
11776,952.171233,952.1897,1,28565136,28565691,555,0.6247685505443776
11777,952.2423,952.2473,1,28567269,28567419,150,0.395425804086642
11778,952.251,952.260367,1,28567530,28567811,281,0.6933874099364958
11779,952.389367,952.393633,1,28571681,28571808,127,0.484168138674762
11780,952.403667,952.488967,1,28572110,28574669,2559,0.7313058870361349
11781,952.491633,952.525767,1,28574748,28575773,1025,0.8814534627959036
11782,952.547167,952.722933,1,28576415,28581687,5272,0.7723820045825149
11783,952.7266,952.741867,1,28581798,28582256,458,0.7529011249591226
11784,952.746833,952.764767,1,28582404,28582943,539,0.652335813961892
11785,953.062733,953.284033,1,28591881,28598520,6639,0.7660417186825188
11786,953.326267,953.329567,1,28599788,28599887,99,
11787,953.334033,953.338833,1,28600020,28600164,144,0.6760829045769601
11788,953.612,953.627133,1,28608360,28608813,453,0.8643548799545436
11789,953.6293,953.725133,1,28608879,28611753,2874,0.8035713415234503
11790,954.037733,954.130833,1,28621131,28623924,2793,0.7629467554050807
11791,954.138367,954.258767,1,28624151,28627763,3612,0.695356297789475
11792,954.260533,954.290433,1,28627815,28628712,897,0.754654435612469
11793,954.305933,954.401533,1,28629177,28632045,2868,0.7834956325190542
11794,954.403333,954.415167,1,28632099,28632455,356,0.36956689099048606
11795,954.4383,954.441667,1,28633149,28633250,101,0.8502860614583646
11796,954.860233,954.868867,1,28645806,28646066,260,0.28759126955404785
11797,954.870533,954.9578,1,28646115,28648734,2619,0.8217277115489318
11798,954.960733,954.969933,1,28648821,28649097,276,0.7099481493950228
11799,954.972633,955.014933,1,28649178,28650447,1269,0.8855266729120198
11800,955.045767,955.095,1,28651373,28652850,1477,0.6992091054605448
11801,955.097067,955.1604,1,28652912,28654812,1900,0.795060193424508
11802,955.184833,955.189933,1,28655544,28655697,153,0.25125743063703226
11803,955.323967,955.331167,1,28659719,28659935,216,0.32593442810146517
11804,955.519967,955.7005,1,28665599,28671015,5416,0.8166347061731216
11805,955.708433,955.7329,1,28671252,28671987,735,0.7860849471152344
11806,955.736833,955.777367,1,28672104,28673321,1217,0.755583805504061
11807,955.7947,955.877467,1,28673841,28676324,2483,0.7913033783391051
11808,955.9047,955.980633,1,28677141,28679418,2277,0.8047946226538955
11809,955.996333,956.001633,1,28679889,28680048,159,-0.052037159942260526
11810,956.008767,956.011967,1,28680263,28680359,96,
11811,956.013033,956.017033,1,28680390,28680510,120,0.2572572159285274
11812,956.022267,956.026133,1,28680668,28680783,115,0.34549619478816684
11813,956.2835,956.402033,1,28688505,28692060,3555,0.7994660567362496
11814,956.797967,956.8766,1,28703939,28706298,2359,0.7334199982056611
11815,956.889933,956.893567,1,28706697,28706807,110,0.7807515403055524
11816,956.896367,957.020133,1,28706891,28710603,3712,0.7747926626687048
11817,957.4955,957.508433,1,28724865,28725252,387,0.561754384747789
11818,957.513,957.539133,1,28725390,28726173,783,0.719910521762161
11819,957.5507,957.570767,1,28726521,28727123,602,0.8350387093068541
11820,957.579033,957.6083,1,28727370,28728249,879,0.8427513596694665
11821,957.6211,957.6361,1,28728633,28729083,450,0.8766182870691194
11822,957.645833,957.6844,1,28729374,28730532,1158,0.7432345730939954
11823,957.6854,957.694467,1,28730562,28730834,272,0.7159282886930377
11824,957.703167,957.724267,1,28731095,28731728,633,0.8312218693519047
11825,957.727267,957.7347,1,28731818,28732041,223,0.639775104102119
11826,957.766267,957.8276,1,28732988,28734828,1840,0.8052011639974633
11827,957.829733,957.8342,1,28734891,28735026,135,0.45746481510995407
11828,957.849,957.8527,1,28735470,28735581,111,-0.31812209049218976
11829,957.854367,957.889267,1,28735631,28736678,1047,0.7225335154766841
11830,957.959033,957.9802,1,28738770,28739406,636,0.6293070187008922
11831,957.981733,958.005233,1,28739451,28740156,705,0.6588994237999215
11832,958.0177,958.0879,1,28740531,28742637,2106,0.8031420240818983
11833,958.0944,958.101167,1,28742832,28743035,203,0.2558315195812938
11834,959.4027,959.516767,1,28782081,28785503,3422,0.7446957508145335
11835,959.798633,959.809233,1,28793958,28794276,318,0.7194310731031919
11836,959.8114,959.8193,1,28794342,28794579,237,0.5226698104737684
11837,959.820367,959.826667,1,28794611,28794800,189,0.09081126742053867
11838,959.8316,959.925833,1,28794948,28797774,2826,0.6922534753310279
11839,959.941267,959.946267,1,28798238,28798388,150,-0.03920515195905325
11840,959.9484,960.042567,1,28798452,28801277,2825,0.8237543626680169
11841,960.0537,960.061767,1,28801611,28801853,242,0.419038007076603
11842,960.0678,960.071133,1,28802034,28802133,99,
11843,960.486767,960.5008,1,28814603,28815024,421,0.47311142798748573
11844,960.506333,960.516933,1,28815189,28815507,318,0.36463112697326383
11845,960.518,960.5246,1,28815540,28815738,198,0.13006331826536457
11846,960.550167,960.5691,1,28816505,28817073,568,0.7937446977963719
11847,960.607833,960.627067,1,28818234,28818812,578,0.5709459601783622
11848,960.682767,960.695167,1,28820483,28820855,372,0.45940835392964535
11849,960.720467,960.733067,1,28821614,28821992,378,0.4792754013338457
11850,960.789,960.795,1,28823670,28823850,180,0.6440488584068145
11851,960.7971,960.8077,1,28823913,28824231,318,0.6646308893169391
11852,960.844933,960.848633,1,28825347,28825458,111,0.40128843749877713
11853,960.977067,961.0863,1,28829312,28832589,3277,0.7534583963172591
11854,961.098267,961.160333,1,28832948,28834809,1861,0.8085992607062022
11855,961.181867,961.2635,1,28835456,28837905,2449,0.7789782410110959
11856,961.280867,961.371167,1,28838426,28841135,2709,0.7975118230453186
11857,961.380567,961.3896,1,28841417,28841688,271,0.3524696903558302
11858,961.391367,961.396433,1,28841741,28841892,151,0.4360806138774989
11859,961.772233,961.972167,1,28853166,28859165,5999,0.7702840003706681
11860,961.973667,962.0019,1,28859210,28860057,847,0.7112333558781071
11861,962.0029,962.090433,1,28860087,28862712,2625,0.7956908310640208
11862,962.1157,962.125733,1,28863471,28863771,300,0.0005415001204620418
11863,962.127433,962.1305,1,28863822,28863915,93,-0.05640072995594751
11864,962.1548,962.164,1,28864644,28864920,276,0.5385128998674625
11865,962.166867,962.179667,1,28865006,28865390,384,0.7055894812025418
11866,962.190367,962.2874,1,28865711,28868622,2911,0.7693107665869299
11867,962.290233,962.301833,1,28868706,28869054,348,0.16211474744536863
11868,962.3172,962.323767,1,28869516,28869713,197,0.1637445084275138
11869,962.5903,962.596967,1,28877709,28877909,200,0.5976842780847206
11870,962.598167,962.617667,1,28877945,28878530,585,0.7725586260649858
11871,962.618833,962.757333,1,28878564,28882719,4155,0.7131784212001954
11872,962.759133,962.767167,1,28882773,28883015,242,0.3313673362764603
11873,962.768233,962.8141,1,28883046,28884423,1377,0.6653332143968825
11874,962.841367,962.863033,1,28885241,28885890,649,0.7251932298649634
11875,962.867667,962.875233,1,28886030,28886256,226,0.5467665383590719
11876,962.877867,962.935267,1,28886336,28888058,1722,0.6287411807105765
11877,962.936333,962.942667,1,28888089,28888280,191,0.6466117642977083
11878,962.952533,963.037467,1,28888575,28891124,2549,0.7153675592044856
11879,963.043767,963.048167,1,28891313,28891445,132,0.2780580904920675
11880,963.090467,963.182967,1,28892714,28895489,2775,0.7967144290592783
11881,963.211267,963.214467,1,28896338,28896434,96,
11882,963.415,963.418333,1,28902450,28902549,99,
11883,963.421667,963.493267,1,28902650,28904798,2148,0.744008514955225
11884,963.4943,963.535133,1,28904829,28906053,1224,0.7617275173710987
11885,963.555233,963.698533,1,28906656,28910955,4299,0.7661126033102321
11886,963.9969,964.061067,1,28919907,28921832,1925,0.7658167137172687
11887,964.458767,964.558067,1,28933763,28936742,2979,0.8102855454603867
11888,964.830333,964.948633,1,28944909,28948458,3549,0.7913623020702705
11889,965.253333,965.2579,1,28957599,28957737,138,0.6877283564805813
11890,965.259367,965.267567,1,28957781,28958027,246,0.6346918054129261
11891,965.289567,965.389333,1,28958687,28961679,2992,0.8080600365555449
11892,965.750033,965.765333,1,28972500,28972959,459,0.5821198549063588
11893,965.823333,965.8396,1,28974699,28975188,489,0.6943998708150446
11894,965.869833,965.8773,1,28976094,28976319,225,0.31385178251016177
11895,965.8798,965.895567,1,28976394,28976867,473,0.570661123012875
11896,965.9122,965.918667,1,28977366,28977560,194,0.5023869929179369
11897,965.9549,965.961567,1,28978647,28978847,200,0.6260510022607735
11898,965.967367,965.9846,1,28979021,28979538,517,0.6173851087653811
11899,966.003033,966.017467,1,28980090,28980524,434,0.48320311679294986
11900,966.072267,966.086667,1,28982168,28982600,432,0.6800970454246544
11901,966.108667,966.143233,1,28983260,28984296,1036,0.6878138885122229
11902,966.144833,966.1491,1,28984344,28984473,129,0.23494700889830342
11903,966.157567,966.163133,1,28984727,28984893,166,0.028461853974424238
11904,966.176267,966.212933,1,28985288,28986387,1099,0.06284591320966518
11905,966.241633,966.2583,1,28987248,28987749,501,0.7112115220168651
11906,966.2597,966.352633,1,28987791,28990578,2787,0.8091739068064331
11907,967.137967,967.1415,1,29014139,29014245,106,0.3695876020200669
11908,967.143233,967.149567,1,29014296,29014487,191,0.5633386645283035
11909,967.158333,967.172267,1,29014749,29015168,419,0.7155488728157073
11910,967.214133,967.225,1,29016423,29016750,327,0.8622323384124526
11911,967.2541,967.267,1,29017623,29018010,387,0.7207779010031826
11912,967.284133,967.3262,1,29018523,29019786,1263,0.58306027872945
11913,967.3526,967.365567,1,29020578,29020967,389,0.5563707387269725
11914,967.502433,967.622133,1,29025072,29028663,3591,0.7962977159225016
11915,968.084633,968.090267,1,29042538,29042708,170,0.6626754517750931
11916,968.091833,968.120033,1,29042754,29043600,846,0.7293886432183629
11917,968.1216,968.1831,1,29043648,29045493,1845,0.7804140687196895
11918,968.188033,968.243767,1,29045640,29047313,1673,0.7326955366369132
11919,968.249233,968.332633,1,29047476,29049978,2502,0.7334392803845452
11920,968.337067,968.363267,1,29050112,29050898,786,0.7286773856747174
11921,968.367567,968.3852,1,29051027,29051556,529,0.5914943642914504
11922,968.655833,968.661533,1,29059674,29059845,171,0.478058214396215
11923,968.670067,968.721067,1,29060102,29061632,1530,0.8168554142346675
11924,968.727067,968.744167,1,29061812,29062325,513,0.7964949802869093
11925,968.7461,968.803867,1,29062383,29064116,1733,0.8055188600151646
11926,968.819467,968.932767,1,29064584,29067983,3399,0.804789704202312
11927,968.944367,969.1992,1,29068331,29075976,7645,0.7225322421325507
11928,969.217167,969.220867,1,29076515,29076626,111,-0.13492914366224654
11929,969.301667,969.39,1,29079050,29081700,2650,0.8412578374853849
11930,969.4005,969.4062,1,29082015,29082186,171,-0.18227975894838488
11931,969.893567,969.902533,1,29096807,29097075,268,0.8349724134017846
11932,969.9232,969.927067,1,29097696,29097812,116,-0.4307821986081831
11933,970.016833,970.031667,1,29100504,29100950,446,0.5613236873643412
11934,970.090467,970.101233,1,29102714,29103036,322,0.5655395377675122
11935,970.1272,970.131633,1,29103816,29103948,132,0.45941935736629397
11936,970.1369,970.149667,1,29104107,29104490,383,0.5785125351576691
11937,970.217,970.220867,1,29106510,29106626,116,0.09941410704175295
11938,970.269533,970.3821,1,29108085,29111463,3378,0.7892598757002682
11939,970.613767,970.779067,1,29118413,29123372,4959,0.7753132554686804
11940,970.780133,970.785367,1,29123403,29123561,158,-0.3048640562588336
11941,970.7975,970.9159,1,29123925,29127477,3552,0.7648071774045009
11942,971.190633,971.215433,1,29135718,29136462,744,0.7346912104752277
11943,971.4929,971.530067,1,29144787,29145902,1115,0.6916395235937343
11944,971.533933,971.557933,1,29146017,29146737,720,0.41415871629210965
11945,971.5801,971.683667,1,29147403,29150510,3107,0.7540799772122936
11946,971.690067,971.764733,1,29150702,29152941,2239,0.6888679876867102
11947,971.774133,971.777867,1,29153223,29153336,113,0.6297303746777391
11948,971.788267,971.8139,1,29153648,29154417,769,0.7294457570284176
11949,971.836733,971.878433,1,29155101,29156352,1251,0.0029338081259313387
11950,971.884933,971.891633,1,29156547,29156748,201,0.2028872287705674
11951,971.8992,971.905467,1,29156976,29157164,188,0.6940143684659077
11952,971.906633,971.9846,1,29157198,29159538,2340,0.8087865279100591
11953,971.989633,972.134367,1,29159688,29164031,4343,0.7858645652485359
11954,972.1402,972.144367,1,29164206,29164331,125,0.21554419232917194
11955,972.146667,972.15,1,29164400,29164500,100,-0.14959414584578123
11956,972.151567,972.161133,1,29164547,29164833,286,0.0017324006598117515
11957,972.174067,972.180067,1,29165222,29165402,180,0.20897292785355856
11958,972.1867,972.192133,1,29165601,29165763,162,
11959,972.369333,972.428933,1,29171079,29172867,1788,0.8053720273868837
11960,972.430567,972.434233,1,29172917,29173026,109,
11961,972.435667,972.479067,1,29173070,29174372,1302,0.7922746914835311
11962,972.495167,972.502833,1,29174855,29175084,229,-0.12313824448573844
11963,972.5107,972.522233,1,29175321,29175666,345,0.14431646239903234
11964,972.527167,972.536967,1,29175815,29176109,294,0.06838218651019976
11965,972.540467,972.545567,1,29176214,29176367,153,0.4814059686695092
11966,972.8019,972.805067,1,29184057,29184152,95,-0.08568134191765861
11967,972.809567,972.918733,1,29184287,29187561,3274,0.8209143413982347
11968,972.9206,972.9236,1,29187618,29187708,90,0.4047394595326246
11969,973.594267,973.605567,1,29207828,29208167,339,0.5601995695313198
11970,973.6114,973.630767,1,29208342,29208923,581,0.5399051380414638
11971,973.699867,973.713467,1,29210996,29211404,408,0.6816447471829127
11972,973.717833,973.731967,1,29211534,29211959,425,0.5214640492450289
11973,973.767867,973.7837,1,29213036,29213511,475,0.46572691766708296
11974,973.871667,973.883933,1,29216150,29216517,367,0.5202256396075059
11975,973.941467,973.946967,1,29218244,29218409,165,0.4690424173122468
11976,973.9505,973.9586,1,29218515,29218758,243,0.633338706138872
11977,973.994833,974.006233,1,29219844,29220186,342,0.5554107135568686
11978,974.1639,974.1672,1,29224917,29225016,99,0.5769206714640701
11979,974.1685,974.173067,1,29225055,29225192,137,0.267152485208908
11980,974.180833,974.2798,1,29225424,29228394,2970,0.7782921810838037
11981,974.283667,974.2968,1,29228510,29228904,394,0.3340817128634041
11982,974.301233,974.305033,1,29229036,29229150,114,
11983,974.325933,974.331067,1,29229777,29229932,155,
11984,974.3345,974.339867,1,29230035,29230196,161,0.26178743354539297
11985,974.348733,974.4954,1,29230461,29234862,4401,0.8103879025219992
11986,974.765133,974.830167,1,29242953,29244905,1952,0.7657875296533702
11987,974.832867,974.920433,1,29244986,29247612,2626,0.7368774405832791
11988,974.922867,974.979867,1,29247686,29249396,1710,0.7726082446207473
11989,975.008233,975.018167,1,29250246,29250545,299,0.7258627427406118
11990,975.0368,975.0977,1,29251104,29252931,1827,0.809423233004789
11991,975.101567,975.1145,1,29253047,29253435,388,0.7518181251631821
11992,975.1274,975.209867,1,29253822,29256296,2474,0.8175413083747077
11993,975.238433,975.244967,1,29257152,29257349,197,0.10019292909926292
11994,975.250367,975.2563,1,29257511,29257689,178,0.28503328393063954
11995,975.586233,975.6214,1,29267586,29268642,1056,0.4628856002177975
11996,975.6403,975.659067,1,29269209,29269772,563,0.4763023605496095
11997,975.714467,975.7265,1,29271434,29271795,361,0.7765704765691954
11998,975.855,975.8768,1,29275650,29276304,654,0.7791619653575056
11999,975.877967,975.885567,1,29276339,29276567,228,0.6380022891107658
12000,975.887033,975.962233,1,29276610,29278866,2256,0.7717359027179631
12001,975.963333,976.0346,1,29278899,29281038,2139,0.7340047010845381
12002,976.057,976.130233,1,29281710,29283906,2196,0.728707644961828
12003,976.132333,976.2101,1,29283969,29286303,2334,0.7842944721741822
12004,976.215733,976.231933,1,29286471,29286957,486,0.6889451141840536
12005,976.241567,976.307967,1,29287247,29289239,1992,0.7924754511120305
12006,976.341033,976.3478,1,29290230,29290434,204,
12007,976.3515,976.3607,1,29290545,29290821,276,0.38963671787127807
12008,976.682367,976.721567,1,29300471,29301647,1176,0.6576174349160718
12009,976.722767,976.826867,1,29301683,29304806,3123,0.760729625792316
12010,976.840433,977.0031,1,29305212,29310093,4881,0.7536150116684717
12011,977.005967,977.009267,1,29310179,29310278,99,0.2358794350597322
12012,977.550467,977.555067,1,29326514,29326652,138,0.718457387312805
12013,977.5812,977.6201,1,29327436,29328603,1167,0.7245478428775904
12014,977.649467,977.6661,1,29329484,29329983,499,0.7079427771251223
12015,977.6674,977.672533,1,29330022,29330175,153,-0.0211349021537583
12016,977.6827,977.722967,1,29330481,29331689,1208,0.667988632744599
12017,977.747667,977.756767,1,29332430,29332703,273,0.6736197380197403
12018,977.760667,977.767567,1,29332820,29333027,207,0.5749679749803579
12019,977.813667,977.820167,1,29334410,29334605,195,0.6145437322993378
12020,977.828067,977.850867,1,29334842,29335526,684,0.040693856679651114
12021,977.8533,977.859933,1,29335599,29335797,198,0.44118881883866556
12022,977.874633,977.992067,1,29336238,29339762,3524,0.7843966199686268
12023,978.225333,978.401867,1,29346759,29352056,5297,0.8172295840944033
12024,978.4073,978.459867,1,29352219,29353796,1577,0.8250701436452691
12025,978.4714,978.476533,1,29354142,29354295,153,0.20456627894830054
12026,978.484867,978.5147,1,29354546,29355441,895,0.7577720714889175
12027,978.5367,978.646,1,29356101,29359380,3279,0.7809443472217079
12028,978.739333,978.874267,1,29362179,29366228,4049,0.795544753143218
12029,978.899933,979.025567,1,29366997,29370767,3770,0.7245481781148098
12030,979.029033,979.1143,1,29370870,29373429,2559,0.34847712613251547
12031,979.1407,979.1593,1,29374221,29374779,558,-0.011541667829808474
12032,979.161467,979.1695,1,29374844,29375085,241,-0.38185856549505987
12033,979.193967,979.308733,1,29375819,29379261,3442,0.7982373931820694
12034,979.912333,979.938333,1,29397369,29398149,780,0.6133840077384928
12035,979.966567,979.986033,1,29398997,29399580,583,0.5808912474139524
12036,979.99,979.993067,1,29399700,29399792,92,-0.2173124714775417
12037,980.222133,980.272433,1,29406663,29408172,1509,0.7087950488677173
12038,980.281133,980.363,1,29408433,29410890,2457,0.8274706485515947
12039,980.379067,980.382733,1,29411372,29411481,109,-0.025633826004484817
12040,980.3912,980.3944,1,29411736,29411832,96,0.47910222465021385
12041,980.832067,980.872333,1,29424962,29426169,1207,0.633454976369922
12042,980.879333,980.8915,1,29426379,29426745,366,0.4594229384286885
12043,980.893133,980.9075,1,29426793,29427225,432,0.5264968259216788
12044,980.908767,980.9331,1,29427263,29427993,730,0.6850813924342513
12045,981.113133,981.124267,1,29433393,29433728,335,0.772441625709229
12046,981.125267,981.216533,1,29433758,29436495,2737,0.7729611194047022
12047,981.488133,981.573333,1,29444643,29447199,2556,0.8069358946122198
12048,981.575267,981.707367,1,29447258,29451221,3963,0.7642837317615817
12049,981.7259,981.777667,1,29451777,29453330,1553,0.7519662022771914
12050,981.7873,981.8201,1,29453619,29454603,984,0.6862769879425943
12051,981.823967,981.828033,1,29454719,29454840,121,0.20976160838764843
12052,981.849,981.855533,1,29455470,29455665,195,-0.06615467742477754
12053,981.856967,981.880533,1,29455709,29456415,706,0.02942305798680683
12054,981.901967,981.905767,1,29457059,29457173,114,0.23125149603144726
12055,981.909267,982.072,1,29457278,29462160,4882,0.8449224734817657
12056,982.075533,982.154233,1,29462265,29464626,2361,0.7982993215004182
12057,982.1578,982.2051,1,29464734,29466153,1419,0.7392863484381931
12058,982.232867,982.238233,1,29466986,29467146,160,-0.1289133049049016
12059,982.240467,982.247667,1,29467214,29467430,216,-0.14442985851466902
12060,982.397033,982.401433,1,29471910,29472042,132,
12061,982.4102,982.570233,1,29472306,29477106,4800,0.8458634045705224
12062,982.573833,982.620367,1,29477214,29478611,1397,0.7882608060117838
12063,982.6478,982.6646,1,29479434,29479938,504,0.8173446659914727
12064,982.676667,982.727667,1,29480300,29481830,1530,0.7954272173835784
12065,982.7421,982.757833,1,29482263,29482734,471,0.7478504839128345
12066,982.761233,982.780733,1,29482836,29483421,585,0.7137620399012573
12067,982.8256,982.830733,1,29484768,29484921,153,-0.2152247700147244
12068,982.8398,982.848033,1,29485194,29485440,246,0.24326182813331104
12069,982.872367,982.991233,1,29486171,29489736,3565,0.6476241692456767
12070,983.019167,983.1132,1,29490575,29493396,2821,0.7966050920904547
12071,983.7374,983.741167,1,29512122,29512235,113,0.6558477133415073
12072,984.005233,984.037,1,29520156,29521110,954,0.6696070995969552
12073,984.0655,984.083733,1,29521965,29522511,546,0.7388198780078907
12074,984.085167,984.098967,1,29522555,29522969,414,0.6208411358098533
12075,984.119767,984.131633,1,29523593,29523948,355,0.3497904761898354
12076,984.1715,984.178967,1,29525145,29525369,224,0.06938241981932337
12077,984.186033,984.208633,1,29525580,29526258,678,0.21909278117864533
12078,984.2186,984.293033,1,29526558,29528790,2232,0.7781929534442045
12079,984.2958,984.299867,1,29528874,29528996,122,0.5169559531643604
12080,984.308333,984.315533,1,29529249,29529465,216,0.36426776757128415
12081,984.875367,984.912533,1,29546261,29547375,1114,0.5752917602819613
12082,984.9314,984.951667,1,29547942,29548550,608,0.6209589674494322
12083,984.9809,984.9893,1,29549427,29549679,252,0.584306253070815
12084,985.003933,985.015433,1,29550117,29550462,345,0.623125403093924
12085,985.1565,985.163533,1,29554695,29554905,210,0.03707476449843041
12086,985.166467,985.178267,1,29554994,29555348,354,0.6871902507580868
12087,985.180267,985.2192,1,29555408,29556576,1168,0.8592524907155319
12088,985.2242,985.2688,1,29556726,29558064,1338,0.8362728867166456
12089,985.2883,985.293167,1,29558649,29558795,146,
12090,985.303667,985.3135,1,29559110,29559405,295,0.15225594263889736
12091,985.3227,985.4435,1,29559681,29563305,3624,0.8670110156779623
12092,985.701233,985.728767,1,29571036,29571863,827,0.5650385982928264
12093,985.739167,985.7428,1,29572175,29572284,109,-0.12214113579362677
12094,985.747633,985.757767,1,29572428,29572733,305,0.7112551713834986
12095,985.828067,985.833233,1,29574842,29574996,154,0.2990403426720067
12096,985.8395,986.1525,1,29575185,29584575,9390,0.7482867525426443
12097,986.170867,986.1768,1,29585126,29585304,178,-0.10501126669541186
12098,986.828767,986.855033,1,29604863,29605650,787,0.600870812401883
12099,986.866133,986.884433,1,29605983,29606532,549,0.5334932756584324
12100,986.8879,986.915033,1,29606637,29607450,813,0.8025801690005546
12101,986.935433,986.984033,1,29608062,29609520,1458,0.5994543986538963
12102,986.985067,986.989867,1,29609552,29609696,144,0.6684939086190121
12103,987.011233,987.076333,1,29610336,29612289,1953,0.6866734298017231
12104,987.0958,987.104233,1,29612874,29613126,252,0.530142473847597
12105,987.1134,987.1383,1,29613402,29614149,747,0.666773600409109
12106,987.163767,987.209267,1,29614913,29616278,1365,-0.02622223525555741
12107,987.2185,987.477,1,29616555,29624310,7755,0.8063446986667001
12108,987.4973,987.5074,1,29624919,29625222,303,-0.030581528879833866
12109,987.508967,987.512767,1,29625269,29625383,114,0.08439750897241857
12110,987.599267,987.604167,1,29627978,29628125,147,-0.024961401176813607
12111,987.6101,987.7126,1,29628303,29631378,3075,0.43877639945214447
12112,987.730267,987.7375,1,29631908,29632125,217,-0.06474005437064678
12113,987.7752,987.7754,1,29633256,29633262,6,
12114,987.787467,987.953867,1,29633624,29638616,4992,0.8143462381023603
12115,987.996233,988.002433,1,29639886,29640072,186,0.7197420540044591
12116,988.172867,988.180767,1,29645186,29645423,237,0.1047247654876833
12117,988.188767,988.215267,1,29645663,29646458,795,0.7020236112249909
12118,988.217067,988.223267,1,29646512,29646698,186,0.11625965198966698
12119,988.528867,988.549167,1,29655866,29656475,609,0.6840133789956344
12120,988.554133,988.557367,1,29656623,29656721,98,
12121,988.559967,988.563433,1,29656799,29656902,103,
12122,989.151767,989.171733,1,29674553,29675151,598,0.4047609577193739
12123,989.1728,989.1777,1,29675184,29675331,147,0.4396485017635046
12124,989.179033,989.1831,1,29675370,29675493,123,0.14789722791380636
12125,989.2117,989.228567,1,29676351,29676857,506,0.3135697146214265
12126,989.372133,989.3853,1,29681163,29681559,396,0.5718472974821229
12127,989.389933,989.396667,1,29681697,29681900,203,0.045753339074571714
12128,989.436767,989.444133,1,29683103,29683323,220,0.6547482067710739
12129,989.446133,989.452467,1,29683383,29683574,191,0.5222022598938284
12130,989.5184,989.522767,1,29685552,29685683,131,0.6960461154815145
12131,989.527067,989.532467,1,29685812,29685974,162,-0.06785644482732171
12132,989.7098,989.8103,1,29691294,29694309,3015,0.8053699999559898
12133,989.815233,989.818233,1,29694456,29694546,90,0.35095362266451885
12134,989.8199,989.827633,1,29694597,29694828,231,0.0458698339359472
12135,990.068467,990.084533,1,29702054,29702535,481,0.7539884267542467
12136,990.085733,990.140767,1,29702571,29704223,1652,0.765860469097868
12137,990.142533,990.1698,1,29704275,29705094,819,0.8573938956964072
12138,990.1728,990.180667,1,29705184,29705420,236,0.22524027788212705
12139,990.191133,990.1949,1,29705733,29705847,114,-0.040239363938629584
12140,990.207233,990.235767,1,29706216,29707073,857,0.2648026351299286
12141,990.333,990.339633,1,29709990,29710188,198,0.7150472436297686
12142,990.353067,990.360133,1,29710592,29710803,211,0.562520115722864
12143,990.4915,990.519067,1,29714745,29715572,827,0.7707844158881741
12144,990.532533,990.548267,1,29715975,29716448,473,0.7108580494049627
12145,990.554,990.5805,1,29716620,29717415,795,0.6998821207272491
12146,990.585067,990.632367,1,29717552,29718971,1419,0.6840480090340529
12147,990.642633,990.6894,1,29719278,29720682,1404,0.6438886363893358
12148,990.6995,990.780233,1,29720985,29723406,2421,0.6786417517400576
12149,990.782967,990.7922,1,29723489,29723766,277,0.7431972096354313
12150,990.799067,990.836267,1,29723972,29725088,1116,0.7513491044398299
12151,990.851,990.864733,1,29725530,29725941,411,-0.09036981890526893
12152,990.8672,990.871667,1,29726016,29726150,134,-0.07124887832239438
12153,990.879633,990.8907,1,29726388,29726721,333,0.07318393957924348
12154,990.899667,990.905133,1,29726990,29727153,163,0.47770046670900596
12155,990.906833,991.150633,1,29727204,29734518,7314,0.7715098770700087
12156,991.152767,991.232867,1,29734583,29736986,2403,0.613783136366975
12157,991.2351,991.243333,1,29737053,29737299,246,0.5781452073594937
12158,991.259433,991.285367,1,29737782,29738561,779,0.13068688664036127
12159,991.288567,991.499867,1,29738657,29744996,6339,0.8110308385857361
12160,991.502967,991.5736,1,29745089,29747208,2119,0.7814482723921492
12161,991.5754,991.6192,1,29747262,29748576,1314,0.7815634032157678
12162,991.6224,991.715533,1,29748672,29751465,2793,0.823815582040276
12163,991.717067,991.7335,1,29751512,29752005,493,0.8479048105147307
12164,991.745733,991.819033,1,29752371,29754570,2199,0.8175922116746147
12165,991.820033,991.8385,1,29754600,29755155,555,0.8106334421549466
12166,991.839633,991.8533,1,29755188,29755599,411,0.7318103184774458
12167,991.868933,991.963433,1,29756067,29758902,2835,0.8251896740957624
12168,991.9645,991.9907,1,29758935,29759721,786,0.7641326927300727
12169,991.993467,992.087,1,29759804,29762610,2806,0.8246825453774855
12170,992.090767,992.1157,1,29762723,29763471,748,0.716438172379958
12171,992.119467,992.1761,1,29763584,29765283,1699,0.7916055434563957
12172,992.178967,992.209733,1,29765369,29766291,922,0.8097425239451674
12173,992.211233,992.217,1,29766336,29766510,174,0.31015337134775645
12174,992.220533,992.226267,1,29766615,29766788,173,0.9470801119803257
12175,992.244667,992.299,1,29767340,29768970,1630,0.5660090290556703
12176,992.3021,992.33,1,29769063,29769900,837,0.6535648208426559
12177,992.338133,992.3485,1,29770143,29770455,312,0.5803413746540101
12178,992.357367,992.425833,1,29770721,29772774,2053,0.7262240592305603
12179,992.4498,992.469567,1,29773494,29774087,593,-0.023954648058237143
12180,992.477433,992.4815,1,29774322,29774445,123,0.5846508035841822
12181,992.482533,992.4872,1,29774475,29774616,141,-0.2024667711895813
12182,992.698333,992.783567,1,29780949,29783507,2558,0.8172032853908077
12183,992.784933,992.7894,1,29783547,29783682,135,0.37798035136653235
12184,992.791,992.7948,1,29783730,29783844,114,0.1280089920700601
12185,993.0056,993.012633,1,29790168,29790378,210,0.27693938571183385
12186,993.014933,993.0189,1,29790447,29790567,120,0.06670532165101854
12187,993.020133,993.178767,1,29790603,29795363,4760,0.8461460135490492
12188,993.2044,993.2677,1,29796132,29798031,1899,0.8251593130254753
12189,993.284567,993.297733,1,29798537,29798931,394,0.0941422613265311
12190,993.310933,993.314267,1,29799327,29799428,101,
12191,993.812433,993.842933,1,29814372,29815287,915,0.5477545174405961
12192,993.909067,993.914867,1,29817272,29817446,174,0.6036933749214982
12193,994.118133,994.122467,1,29823543,29823674,131,-0.07640115193081135
12194,994.125767,994.2574,1,29823773,29827722,3949,0.8201155244068375
12195,994.269,994.343633,1,29828070,29830308,2238,0.7266860287705443
12196,994.345733,994.429433,1,29830371,29832882,2511,0.7386138894604
12197,994.431633,994.458467,1,29832948,29833754,806,0.6697307668132
12198,994.462467,994.5592,1,29833874,29836776,2902,0.72519036001811
12199,994.561,994.566833,1,29836830,29837004,174,
12200,994.578267,994.582767,1,29837348,29837483,135,0.1789658684754285
12201,994.593733,994.602567,1,29837811,29838077,266,0.18323937535741192
12202,994.6082,994.614767,1,29838246,29838443,197,0.17075102564989997
12203,994.666267,994.685333,1,29839988,29840559,571,0.5803714940319727
12204,994.7025,994.705533,1,29841075,29841165,90,
12205,994.935233,994.9407,1,29848056,29848221,165,0.6996836727980227
12206,994.946633,995.1639,1,29848398,29854917,6519,0.8088994242969252
12207,995.1774,995.310933,1,29855322,29859327,4005,0.7445358818037574
12208,995.691533,995.718667,1,29870745,29871560,815,0.794456661883917
12209,995.7362,995.8477,1,29872086,29875431,3345,0.7156542082307564
12210,995.855133,995.904633,1,29875653,29877138,1485,0.7183495272172961
12211,995.925,995.958633,1,29877750,29878758,1008,0.6759783788331482
12212,995.960933,995.9652,1,29878827,29878956,129,0.21929198505639233
12213,995.966733,996.026567,1,29879001,29880797,1796,0.24804411880982274
12214,996.039767,996.088733,1,29881193,29882661,1468,0.828441553679992
12215,996.099667,996.122267,1,29882990,29883668,678,0.6836964896602438
12216,996.138633,996.154233,1,29884158,29884626,468,0.011063010833810593
12217,996.155233,996.181767,1,29884656,29885453,797,0.011520251034866102
12218,996.209167,996.2239,1,29886275,29886717,442,0.7604341729719681
12219,996.225367,996.2636,1,29886761,29887908,1147,0.8179068269189008
12220,996.265233,996.3166,1,29887956,29889498,1542,0.8110550242308099
12221,996.329233,996.3501,1,29889876,29890503,627,0.07501334446289835
12222,996.351733,996.358567,1,29890551,29890757,206,-0.05078570328798895
12223,996.3776,996.4947,1,29891328,29894841,3513,0.8219791281678961
12224,996.5214,996.6079,1,29895642,29898237,2595,0.7955972411933468
12225,996.6391,996.642533,1,29899173,29899275,102,
12226,996.6438,996.647333,1,29899314,29899419,105,-0.04875057063961842
12227,997.488167,997.499467,1,29924645,29924984,339,0.6993327957191112
12228,997.507867,997.512333,1,29925236,29925369,133,0.36993991781514884
12229,997.560933,997.567833,1,29926827,29927034,207,0.843651335460269
12230,997.655133,997.6643,1,29929653,29929929,276,0.7259096673792594
12231,997.668233,997.673333,1,29930046,29930199,153,0.6309446883981729
12232,997.6993,997.723667,1,29930979,29931710,731,0.7083133189099238
12233,997.725933,997.743933,1,29931777,29932317,540,0.8930206809072199
12234,997.778867,997.789467,1,29933366,29933684,318,0.6920899124304392
12235,997.816767,997.826333,1,29934503,29934789,286,0.6675737946585454
12236,997.831433,997.843967,1,29934942,29935319,377,0.5535556507358452
12237,998.061933,998.266833,1,29941857,29948004,6147,0.8041323169233452
12238,998.3051,998.313933,1,29949153,29949417,264,0.04392987006913507
12239,998.3193,998.329733,1,29949579,29949891,312,0.10439236841193596
12240,998.333533,998.3423,1,29950005,29950269,264,-0.008821115810969659
12241,998.393267,998.4062,1,29951798,29952186,388,0.6952090108354299
12242,998.4074,998.444667,1,29952222,29953340,1118,0.8017332954503895
12243,998.445933,998.4517,1,29953377,29953551,174,0.8292322358567806
12244,998.455333,998.493967,1,29953659,29954819,1160,0.745618010897455
12245,998.5021,998.507133,1,29955063,29955213,150,-0.04046541054838223
12246,998.5083,998.5213,1,29955249,29955639,390,0.1067250452591636
12247,998.541233,998.548967,1,29956236,29956469,233,0.3502201750453912
12248,998.5551,998.563,1,29956653,29956890,237,0.6845103420855189
12249,998.602467,998.6266,1,29958074,29958798,724,0.5256394761559429
12250,998.643867,998.661133,1,29959316,29959833,517,0.6210581172873401
12251,998.6625,998.7276,1,29959875,29961828,1953,0.803878367062976
12252,998.758633,998.765733,1,29962758,29962971,213,-0.1075226963074117
12253,998.767133,998.7725,1,29963013,29963175,162,-0.07104074362683611
12254,999.779967,999.784933,1,29993399,29993547,148,0.5743957070541711
12255,999.8127,999.835533,1,29994381,29995065,684,0.8193530774742025
12256,999.860267,999.878867,1,29995808,29996366,558,0.8645408711793122
12257,999.886033,999.9029,1,29996580,29997087,507,0.734621552019398
12258,999.914667,999.963267,1,29997440,29998898,1458,0.7122561591011501
12259,999.973033,1000.0492,1,29999190,30001476,2286,0.6904173852262294
12260,1000.0611,1000.1002,1,30001833,30003006,1173,0.6725394691333694
12261,1000.1125,1000.116833,1,30003375,30003504,129,0.519455838055374
12262,1000.122433,1000.165667,1,30003672,30004970,1298,0.021001123095841012
12263,1000.1695,1000.1764,1,30005085,30005292,207,0.5455733432825007
12264,1000.398833,1000.425767,1,30011964,30012773,809,0.8001325366266027
12265,1000.428333,1000.526567,1,30012849,30015797,2948,0.7956680160790209
12266,1000.533233,1000.563233,1,30015996,30016896,900,0.7779646855605911
12267,1000.564533,1000.6632,1,30016935,30019896,2961,0.7658077438884343
12268,1000.6673,1000.686133,1,30020019,30020583,564,0.6612756885393505
12269,1000.6873,1000.710867,1,30020619,30021326,707,0.6234792519268653
12270,1000.713167,1000.738033,1,30021395,30022140,745,0.7753215538378732
12271,1000.742133,1000.798233,1,30022263,30023946,1683,0.7846458984627631
12272,1000.8111,1000.8436,1,30024333,30025308,975,0.6071092413073614
12273,1000.8751,1000.883333,1,30026253,30026499,246,-0.08867715350318969
12274,1001.1687,1001.172333,1,30035061,30035169,108,0.40064434376540814
12275,1001.176933,1001.335033,1,30035307,30040050,4743,0.8143529336838874
12276,1001.336733,1001.3471,1,30040101,30040413,312,0.09097810532426981
12277,1001.350133,1001.3732,1,30040503,30041196,693,0.7626188232257611
12278,1001.377433,1001.414367,1,30041322,30042431,1109,0.7347239981437514
12279,1001.4369,1001.4873,1,30043107,30044619,1512,0.5921708433100652
12280,1001.489967,1001.514067,1,30044699,30045422,723,0.29984068700513705
12281,1001.519467,1001.6035,1,30045584,30048105,2521,0.8066824845064964
12282,1001.604667,1001.632033,1,30048140,30048960,820,0.7402569830227497
12283,1001.648067,1001.733267,1,30049442,30051998,2556,0.8143732128412671
12284,1001.7449,1001.748333,1,30052347,30052449,102,-0.133640478595748
12285,1001.7524,1001.755667,1,30052572,30052670,98,
12286,1001.758933,1001.762733,1,30052767,30052881,114,
12287,1001.763867,1001.768333,1,30052916,30053049,133,
12288,1001.776433,1001.786967,1,30053292,30053609,317,0.2589286449623066
12289,1002.161433,1002.211767,1,30064842,30066353,1511,0.5670260893464134
12290,1002.2406,1002.259933,1,30067218,30067797,579,0.5068989944713336
12291,1002.2726,1002.288867,1,30068178,30068666,488,0.5337078530543987
12292,1002.289867,1002.293233,1,30068696,30068796,100,0.17010775325128852
12293,1002.295633,1002.316833,1,30068868,30069504,636,0.5375314247946608
12294,1002.359733,1002.379133,1,30070791,30071373,582,0.3913796588410162
12295,1002.402233,1002.412633,1,30072066,30072378,312,0.5254035613907146
12296,1002.419367,1002.425667,1,30072581,30072770,189,0.45846949043123175
12297,1002.458767,1002.462433,1,30073763,30073872,109,0.18511558367639752
12298,1002.474133,1002.504533,1,30074223,30075135,912,0.17232198331906545
12299,1002.5155,1002.5208,1,30075465,30075624,159,0.15926286900550138
12300,1002.5773,1002.6161,1,30077319,30078483,1164,0.6865385753829204
12301,1002.622533,1002.633833,1,30078675,30079014,339,0.7608508654232076
12302,1002.636033,1002.7751,1,30079080,30083253,4173,0.8128467201840192
12303,1002.791567,1002.795667,1,30083747,30083870,123,
12304,1002.799633,1002.807467,1,30083988,30084224,236,0.2656574868923475
12305,1003.027067,1003.0363,1,30090812,30091089,277,0.6546254966912372
12306,1003.041067,1003.1838,1,30091232,30095514,4282,0.8056965991768941
12307,1003.196167,1003.2003,1,30095885,30096009,124,0.4464039443281883
12308,1003.2013,1003.262,1,30096039,30097860,1821,0.6915883597841911
12309,1003.2654,1003.346733,1,30097962,30100401,2439,0.7653299582753441
12310,1003.3484,1003.354667,1,30100452,30100640,188,0.4171262780580671
12311,1003.366767,1003.371,1,30101003,30101130,127,0.3463498452921385
12312,1003.390533,1003.410767,1,30101715,30102323,608,-0.05678423704221507
12313,1003.413067,1003.442667,1,30102392,30103280,888,0.18215753466988527
12314,1003.4565,1003.465933,1,30103695,30103977,282,0.5251934059993002
12315,1003.470333,1003.636633,1,30104109,30109098,4989,0.8008972031194803
12316,1003.648033,1003.7836,1,30109440,30113508,4068,0.7534665429711287
12317,1003.817667,1003.828333,1,30114530,30114849,319,0.33083859642366276
12318,1003.8993,1003.932567,1,30116979,30117977,998,0.6205649570808712
12319,1003.933567,1004.0241,1,30118007,30120723,2716,0.8218731113440537
12320,1004.0411,1004.056367,1,30121233,30121691,458,0.005510150351567309
12321,1004.065533,1004.069233,1,30121965,30122076,111,
12322,1004.0768,1004.081933,1,30122304,30122457,153,0.4568718257609999
12323,1004.4563,1004.497867,1,30133689,30134936,1247,0.6304525173381632
12324,1004.508233,1004.5305,1,30135246,30135915,669,0.605144818697684
12325,1004.535533,1004.538567,1,30136065,30136157,92,0.3028576397519329
12326,1004.559033,1004.563133,1,30136770,30136893,123,0.7420412880042463
12327,1004.586867,1004.5946,1,30137606,30137838,232,0.7448218137227189
12328,1004.620733,1004.624833,1,30138621,30138744,123,-0.1322540348077925
12329,1004.626767,1004.632967,1,30138803,30138989,186,0.42414778605014214
12330,1004.656067,1004.660733,1,30139682,30139821,139,-0.6389055972095085
12331,1004.7424,1004.853033,1,30142272,30145590,3318,0.7280154233536901
12332,1004.860267,1004.866033,1,30145808,30145980,172,0.04516188068376678
12333,1004.872633,1004.877267,1,30146178,30146318,140,-0.11276779960948627
12334,1004.891333,1004.9166,1,30146739,30147498,759,0.10516007408813373
12335,1004.9258,1004.931,1,30147774,30147930,156,0.3523482987078855
12336,1004.953867,1005.1619,1,30148616,30154857,6241,0.7990039544665649
12337,1005.164167,1005.169867,1,30154925,30155096,171,0.48266483102785734
12338,1005.3805,1005.3866,1,30161415,30161598,183,-0.07588299373390983
12339,1005.396067,1005.450167,1,30161882,30163505,1623,0.7735922981649042
12340,1005.452367,1005.512,1,30163571,30165360,1789,0.8476443593839019
12341,1005.5189,1005.628933,1,30165567,30168867,3300,0.7800750108685086
12342,1005.643833,1005.723167,1,30169314,30171695,2381,0.7567763131103324
12343,1005.735333,1005.7571,1,30172059,30172713,654,-0.08612413968605008
12344,1005.763267,1005.781867,1,30172898,30173456,558,0.08732220912513505
12345,1005.803467,1005.9135,1,30174104,30177405,3301,0.8084681932820514
12346,1005.928767,1005.937367,1,30177863,30178121,258,0.05372735963504244
12347,1005.9387,1005.946233,1,30178161,30178386,225,0.1252969520313831
12348,1005.958533,1005.9624,1,30178755,30178872,117,0.06751523633907036
12349,1005.963633,1006.082633,1,30178908,30182478,3570,0.8640167788327068
12350,1006.434733,1006.441867,1,30193041,30193256,215,0.2858026157845247
12351,1006.445433,1006.473967,1,30193362,30194219,857,0.7031043482259565
12352,1006.705167,1006.7101,1,30201155,30201303,148,0.7087216503166829
12353,1006.7172,1006.737467,1,30201516,30202124,608,0.633156800178806
12354,1006.752233,1006.770733,1,30202566,30203121,555,0.7364774012579178
12355,1006.773867,1006.7907,1,30203216,30203721,505,0.8504378338408675
12356,1006.7984,1006.824733,1,30203952,30204741,789,0.8049700650839369
12357,1006.840567,1006.922467,1,30205217,30207674,2457,0.7392965268836755
12358,1006.9251,1006.953967,1,30207753,30208619,866,0.857566526233408
12359,1006.974133,1006.9818,1,30209223,30209454,231,0.45642916391675836
12360,1006.9832,1007.007533,1,30209496,30210225,729,0.11121111303900601
12361,1007.0148,1007.018433,1,30210444,30210552,108,
12362,1007.1791,1007.4338,1,30215373,30223014,7641,0.7538374347461041
12363,1007.452133,1007.4561,1,30223563,30223683,120,-0.1122186762267652
12364,1007.464767,1007.4678,1,30223943,30224034,91,-0.6283517458239289
12365,1007.953433,1007.959067,1,30238602,30238772,170,0.6853741815024886
12366,1007.9798,1007.987867,1,30239394,30239636,242,0.5049190140648004
12367,1008.003467,1008.011567,1,30240104,30240347,243,0.5936625400170031
12368,1008.019667,1008.023567,1,30240590,30240707,117,0.14809859317486268
12369,1008.0317,1008.051667,1,30240951,30241550,599,0.7201809845831704
12370,1008.079833,1008.1035,1,30242394,30243105,711,0.720920264544659
12371,1008.1357,1008.167533,1,30244071,30245025,954,0.651445136067501
12372,1008.179633,1008.184833,1,30245388,30245544,156,-0.00021960054064914874
12373,1008.186167,1008.230767,1,30245585,30246923,1338,0.5672834361744099
12374,1008.251367,1008.2707,1,30247541,30248121,580,0.5233280040949194
12375,1008.289067,1008.3034,1,30248672,30249102,430,0.6060181901504594
12376,1008.311367,1008.319833,1,30249341,30249594,253,0.4594693449639697
12377,1008.3649,1008.395933,1,30250947,30251877,930,-0.03501789371339183
12378,1008.3997,1008.4043,1,30251991,30252129,138,
12379,1008.4788,1008.494067,1,30254364,30254822,458,0.4103008212941975
12380,1008.495967,1008.526733,1,30254879,30255801,922,0.7915947221276506
12381,1008.540833,1008.5556,1,30256224,30256668,444,0.45140993888297415
12382,1008.5651,1008.576467,1,30256953,30257294,341,0.8360072332101711
12383,1008.592267,1008.596867,1,30257768,30257906,138,-0.21142998242729044
12384,1008.612767,1008.6181,1,30258383,30258543,160,-0.053130006539986036
12385,1008.629167,1008.6375,1,30258875,30259125,250,-0.214046729774723
12386,1008.648033,1008.651133,1,30259440,30259533,93,-0.404203759040058
12387,1008.716233,1008.836367,1,30261486,30265091,3605,0.8141994989021105
12388,1008.8526,1008.856367,1,30265578,30265691,113,-0.04285139018262422
12389,1008.8589,1008.8638,1,30265767,30265914,147,-0.07625737045709186
12390,1008.920233,1008.924167,1,30267606,30267725,119,0.1409931965587101
12391,1008.925533,1009.097,1,30267765,30272910,5145,0.8261994241953895
12392,1009.103467,1009.1109,1,30273104,30273327,223,0.7572171636775624
12393,1009.114933,1009.1819,1,30273447,30275457,2010,0.7478199872830069
12394,1009.200067,1009.2316,1,30276002,30276948,946,0.03385865822293158
12395,1009.237333,1009.2433,1,30277119,30277299,180,0.7028339655425516
12396,1009.2658,1009.285867,1,30277974,30278576,602,0.8319854851193714
12397,1009.2879,1009.3913,1,30278637,30281739,3102,0.7892512288987135
12398,1009.4031,1009.410333,1,30282093,30282309,216,0.8986203758421321
12399,1009.416667,1009.524367,1,30282500,30285731,3231,0.799100301240207
12400,1009.532067,1009.596367,1,30285962,30287891,1929,0.7457459048114243
12401,1009.611833,1009.6311,1,30288354,30288933,579,0.04690957854840347
12402,1009.632867,1009.643267,1,30288986,30289298,312,0.012406680558463942
12403,1009.648067,1009.6562,1,30289442,30289686,244,
12404,1009.6783,1009.686733,1,30290349,30290601,252,0.024050958551339312
12405,1009.6893,1009.8173,1,30290679,30294519,3840,0.5193574452325932
12406,1010.781233,1010.788733,1,30323436,30323661,225,0.7224648576449176
12407,1010.791667,1010.858833,1,30323750,30325764,2014,0.558861884229047
12408,1010.870533,1010.889433,1,30326115,30326682,567,0.6807079644349084
12409,1010.916367,1010.9724,1,30327491,30329172,1681,0.6229249005145556
12410,1010.9927,1011.034467,1,30329781,30331034,1253,0.6101415328371166
12411,1011.046233,1011.0579,1,30331386,30331737,351,0.5434539434882468
12412,1011.0965,1011.103267,1,30332895,30333098,203,-0.06495069242477383
12413,1011.1044,1011.113667,1,30333132,30333410,278,0.12577561504431853
12414,1011.115067,1011.1378,1,30333452,30334134,682,0.1653021550788484
12415,1011.142933,1011.147933,1,30334287,30334437,150,0.2152183928279459
12416,1011.1634,1011.166467,1,30334902,30334994,92,0.9046968034599744
12417,1011.1806,1011.296267,1,30335418,30338888,3470,0.7828867183620021
12418,1011.341533,1011.345467,1,30340245,30340364,119,0.04278023393255946
12419,1011.5279,1011.610833,1,30345837,30348324,2487,0.7976559807795496
12420,1011.6141,1011.749433,1,30348423,30352482,4059,0.7760523589036136
12421,1011.766467,1011.8065,1,30352994,30354195,1201,0.8133839475091129
12422,1011.808233,1011.8182,1,30354246,30354546,300,0.75492508525461
12423,1011.8336,1011.851033,1,30355008,30355530,522,0.650751321288515
12424,1011.8551,1011.8614,1,30355653,30355842,189,0.508661348981174
12425,1011.8729,1011.960467,1,30356187,30358814,2627,0.7907337929435776
12426,1012.037433,1012.041267,1,30361122,30361238,116,-0.05794941643269789
12427,1012.0437,1012.120867,1,30361311,30363626,2315,0.7584522992889501
12428,1012.154733,1012.158333,1,30364641,30364749,108,
12429,1012.172633,1012.221967,1,30365178,30366659,1481,-0.005072039312106899
12430,1012.223933,1012.3422,1,30366717,30370266,3549,0.8190621930866508
12431,1012.349467,1012.440867,1,30370484,30373226,2742,0.7365377583883425
12432,1012.452633,1012.548033,1,30373578,30376440,2862,0.767435578312107
12433,1012.551367,1012.634967,1,30376541,30379049,2508,0.746699410005706
12434,1012.656733,1012.7362,1,30379701,30382086,2385,0.45014796755953285
12435,1012.739733,1012.7517,1,30382191,30382551,360,-0.042132026671212526
12436,1012.755467,1012.791367,1,30382664,30383741,1077,0.7945790732244271
12437,1012.792367,1012.913367,1,30383771,30387401,3630,0.7327388296473685
12438,1012.918933,1012.970633,1,30387567,30389118,1551,0.7028199960468909
12439,1012.9744,1012.9806,1,30389232,30389418,186,0.7467923906348175
12440,1012.981633,1013.060767,1,30389448,30391823,2375,0.7473896462574521
12441,1013.074233,1013.077367,1,30392226,30392321,95,-0.1381096588588756
12442,1013.346433,1013.468633,1,30400392,30404058,3666,0.7213475510200245
12443,1013.4881,1013.679533,1,30404643,30410385,5742,0.7983918446006187
12444,1013.681533,1013.715667,1,30410445,30411470,1025,0.7334249525866399
12445,1013.7191,1013.7227,1,30411573,30411681,108,0.38283537838225357
12446,1013.7303,1013.7346,1,30411909,30412038,129,0.06988524286447617
12447,1013.744667,1013.765233,1,30412340,30412956,616,-0.0266588712660284
12448,1014.042233,1014.141667,1,30421266,30424250,2984,0.8035560495050346
12449,1014.6355,1014.650167,1,30439065,30439505,440,0.5539640790526262
12450,1014.6582,1014.664667,1,30439746,30439940,194,0.7656127613751041
12451,1014.700933,1014.7183,1,30441027,30441549,522,0.5541463001356881
12452,1014.723333,1014.732533,1,30441699,30441975,276,0.4371817358379933
12453,1014.755133,1014.782667,1,30442653,30443480,827,0.6408343755985768
12454,1014.815733,1014.819333,1,30444471,30444579,108,0.22434954879690747
12455,1014.833433,1014.843233,1,30445002,30445296,294,0.47593204374830694
12456,1014.844367,1014.849367,1,30445331,30445481,150,-0.14027987108328377
12457,1014.8672,1014.903033,1,30446016,30447090,1074,0.6355909819351694
12458,1014.932633,1014.938933,1,30447978,30448167,189,0.6377222985127
12459,1014.939933,1014.950433,1,30448197,30448512,315,0.575254167447218
12460,1014.973033,1014.9831,1,30449190,30449493,303,0.5668597370675513
12461,1014.988567,1014.996933,1,30449657,30449907,250,0.6694163842097588
12462,1015.054567,1015.067233,1,30451637,30452016,379,0.006588849127500548
12463,1015.068633,1015.078833,1,30452058,30452364,306,0.1967369365639313
12464,1015.082367,1015.089233,1,30452471,30452676,205,0.11295794984746807
12465,1015.1126,1015.1243,1,30453378,30453729,351,0.6513451377338804
12466,1015.1254,1015.2197,1,30453762,30456591,2829,0.7932949317820814
12467,1015.2432,1015.2489,1,30457296,30457467,171,-0.01489608751793942
12468,1015.267433,1015.2784,1,30458022,30458352,330,-0.07080257838395244
12469,1015.281867,1015.451533,1,30458456,30463545,5089,0.8304558913804074
12470,1015.8253,1015.833333,1,30474759,30474999,240,0.6142014204804372
12471,1015.836233,1015.839867,1,30475086,30475196,110,0.4912316386274868
12472,1015.850633,1015.8684,1,30475518,30476052,534,0.7770391961384295
12473,1015.869533,1015.883233,1,30476085,30476496,411,0.7457553258772674
12474,1015.885033,1015.924267,1,30476550,30477728,1178,0.8140615866999161
12475,1015.9254,1015.9353,1,30477762,30478059,297,0.405061412748836
12476,1015.937067,1016.0357,1,30478112,30481071,2959,0.7006162856044602
12477,1016.040333,1016.159833,1,30481209,30484794,3585,0.7851411109318547
12478,1016.171733,1016.182767,1,30485151,30485483,332,0.09400769009327489
12479,1016.1894,1016.197533,1,30485682,30485925,243,-0.24017902323870838
12480,1016.244833,1016.2633,1,30487344,30487899,555,0.6444007525712497
12481,1016.268667,1016.283467,1,30488060,30488504,444,0.6164263443039176
12482,1016.286067,1016.3167,1,30488582,30489501,919,0.7373742192210311
12483,1016.3448,1016.3502,1,30490344,30490506,162,-0.02288847487130457
12484,1016.3684,1016.3734,1,30491052,30491202,150,-0.008197705540339929
12485,1016.3894,1016.3981,1,30491682,30491943,261,0.05236105042874661
12486,1016.5168,1016.519833,1,30495504,30495594,90,
12487,1016.5442,1016.6807,1,30496326,30500421,4095,0.7501492290873678
12488,1016.681767,1016.689567,1,30500453,30500687,234,0.7135380027542755
12489,1016.700467,1016.733633,1,30501014,30502008,994,0.7844811722769323
12490,1016.755433,1016.795933,1,30502662,30503877,1215,0.0026405603494702367
12491,1016.797567,1016.808233,1,30503927,30504246,319,0.4720298010512813
12492,1016.932133,1016.980367,1,30507963,30509411,1448,0.5289242130878323
12493,1016.991367,1017.001567,1,30509741,30510047,306,0.14846757773981342
12494,1017.186333,1017.237867,1,30515589,30517136,1547,0.3830738996304661
12495,1017.248167,1017.256833,1,30517445,30517704,259,0.8354295616105709
12496,1017.2722,1017.290467,1,30518166,30518714,548,0.5406979832234704
12497,1017.292333,1017.300033,1,30518769,30519000,231,0.8270173083834504
12498,1017.3016,1017.365233,1,30519048,30520956,1908,0.6411831001489716
12499,1017.3821,1017.4358,1,30521463,30523074,1611,0.620861688578408
12500,1017.4517,1017.4561,1,30523551,30523683,132,0.3778864272764712
12501,1017.4656,1017.4876,1,30523968,30524628,660,0.5469643074312344
12502,1017.523767,1017.732,1,30525713,30531960,6247,0.31893642256127797
12503,1017.749767,1017.8531,1,30532493,30535593,3100,0.729188970191239
12504,1017.862333,1017.868733,1,30535869,30536061,192,-0.0916142562325691
12505,1017.911233,1017.914867,1,30537336,30537446,110,-0.044037696294789895
12506,1017.918433,1017.922733,1,30537552,30537681,129,
12507,1017.990533,1018.069567,1,30539715,30542087,2372,0.3241220210553171
12508,1018.071033,1018.1085,1,30542130,30543255,1125,0.3181361695832565
12509,1018.213467,1018.219533,1,30546404,30546585,181,0.13898583729514874
12510,1018.280367,1018.283533,1,30548411,30548505,94,0.7302078597986913
12511,1018.285467,1018.288567,1,30548564,30548657,93,
12512,1018.293533,1018.323633,1,30548805,30549708,903,0.49689227864312585
12513,1018.329333,1018.3983,1,30549879,30551949,2070,0.14686810213464532
12514,1018.4001,1018.425467,1,30552003,30552764,761,0.7739206859585247
12515,1018.428067,1018.5234,1,30552842,30555702,2860,0.6997740195563704
12516,1018.550033,1018.640967,1,30556500,30559229,2729,0.5969284516776608
12517,1018.660933,1018.670967,1,30559827,30560129,302,0.7272295116156858
12518,1018.678933,1018.6938,1,30560367,30560814,447,0.23974179014494226
12519,1018.707733,1018.757267,1,30561231,30562718,1487,0.5492929342746633
12520,1018.758767,1018.8238,1,30562763,30564714,1951,0.7954939446028674
12521,1018.825733,1018.881667,1,30564771,30566450,1679,0.17462191361876186
12522,1018.886067,1018.902167,1,30566582,30567065,483,0.06801346374153841
12523,1018.9205,1018.932633,1,30567615,30567978,363,0.496845767391807
12524,1018.9422,1018.9654,1,30568266,30568962,696,0.2765133446752632
12525,1018.970667,1018.992333,1,30569120,30569769,649,0.005397493078881744
12526,1019.007467,1019.132,1,30570224,30573960,3736,0.8064650282396619
12527,1019.162933,1019.1702,1,30574887,30575106,219,0.153626888670496
12528,1019.1827,1019.194,1,30575481,30575820,339,-0.07932787459197521
12529,1019.206367,1019.209933,1,30576191,30576297,106,
12530,1019.268233,1019.2802,1,30578046,30578406,360,0.1557582701597309
12531,1019.286567,1019.308867,1,30578597,30579266,669,0.1694850326168467
12532,1019.309867,1019.315767,1,30579296,30579473,177,0.700491872640365
12533,1019.329933,1019.3519,1,30579897,30580557,660,-0.046414509080644845
12534,1019.360333,1019.367667,1,30580809,30581030,221,-0.06219664086237561
12535,1019.4018,1019.4665,1,30582054,30583995,1941,0.7972638048279733
12536,1019.468233,1019.488833,1,30584046,30584664,618,0.6623109774341169
12537,1019.4915,1019.6158,1,30584745,30588474,3729,0.7355256955374627
12538,1019.6169,1019.624333,1,30588507,30588729,222,0.6753440453499691
12539,1019.6424,1019.697433,1,30589272,30590922,1650,0.7505780385185505
12540,1019.7083,1019.723333,1,30591249,30591699,450,0.6321262159489534
12541,1019.733233,1019.744633,1,30591996,30592338,342,0.3675055169727195
12542,1019.7457,1019.7499,1,30592371,30592497,126,-0.07813838354674846
12543,1019.753467,1019.782167,1,30592604,30593465,861,0.0034624241093500546
12544,1019.784267,1019.798067,1,30593528,30593942,414,0.4144923081875811
12545,1019.801733,1019.806067,1,30594051,30594182,131,0.1855201321257087
12546,1019.890267,1019.896767,1,30596708,30596903,195,0.3994693269142611
12547,1019.936633,1019.9621,1,30598098,30598863,765,0.4257562980695064
12548,1019.9637,1020.1416,1,30598911,30604248,5337,0.8104924638358432
12549,1020.179267,1020.1825,1,30605378,30605475,97,0.3208891223060949
12550,1020.196833,1020.2006,1,30605904,30606018,114,-0.06807534147137026
12551,1020.201933,1020.2245,1,30606057,30606735,678,0.6548868372224123
12552,1020.2419,1020.259367,1,30607257,30607781,524,0.6174154959977516
12553,1020.260767,1020.324033,1,30607823,30609720,1897,0.7979037308291302
12554,1020.349833,1020.354467,1,30610494,30610634,140,
12555,1020.3613,1020.3665,1,30610839,30610995,156,0.4238742846257072
12556,1020.438667,1020.554933,1,30613160,30616647,3487,0.7857750208322484
12557,1020.627233,1020.630567,1,30618816,30618917,101,
12558,1020.632067,1020.738167,1,30618962,30622145,3183,0.8492516417397815
12559,1020.754633,1020.850267,1,30622638,30625508,2870,0.7668223899463567
12560,1020.852467,1020.8698,1,30625574,30626094,520,0.6200280509565426
12561,1021.114967,1021.123967,1,30633449,30633719,270,0.4877000111184298
12562,1021.140367,1021.1673,1,30634211,30635019,808,0.7726111552659963
12563,1021.188467,1021.212933,1,30635654,30636387,733,0.9139783201126369
12564,1021.213933,1021.272133,1,30636417,30638163,1746,0.7554907834719116
12565,1021.2776,1021.408967,1,30638328,30642269,3941,0.7871099310266699
12566,1021.412433,1021.425967,1,30642372,30642779,407,0.8035880906998922
12567,1021.435433,1021.513667,1,30643062,30645410,2348,0.7117156374533319
12568,1021.582767,1021.591,1,30647483,30647730,247,0.43921482280234025
12569,1021.595767,1021.637967,1,30647873,30649139,1266,-0.009171755425807395
12570,1021.639833,1021.7121,1,30649194,30651363,2169,0.8129639681920463
12571,1021.713233,1021.803867,1,30651396,30654116,2720,0.7845235208566655
12572,1021.8091,1021.991,1,30654273,30659730,5457,0.748535565632093
12573,1022.032433,1022.038133,1,30660972,30661143,171,0.05873971603241739
12574,1022.040333,1022.0456,1,30661209,30661368,159,0.29773093655621796
12575,1022.078133,1022.081567,1,30662343,30662447,104,0.8177865519256073
12576,1022.093333,1022.106567,1,30662799,30663197,398,0.7199108003665499
12577,1022.110433,1022.2052,1,30663312,30666156,2844,0.652402562076593
12578,1022.211833,1022.2776,1,30666354,30668328,1974,0.7813537823342181
12579,1022.279733,1022.3309,1,30668391,30669927,1536,0.7836926747006203
12580,1022.331933,1022.3492,1,30669957,30670476,519,0.6162026862389187
12581,1022.3532,1022.364467,1,30670596,30670934,338,0.6318824761972485
12582,1022.369667,1022.407733,1,30671090,30672231,1141,0.7318620549861206
12583,1022.408733,1022.486167,1,30672261,30674585,2324,0.7678524825312854
12584,1022.487267,1022.492233,1,30674618,30674766,148,-0.12526978310772482
12585,1022.493867,1022.576667,1,30674816,30677300,2484,0.799656092472579
12586,1022.577833,1022.607033,1,30677334,30678210,876,0.7221500008703308
12587,1022.619267,1022.6264,1,30678578,30678792,214,-0.07300764742653977
12588,1022.635833,1022.678533,1,30679074,30680355,1281,0.13349892561674823
12589,1022.7099,1022.820733,1,30681297,30684621,3324,0.762543460647205
12590,1022.831833,1022.863933,1,30684954,30685917,963,0.05917670447038986
12591,1022.8663,1022.8761,1,30685989,30686283,294,-0.030282365335690117
12592,1022.889233,1022.895233,1,30686676,30686856,180,-0.19251615451208684
12593,1022.897667,1022.932733,1,30686930,30687981,1051,0.7413502873788089
12594,1022.933867,1023.021567,1,30688016,30690647,2631,0.8087924929300457
12595,1023.040667,1023.106533,1,30691220,30693195,1975,0.7849283192380028
12596,1023.1192,1023.161667,1,30693576,30694850,1274,0.7033383463323065
12597,1023.1706,1023.210033,1,30695118,30696300,1182,-0.009548886449885748
12598,1023.211933,1023.224733,1,30696357,30696741,384,0.21574233274606644
12599,1023.247533,1023.528833,1,30697425,30705864,8439,0.7686922048389849
12600,1023.6662,1023.6739,1,30709986,30710217,231,-0.07443715116422962
12601,1023.6788,1023.719933,1,30710364,30711597,1233,0.6739165418064057
12602,1023.7249,1023.739633,1,30711747,30712188,441,0.7911968960978603
12603,1023.7418,1023.758333,1,30712254,30712749,495,0.8339495855024603
12604,1023.766933,1023.811167,1,30713007,30714335,1328,0.7911506321362362
12605,1023.8209,1023.829967,1,30714627,30714899,272,0.5730670660073067
12606,1023.8332,1023.851767,1,30714996,30715553,557,-0.014289854950798292
12607,1023.854767,1023.886533,1,30715643,30716595,952,0.189612354661497
12608,1023.9135,1024.024933,1,30717405,30720747,3342,0.8174303077398515
12609,1024.035367,1024.0417,1,30721061,30721251,190,0.48983586432348936
12610,1024.0466,1024.102567,1,30721397,30723077,1680,0.058067135715487314
12611,1024.1184,1024.2835,1,30723552,30728505,4953,0.8375976442619164
12612,1024.284967,1024.295233,1,30728549,30728856,307,0.9023669935387466
12613,1024.3181,1024.347333,1,30729543,30730419,876,0.04606852134167385
12614,1024.3487,1024.374367,1,30730461,30731231,770,0.033712461627631286
12615,1024.392333,1024.5234,1,30731769,30735702,3933,0.8071150609302457
12616,1024.533333,1024.550067,1,30735999,30736502,503,-0.042599432866567324
12617,1024.5555,1024.567733,1,30736665,30737031,366,-0.010141625684963134
12618,1024.6823,1024.7926,1,30740469,30743778,3309,0.8119744953852377
12619,1024.801667,1024.849333,1,30744050,30745479,1429,0.10210727831727899
12620,1024.859867,1025.032467,1,30745796,30750974,5178,0.7988289029934604
12621,1025.039533,1025.0981,1,30751185,30752942,1757,0.04463356002157683
12622,1025.120067,1025.214933,1,30753602,30756447,2845,0.838825100114392
12623,1025.217033,1025.276733,1,30756510,30758301,1791,0.8304587626137395
12624,1025.282,1025.293533,1,30758459,30758805,346,0.3221494295642607
12625,1025.2968,1025.3155,1,30758904,30759464,560,0.0331538308404242
12626,1025.318167,1025.350267,1,30759545,30760508,963,0.1500703197464523
12627,1025.366133,1025.481133,1,30760983,30764433,3450,0.7923341365272395
12628,1025.4846,1025.524933,1,30764538,30765747,1209,0.7681835583817747
12629,1025.532567,1025.589967,1,30765977,30767699,1722,0.03662365486049399
12630,1025.611667,1025.618933,1,30768350,30768567,217,0.5071251103458694
12631,1025.620467,1025.7447,1,30768614,30772341,3727,0.6897992233718672
12632,1025.7513,1025.771267,1,30772538,30773138,600,-0.04373677485914912
12633,1025.774233,1025.799233,1,30773226,30773976,750,0.31801588078190673
12634,1025.804333,1025.8094,1,30774129,30774282,153,-0.07554494594409322
12635,1025.8319,1025.992233,1,30774956,30779766,4810,0.8319923412497755
12636,1025.997933,1026.030067,1,30779937,30780902,965,-0.01050871971262267
12637,1026.032267,1026.048767,1,30780968,30781463,495,0.3008970420625606
12638,1026.05,1026.059167,1,30781500,30781775,275,0.26915769492688907
12639,1026.079967,1026.083067,1,30782399,30782492,93,0.8543695073609472
12640,1026.087767,1026.2393,1,30782633,30787179,4546,0.8290741148115731
12641,1026.242667,1026.2643,1,30787280,30787929,649,0.05519678362615324
12642,1026.267367,1026.2714,1,30788021,30788142,121,
12643,1026.2816,1026.2861,1,30788448,30788583,135,-0.09504291347679042
12644,1026.3016,1026.3052,1,30789048,30789156,108,
12645,1026.5264,1026.5451,1,30795792,30796353,561,0.1493430662156755
12646,1026.546833,1026.558433,1,30796404,30796752,348,-0.02200271323870468
12647,1026.564867,1026.5698,1,30796946,30797094,148,
12648,1026.570867,1026.611933,1,30797126,30798357,1231,0.1938704931400582
12649,1026.616667,1026.763733,1,30798500,30802911,4411,0.7994123991446606
12650,1026.770833,1026.795133,1,30803124,30803853,729,0.004821539861959725
12651,1026.7982,1026.8303,1,30803946,30804909,963,0.13187833261604187
12652,1026.857967,1026.8669,1,30805739,30806007,268,0.17755597236921747
12653,1026.877033,1026.968467,1,30806310,30809054,2744,0.7694387290643447
12654,1026.9699,1027.010367,1,30809097,30810311,1214,0.8450341418078243
12655,1027.0273,1027.0597,1,30810819,30811791,972,0.06516968193191808
12656,1027.060733,1027.0912,1,30811821,30812736,915,0.12271499194800234
12657,1027.1234,1027.2643,1,30813702,30817929,4227,0.8053162174511908
12658,1027.2719,1027.277867,1,30818157,30818336,179,0.011607946646942776
12659,1027.281733,1027.295033,1,30818451,30818850,399,0.3622257439023432
12660,1027.296667,1027.312133,1,30818900,30819363,463,0.07543203456286031
12661,1027.317,1027.334367,1,30819510,30820031,521,0.2546602571957346
12662,1027.369367,1027.535933,1,30821081,30826077,4996,0.7934602020630929
12663,1027.543,1027.5633,1,30826289,30826899,610,-0.018406294366793093
12664,1027.565967,1027.574833,1,30826979,30827244,265,0.22740901013353806
12665,1027.577667,1027.591467,1,30827330,30827744,414,0.03376295625889625
12666,1027.594167,1027.5994,1,30827825,30827982,157,0.14526681675148173
12667,1027.633433,1027.811067,1,30829002,30834332,5330,0.83628712334601
12668,1027.820633,1027.87,1,30834618,30836099,1481,0.8111946792145244
12669,1027.871033,1027.9294,1,30836130,30837882,1752,0.7501364245623813
12670,1027.950533,1027.9721,1,30838515,30839163,648,-0.049077038274474426
12671,1027.9734,1027.981533,1,30839202,30839445,243,-0.11505967638423063
12672,1027.9886,1027.994333,1,30839657,30839829,172,-0.06409045019243838
12673,1028.170933,1028.4024,1,30845127,30852072,6945,0.7623439473909696
12674,1028.420033,1028.570033,1,30852600,30857100,4500,0.7977588614218284
12675,1028.573367,1028.6103,1,30857201,30858309,1108,0.6579452215259676
12676,1028.6117,1028.622967,1,30858350,30858689,339,0.6273445949325921
12677,1028.637033,1028.720367,1,30859110,30861611,2501,0.7226071143371205
12678,1028.736667,1028.7398,1,30862100,30862194,94,
12679,1028.769767,1028.8834,1,30863093,30866501,3408,0.7678329918731777
12680,1028.896033,1028.901633,1,30866880,30867048,168,-0.10532801619894303
12681,1028.992733,1029.0254,1,30869781,30870762,981,0.6970456567381785
12682,1029.027267,1029.1298,1,30870818,30873893,3075,0.80527057414061
12683,1029.216233,1029.302167,1,30876486,30879065,2579,0.8178007018655133
12684,1029.306567,1029.421933,1,30879197,30882657,3460,0.8256942966056129
12685,1029.4343,1029.441733,1,30883028,30883251,223,-0.07816681701228058
12686,1029.4558,1029.4597,1,30883674,30883791,117,
12687,1029.531867,1029.551,1,30885956,30886529,573,0.5896643851428749
12688,1030.146133,1030.1557,1,30904383,30904671,288,0.7017942784070993
12689,1030.1575,1030.173933,1,30904725,30905217,492,0.6101985221292621
12690,1030.207967,1030.2192,1,30906239,30906576,337,0.5507981236431951
12691,1030.240933,1030.247933,1,30907227,30907437,210,0.5606381102114015
12692,1030.270767,1030.283867,1,30908123,30908516,393,0.8705660178191379
12693,1030.407633,1030.437733,1,30912228,30913131,903,0.47236329554052126
12694,1030.479167,1030.493033,1,30914375,30914790,415,0.600427866737864
12695,1030.927967,1030.971333,1,30927839,30929139,1300,0.6471265968970413
12696,1030.981033,1031.026367,1,30929430,30930791,1361,0.6554600410370339
12697,1031.043,1031.062,1,30931289,30931859,570,0.772859477297784
12698,1031.3098,1031.4966,1,30939294,30944898,5604,0.8315989354664569
12699,1031.509767,1031.567167,1,30945293,30947015,1722,0.8118222949112355
12700,1031.5835,1031.627367,1,30947505,30948821,1316,0.8360121704623571
12701,1031.6633,1031.6691,1,30949898,30950073,175,0.02062425261289745
12702,1031.670467,1031.6766,1,30950114,30950298,184,0.6613594118279691
12703,1031.684567,1031.688067,1,30950537,30950642,105,0.20913906324978287
12704,1031.694,1031.733133,1,30950820,30951993,1173,0.5971397577947696
12705,1031.738867,1031.7432,1,30952166,30952295,129,0.5529175432907161
12706,1031.754033,1031.816467,1,30952620,30954494,1874,0.806320062233716
12707,1031.9613,1031.972133,1,30958838,30959163,325,0.7499306362521563
12708,1031.974767,1032.0691,1,30959243,30962072,2829,0.82840400013448
12709,1032.071567,1032.0751,1,30962147,30962253,106,
12710,1032.076567,1032.151,1,30962297,30964530,2233,0.05871012565560745
12711,1032.17,1032.173067,1,30965100,30965192,92,0.02530952591873365
12712,1032.174333,1032.343667,1,30965229,30970310,5081,0.7986641137886074
12713,1032.349267,1032.376933,1,30970478,30971307,829,0.7859171762494982
12714,1032.379733,1032.427233,1,30971391,30972816,1425,0.6111261493217831
12715,1032.430067,1032.5316,1,30972902,30975948,3046,0.744673426865266
12716,1032.533433,1032.564767,1,30976002,30976943,941,0.7815529215872508
12717,1032.572733,1032.587833,1,30977181,30977634,453,0.0006531562123087332
12718,1032.5911,1032.6185,1,30977733,30978555,822,0.11147569095410935
12719,1032.647267,1032.664233,1,30979418,30979926,508,0.8714933787572489
12720,1032.666467,1032.733067,1,30979994,30981992,1998,0.7321891471803785
12721,1032.7354,1032.7609,1,30982062,30982827,765,0.6109457666732109
12722,1032.787833,1032.796167,1,30983634,30983885,251,-0.29196705489412306
12723,1032.800133,1032.804767,1,30984003,30984143,140,0.1645006108271001
12724,1032.8066,1032.9295,1,30984197,30987885,3688,0.8584347525430052
12725,1032.931667,1032.937233,1,30987950,30988116,166,0.12267161002408562
12726,1032.957967,1033.0472,1,30988739,30991416,2677,0.8031096334683905
12727,1033.0789,1033.082833,1,30992367,30992484,117,
12728,1033.385633,1033.3899,1,31001568,31001696,128,0.5600613524929885
12729,1033.392267,1033.3964,1,31001768,31001892,124,0.5830233839741947
12730,1033.4418,1033.4607,1,31003254,31003821,567,0.718275492178751
12731,1033.4856,1033.494033,1,31004568,31004820,252,0.5994952757486975
12732,1033.496333,1033.544367,1,31004889,31006331,1442,0.6208983718792345
12733,1033.570767,1033.603367,1,31007123,31008101,978,0.6674214910491068
12734,1033.624733,1033.6681,1,31008741,31010043,1302,0.37894893959386283
12735,1033.6934,1033.712,1,31010802,31011360,558,0.7910706925735391
12736,1033.729833,1033.742867,1,31011894,31012286,392,0.8339979067180365
12737,1033.751867,1033.7704,1,31012556,31013112,556,0.7929169927540805
12738,1034.040967,1034.1105,1,31021229,31023315,2086,0.6445191142407132
12739,1034.1133,1034.137867,1,31023399,31024136,737,0.6823788956688462
12740,1034.147967,1034.225467,1,31024439,31026764,2325,0.7750336091235461
12741,1034.230667,1034.2523,1,31026920,31027569,649,0.8497080702379426
12742,1034.359733,1034.3646,1,31030791,31030938,147,0.11018369169561652
12743,1034.370733,1034.457033,1,31031121,31033710,2589,0.8108276663671283
12744,1034.4834,1034.483567,1,31034502,31034507,5,
12745,1034.767433,1034.7727,1,31043022,31043181,159,0.7448495633584445
12746,1034.791867,1034.8347,1,31043756,31045041,1285,0.8027961677543464
12747,1034.850767,1034.888633,1,31045523,31046658,1135,0.7256119026676003
12748,1034.8975,1035.0255,1,31046925,31050765,3840,0.7959071843882969
12749,1035.0281,1035.085633,1,31050843,31052568,1725,0.7933672621819193
12750,1035.0974,1035.1144,1,31052922,31053431,509,0.7046260989593641
12751,1035.115633,1035.129833,1,31053468,31053894,426,0.5375751252750282
12752,1035.1433,1035.1463,1,31054299,31054389,90,
12753,1035.154,1035.212733,1,31054620,31056381,1761,0.23977811972865096
12754,1035.228467,1035.368467,1,31056854,31061054,4200,0.7208386115829061
12755,1035.376933,1035.4807,1,31061307,31064421,3114,0.8441972192381624
12756,1035.5178,1035.5213,1,31065534,31065639,105,-0.0868822461744547
12757,1035.532567,1035.542367,1,31065977,31066271,294,0.031169209221427786
12758,1035.546167,1035.549667,1,31066385,31066490,105,0.1728950651974602
12759,1035.552667,1035.5618,1,31066580,31066854,274,0.2044558187231805
12760,1035.567833,1035.5768,1,31067034,31067304,270,0.43621590600596977
12761,1035.579167,1035.582367,1,31067375,31067471,96,
12762,1035.8647,1035.935933,1,31075941,31078077,2136,0.844839803712923
12763,1035.937933,1035.995833,1,31078137,31079874,1737,0.8143248657792898
12764,1036.000533,1036.088633,1,31080015,31082658,2643,0.8224432211240214
12765,1036.092,1036.096867,1,31082760,31082906,146,0.874081043071515
12766,1036.101867,1036.117167,1,31083056,31083515,459,0.552784355841002
12767,1036.1644,1036.296767,1,31084931,31088903,3972,0.7847406170885095
12768,1036.299,1036.304,1,31088970,31089120,150,0.47179747551038304
12769,1036.305133,1036.308133,1,31089153,31089243,90,-0.11362065422836885
12770,1036.329233,1036.335267,1,31089876,31090058,182,0.05271743438708375
12771,1036.337233,1036.340533,1,31090116,31090215,99,0.48076366326052966
12772,1036.455533,1036.535033,1,31093665,31096050,2385,0.780110384748825
12773,1036.542233,1036.546467,1,31096266,31096394,128,0.019440673284328552
12774,1036.821567,1036.837,1,31104647,31105110,463,0.6420182833614957
12775,1036.8603,1036.874933,1,31105809,31106247,438,0.7844855865149919
12776,1036.909967,1036.9182,1,31107299,31107546,247,0.3842914022234666
12777,1036.932533,1036.957267,1,31107975,31108718,743,0.6647514189532393
12778,1036.963267,1036.9847,1,31108898,31109541,643,0.7831126565647782
12779,1036.9895,1037.066867,1,31109684,31112006,2322,0.8291162290552727
12780,1037.0691,1037.119633,1,31112072,31113588,1516,0.7025045236434575
12781,1037.123367,1037.146733,1,31113701,31114401,700,0.8074108124876895
12782,1037.149967,1037.2575,1,31114499,31117724,3225,0.7865733844989445
12783,1037.2651,1037.2805,1,31117953,31118415,462,0.7895948328810082
12784,1037.288333,1037.316567,1,31118649,31119497,848,0.15462955645949536
12785,1037.325033,1037.338867,1,31119750,31120166,416,0.15276087321306914
12786,1037.3405,1037.346467,1,31120215,31120394,179,-0.20842129215987173
12787,1037.379267,1037.3914,1,31121378,31121742,364,0.5181008119645676
12788,1037.392633,1037.629467,1,31121778,31128884,7106,0.7736446261675344
12789,1037.643767,1037.650033,1,31129313,31129500,187,-0.013346324194311112
12790,1037.9906,1038.0267,1,31139718,31140800,1082,0.6542897497145979
12791,1038.0532,1038.072467,1,31141596,31142174,578,0.6279897623556926
12792,1038.097167,1038.103733,1,31142915,31143111,196,0.6690345296985473
12793,1038.248967,1038.2657,1,31147469,31147970,501,0.4478287687690885
12794,1038.268933,1038.2924,1,31148067,31148772,705,0.750617703028374
12795,1038.293467,1038.301833,1,31148804,31149054,250,0.456710823499822
12796,1038.3115,1038.353067,1,31149345,31150592,1247,0.694230460311674
12797,1038.373167,1038.420933,1,31151195,31152627,1432,-0.07134491794398269
12798,1038.4263,1038.4307,1,31152789,31152920,131,0.11690667307885252
12799,1038.4395,1038.468833,1,31153185,31154064,879,0.7193608962758669
12800,1038.469833,1038.549067,1,31154094,31156472,2378,0.7436490336539735
12801,1038.5508,1038.6155,1,31156524,31158465,1941,0.8190242386911526
12802,1038.6242,1038.687367,1,31158726,31160621,1895,0.8064819850036568
12803,1038.692633,1038.741567,1,31160778,31162247,1469,0.7386539570279236
12804,1038.743067,1038.810533,1,31162292,31164315,2023,0.7096844640041021
12805,1038.815967,1038.857367,1,31164479,31165721,1242,0.7592299912943767
12806,1038.8618,1038.892667,1,31165853,31166780,927,0.8001803109768778
12807,1038.909667,1038.925133,1,31167290,31167753,463,-0.04962426617353313
12808,1038.978433,1039.025567,1,31169352,31170767,1415,0.5350024940751399
12809,1039.036167,1039.041633,1,31171085,31171248,163,0.7002040249015938
12810,1039.044333,1039.253467,1,31171329,31177604,6275,0.8026261759540908
12811,1039.730467,1039.737833,1,31191914,31192134,220,0.717145472032067
12812,1039.74,1039.772633,1,31192200,31193178,978,0.5076352908850787
12813,1039.790467,1039.894333,1,31193714,31196829,3115,0.8081626739636776
12814,1040.516933,1040.524267,1,31215507,31215728,221,0.7177064402741797
12815,1040.5391,1040.545933,1,31216173,31216377,204,0.6368800484725206
12816,1040.570067,1040.601433,1,31217102,31218042,940,0.5390924839014098
12817,1040.624367,1040.6483,1,31218731,31219449,718,0.6796926106334619
12818,1040.680233,1040.689333,1,31220406,31220679,273,0.593497350841659
12819,1040.694867,1040.718333,1,31220846,31221549,703,0.6270061564897976
12820,1040.7292,1040.741667,1,31221876,31222250,374,0.6443340189609604
12821,1040.7852,1040.800667,1,31223556,31224020,464,0.07453117546491432
12822,1040.804167,1040.815367,1,31224125,31224461,336,0.04375630850217047
12823,1040.8404,1040.857833,1,31225212,31225734,522,0.7255279194555687
12824,1040.8595,1040.957733,1,31225785,31228731,2946,0.7748452826173305
12825,1041.234567,1041.3021,1,31237037,31239063,2026,0.759074878031627
12826,1041.3032,1041.398033,1,31239096,31241940,2844,0.7769185652966202
12827,1041.415533,1041.614167,1,31242465,31248425,5960,0.7865981758194207
12828,1042.034067,1042.0404,1,31261022,31261212,190,0.7820421397123681
12829,1042.041933,1042.062767,1,31261257,31261883,626,0.5420870855206285
12830,1042.087,1042.1067,1,31262610,31263201,591,0.669340145310153
12831,1042.112267,1042.1165,1,31263368,31263495,127,0.2586295530509576
12832,1042.159133,1042.1746,1,31264773,31265238,465,0.767189088907043
12833,1042.195867,1042.2904,1,31265876,31268712,2836,0.7669320356151719
12834,1042.335867,1042.3398,1,31270076,31270194,118,-0.04901137029235213
12835,1042.414667,1042.5086,1,31272440,31275257,2817,0.8228281925510051
12836,1042.513533,1042.520467,1,31275405,31275614,209,-0.07367823405979441
12837,1042.528533,1042.543367,1,31275855,31276301,446,0.5635993136788497
12838,1042.550867,1042.601167,1,31276526,31278035,1509,-0.023057756495607415
12839,1042.605467,1042.801833,1,31278164,31284054,5890,0.6649762017669217
12840,1042.8121,1042.834767,1,31284363,31285043,680,0.8126324221979235
12841,1042.845933,1042.856167,1,31285377,31285685,308,0.6008154758313314
12842,1042.857433,1042.8914,1,31285722,31286742,1020,0.7439403729485562
12843,1042.917567,1043.023967,1,31287527,31290719,3192,0.8028344802115855
12844,1043.0339,1043.038467,1,31291016,31291154,138,-0.018329964830297703
12845,1043.1079,1043.134033,1,31293237,31294020,783,0.30657669889351213
12846,1043.1351,1043.1994,1,31294053,31295982,1929,0.7779547031684309
12847,1043.2012,1043.223567,1,31296036,31296707,671,0.8242395859337094
12848,1043.248433,1043.255733,1,31297452,31297671,219,-0.09456202063171062
12849,1043.2917,1043.296067,1,31298751,31298882,131,-0.26140317712727673
12850,1043.2982,1043.411633,1,31298946,31302348,3402,0.8198843867750994
12851,1043.620167,1043.8128,1,31308605,31314383,5778,0.6139635904546397
12852,1043.813967,1043.817033,1,31314419,31314510,91,0.36096017396533864
12853,1043.821533,1043.889567,1,31314645,31316687,2042,0.6768485112395385
12854,1043.895333,1043.971467,1,31316859,31319144,2285,0.834075181810927
12855,1043.975867,1044.023667,1,31319276,31320710,1434,0.729462668915785
12856,1044.0431,1044.0564,1,31321293,31321692,399,0.02031673661186882
12857,1044.064,1044.0905,1,31321920,31322715,795,0.15547734708008135
12858,1044.103333,1044.108,1,31323099,31323240,141,0.337979118621122
12859,1044.116433,1044.245467,1,31323492,31327364,3872,0.7925311893623422
12860,1044.254867,1044.3478,1,31327646,31330434,2788,0.8284863682736477
12861,1044.4365,1044.558833,1,31333095,31336764,3669,0.7664847647234573
12862,1044.595467,1044.6324,1,31337864,31338972,1108,-0.08980523369307858
12863,1044.639233,1044.835867,1,31339176,31345076,5900,0.6516735640742387
12864,1044.838567,1044.8939,1,31345157,31346817,1660,0.5733446489001837
12865,1044.894933,1044.930167,1,31346847,31347905,1058,0.8227902078238426
12866,1044.935267,1044.9521,1,31348058,31348563,505,0.7224732904909097
12867,1044.953233,1044.958,1,31348596,31348740,144,0.0691685603860946
12868,1044.960867,1044.9823,1,31348826,31349468,642,0.7115602656150132
12869,1044.9842,1045.015033,1,31349526,31350450,924,0.8467798462447217
12870,1045.019867,1045.022867,1,31350596,31350686,90,0.7205431977399362
12871,1045.028367,1045.0978,1,31350851,31352934,2083,0.8024347900544635
12872,1045.1099,1045.125933,1,31353296,31353777,481,0.7491382425024227
12873,1045.1296,1045.143733,1,31353888,31354311,423,0.500578664989445
12874,1045.1578,1045.165767,1,31354734,31354973,239,-0.11157228382576519
12875,1045.1697,1045.184667,1,31355090,31355540,450,0.08776599219077041
12876,1045.185867,1045.214133,1,31355576,31356423,847,-0.11920529252219116
12877,1045.235733,1045.239967,1,31357071,31357199,128,0.4248897292964433
12878,1045.243833,1045.264467,1,31357314,31357934,620,0.8207342730775292
12879,1045.266467,1045.515133,1,31357994,31365453,7459,0.7563074339379606
12880,1045.560267,1045.5664,1,31366808,31366991,183,0.4094638995609386
12881,1045.6077,1045.612767,1,31368231,31368383,152,-0.1138893314492001
12882,1045.617267,1045.767,1,31368518,31373010,4492,0.8024644471673475
12883,1045.768667,1045.835633,1,31373060,31375068,2008,0.7897888148535583
12884,1045.843733,1045.9719,1,31375311,31379157,3846,0.8214635326607649
12885,1045.9782,1046.0555,1,31379346,31381665,2319,0.8020021632536724
12886,1046.056967,1046.0628,1,31381709,31381883,174,0.6478777009830573
12887,1046.064,1046.0733,1,31381920,31382199,279,0.3464125744371977
12888,1046.0843,1046.1701,1,31382529,31385103,2574,0.8094908952508311
12889,1046.174333,1046.193033,1,31385229,31385790,561,0.6603133228787266
12890,1046.204833,1046.293,1,31386144,31388789,2645,0.8244992589834196
12891,1046.2963,1046.301633,1,31388889,31389048,159,0.7065486374586735
12892,1046.3053,1046.3144,1,31389159,31389432,273,-0.24883285938970776
12893,1046.326667,1046.381733,1,31389800,31391451,1651,0.7924067103614636
12894,1046.384467,1046.415967,1,31391534,31392479,945,0.8239509334318988
12895,1046.420067,1046.423067,1,31392602,31392692,90,
12896,1046.449867,1046.4883,1,31393496,31394649,1153,0.7185850853036898
12897,1046.490567,1046.5054,1,31394717,31395162,445,0.8122995786363326
12898,1046.525367,1046.537067,1,31395761,31396112,351,0.34348890980484215
12899,1046.573433,1046.612433,1,31397202,31398372,1170,0.7220075423640688
12900,1046.613933,1046.628733,1,31398417,31398861,444,0.6359661930742775
12901,1046.643633,1046.664067,1,31399308,31399922,614,0.5454793164285243
12902,1046.6693,1046.6886,1,31400079,31400658,579,-0.31960724000893814
12903,1046.700167,1046.7551,1,31401005,31402653,1648,0.7957763435109777
12904,1046.756333,1046.760167,1,31402689,31402805,116,0.4503720129014499
12905,1046.761467,1046.7673,1,31402844,31403019,175,0.7901001298187063
12906,1046.773,1046.7924,1,31403189,31403772,583,0.8055812925513265
12907,1046.797467,1046.816267,1,31403924,31404488,564,0.36863499930099736
12908,1046.8261,1046.8587,1,31404783,31405761,978,0.6890857935034272
12909,1046.867033,1046.881033,1,31406010,31406430,420,0.8006923214100277
12910,1046.891933,1046.8969,1,31406757,31406907,150,0.4349050950659275
12911,1046.908233,1046.94,1,31407246,31408200,954,0.7302506917101024
12912,1046.953733,1046.974867,1,31408611,31409246,635,0.11781166961963133
12913,1046.976733,1046.999033,1,31409301,31409970,669,0.00626549967892873
12914,1047.0005,1047.0118,1,31410015,31410354,339,-0.016281506845226435
12915,1047.088533,1047.155433,1,31412655,31414662,2007,0.8059218474206401
12916,1047.1592,1047.2198,1,31414776,31416594,1818,0.8038511620317996
12917,1047.226533,1047.282533,1,31416795,31418475,1680,0.8149743475254283
12918,1047.283867,1047.316733,1,31418516,31419501,985,0.7697266194956545
12919,1047.330533,1047.3554,1,31419915,31420661,746,0.6616792665890635
12920,1047.372933,1047.398167,1,31421187,31421945,758,0.028536402700459894
12921,1047.401233,1047.412933,1,31422036,31422387,351,-0.006198524360186982
12922,1047.417867,1047.4216,1,31422536,31422647,111,0.07331663448334076
12923,1047.431467,1047.437667,1,31422944,31423130,186,0.236288374160603
12924,1047.4415,1047.452033,1,31423244,31423560,316,0.7910632428540223
12925,1047.453167,1047.4598,1,31423595,31423794,199,0.37147647893542324
12926,1047.473767,1047.569567,1,31424213,31427087,2874,0.7933785447983506
12927,1047.5788,1047.5831,1,31427364,31427493,129,-0.25851877081413055
12928,1047.626733,1047.666233,1,31428801,31429986,1185,0.7231627318416227
12929,1047.6699,1047.704,1,31430097,31431120,1023,0.7945631938326192
12930,1047.7247,1047.731,1,31431741,31431930,189,0.317916693906583
12931,1047.754,1047.765467,1,31432619,31432964,345,0.138579632730274
12932,1047.767967,1047.779167,1,31433039,31433375,336,-0.18041529734472142
12933,1047.7808,1047.7879,1,31433424,31433637,213,-0.2637512241644642
12934,1047.818667,1047.926833,1,31434560,31437804,3244,0.8502139202322025
12935,1047.928767,1047.942333,1,31437863,31438269,406,0.4874936367621493
12936,1047.950667,1047.998,1,31438520,31439940,1420,0.13729347641780706
12937,1048.000267,1048.014567,1,31440008,31440437,429,0.32100106316716437
12938,1048.049333,1048.152833,1,31441479,31444584,3105,0.8025762221584221
12939,1048.161333,1048.172933,1,31444839,31445187,348,0.33506184001587996
12940,1048.1843,1048.215167,1,31445528,31446455,927,0.08186675334823519
12941,1048.216233,1048.223133,1,31446486,31446693,207,-0.06753969816294526
12942,1048.225633,1048.238967,1,31446768,31447169,401,0.1724926636170813
12943,1048.2404,1048.248333,1,31447211,31447449,238,0.4636426103882744
12944,1048.2649,1048.3787,1,31447946,31451361,3415,0.8112616464359119
12945,1048.3808,1048.390833,1,31451423,31451724,301,0.283139955002019
12946,1048.394667,1048.429467,1,31451840,31452884,1044,0.06103069471810854
12947,1048.431967,1048.458833,1,31452959,31453764,805,0.04678217736323842
12948,1048.469133,1048.4728,1,31454073,31454184,111,0.13867321969058738
12949,1048.495733,1048.664233,1,31454871,31459926,5055,0.7975403903835903
12950,1048.686367,1048.707933,1,31460591,31461237,646,-0.02110537663397156
12951,1048.709233,1048.7397,1,31461276,31462191,915,0.08841232961911333
12952,1048.761933,1048.8865,1,31462857,31466595,3738,0.8455139457564738
12953,1048.9063,1048.9652,1,31467189,31468956,1767,0.10525608260556192
12954,1048.984633,1049.120467,1,31469538,31473614,4076,0.450647073487025
12955,1049.135067,1049.1389,1,31474052,31474166,114,0.5948807423539714
12956,1049.140033,1049.2682,1,31474200,31478046,3846,0.7632633448750564
12957,1049.273767,1049.3558,1,31478213,31480674,2461,0.7838639437256738
12958,1049.357833,1049.385567,1,31480734,31481567,833,0.6370755968144545
12959,1049.388867,1049.4674,1,31481666,31484022,2356,0.5794906150530381
12960,1049.473367,1049.4774,1,31484201,31484322,121,0.3260323452005169
12961,1049.489133,1049.611233,1,31484673,31488336,3663,0.8068345205167843
12962,1049.614867,1049.672167,1,31488446,31490165,1719,0.825639550176959
12963,1049.678933,1049.713167,1,31490367,31491395,1028,0.7107074026995491
12964,1049.714367,1049.721133,1,31491431,31491633,202,0.43007787934428254
12965,1049.722233,1049.780033,1,31491666,31493400,1734,0.48724921995681686
12966,1049.8216,1049.847667,1,31494648,31495430,782,0.7343648392516919
12967,1049.848767,1049.852267,1,31495463,31495568,105,0.4416312328918498
12968,1049.8537,1050.0056,1,31495610,31500168,4558,0.8226697252611109
12969,1050.015467,1050.042667,1,31500464,31501280,816,0.767237213701801
12970,1050.0513,1050.139333,1,31501539,31504179,2640,0.8382417841452874
12971,1050.140833,1050.145333,1,31504224,31504359,135,0.24544744393949453
12972,1050.148567,1050.156333,1,31504457,31504689,232,0.4389280704656375
12973,1050.159067,1050.219567,1,31504772,31506587,1815,-0.008197327917182333
12974,1050.2402,1050.247767,1,31507206,31507433,227,0.2255326966632441
12975,1050.2679,1050.436733,1,31508037,31513101,5064,0.7747678818430099
12976,1050.4454,1050.449167,1,31513362,31513475,113,0.42651518249516523
12977,1050.4526,1050.4843,1,31513578,31514529,951,0.8053124788591319
12978,1050.495033,1050.500233,1,31514850,31515006,156,0.41053141909738355
12979,1050.506833,1050.564067,1,31515204,31516922,1718,0.02819990791559014
12980,1050.596567,1050.812167,1,31517897,31524365,6468,0.8235642746932462
12981,1050.823167,1050.8317,1,31524695,31524951,256,0.19893600635032557
12982,1050.837933,1050.8661,1,31525137,31525983,846,-0.03557436220096809
12983,1050.869333,1050.889233,1,31526079,31526676,597,0.1911501777848453
12984,1050.890467,1050.893967,1,31526714,31526819,105,
12985,1050.958633,1051.1114,1,31528758,31533342,4584,0.8344251611745437
12986,1051.394233,1051.406433,1,31541826,31542192,366,0.5455938544944402
12987,1051.4083,1051.4167,1,31542249,31542501,252,0.057791831661103965
12988,1051.420333,1051.431067,1,31542609,31542932,323,0.04509621535345024
12989,1051.433467,1051.4376,1,31543004,31543128,124,-0.022468179636530285
12990,1051.4386,1051.451567,1,31543158,31543547,389,0.5654523267508154
12991,1051.4608,1051.468133,1,31543824,31544043,219,0.025563215507494918
12992,1051.469867,1051.478033,1,31544096,31544340,244,-0.12358223180818932
12993,1051.4862,1051.496433,1,31544586,31544892,306,-0.07321204262806079
12994,1051.525,1051.602733,1,31545750,31548081,2331,0.7389437595385556
12995,1051.604567,1051.635633,1,31548137,31549068,931,0.6571724388748051
12996,1051.663867,1051.6705,1,31549916,31550115,199,0.27717900155593833
12997,1051.687567,1051.739433,1,31550627,31552182,1555,0.049040384390407026
12998,1051.758867,1051.762367,1,31552766,31552871,105,-0.30216331023355136
12999,1051.7801,1051.7879,1,31553403,31553637,234,0.6100772892561576
13000,1051.796333,1051.837,1,31553889,31555110,1221,0.0782977362336785
13001,1051.845133,1051.8686,1,31555353,31556058,705,-0.004344771015458921
13002,1051.873567,1051.883767,1,31556207,31556513,306,0.009645847751444793
13003,1051.894167,1051.899867,1,31556825,31556996,171,-0.3778211396609866
13004,1051.9402,1052.0646,1,31558206,31561937,3731,0.8223623964512573
13005,1052.0835,1052.106767,1,31562505,31563203,698,0.2276872991601608
13006,1052.113333,1052.132467,1,31563399,31563974,575,0.07297639293943094
13007,1052.134367,1052.141467,1,31564031,31564244,213,0.10280733348668519
13008,1052.1429,1052.1544,1,31564287,31564631,344,-0.14472849013182287
13009,1052.160167,1052.173467,1,31564805,31565204,399,-0.15255913110723407
13010,1052.202967,1052.210867,1,31566089,31566326,237,0.5303073645470453
13011,1052.227033,1052.2539,1,31566810,31567616,806,0.10487254689873438
13012,1052.256967,1052.284967,1,31567709,31568549,840,-0.00034930303196016436
13013,1052.287767,1052.3153,1,31568633,31569459,826,0.3051224880690881
13014,1052.344033,1052.359533,1,31570320,31570785,465,0.7377683725187709
13015,1052.3616,1052.5203,1,31570848,31575608,4760,0.8175510321817305
13016,1052.532,1052.560933,1,31575959,31576827,868,0.782364215558275
13017,1052.5637,1052.6462,1,31576910,31579385,2475,0.8119002323093317
13018,1052.666933,1052.6746,1,31580007,31580238,231,0.5922330030008801
13019,1052.688,1052.713567,1,31580640,31581407,767,0.027140796838735996
13020,1052.7191,1052.7293,1,31581573,31581879,306,0.040037891419162114
13021,1052.735433,1052.744967,1,31582062,31582349,287,0.04106665431665835
13022,1052.8147,1052.965567,1,31584440,31588967,4527,0.8163816081304271
13023,1052.970933,1053.0447,1,31589127,31591340,2213,0.7876737452229949
13024,1053.053033,1053.1402,1,31591590,31594206,2616,0.8079593684393229
13025,1053.1529,1053.2036,1,31594587,31596108,1521,0.004897938409736494
13026,1053.2104,1053.2156,1,31596311,31596468,157,0.13730280987360938
13027,1053.247067,1053.451633,1,31597412,31603548,6136,0.8553837287515177
13028,1053.453667,1053.461633,1,31603610,31603848,238,0.7172673721862732
13029,1053.4756,1053.494267,1,31604268,31604828,560,-0.019151102246074563
13030,1053.4971,1053.502633,1,31604913,31605078,165,-0.15338534195755055
13031,1053.514767,1053.5209,1,31605443,31605627,184,0.12764791356932761
13032,1053.6822,1053.686767,1,31610466,31610603,137,0.19518046878883438
13033,1053.695333,1053.797467,1,31610859,31613924,3065,0.8100762357815868
13034,1053.8124,1053.819667,1,31614372,31614590,218,-0.04333269563077295
13035,1054.1912,1054.1949,1,31625736,31625847,111,0.6967922647516838
13036,1054.207,1054.2239,1,31626210,31626717,507,0.4929312675659968
13037,1054.263,1054.2722,1,31627889,31628166,277,0.3430128833975408
13038,1054.283967,1054.2989,1,31628519,31628967,448,0.7136660946090143
13039,1054.470033,1054.476767,1,31634100,31634303,203,0.36154866527504625
13040,1054.477833,1054.5444,1,31634334,31636332,1998,0.8131334658253546
13041,1054.5496,1054.7848,1,31636488,31643543,7055,0.7737278018967462
13042,1054.7874,1054.8105,1,31643621,31644315,694,0.6189508777313866
13043,1054.811867,1054.942967,1,31644356,31648289,3933,0.7858408358204265
13044,1055.047033,1055.050233,1,31651410,31651506,96,0.6150904771576811
13045,1055.053,1055.244367,1,31651590,31657331,5741,0.8654754601789922
13046,1055.2666,1055.338767,1,31657997,31660163,2166,0.8079353692733161
13047,1055.3664,1055.392233,1,31660992,31661766,774,0.7549308731484133
13048,1055.3973,1055.4732,1,31661919,31664195,2276,0.77727975301545
13049,1055.474633,1055.498433,1,31664238,31664952,714,0.41125263201301177
13050,1055.5009,1055.585833,1,31665027,31667574,2547,0.8148663306240855
13051,1055.5893,1055.6127,1,31667679,31668380,701,0.9108438398615938
13052,1055.615433,1055.7006,1,31668462,31671017,2555,0.8597505946644781
13053,1055.703667,1055.729067,1,31671110,31671872,762,0.7273261614772139
13054,1055.731767,1055.818667,1,31671953,31674560,2607,0.8440987942602088
13055,1055.821,1055.837367,1,31674629,31675121,492,0.8573097853625357
13056,1055.838367,1055.8483,1,31675151,31675449,298,0.860574701562449
13057,1055.851367,1055.9359,1,31675541,31678077,2536,0.845664594476873
13058,1055.938167,1055.9576,1,31678145,31678728,583,0.27110941979816433
13059,1055.958767,1055.9662,1,31678763,31678986,223,0.8634776554757445
13060,1055.968833,1056.063133,1,31679064,31681893,2829,0.8403872584793138
13061,1056.064867,1056.180433,1,31681946,31685412,3466,0.5285481698652701
13062,1056.193767,1056.1996,1,31685813,31685987,174,
13063,1056.215267,1056.2184,1,31686458,31686552,94,
13064,1056.2246,1056.244567,1,31686738,31687337,599,-0.10456299568113445
13065,1056.249233,1056.335167,1,31687476,31690055,2579,0.8154169421219689
13066,1056.791733,1056.8002,1,31703751,31704005,254,0.6454702791777109
13067,1056.802233,1056.816767,1,31704066,31704503,437,0.6534745163162528
13068,1056.851033,1056.8686,1,31705530,31706058,528,0.6753446430321147
13069,1057.139233,1057.1863,1,31714176,31715589,1413,0.643911209418827
13070,1057.199667,1057.282033,1,31715990,31718460,2470,0.7786361682214247
13071,1057.303267,1057.307,1,31719098,31719210,112,-0.04301537833860388
13072,1057.308067,1057.312833,1,31719242,31719384,142,
13073,1057.6445,1057.671367,1,31729335,31730141,806,0.7851002522750934
13074,1057.680533,1057.7377,1,31730415,31732130,1715,0.646964903478924
13075,1057.754533,1057.786633,1,31732635,31733598,963,0.6798659295217668
13076,1057.805467,1057.846633,1,31734164,31735398,1234,0.6288718395271027
13077,1057.9228,1057.9431,1,31737684,31738293,609,-0.0636306323029215
13078,1057.9442,1057.949567,1,31738325,31738487,162,0.07705410919631941
13079,1057.967633,1057.983767,1,31739028,31739513,485,0.6976860875737213
13080,1057.9853,1058.027567,1,31739559,31740827,1268,0.867879148913888
13081,1058.0309,1058.073633,1,31740927,31742208,1281,0.7979496746794944
13082,1058.0952,1058.1175,1,31742856,31743525,669,-0.06228041558465558
13083,1058.123433,1058.1325,1,31743702,31743974,272,0.01951174038469547
13084,1058.133633,1058.1372,1,31744008,31744115,107,-0.4402413564853156
13085,1058.145233,1058.2737,1,31744356,31748211,3855,0.8689455753538984
13086,1058.287567,1058.373433,1,31748627,31751202,2575,0.7942514917366275
13087,1058.474567,1058.479,1,31754237,31754370,133,0.7840492056666085
13088,1058.480767,1058.510467,1,31754423,31755314,891,0.4860803255375358
13089,1058.518,1058.594067,1,31755540,31757822,2282,0.4279615897715166
13090,1058.597367,1058.717933,1,31757921,31761537,3616,0.7828856619181925
13091,1058.7281,1058.9177,1,31761843,31767531,5688,0.7852181644662865
13092,1058.933667,1058.948967,1,31768010,31768469,459,-0.05853462657779195
13093,1058.952533,1058.9738,1,31768575,31769214,639,0.15772870540956674
13094,1058.975,1058.982767,1,31769249,31769483,234,0.10546735630450096
13095,1059.009567,1059.127967,1,31770287,31773839,3552,0.7959205673084194
13096,1059.141133,1059.1648,1,31774233,31774944,711,0.00576406818723948
13097,1059.165867,1059.176933,1,31774976,31775307,331,0.13202663182730484
13098,1059.178067,1059.182567,1,31775342,31775477,135,
13099,1059.1987,1059.369,1,31775960,31781069,5109,0.8262930891056969
13100,1059.395933,1059.406233,1,31781877,31782186,309,-0.018596368543792176
13101,1059.4131,1059.421867,1,31782393,31782656,263,0.2882908374074393
13102,1059.438967,1059.4661,1,31783169,31783983,814,0.01226455140386392
13103,1059.474267,1059.479567,1,31784228,31784387,159,0.3687676454724673
13104,1059.4831,1059.592,1,31784492,31787760,3268,0.784891404094601
13105,1059.5931,1059.6219,1,31787793,31788657,864,0.8016711963734859
13106,1059.649033,1059.657267,1,31789470,31789718,248,-0.1518000813229449
13107,1059.831467,1059.932033,1,31794944,31797960,3016,0.7696660337515733
13108,1059.9561,1059.960867,1,31798683,31798826,143,
13109,1060.742633,1060.748167,1,31822278,31822445,167,0.5425062772460398
13110,1060.756133,1060.779267,1,31822683,31823378,695,0.4287514404119514
13111,1060.808533,1060.8117,1,31824255,31824351,96,0.006540609069140036
13112,1060.824633,1060.829567,1,31824738,31824887,149,0.5839551880192975
13113,1060.878367,1060.886967,1,31826351,31826609,258,0.5733242256410988
13114,1060.942267,1060.952,1,31828268,31828560,292,0.6447972423825185
13115,1060.979567,1061.0019,1,31829387,31830057,670,0.6328899897330134
13116,1061.2024,1061.3469,1,31836071,31840407,4336,0.8517192429229574
13117,1061.371433,1061.518967,1,31841142,31845569,4427,0.7671776413157853
13118,1061.539033,1061.542367,1,31846170,31846271,101,-0.3182005330244238
13119,1061.546267,1061.551733,1,31846388,31846551,163,-0.4983974490445921
13120,1061.608567,1061.613833,1,31848257,31848414,157,-0.09561931817672119
13121,1061.615767,1061.7347,1,31848473,31852041,3568,0.8329978699118973
13122,1061.737967,1061.7423,1,31852139,31852268,129,0.3811054359126141
13123,1062.194,1062.2033,1,31865820,31866098,278,0.5876202732840653
13124,1062.216533,1062.2266,1,31866495,31866798,303,0.14567901634143773
13125,1062.264367,1062.300933,1,31867931,31869027,1096,0.6403838478554505
13126,1062.327167,1062.369667,1,31869815,31871090,1275,0.6657540764585623
13127,1062.397767,1062.4087,1,31871933,31872261,328,0.7985997141512731
13128,1062.4285,1062.4707,1,31872855,31874121,1266,0.6322162407893286
13129,1062.498067,1062.514133,1,31874942,31875423,481,0.7045845910897756
13130,1062.527033,1062.534267,1,31875810,31876028,218,0.375788932287015
13131,1062.542567,1062.551233,1,31876277,31876536,259,0.49842171081073217
13132,1062.553167,1062.5937,1,31876595,31877810,1215,-0.0926782163476259
13133,1062.6153,1062.631133,1,31878458,31878933,475,0.7615753991898322
13134,1062.6327,1062.6688,1,31878981,31880063,1082,0.7742857642885353
13135,1062.6707,1062.721533,1,31880120,31881645,1525,0.7919935743692864
13136,1062.736033,1062.768833,1,31882080,31883064,984,0.011141363874643097
13137,1062.774667,1062.781733,1,31883240,31883451,211,0.1675666422602196
13138,1062.7845,1062.9432,1,31883535,31888295,4760,0.800849414585005
13139,1062.9479,1062.963533,1,31888436,31888905,469,0.39778810687215266
13140,1062.9705,1062.9755,1,31889114,31889265,151,-0.055769565881385874
13141,1062.979533,1062.9871,1,31889385,31889613,228,0.20543001992778756
13142,1062.996133,1063.0031,1,31889883,31890092,209,-0.027014400713889015
13143,1063.0146,1063.023867,1,31890438,31890716,278,0.2795638437555165
13144,1063.025233,1063.030733,1,31890756,31890921,165,0.7842846664176049
13145,1063.031967,1063.0355,1,31890959,31891065,106,0.5611467460230668
13146,1063.079867,1063.086967,1,31892396,31892609,213,-0.007943751956887422
13147,1063.092567,1063.112833,1,31892777,31893384,607,0.7195149219089946
13148,1063.114833,1063.120667,1,31893444,31893620,176,-0.09492335101885281
13149,1063.358133,1063.524633,1,31900743,31905738,4995,0.7911038661782612
13150,1063.533333,1063.5371,1,31905999,31906113,114,0.3000067668176207
13151,1064.0091,1064.0153,1,31920273,31920459,186,0.6370650064004706
13152,1064.021933,1064.031133,1,31920657,31920933,276,0.5368914911894648
13153,1064.032367,1064.0427,1,31920971,31921281,310,0.23191595521308594
13154,1064.070067,1064.088667,1,31922102,31922660,558,0.5841610826315925
13155,1064.0911,1064.095667,1,31922733,31922870,137,0.013693001537084718
13156,1064.117233,1064.1226,1,31923516,31923677,161,0.6052782731776456
13157,1064.146733,1064.235033,1,31924401,31927050,2649,0.7189916384369099
13158,1064.250667,1064.287633,1,31927520,31928628,1108,0.7874940704323663
13159,1064.299433,1064.3113,1,31928982,31929339,357,0.6969892110268322
13160,1064.323167,1064.332767,1,31929695,31929983,288,0.4407113606889254
13161,1064.346767,1064.360067,1,31930403,31930802,399,-0.10540606653775877
13162,1064.3625,1064.377267,1,31930875,31931318,443,0.00043018078344987177
13163,1064.3811,1064.388033,1,31931433,31931640,207,0.6324835193643734
13164,1064.430233,1064.735467,1,31932906,31942064,9158,0.741402761787412
13165,1064.744433,1064.747433,1,31942332,31942422,90,-0.3505034300018914
13166,1064.8264,1064.832567,1,31944791,31944977,186,0.10102375951312599
13167,1064.836367,1064.886733,1,31945091,31946601,1510,0.7319411202497283
13168,1064.888333,1064.894467,1,31946649,31946834,185,0.774913586330918
13169,1064.8955,1064.938633,1,31946865,31948158,1293,0.6698346953368008
13170,1064.945133,1064.948667,1,31948353,31948460,107,-0.06216164420190703
13171,1064.961433,1064.9694,1,31948842,31949082,240,0.193002181521648
13172,1064.971667,1064.984,1,31949150,31949519,369,0.25602829496329166
13173,1064.985033,1064.990967,1,31949550,31949729,179,0.5392637220721342
13174,1065.019467,1065.229267,1,31950584,31956878,6294,0.8091014111506296
13175,1065.2469,1065.254667,1,31957407,31957640,233,0.6227149220004536
13176,1065.265,1065.304133,1,31957950,31959123,1173,0.007492941634240746
13177,1065.322533,1065.3418,1,31959675,31960253,578,0.8175062301048094
13178,1065.3443,1065.460433,1,31960329,31963812,3483,0.780796453082295
13179,1065.4623,1065.466833,1,31963868,31964004,136,0.7183670360418344
13180,1065.468067,1065.5334,1,31964042,31966002,1960,0.7708564241752747
13181,1065.5433,1065.621567,1,31966299,31968647,2348,0.8127315704546466
13182,1065.631967,1065.670267,1,31968959,31970108,1149,0.6478564019408959
13183,1065.684067,1065.706133,1,31970522,31971183,661,0.14937538243311324
13184,1065.707567,1065.729867,1,31971227,31971896,669,0.0001722506681036646
13185,1065.741833,1065.768433,1,31972254,31973052,798,0.6772994812432375
13186,1065.769733,1066.0009,1,31973091,31980027,6936,0.7925322395071075
13187,1066.0251,1066.0405,1,31980753,31981215,462,0.07154447170215286
13188,1066.0494,1066.0651,1,31981482,31981953,471,0.04859971990246151
13189,1066.096467,1066.2189,1,31982894,31986567,3673,0.7012769480499945
13190,1066.2317,1066.249067,1,31986951,31987472,521,0.10805380606778855
13191,1066.250133,1066.262367,1,31987503,31987871,368,0.06974905376127605
13192,1066.281067,1066.3606,1,31988432,31990818,2386,0.7715176746461013
13193,1066.3623,1066.365333,1,31990869,31990959,90,0.8551851202572618
13194,1066.366533,1066.4046,1,31990995,31992138,1143,0.7056569278291509
13195,1066.415367,1066.418867,1,31992461,31992566,105,0.04862396953469663
13196,1066.420067,1066.429633,1,31992602,31992888,286,-0.2760313803469196
13197,1066.431067,1066.4408,1,31992932,31993224,292,-0.06740111579853264
13198,1066.445533,1066.453433,1,31993365,31993602,237,-0.3033828256724241
13199,1066.520133,1066.608967,1,31995603,31998269,2666,0.8101088003878295
13200,1066.6131,1066.701067,1,31998393,32001032,2639,0.8121999567404162
13201,1067.055867,1067.061433,1,32011676,32011842,166,0.677640157608161
13202,1067.0633,1067.067933,1,32011899,32012037,138,0.5378698555495944
13203,1067.073233,1067.076733,1,32012196,32012301,105,0.6203876300267939
13204,1067.078433,1067.082167,1,32012352,32012465,113,0.7211910108161089
13205,1067.101,1067.109133,1,32013030,32013273,243,0.7420217251228389
13206,1067.1325,1067.153867,1,32013974,32014616,642,0.8658797446548162
13207,1067.157067,1067.160233,1,32014712,32014806,94,0.6344052178711636
13208,1067.162933,1067.220633,1,32014887,32016618,1731,0.7718749908196376
13209,1067.222733,1067.263567,1,32016681,32017907,1226,0.7906427485704208
13210,1067.269533,1067.297833,1,32018085,32018934,849,0.8011317653548904
13211,1067.302867,1067.378967,1,32019086,32021369,2283,0.7757128926256103
13212,1067.3832,1067.4858,1,32021496,32024573,3077,0.7558462419633982
13213,1067.487033,1067.4923,1,32024610,32024768,158,0.7684107080971443
13214,1067.503433,1067.5072,1,32025102,32025216,114,0.32987236449859186
13215,1067.5418,1067.546333,1,32026254,32026389,135,-0.12957667340126752
13216,1067.5553,1067.561967,1,32026659,32026859,200,0.04812961452726026
13217,1067.79,1067.795633,1,32033700,32033868,168,0.7615699028457025
13218,1067.796867,1067.817067,1,32033906,32034512,606,0.828041979654233
13219,1067.821533,1067.8603,1,32034645,32035809,1164,0.845309459460831
13220,1067.8666,1067.935667,1,32035998,32038070,2072,0.8165243598203179
13221,1067.936867,1067.947967,1,32038106,32038439,333,0.687328274997596
13222,1067.968433,1068.082167,1,32039052,32042465,3413,0.7998096206540329
13223,1068.089367,1068.166967,1,32042681,32045009,2328,0.7133874223386152
13224,1068.176567,1068.201733,1,32045297,32046051,754,0.7602055413492801
13225,1068.2125,1068.222433,1,32046375,32046672,297,0.6813532666035871
13226,1068.2474,1068.2638,1,32047422,32047914,492,-0.02069793032773565
13227,1068.268567,1068.286033,1,32048057,32048580,523,0.1532704830840919
13228,1068.292133,1068.2978,1,32048763,32048934,171,0.5071949560030695
13229,1068.390067,1068.415167,1,32051702,32052455,753,0.7804587234871461
13230,1068.418867,1068.525133,1,32052566,32055753,3187,0.7899336487857648
13231,1068.577667,1068.6646,1,32057330,32059938,2608,0.8051716035643639
13232,1068.687033,1068.691,1,32060610,32060730,120,-0.054941796852570904
13233,1069.0596,1069.071667,1,32071788,32072150,362,0.6925789109438043
13234,1069.074967,1069.081267,1,32072249,32072438,189,0.5315500098425464
13235,1069.094967,1069.111767,1,32072849,32073353,504,0.8479978078149405
13236,1069.142467,1069.147033,1,32074274,32074410,136,0.7014819087594857
13237,1069.1936,1069.227467,1,32075808,32076824,1016,0.7895900265243184
13238,1069.228967,1069.2975,1,32076869,32078924,2055,0.7587408699787453
13239,1069.3121,1069.3558,1,32079363,32080674,1311,0.7444193926563536
13240,1069.653167,1069.657533,1,32089595,32089725,130,0.40690249343755214
13241,1069.659067,1069.7215,1,32089772,32091645,1873,0.7948477852702628
13242,1069.725233,1069.781133,1,32091756,32093433,1677,0.7929147203836815
13243,1069.792267,1069.801967,1,32093768,32094059,291,0.7376263290976118
13244,1069.8058,1069.815233,1,32094174,32094456,282,0.6268017228670403
13245,1069.819433,1069.8605,1,32094582,32095815,1233,0.7517441439849617
13246,1069.867433,1069.915067,1,32096022,32097452,1430,0.6595180712051116
13247,1069.916367,1069.9195,1,32097491,32097585,94,0.8966571551382414
13248,1069.936467,1069.9932,1,32098094,32099795,1701,0.8179212350043539
13249,1070.002533,1070.016333,1,32100075,32100489,414,0.6994878125550493
13250,1070.0197,1070.094233,1,32100591,32102826,2235,0.7769524493930858
13251,1070.1238,1070.129067,1,32103714,32103872,158,-0.05653260289692737
13252,1070.131267,1070.135267,1,32103938,32104058,120,-0.1369511589772319
13253,1070.365533,1070.3715,1,32110965,32111145,180,0.5364960965521988
13254,1070.373667,1070.430667,1,32111210,32112920,1710,0.7860406230226492
13255,1070.4355,1070.522833,1,32113065,32115684,2619,0.7879522517039745
13256,1070.524567,1070.589033,1,32115737,32117670,1933,0.706347914362906
13257,1070.616967,1070.6429,1,32118509,32119287,778,0.8011682509240637
13258,1070.646367,1070.718067,1,32119391,32121542,2151,0.7597436405699342
13259,1070.721367,1070.727067,1,32121641,32121812,171,0.774654347757755
13260,1070.743733,1070.8168,1,32122311,32124504,2193,0.7745237490278682
13261,1070.8241,1070.843033,1,32124723,32125290,567,0.5449003179305747
13262,1070.862833,1070.873133,1,32125884,32126193,309,-0.09900056417491487
13263,1070.8806,1070.8996,1,32126418,32126988,570,0.05499351105085767
13264,1071.042,1071.088633,1,32131259,32132658,1399,0.5925355475284686
13265,1071.3314,1071.553167,1,32139942,32146595,6653,0.8052334156691641
13266,1071.5607,1071.6574,1,32146821,32149722,2901,0.747697273688862
13267,1071.6798,1071.741867,1,32150393,32152256,1863,0.7958542892272188
13268,1071.7455,1071.7549,1,32152365,32152646,281,0.4960481860628598
13269,1071.773467,1071.778967,1,32153204,32153369,165,-0.08209228639012886
13270,1071.794,1071.804033,1,32153820,32154120,300,-0.03625722931567743
13271,1071.875367,1071.894767,1,32156261,32156843,582,0.6426930579768508
13272,1072.178033,1072.185933,1,32165340,32165577,237,0.5647065788375181
13273,1072.191267,1072.2052,1,32165738,32166156,418,0.7098053075704712
13274,1072.219733,1072.3836,1,32166591,32171507,4916,0.7689113603887723
13275,1072.404333,1072.508233,1,32172129,32175246,3117,0.7666068304353146
13276,1072.509967,1072.5652,1,32175299,32176956,1657,0.7263348938381716
13277,1072.5691,1072.584733,1,32177072,32177541,469,0.5930086499024706
13278,1072.588767,1072.6793,1,32177663,32180379,2716,0.793406033869889
13279,1072.682933,1072.7057,1,32180487,32181171,684,0.8241395370073291
13280,1072.764967,1072.7689,1,32182949,32183067,118,-0.1264573956633565
13281,1072.809433,1072.849433,1,32184282,32185482,1200,0.21866390380108403
13282,1073.101133,1073.106567,1,32193033,32193197,164,
13283,1073.109667,1073.163,1,32193290,32194890,1600,0.7194150917323253
13284,1073.164067,1073.1693,1,32194922,32195079,157,-0.10554792705405668
13285,1073.170567,1073.215533,1,32195117,32196465,1348,0.7895196007321714
13286,1073.229067,1073.237267,1,32196872,32197118,246,-0.0826395812889627
13287,1073.2589,1073.265533,1,32197767,32197965,198,0.10384173902205272
13288,1073.302067,1073.306167,1,32199062,32199185,123,0.1312384682330822
13289,1073.3178,1073.326167,1,32199534,32199785,251,0.19299980784251017
13290,1073.357067,1073.430033,1,32200712,32202900,2188,0.3864135826293561
13291,1073.8508,1073.868167,1,32215523,32216045,522,0.5819526051300283
13292,1073.8696,1073.872967,1,32216088,32216189,101,0.2034096644559837
13293,1073.898933,1073.9174,1,32216967,32217522,555,0.5795696691426354
13294,1073.944833,1073.9504,1,32218344,32218512,168,0.5405159134186033
13295,1074.121233,1074.1322,1,32223636,32223966,330,0.5769315095158275
13296,1074.141233,1074.1653,1,32224236,32224958,722,0.3847266605501835
13297,1074.1849,1074.192767,1,32225547,32225783,236,0.31837293231634145
13298,1074.317933,1074.355867,1,32229537,32230676,1139,0.5776358335035978
13299,1074.362433,1074.3885,1,32230872,32231655,783,0.6918321000559395
13300,1074.413233,1074.422167,1,32232396,32232665,269,-0.0045181982171834225
13301,1074.429833,1074.440367,1,32232894,32233211,317,0.07005554977405458
13302,1074.442333,1074.451267,1,32233269,32233538,269,0.2340119088263909
13303,1074.4564,1074.465533,1,32233692,32233965,273,-0.15926870448519215
13304,1074.537033,1074.5658,1,32236110,32236974,864,0.4479339247849091
13305,1074.5672,1074.573167,1,32237016,32237195,179,-0.3243829769191418
13306,1074.5955,1074.605567,1,32237864,32238167,303,-0.018300663565993164
13307,1074.6066,1074.614067,1,32238198,32238422,224,0.27097944609975216
13308,1074.624967,1074.632867,1,32238749,32238986,237,-0.08713754522833328
13309,1074.719833,1074.849267,1,32241594,32245478,3884,0.8473035102158922
13310,1074.8565,1074.8605,1,32245695,32245815,120,-0.11158673052748047
13311,1075.3665,1075.394067,1,32260995,32261822,827,0.6188143911598992
13312,1075.428367,1075.446433,1,32262851,32263392,541,0.6276601191773805
13313,1075.474667,1075.4783,1,32264240,32264349,109,0.5611874415746719
13314,1075.503367,1075.5108,1,32265101,32265324,223,0.4637535544370294
13315,1075.515633,1075.525867,1,32265468,32265776,308,0.6112118224029666
13316,1075.590667,1075.6021,1,32267720,32268063,343,0.6900091367522896
13317,1075.626933,1075.6331,1,32268807,32268993,186,0.5948238114086072
13318,1075.6362,1075.650967,1,32269085,32269529,444,0.5881986566641665
13319,1075.667033,1075.6776,1,32270010,32270328,318,0.47636112674324577
13320,1075.6873,1075.690967,1,32270619,32270729,110,0.6256801445906094
13321,1075.702333,1075.706067,1,32271069,32271182,113,0.17439327615950803
13322,1075.7127,1075.7237,1,32271381,32271711,330,0.08966117105105732
13323,1075.725467,1075.732567,1,32271764,32271977,213,0.08079151629844743
13324,1075.766867,1075.831633,1,32273006,32274948,1942,0.7732143097982243
13325,1075.8327,1075.888933,1,32274980,32276667,1687,0.7423799121083603
13326,1075.9203,1076.107333,1,32277609,32283219,5610,0.7931628572281644
13327,1076.111633,1076.127967,1,32283348,32283839,491,0.7040683877830759
13328,1076.134467,1076.1977,1,32284034,32285931,1897,0.7761649393549979
13329,1076.2195,1076.2232,1,32286584,32286695,111,0.31487080313378457
13330,1076.242667,1076.2463,1,32287280,32287389,109,
13331,1076.519333,1076.545867,1,32295579,32296376,797,0.697277488022154
13332,1076.592033,1076.649833,1,32297760,32299494,1734,0.7595191621812368
13333,1076.650933,1076.6752,1,32299527,32300255,728,0.6863263512482891
13334,1076.6799,1076.7602,1,32300397,32302806,2409,0.7833159659726875
13335,1076.7629,1076.834367,1,32302887,32305031,2144,0.7033920854481508
13336,1076.846133,1076.881033,1,32305383,32306430,1047,0.7054594825834379
13337,1076.903833,1076.914333,1,32307114,32307429,315,-0.07770298503763443
13338,1076.924033,1076.9407,1,32307720,32308221,501,0.0002690835305168994
13339,1076.9481,1076.955667,1,32308443,32308670,227,0.1925243211562793
13340,1077.397333,1077.401467,1,32321919,32322044,125,
13341,1077.407,1077.415867,1,32322209,32322476,267,0.7405648146798663
13342,1077.421067,1077.428167,1,32322632,32322845,213,0.4780887374083761
13343,1077.431233,1077.435067,1,32322936,32323052,116,0.17477464225499237
13344,1077.4886,1077.5045,1,32324657,32325135,478,0.6217146570240132
13345,1077.5989,1077.6102,1,32327967,32328306,339,0.2858784738499706
13346,1077.658633,1077.6743,1,32329758,32330228,470,0.6656653177836942
13347,1077.848133,1077.989933,1,32335443,32339697,4254,0.776057350774252
13348,1078.004967,1078.130867,1,32340149,32343926,3777,0.8151868282833746
13349,1078.133367,1078.192533,1,32344001,32345775,1774,0.7688813154102652
13350,1078.197967,1078.2229,1,32345939,32346687,748,0.757697461756517
13351,1078.226633,1078.2742,1,32346798,32348226,1428,0.7563551076665104
13352,1078.283367,1078.295233,1,32348501,32348856,355,0.7810767803016364
13353,1078.414067,1078.4212,1,32352422,32352636,214,0.14293919029983818
13354,1078.4252,1078.439333,1,32352755,32353179,424,0.6356366482967332
13355,1078.440433,1078.477567,1,32353212,32354327,1115,0.7270892555895592
13356,1078.479867,1078.4838,1,32354396,32354514,118,0.23586235484390344
13357,1078.488567,1078.526067,1,32354657,32355782,1125,0.779931764195385
13358,1078.5352,1078.542967,1,32356056,32356289,233,-0.08220841607771717
13359,1078.5528,1078.593467,1,32356583,32357804,1221,0.09537598268222322
13360,1078.603367,1078.632567,1,32358101,32358977,876,0.7120928535758987
13361,1078.635233,1078.7961,1,32359056,32363883,4827,0.8272039714185029
13362,1078.798333,1078.926033,1,32363949,32367780,3831,0.7655794487756296
13363,1078.928333,1078.937667,1,32367849,32368130,281,0.6597407896494155
13364,1078.949633,1078.974533,1,32368488,32369235,747,0.7695366425356148
13365,1078.9796,1079.067633,1,32369387,32372028,2641,0.7399867833794989
13366,1079.081233,1079.104967,1,32372436,32373149,713,-0.010066152484938718
13367,1079.1079,1079.1185,1,32373237,32373555,318,0.04928905793626627
13368,1079.147833,1079.272133,1,32374434,32378163,3729,0.7833934624129422
13369,1079.2925,1079.388767,1,32378775,32381663,2888,0.7819985960969934
13370,1079.590167,1079.601667,1,32387705,32388050,345,0.5096146571760664
13371,1079.626967,1079.632833,1,32388809,32388984,175,0.0024393876200767685
13372,1079.660333,1079.712333,1,32389809,32391369,1560,0.7500562113645737
13373,1079.716367,1079.9285,1,32391491,32397855,6364,0.7647291672012841
13374,1079.959333,1079.9826,1,32398779,32399478,699,0.7756834064020497
13375,1079.9858,1080.038267,1,32399573,32401148,1575,0.7757749993154333
13376,1080.044033,1080.087467,1,32401320,32402624,1304,0.7551341376023079
13377,1080.090067,1080.181433,1,32402702,32405442,2740,0.7962890778828369
13378,1080.1841,1080.2099,1,32405523,32406297,774,0.7956180303249314
13379,1080.213033,1080.2892,1,32406390,32408675,2285,0.8223946800320134
13380,1080.291533,1080.329533,1,32408745,32409885,1140,0.7939431709842806
13381,1080.336333,1080.433267,1,32410089,32412998,2909,0.8230990397188446
13382,1080.435433,1080.4506,1,32413062,32413517,455,0.7906046610319043
13383,1080.460067,1080.537533,1,32413802,32416125,2323,0.808660863473875
13384,1080.5401,1080.553667,1,32416203,32416610,407,0.7996167934991355
13385,1080.5571,1080.578633,1,32416713,32417358,645,0.8008388243491847
13386,1080.5839,1080.681267,1,32417517,32420438,2921,0.831946477331105
13387,1080.684167,1080.709767,1,32420525,32421293,768,0.8616960917551274
13388,1080.7128,1080.809733,1,32421384,32424291,2907,0.8297340555056619
13389,1080.812567,1080.839267,1,32424377,32425178,801,0.8089280108346466
13390,1080.841333,1080.940633,1,32425239,32428218,2979,0.7899139542341538
13391,1080.943467,1080.9479,1,32428304,32428436,132,0.8763442942869476
13392,1080.9491,1080.9641,1,32428473,32428922,449,0.8220890532598512
13393,1080.973667,1081.074933,1,32429210,32432247,3037,0.80838961232695
13394,1081.077167,1081.104167,1,32432315,32433125,810,0.7946233678907442
13395,1081.107433,1081.1955,1,32433222,32435865,2643,0.7853871955089131
13396,1081.198767,1081.223567,1,32435963,32436707,744,0.8964830434504066
13397,1081.225367,1081.293133,1,32436761,32438793,2032,0.7733444239693228
13398,1081.305533,1081.318367,1,32439165,32439551,386,0.7010444538324301
13399,1081.3269,1081.337233,1,32439807,32440116,309,0.5225711196188483
13400,1081.356467,1081.365133,1,32440694,32440953,259,-0.09722372332903265
13401,1081.410033,1081.4147,1,32442300,32442441,141,0.024333533190709293
13402,1081.424567,1081.435667,1,32442737,32443070,333,0.20701868952966518
13403,1081.594067,1081.605533,1,32447822,32448165,343,0.6297441090321572
13404,1081.649733,1081.658767,1,32449491,32449763,272,0.4167505430905069
13405,1081.8509,1081.881433,1,32455526,32456442,916,0.46293796737739695
13406,1081.886433,1081.9159,1,32456592,32457477,885,0.03652543296011762
13407,1081.9201,1081.945767,1,32457603,32458373,770,0.05660193757713176
13408,1081.948367,1081.9552,1,32458451,32458656,205,-0.040363086627863067
13409,1082.002033,1082.011167,1,32460060,32460335,275,0.6456925174829666
13410,1082.012267,1082.0153,1,32460368,32460459,91,0.3298256776847313
13411,1082.020167,1082.0457,1,32460605,32461370,765,0.34211622098836364
13412,1082.048,1082.083,1,32461440,32462490,1050,0.03189073792189105
13413,1082.086567,1082.097167,1,32462597,32462915,318,-0.04751702623433609
13414,1082.104067,1082.111333,1,32463122,32463339,217,0.10489352814822867
13415,1082.1162,1082.129767,1,32463485,32463893,408,0.14959568520550856
13416,1082.146667,1082.1907,1,32464400,32465721,1321,0.14159162259290553
13417,1082.194167,1082.225033,1,32465825,32466750,925,0.17761866210807623
13418,1082.2289,1082.236633,1,32466867,32467098,231,0.14980069737476392
13419,1082.248633,1082.255567,1,32467458,32467667,209,0.2941914423802165
13420,1082.298067,1082.303367,1,32468942,32469101,159,0.40119224956678196
13421,1082.3054,1082.337667,1,32469162,32470130,968,0.2530877321626929
13422,1082.343533,1082.3734,1,32470305,32471202,897,0.16590437803003852
13423,1082.379667,1082.388533,1,32471390,32471655,265,-0.001581930491380031
13424,1082.398367,1082.4061,1,32471951,32472182,231,0.22706288970505703
13425,1082.4323,1082.477867,1,32472969,32474336,1367,0.1683749383621052
13426,1082.4812,1082.516467,1,32474436,32475494,1058,-0.03030828415952495
13427,1082.518333,1082.5261,1,32475549,32475783,234,-0.0968233385757304
13428,1082.541733,1082.547933,1,32476251,32476437,186,0.06395116563314586
13429,1082.5925,1082.5971,1,32477775,32477913,138,0.45638693725844803
13430,1082.602933,1082.623933,1,32478087,32478717,630,0.17796761476736914
13431,1082.6267,1082.631067,1,32478801,32478932,131,0.40037413128092847
13432,1082.634633,1082.658333,1,32479038,32479749,711,0.11544150986349938
13433,1082.665867,1082.6733,1,32479976,32480198,222,-0.08454105473091679
13434,1082.676,1082.6877,1,32480279,32480631,352,-0.05287172056596676
13435,1082.701133,1082.711267,1,32481033,32481338,305,0.20451431004854392
13436,1082.769633,1082.7747,1,32483088,32483241,153,0.13789191194787048
13437,1082.786733,1082.8054,1,32483601,32484162,561,0.6507362813403788
13438,1082.8269,1082.830567,1,32484807,32484917,110,
13439,1083.383633,1083.392467,1,32501508,32501774,266,0.6562049347581741
13440,1083.3941,1083.399167,1,32501823,32501975,152,0.10197863451077967
13441,1083.414833,1083.4209,1,32502444,32502627,183,0.6236293878796042
13442,1083.4398,1083.444433,1,32503194,32503332,138,0.31973581499406073
13443,1083.463733,1083.473067,1,32503911,32504192,281,0.6510228741323416
13444,1083.518367,1083.527033,1,32505551,32505810,259,0.6002348556964108
13445,1083.587467,1083.597167,1,32507624,32507915,291,0.600336929147621
13446,1083.623967,1083.6298,1,32508719,32508893,174,0.6579353542658405
13447,1083.632667,1083.647133,1,32508980,32509413,433,0.5961130271894063
13448,1083.669067,1083.6739,1,32510072,32510217,145,0.2080467309302888
13449,1083.675433,1083.683667,1,32510262,32510510,248,0.008852010041671998
13450,1083.6901,1083.6972,1,32510703,32510916,213,0.3662490758872029
13451,1083.702167,1083.7109,1,32511065,32511327,262,0.008841313128396009
13452,1083.723067,1083.7309,1,32511692,32511927,235,0.017960579749350135
13453,1083.735367,1083.7526,1,32512061,32512578,517,0.06553483791080375
13454,1083.762567,1083.784233,1,32512877,32513526,649,0.7650456714795718
13455,1083.785867,1083.8229,1,32513576,32514686,1110,0.7969192236954402
13456,1083.824233,1083.850667,1,32514726,32515520,794,0.6663745857932221
13457,1083.851667,1083.8729,1,32515550,32516187,637,0.8857621439592808
13458,1083.876967,1083.8823,1,32516309,32516469,160,0.5506117931657946
13459,1083.8985,1083.921767,1,32516955,32517653,698,0.03155347077730998
13460,1083.926633,1083.9363,1,32517798,32518089,291,0.09207811834269021
13461,1083.943667,1083.948167,1,32518310,32518445,135,0.42695572616722877
13462,1083.993067,1084.0325,1,32519792,32520975,1183,0.215061615423117
13463,1084.0349,1084.066967,1,32521047,32522009,962,0.07307111418665625
13464,1084.0681,1084.084833,1,32522043,32522544,501,0.18198954603138867
13465,1084.085867,1084.094767,1,32522576,32522843,267,0.23314820320914906
13466,1084.108267,1084.291033,1,32523248,32528730,5482,0.8055615590433003
13467,1084.2984,1084.347033,1,32528951,32530410,1459,0.7723613203870204
13468,1084.374633,1084.4003,1,32531238,32532009,771,0.7522937107404519
13469,1084.440233,1084.5187,1,32533206,32535561,2355,0.8047364504047363
13470,1084.533,1084.5362,1,32535989,32536086,97,
13471,1084.6308,1084.634567,1,32538923,32539037,114,0.6701019096903006
13472,1084.6573,1084.6905,1,32539719,32540714,995,0.6107073286556995
13473,1084.6997,1084.819667,1,32540990,32544590,3600,0.7504913168222075
13474,1084.835633,1084.9107,1,32545068,32547320,2252,0.749615835459979
13475,1084.9138,1084.9209,1,32547414,32547627,213,0.4892509389088352
13476,1084.9345,1084.9432,1,32548035,32548295,260,0.8834740086524228
13477,1084.952633,1084.968533,1,32548578,32549055,477,0.6508723646616477
13478,1084.970367,1085.0472,1,32549111,32551416,2305,0.7880027090124853
13479,1085.048267,1085.072267,1,32551448,32552168,720,0.32226677736746445
13480,1085.0751,1085.160433,1,32552253,32554812,2559,0.777543212904613
13481,1085.1649,1085.188067,1,32554947,32555642,695,0.7917919010549468
13482,1085.191367,1085.278933,1,32555741,32558367,2626,0.7990916667035469
13483,1085.282,1085.294633,1,32558459,32558838,379,0.8204237021107172
13484,1085.296967,1085.306433,1,32558909,32559192,283,0.6502490062540061
13485,1085.309733,1085.397667,1,32559291,32561930,2639,0.8274271392043806
13486,1085.402633,1085.4264,1,32562078,32562792,714,0.7286425819087471
13487,1085.429733,1085.515833,1,32562891,32565474,2583,0.7714183369514293
13488,1085.5184,1085.545233,1,32565551,32566356,805,0.8604607130136326
13489,1085.5482,1085.641033,1,32566446,32569230,2784,0.799966024730298
13490,1085.647467,1085.671233,1,32569424,32570136,712,0.8472273513146629
13491,1085.674067,1085.763267,1,32570222,32572898,2676,0.802277073164406
13492,1085.770633,1085.794467,1,32573118,32573834,716,0.8815013866755448
13493,1085.7971,1085.883,1,32573913,32576490,2577,0.8114702692683855
13494,1085.8853,1085.911633,1,32576558,32577348,790,0.6417706950039428
13495,1085.915167,1085.9717,1,32577455,32579151,1696,0.810056918329779
13496,1085.9774,1086.008367,1,32579322,32580251,929,0.7165486835080959
13497,1086.013567,1086.040667,1,32580407,32581220,813,0.8262418908596688
13498,1086.0446,1086.099667,1,32581338,32582990,1652,0.7518300254520316
13499,1086.1166,1086.133767,1,32583498,32584013,515,0.728350489413837
13500,1086.139367,1086.154767,1,32584181,32584643,462,0.7547759200743313
13501,1086.168333,1086.205933,1,32585049,32586177,1128,0.7799540516110014
13502,1086.210833,1086.223333,1,32586324,32586699,375,0.6680119722025326
13503,1086.243367,1086.255167,1,32587301,32587655,354,0.797342511694209
13504,1086.264167,1086.270633,1,32587925,32588118,193,0.6825273599854937
13505,1086.2846,1086.343767,1,32588538,32590313,1775,0.8134088015384451
13506,1086.359033,1086.384267,1,32590770,32591528,758,-0.08143266030999623
13507,1086.3862,1086.397533,1,32591585,32591925,340,0.14284271565132695
13508,1086.503567,1086.5168,1,32595107,32595504,397,0.6352952101528766
13509,1086.521533,1086.5276,1,32595645,32595827,182,0.32119676785913454
13510,1086.5695,1086.576967,1,32597085,32597309,224,0.5262666916531588
13511,1086.929867,1086.9697,1,32607896,32609091,1195,0.5457988588576044
13512,1086.974433,1087.0028,1,32609232,32610084,852,0.491435599920958
13513,1087.0047,1087.029367,1,32610141,32610881,740,0.5391988387870251
13514,1087.048133,1087.0693,1,32611443,32612079,636,0.7237149965954537
13515,1087.242867,1087.249367,1,32617286,32617481,195,0.5252947738980356
13516,1087.268267,1087.281767,1,32618048,32618453,405,0.3106698741593758
13517,1087.294233,1087.315367,1,32618826,32619461,635,0.0059156244424000155
13518,1087.322333,1087.341367,1,32619669,32620241,572,0.004335499953343186
13519,1087.363,1087.368933,1,32620890,32621067,177,0.500868325477731
13520,1087.371133,1087.5257,1,32621133,32625770,4637,0.8277602655815856
13521,1087.552,1087.5857,1,32626559,32627571,1012,0.7676731710012444
13522,1087.587433,1087.5913,1,32627622,32627739,117,-0.0946655554679253
13523,1087.595767,1087.651133,1,32627873,32629533,1660,0.6499804352036963
13524,1087.676767,1087.707867,1,32630303,32631236,933,0.6703999411067144
13525,1087.743833,1087.755733,1,32632314,32632671,357,0.10236131179743686
13526,1087.758567,1087.783233,1,32632757,32633496,739,0.0948107778561404
13527,1087.7912,1087.8,1,32633735,32634000,265,-0.07846007445068291
13528,1087.807367,1087.930967,1,32634221,32637929,3708,0.8392566080103587
13529,1088.184467,1088.2083,1,32645534,32646249,715,0.08055902743968549
13530,1088.209333,1088.2219,1,32646279,32646657,378,0.6512918748629554
13531,1088.454567,1088.457967,1,32653637,32653739,102,0.6153832754902487
13532,1088.466133,1088.5813,1,32653983,32657439,3456,0.7915123606023784
13533,1088.586633,1088.6112,1,32657598,32658336,738,0.5828820211747249
13534,1088.6249,1088.7095,1,32658747,32661284,2537,0.8118634904585179
13535,1088.712233,1088.7317,1,32661366,32661951,585,0.7339773285044554
13536,1088.734133,1088.757033,1,32662023,32662710,687,0.5836147782757984
13537,1088.761233,1088.784533,1,32662836,32663535,699,0.7695251488566598
13538,1088.789033,1088.861367,1,32663670,32665841,2171,0.8375092163670425
13539,1088.864867,1088.871533,1,32665946,32666145,199,0.7538793038184529
13540,1088.882133,1089.0077,1,32666463,32670231,3768,0.7430802230502331
13541,1089.025633,1089.029867,1,32670768,32670896,128,-0.02923027571232314
13542,1089.0326,1089.035667,1,32670978,32671070,92,
13543,1089.0373,1089.041267,1,32671119,32671238,119,
13544,1089.050733,1089.054433,1,32671521,32671632,111,0.581503675759636
13545,1089.182233,1089.1878,1,32675466,32675633,167,0.6134639966850199
13546,1089.193133,1089.2235,1,32675793,32676705,912,0.6688750661756498
13547,1089.2277,1089.24,1,32676830,32677200,370,0.5649167137399772
13548,1089.241433,1089.251433,1,32677242,32677542,300,0.7558804001810248
13549,1089.2558,1089.281567,1,32677673,32678447,774,0.6940494914090513
13550,1089.282733,1089.328567,1,32678481,32679857,1376,0.682378212457467
13551,1089.3316,1089.367867,1,32679948,32681036,1088,0.7935135103647194
13552,1089.369333,1089.377233,1,32681079,32681316,237,0.35093666934750123
13553,1089.3789,1089.382867,1,32681366,32681486,120,0.8427659202984041
13554,1089.391767,1089.484367,1,32681753,32684531,2778,0.7333469895049977
13555,1089.488267,1089.5035,1,32684648,32685105,457,0.59484355582365
13556,1089.5134,1089.519433,1,32685402,32685582,180,0.4052302984846352
13557,1089.524333,1089.580167,1,32685729,32687405,1676,0.7776478316147633
13558,1089.602867,1089.612167,1,32688086,32688365,279,0.5875692642944844
13559,1089.615533,1089.647967,1,32688465,32689439,974,0.7893132326043968
13560,1089.669567,1089.681033,1,32690087,32690430,343,0.8143938574069277
13561,1089.683433,1089.687833,1,32690502,32690634,132,0.41814578020402443
13562,1089.7141,1089.749667,1,32691422,32692490,1068,0.7420434123657137
13563,1089.751267,1089.766967,1,32692538,32693009,471,0.8589192367986304
13564,1089.783133,1089.800733,1,32693493,32694021,528,0.7313563370727457
13565,1089.8061,1089.811367,1,32694183,32694341,158,0.7407330761035057
13566,1089.8147,1089.820367,1,32694440,32694611,171,-0.12225147463671188
13567,1089.8355,1089.890367,1,32695064,32696711,1647,0.7473574894763437
13568,1089.8943,1089.902,1,32696828,32697060,232,0.5609753796484725
13569,1089.907733,1089.926567,1,32697231,32697797,566,0.8009579041311957
13570,1089.930333,1089.9355,1,32697909,32698065,156,0.741986422625031
13571,1089.940733,1089.9456,1,32698221,32698368,147,-0.338318458275993
13572,1089.9606,1089.997,1,32698818,32699910,1092,0.7467032764790353
13573,1090.000167,1090.016067,1,32700005,32700482,477,0.7768668471716008
13574,1090.032267,1090.052267,1,32700968,32701568,600,0.7538762023670849
13575,1090.056233,1090.0614,1,32701686,32701842,156,0.08682842199680714
13576,1090.087633,1090.1274,1,32702628,32703822,1194,0.7492717619284981
13577,1090.1295,1090.144433,1,32703885,32704332,447,0.8476168616464889
13578,1090.1687,1090.179233,1,32705061,32705376,315,0.7361851380360744
13579,1090.216233,1090.2548,1,32706486,32707643,1157,0.7792577403255132
13580,1090.2575,1090.2731,1,32707724,32708193,469,0.7054514375254601
13581,1090.296033,1090.3085,1,32708880,32709255,375,0.8098732122208243
13582,1090.3135,1090.3278,1,32709405,32709834,429,0.09735263966553936
13583,1090.3461,1090.3814,1,32710383,32711442,1059,0.7709645918433401
13584,1090.384567,1090.387567,1,32711537,32711627,90,0.482305247411014
13585,1092.095033,1092.1,1,32762850,32762999,149,0.3933873740572727
13586,1092.1031,1092.122367,1,32763093,32763671,578,0.5708896299668432
13587,1092.128033,1092.1828,1,32763840,32765484,1644,0.7552240252353863
13588,1092.187233,1092.195633,1,32765616,32765868,252,0.535352773045991
13589,1092.215833,1092.272333,1,32766474,32768169,1695,0.777374886822658
13590,1092.280567,1092.299833,1,32768417,32768994,577,0.7915944960791419
13591,1092.302,1092.309967,1,32769059,32769299,240,0.49480517710385125
13592,1092.313867,1092.358533,1,32769416,32770755,1339,0.677168862165143
13593,1092.366033,1092.371333,1,32770980,32771139,159,0.5067323522540864
13594,1092.3791,1092.3888,1,32771373,32771664,291,0.7714214058306957
13595,1092.3964,1092.409467,1,32771892,32772284,392,0.7386812232850531
13596,1092.453133,1092.4595,1,32773593,32773784,191,0.5026037538462201
13597,1092.4779,1092.487933,1,32774337,32774637,300,0.16804651605909485
13598,1092.5546,1092.675733,1,32776637,32780271,3634,0.8144012056783456
13599,1092.725067,1092.730467,1,32781752,32781914,162,0.6678190449001284
13600,1092.8324,1092.837233,1,32784972,32785116,144,0.05228448308430564
13601,1092.8393,1092.844233,1,32785179,32785326,147,0.09776366725344064
13602,1092.862433,1092.873833,1,32785872,32786214,342,0.40222765171916464
13603,1092.888067,1092.918567,1,32786642,32787557,915,-0.017728152872276384
13604,1092.9495,1092.9667,1,32788485,32789001,516,0.8600739141598629
13605,1092.979133,1093.077233,1,32789373,32792316,2943,0.7885456427756314
13606,1093.088067,1093.1256,1,32792642,32793768,1126,0.8005944219528496
13607,1093.1374,1093.1532,1,32794122,32794596,474,0.6049128221926391
13608,1093.157367,1093.169033,1,32794721,32795070,349,0.5842511765640973
13609,1093.212633,1093.215967,1,32796378,32796479,101,-0.06286830900676413
13610,1093.2214,1093.229967,1,32796641,32796899,258,-0.017003529772278057
13611,1093.233633,1093.236733,1,32797008,32797101,93,-0.2239207600017499
13612,1093.349267,1093.353767,1,32800478,32800613,135,
13613,1093.3666,1093.3723,1,32800998,32801169,171,-0.032567143322467726
13614,1093.376033,1093.398367,1,32801280,32801951,671,0.2924952498773895
13615,1093.403767,1093.409933,1,32802113,32802297,184,0.003968474877801547
13616,1093.411033,1093.415167,1,32802330,32802455,125,-0.01421397317756004
13617,1093.450167,1093.4714,1,32803505,32804141,636,0.7067179541603338
13618,1093.478233,1093.5858,1,32804346,32807574,3228,0.8411887478828594
13619,1093.598767,1093.715667,1,32807963,32811470,3507,0.7695300975972307
13620,1093.957433,1093.980167,1,32818722,32819405,683,0.5775901725889575
13621,1093.982933,1094.159567,1,32819487,32824787,5300,0.6934411626007848
13622,1094.176967,1094.180767,1,32825309,32825423,114,0.08076468491909866
13623,1094.181767,1094.1862,1,32825453,32825586,133,0.0658104116854591
13624,1094.371267,1094.375467,1,32831138,32831264,126,
13625,1094.416467,1094.5694,1,32832494,32837082,4588,0.7320246006153591
13626,1094.5769,1094.6833,1,32837307,32840498,3191,0.6784273918780839
13627,1094.6965,1094.701633,1,32840895,32841048,153,0.14452956670511338
13628,1094.7072,1094.7102,1,32841216,32841306,90,
13629,1094.7157,1094.750533,1,32841471,32842515,1044,0.15274173956361597
13630,1094.754,1094.782233,1,32842619,32843466,847,0.11397290705031134
13631,1094.8467,1094.9574,1,32845401,32848722,3321,0.7601835693463189
13632,1094.9654,1094.972733,1,32848962,32849181,219,0.35719031191802403
13633,1094.9865,1094.9904,1,32849595,32849711,116,0.167096341202786
13634,1094.994467,1095.026533,1,32849834,32850795,961,0.14392028165804602
13635,1095.0291,1095.042,1,32850873,32851259,386,0.09920079165164183
13636,1095.043333,1095.060533,1,32851299,32851815,516,0.03597266944884097
13637,1095.066833,1095.069833,1,32852004,32852094,90,
13638,1095.082467,1095.093667,1,32852474,32852810,336,0.28831109307126007
13639,1095.1014,1095.133667,1,32853042,32854010,968,0.3387786253860156
13640,1095.137967,1095.171667,1,32854139,32855150,1011,0.051250020948541496
13641,1095.175667,1095.270267,1,32855270,32858108,2838,0.7498061148612087
13642,1095.274767,1095.310633,1,32858243,32859318,1075,0.6878660820960246
13643,1095.315133,1095.439433,1,32859453,32863182,3729,0.7779668319416915
13644,1095.447733,1095.535733,1,32863431,32866071,2640,0.7778621449236338
13645,1095.5393,1095.5553,1,32866178,32866659,481,0.7713894701184832
13646,1095.611367,1095.6182,1,32868341,32868545,204,0.3866831457487927
13647,1095.695,1095.786767,1,32870849,32873603,2754,0.12706353803143736
13648,1095.7878,1095.812067,1,32873634,32874362,728,0.1888695431724032
13649,1095.839533,1095.9635,1,32875185,32878905,3720,0.8239132721611552
13650,1095.973967,1095.982167,1,32879219,32879465,246,0.41726927783900875
13651,1095.985433,1096.0057,1,32879562,32880170,608,-0.0029463798913815344
13652,1096.0074,1096.015767,1,32880222,32880473,251,0.14360240162830906
13653,1096.018,1096.027833,1,32880540,32880834,294,0.20662129338493576
13654,1096.035667,1096.042867,1,32881070,32881286,216,-0.04291402545141719
13655,1096.073933,1096.135267,1,32882217,32884058,1841,0.3077810733617998
13656,1096.139,1096.1626,1,32884169,32884878,709,-0.07007378817063818
13657,1096.165,1096.176833,1,32884950,32885304,354,0.24946947462794875
13658,1096.181667,1096.189967,1,32885450,32885699,249,0.05340344352814164
13659,1096.2335,1096.2417,1,32887005,32887251,246,0.6284301357978646
13660,1096.244367,1096.261,1,32887331,32887830,499,0.7073896334177263
13661,1096.263,1096.302767,1,32887889,32889083,1194,0.6711798622127891
13662,1096.305967,1096.401467,1,32889179,32892044,2865,0.7644221250520774
13663,1096.422167,1096.617567,1,32892665,32898527,5862,0.6970714647114026
13664,1096.6377,1096.651967,1,32899131,32899559,428,0.6982358793734508
13665,1096.656767,1096.6626,1,32899703,32899878,175,
13666,1096.681133,1096.6852,1,32900433,32900555,122,-0.1947288863618586
13667,1096.735833,1096.815467,1,32902074,32904464,2390,0.4857918131241012
13668,1096.816733,1096.8318,1,32904501,32904953,452,-0.0555726327052053
13669,1096.834567,1096.8439,1,32905037,32905317,280,0.354798016431951
13670,1097.0279,1097.098033,1,32910837,32912940,2103,0.7328481617095103
13671,1097.099933,1097.134367,1,32912997,32914031,1034,0.721281605385016
13672,1097.153667,1097.1653,1,32914610,32914958,348,0.18272536610568726
13673,1097.1664,1097.198933,1,32914992,32915967,975,0.1880742560425032
13674,1097.201333,1097.2101,1,32916039,32916303,264,0.07488707057832851
13675,1097.212567,1097.238133,1,32916377,32917143,766,0.138004792174036
13676,1097.268133,1097.272967,1,32918043,32918189,146,0.38994965289509215
13677,1097.275,1097.297933,1,32918250,32918937,687,0.2629713794610674
13678,1097.2992,1097.302667,1,32918975,32919080,105,0.1889680011259879
13679,1097.309967,1097.561333,1,32919299,32926839,7540,0.6878604957587003
13680,1097.564933,1097.5687,1,32926947,32927061,114,-0.1113833803263801
13681,1097.587833,1097.597,1,32927634,32927910,276,0.0681149341181845
13682,1097.601,1097.611467,1,32928030,32928344,314,0.20352031443154067
13683,1097.612833,1097.6227,1,32928384,32928680,296,0.4780380096086614
13684,1097.665467,1097.6732,1,32929964,32930196,232,0.3801180535677115
13685,1097.685233,1097.708467,1,32930556,32931254,698,0.2770983122728998
13686,1097.710967,1097.7416,1,32931329,32932248,919,0.05428052008100611
13687,1097.744133,1097.752467,1,32932323,32932574,251,0.04555770404420855
13688,1097.754667,1097.769367,1,32932640,32933081,441,0.2114811999153823
13689,1097.774367,1097.777733,1,32933231,32933331,100,
13690,1097.800467,1097.808833,1,32934014,32934264,250,0.5320791018808885
13691,1097.811967,1098.013167,1,32934359,32940395,6036,0.7197551209811655
13692,1098.033667,1098.1186,1,32941010,32943558,2548,0.7422573130521045
13693,1098.249,1098.321067,1,32947470,32949632,2162,0.5718765195253009
13694,1098.4237,1098.5005,1,32952711,32955015,2304,0.6167130553934531
13695,1098.502167,1098.505167,1,32955065,32955155,90,-0.23214380386063324
13696,1098.510433,1098.5357,1,32955312,32956070,758,0.6770036219688707
13697,1098.553967,1098.559433,1,32956619,32956782,163,0.12290310799148448
13698,1098.578433,1098.594,1,32957352,32957820,468,0.491181539945678
13699,1098.600367,1098.617067,1,32958011,32958512,501,-0.03937615630484746
13700,1098.619,1098.639233,1,32958569,32959176,607,0.19976033713372113
13701,1098.6497,1098.6543,1,32959491,32959628,137,0.4835606389465511
13702,1098.718167,1098.7322,1,32961545,32961965,420,0.391509480385907
13703,1098.7435,1098.8895,1,32962305,32966685,4380,0.7426552097307803
13704,1098.9028,1098.909767,1,32967084,32967293,209,-0.10459336930789034
13705,1098.927933,1098.934233,1,32967837,32968026,189,0.20390964616401006
13706,1098.9771,1099.014233,1,32969313,32970426,1113,0.5916092660990343
13707,1099.089467,1099.0939,1,32972684,32972817,133,0.1560727760165961
13708,1099.102167,1099.106967,1,32973065,32973209,144,0.2460035483965816
13709,1099.176133,1099.1796,1,32975283,32975387,104,0.35907189643517967
13710,1099.1808,1099.21,1,32975424,32976300,876,0.5820455275564915
13711,1099.3748,1099.382033,1,32981244,32981460,216,0.5289879858086575
13712,1099.509433,1099.513533,1,32985282,32985405,123,0.3631725422724103
13713,1099.5321,1099.553267,1,32985962,32986598,636,0.36307665902291814
13714,1099.583267,1099.5945,1,32987498,32987834,336,-0.0031477167427734556
13715,1099.596067,1099.603133,1,32987882,32988093,211,-0.3561064098973899
13716,1099.709067,1099.713067,1,32991272,32991392,120,0.34543519641999165
13717,1099.7215,1099.7582,1,32991645,32992746,1101,0.7953489575526377
13718,1099.760433,1099.808267,1,32992812,32994248,1436,0.7588757672717527
13719,1099.8112,1099.816367,1,32994336,32994491,155,0.08609585137534016
13720,1099.843233,1099.8589,1,32995296,32995767,471,0.005261086332317785
13721,1099.864967,1099.897367,1,32995949,32996921,972,0.1401690082816551
13722,1099.9421,1099.946033,1,32998263,32998380,117,0.41957885026887326
13723,1099.9559,1099.985867,1,32998676,32999576,900,0.41353690590744924
13724,1099.9974,1100.0136,1,32999922,33000408,486,0.019191464807558973
13725,1100.015267,1100.023133,1,33000458,33000693,235,0.03608611841591698
13726,1100.025267,1100.0306,1,33000758,33000918,160,
13727,1100.031967,1100.041267,1,33000959,33001238,279,0.07372797597889208
13728,1100.1077,1100.1121,1,33003231,33003363,132,-0.041950049351247035
13729,1100.149367,1100.153333,1,33004481,33004599,118,
13730,1100.174067,1100.2513,1,33005222,33007538,2316,0.7876967486380656
13731,1100.260867,1100.279967,1,33007826,33008399,573,0.8166647011017648
13732,1100.3437,1100.356933,1,33010310,33010707,397,-0.015247068972155935
13733,1100.364233,1100.371133,1,33010926,33011133,207,0.20276649046354642
13734,1100.515667,1100.558767,1,33015470,33016763,1293,0.5288219184832781
13735,1100.5706,1100.573833,1,33017118,33017214,96,
13736,1100.5754,1100.588733,1,33017262,33017661,399,0.2410573810784786
13737,1100.5955,1100.599333,1,33017864,33017979,115,0.30255417951441865
13738,1100.698033,1100.701933,1,33020940,33021057,117,
13739,1100.710733,1100.7247,1,33021321,33021741,420,0.437017113427926
13740,1100.733333,1100.7613,1,33021999,33022838,839,0.08132975320427516
13741,1100.762467,1100.7721,1,33022874,33023162,288,0.10589972251247685
13742,1100.7734,1100.780167,1,33023202,33023405,203,-0.11093730786892488
13743,1100.793333,1100.9754,1,33023799,33029262,5463,0.801475765127383
13744,1100.978267,1100.9968,1,33029348,33029903,555,0.7845086262126165
13745,1101.011467,1101.0645,1,33030344,33031935,1591,0.5599710726184292
13746,1101.0786,1101.092067,1,33032358,33032762,404,0.5387484876210082
13747,1101.096033,1101.111133,1,33032880,33033333,453,0.48138347132326414
13748,1101.3712,1101.410533,1,33041136,33042315,1179,0.6356732720586953
13749,1101.513933,1101.518733,1,33045417,33045561,144,0.24633201354073567
13750,1101.6237,1101.629033,1,33048711,33048870,159,0.591466410235582
13751,1101.8053,1101.834633,1,33054159,33055038,879,0.5777389303225988
13752,1101.899167,1101.9056,1,33056975,33057168,193,0.3856810564523787
13753,1102.032967,1102.041567,1,33060989,33061247,258,0.3448820389180395
13754,1102.044267,1102.050033,1,33061328,33061500,172,-0.20339190030891086
13755,1102.091933,1102.097067,1,33062757,33062912,155,0.24385707868453046
13756,1102.098767,1102.108233,1,33062963,33063246,283,0.4529866829634781
13757,1102.172733,1102.180167,1,33065181,33065405,224,-0.06290071280975477
13758,1102.1834,1102.1877,1,33065501,33065631,130,-0.11280155887480604
13759,1102.206133,1102.2093,1,33066183,33066279,96,
13760,1102.215933,1102.329467,1,33066477,33069884,3407,0.8278471930488744
13761,1102.336333,1102.399933,1,33070089,33071997,1908,0.8504126061034069
13762,1102.420167,1102.505367,1,33072605,33075161,2556,0.7960216358409815
13763,1103.3477,1103.352267,1,33100431,33100568,137,0.521897561852589
13764,1103.358167,1103.368233,1,33100745,33101046,301,0.2774882516566559
13765,1103.3699,1103.4056,1,33101096,33102168,1072,0.8138648179938854
13766,1103.4069,1103.4561,1,33102207,33103683,1476,0.7745330930478184
13767,1103.875933,1103.880367,1,33116277,33116411,134,0.6895755861134266
13768,1103.890333,1103.934967,1,33116709,33118049,1340,0.8313542347407231
13769,1103.940033,1103.9851,1,33118200,33119553,1353,0.7845634793662147
13770,1104.455667,1104.469233,1,33133670,33134076,406,0.6836129231021617
13771,1104.4868,1104.492467,1,33134603,33134774,171,0.6079600316656074
13772,1104.494767,1104.503367,1,33134843,33135101,258,0.46551632013691735
13773,1104.521967,1104.5373,1,33135659,33136119,460,0.6925039536332517
13774,1104.538567,1104.548433,1,33136157,33136452,295,-0.07885533714552098
13775,1104.566867,1104.5789,1,33137006,33137367,361,0.5512334457862944
13776,1104.609667,1104.637933,1,33138290,33139137,847,0.6050931771878089
13777,1104.666567,1104.6749,1,33139997,33140247,250,0.561822595750976
13778,1104.679833,1104.7004,1,33140394,33141012,618,0.593133678611009
13779,1104.7135,1104.720633,1,33141405,33141618,213,0.5399310510409285
13780,1104.741267,1104.747367,1,33142238,33142421,183,0.0030988491709996197
13781,1104.755633,1104.813267,1,33142668,33144398,1730,0.21027140034273956
13782,1104.831633,1104.835667,1,33144948,33145070,122,0.6420672696384323
13783,1104.839133,1104.964733,1,33145173,33148941,3768,0.7038654137051893
13784,1104.965733,1105.1055,1,33148971,33153164,4193,0.7279990003179695
13785,1105.145367,1105.150033,1,33154361,33154500,139,-0.13937159590851428
13786,1105.5656,1105.576167,1,33166967,33167285,318,-0.03435459341651301
13787,1105.5794,1105.589733,1,33167382,33167691,309,0.14775801722247592
13788,1105.5954,1105.605667,1,33167861,33168170,309,0.4659608652590471
13789,1105.677367,1105.72,1,33170321,33171600,1279,0.6865600757039199
13790,1105.726267,1105.761567,1,33171788,33172847,1059,0.8129501787320293
13791,1105.765967,1105.799367,1,33172979,33173981,1002,0.7535822431914859
13792,1105.800633,1105.8305,1,33174018,33174915,897,0.6950210479352769
13793,1105.833133,1105.846267,1,33174993,33175388,395,0.6383890948034471
13794,1105.847367,1105.853,1,33175421,33175590,169,-0.06903712462080111
13795,1105.870433,1105.9327,1,33176112,33177981,1869,0.6898969571357884
13796,1105.951067,1105.976267,1,33178532,33179288,756,0.6819482049829685
13797,1106.156767,1106.1598,1,33184703,33184793,90,
13798,1106.1706,1106.175167,1,33185117,33185255,138,0.06643884133493341
13799,1106.267367,1106.2944,1,33188021,33188832,811,0.5511407276350052
13800,1106.431533,1106.439433,1,33192945,33193182,237,-0.09924464633347187
13801,1106.4473,1106.4545,1,33193419,33193635,216,0.019087205575223094
13802,1106.535033,1106.540367,1,33196050,33196211,161,0.7369463124678086
13803,1106.581167,1106.5868,1,33197435,33197604,169,-0.08413452691099647
13804,1106.666167,1106.673333,1,33199985,33200199,214,0.4633551186015413
13805,1106.680067,1106.688,1,33200402,33200640,238,0.5095167259306128
13806,1106.690567,1106.7059,1,33200717,33201176,459,0.20767515750532853
13807,1106.739233,1106.7483,1,33202176,33202449,273,-0.00820275555134112
13808,1106.755367,1106.758667,1,33202661,33202760,99,
13809,1106.8196,1106.8269,1,33204588,33204807,219,0.06183218479712989
13810,1106.827967,1106.860667,1,33204839,33205820,981,0.3471957157426175
13811,1106.888667,1106.9378,1,33206660,33208133,1473,0.47904898617610026
13812,1106.941967,1106.959167,1,33208259,33208775,516,0.7259279234586928
13813,1106.9611,1106.9776,1,33208833,33209328,495,0.45129637003718065
13814,1107.005167,1107.038433,1,33210155,33211152,997,0.04289323039706167
13815,1107.039633,1107.0514,1,33211188,33211542,354,-0.05957065976688788
13816,1107.0623,1107.0701,1,33211869,33212102,233,-0.15799872023435957
13817,1107.091967,1107.1077,1,33212759,33213231,472,0.4144566907842791
13818,1107.109933,1107.1419,1,33213297,33214257,960,0.08389747803011605
13819,1107.1777,1107.184033,1,33215331,33215520,189,0.12565240443217085
13820,1107.189833,1107.194833,1,33215694,33215844,150,0.29779382952442984
13821,1107.3791,1107.389867,1,33221373,33221696,323,0.6864678070934295
13822,1107.400367,1107.4267,1,33222011,33222801,790,0.5728406465896175
13823,1107.4543,1107.4732,1,33223629,33224195,566,0.6296548025347634
13824,1107.4922,1107.502,1,33224765,33225060,295,0.5485061322233623
13825,1107.522667,1107.526533,1,33225680,33225795,115,0.5460809084821151
13826,1107.527933,1107.533667,1,33225837,33226010,173,0.5006348164993389
13827,1107.580133,1107.597567,1,33227403,33227927,524,0.5659858754752436
13828,1107.621867,1107.6315,1,33228656,33228945,289,0.6683316945093909
13829,1107.637967,1107.6455,1,33229139,33229365,226,0.6438905904966082
13830,1107.653867,1107.660267,1,33229616,33229808,192,-0.16084247704856006
13831,1107.663533,1107.674367,1,33229905,33230231,326,0.49040715196836543
13832,1107.700733,1107.715633,1,33231021,33231468,447,-0.06588479915042376
13833,1107.7222,1107.7315,1,33231665,33231945,280,0.21616945412562738
13834,1107.734667,1107.738,1,33232040,33232140,100,-0.36912911698736833
13835,1107.758567,1107.898067,1,33232757,33236942,4185,0.6804489916177319
13836,1107.904867,1107.9752,1,33237146,33239256,2110,0.4034083744517655
13837,1107.992233,1108.0038,1,33239766,33240114,348,0.49793470062103623
13838,1108.012433,1108.037,1,33240372,33241110,738,0.2784726070452836
13839,1108.213233,1108.2177,1,33246396,33246530,134,0.771282721501154
13840,1108.2188,1108.2235,1,33246564,33246705,141,0.5774690709024403
13841,1108.239667,1108.2505,1,33247190,33247515,325,0.6911703068463273
13842,1108.281133,1108.2925,1,33248433,33248775,342,0.7191805617179451
13843,1108.3348,1108.348333,1,33250044,33250449,405,0.6664250918101022
13844,1108.3537,1108.3698,1,33250610,33251094,484,0.8217473176879195
13845,1108.413367,1108.422833,1,33252401,33252684,283,0.6989072835179673
13846,1108.463,1108.469633,1,33253890,33254088,198,0.20176663418064433
13847,1108.526967,1108.5335,1,33255809,33256005,196,0.6141945775995049
13848,1108.537333,1108.543133,1,33256119,33256293,174,0.5964728042767338
13849,1108.570633,1108.5742,1,33257118,33257226,108,0.726709327468723
13850,1108.576467,1108.591633,1,33257294,33257748,454,0.692769949312172
13851,1108.6026,1108.6184,1,33258078,33258552,474,0.7230874363264698
13852,1108.6472,1108.662367,1,33259416,33259871,455,0.6197077858942082
13853,1108.6869,1108.7024,1,33260606,33261071,465,0.6518898671842843
13854,1108.7037,1108.719767,1,33261111,33261593,482,0.6782486686032955
13855,1108.743533,1108.7694,1,33262305,33263081,776,0.025795741224357953
13856,1108.771833,1108.777833,1,33263154,33263334,180,0.06660660926385303
13857,1108.7818,1108.806533,1,33263454,33264195,741,0.1454570679750939
13858,1108.822067,1108.834633,1,33264662,33265038,376,0.5745778502430745
13859,1108.8388,1108.846467,1,33265164,33265394,230,0.28256379527416975
13860,1108.849167,1109.0028,1,33265475,33270084,4609,0.7724980023941869
13861,1109.0051,1109.009667,1,33270153,33270290,137,0.14163316990726005
13862,1109.015067,1109.038,1,33270452,33271140,688,0.6748057053671599
13863,1109.060333,1109.087367,1,33271809,33272621,812,-0.005707745601837658
13864,1109.0943,1109.1161,1,33272829,33273483,654,0.08746488513083699
13865,1109.1907,1109.3395,1,33275721,33280185,4464,0.7734775372711347
13866,1109.349067,1109.394,1,33280472,33281820,1348,0.7693770148113779
13867,1109.4115,1109.451933,1,33282344,33283557,1213,0.7309308673322036
13868,1109.4801,1109.5867,1,33284403,33287601,3198,0.7930670433558379
13869,1109.590533,1109.5938,1,33287715,33287814,99,-0.06838483758026517
13870,1109.7376,1109.7466,1,33292127,33292398,271,0.6191790975706774
13871,1109.750933,1109.768633,1,33292527,33293058,531,0.3147362075850845
13872,1109.769867,1109.844133,1,33293096,33295323,2227,0.05769298936421721
13873,1109.873167,1109.882433,1,33296195,33296472,277,0.7109728750466302
13874,1109.890133,1109.942,1,33296703,33298260,1557,0.7695257103682213
13875,1109.947,1110.0069,1,33298409,33300207,1798,0.6078950630651578
13876,1110.0124,1110.0501,1,33300372,33301502,1130,0.5994704105269498
13877,1110.0918,1110.162433,1,33302753,33304872,2119,0.5860246599471337
13878,1110.1679,1110.185533,1,33305036,33305565,529,0.6810041392076916
13879,1110.187867,1110.201733,1,33305636,33306051,415,0.6642630922275319
13880,1110.227367,1110.2337,1,33306821,33307011,190,-0.07167318277694135
13881,1110.245867,1110.2504,1,33307376,33307511,135,0.2152809675099854
13882,1110.511533,1110.530033,1,33315345,33315900,555,0.6258775750640355
13883,1110.5368,1110.548767,1,33316104,33316463,359,0.6772007983673972
13884,1110.6036,1110.613733,1,33318107,33318411,304,0.4792057862922969
13885,1110.6431,1110.6489,1,33319293,33319466,173,0.7116531902645928
13886,1110.6522,1110.689333,1,33319566,33320679,1113,0.7086118200917004
13887,1110.7268,1110.7379,1,33321803,33322137,334,0.6108588282434426
13888,1110.761667,1110.776633,1,33322850,33323298,448,0.7438766376410294
13889,1110.779633,1110.7928,1,33323388,33323784,396,0.7125621724660682
13890,1110.8043,1110.810933,1,33324129,33324327,198,0.441570194838503
13891,1110.8193,1110.856067,1,33324579,33325682,1103,0.028845413122579978
13892,1110.857367,1110.868067,1,33325721,33326042,321,0.09341609473758884
13893,1110.914033,1110.9297,1,33327420,33327890,470,0.7169256946601925
13894,1110.931467,1111.0238,1,33327944,33330713,2769,0.6942925100816194
13895,1111.044567,1111.086333,1,33331337,33332589,1252,-0.013252244802665803
13896,1111.0892,1111.0946,1,33332675,33332837,162,0.6682500228179615
13897,1111.105333,1111.1704,1,33333159,33335112,1953,0.7725131222510687
13898,1111.172,1111.316833,1,33335160,33339504,4344,0.812423583844237
13899,1111.318533,1111.3384,1,33339555,33340152,597,0.5618908107288347
13900,1111.346533,1111.351167,1,33340395,33340535,140,0.6063988562964759
13901,1111.3656,1111.3707,1,33340968,33341121,153,-0.08556873068536189
13902,1111.378667,1111.387733,1,33341360,33341631,271,0.03204520749960381
13903,1111.76,1111.786667,1,33352800,33353600,800,0.7407298248531046
13904,1111.800267,1111.818767,1,33354008,33354563,555,0.8726700484972079
13905,1111.8236,1111.851367,1,33354708,33355541,833,0.8222335141425423
13906,1111.861033,1111.872133,1,33355830,33356163,333,0.6963861534440857
13907,1111.879233,1111.941633,1,33356376,33358248,1872,0.6069380227717438
13908,1111.946567,1112.008267,1,33358397,33360248,1851,0.4571356614317315
13909,1112.013267,1112.112267,1,33360398,33363368,2970,0.7791150928874269
13910,1112.210567,1112.217667,1,33366317,33366530,213,0.2653953775488302
13911,1112.221033,1112.3236,1,33366630,33369708,3078,0.7927871318036599
13912,1112.348567,1112.3688,1,33370457,33371064,607,-0.02664289740498545
13913,1112.371133,1112.379567,1,33371133,33371387,254,0.05004843388493991
13914,1112.380767,1112.3899,1,33371423,33371696,273,-0.049915740141226225
13915,1112.408967,1112.583467,1,33372269,33377504,5235,0.8105898149782291
13916,1112.592033,1112.674833,1,33377760,33380244,2484,0.7407226519753835
13917,1112.678833,1112.701567,1,33380364,33381047,683,0.7668585363923218
13918,1112.724167,1112.7497,1,33381725,33382491,766,-0.03377906576623532
13919,1112.751767,1112.7615,1,33382553,33382845,292,-0.02567303787727432
13920,1112.7799,1112.8677,1,33383397,33386031,2634,0.7860771403284665
13921,1112.871167,1112.9091,1,33386135,33387273,1138,0.7969700909222192
13922,1112.9242,1112.9279,1,33387725,33387836,111,
13923,1112.9289,1112.949867,1,33387867,33388496,629,-0.08416868430576056
13924,1112.960533,1112.964967,1,33388815,33388949,134,
13925,1113.0076,1113.088867,1,33390227,33392666,2439,0.7078422075402061
13926,1113.090467,1113.111633,1,33392714,33393348,634,0.6714420611701134
13927,1113.120567,1113.132433,1,33393617,33393972,355,0.8174661728061974
13928,1113.137333,1113.144033,1,33394119,33394320,201,0.5855404423661289
13929,1113.1496,1113.256,1,33394488,33397680,3192,0.7476150515702779
13930,1113.262167,1113.3507,1,33397865,33400521,2656,0.7707517128352424
13931,1113.7603,1113.773733,1,33412808,33413211,403,0.6570465281677589
13932,1113.7774,1113.783367,1,33413322,33413501,179,0.5306781637120931
13933,1113.823867,1113.870033,1,33414716,33416100,1384,0.8088373559618638
13934,1113.884067,1113.938433,1,33416522,33418152,1630,0.5992297313373537
13935,1113.9437,1114.022667,1,33418311,33420680,2369,0.730707418880861
13936,1114.024933,1114.093167,1,33420747,33422795,2048,0.7255031148841669
13937,1114.103967,1114.113933,1,33423119,33423417,298,0.6702628728877261
13938,1114.1208,1114.143267,1,33423623,33424298,675,0.7310312391232554
13939,1114.163933,1114.183833,1,33424917,33425514,597,-0.038417114905104785
13940,1114.188267,1114.1945,1,33425648,33425835,187,0.24813144621118916
13941,1114.198267,1114.207133,1,33425948,33426213,265,0.10240617541006145
13942,1114.214133,1114.2188,1,33426423,33426564,141,0.14625826876065456
13943,1114.236533,1114.239833,1,33427095,33427194,99,0.4194291301284888
13944,1114.250567,1114.3963,1,33427517,33431889,4372,0.7858405631292333
13945,1114.409933,1114.572267,1,33432297,33437168,4871,0.7553922213070069
13946,1114.9189,1114.922767,1,33447566,33447683,117,0.7698892822269683
13947,1114.9326,1114.9401,1,33447978,33448203,225,0.6971685219119984
13948,1114.946033,1115.0302,1,33448380,33450905,2525,0.7682040594445613
13949,1115.040933,1115.0752,1,33451227,33452256,1029,0.8172000101081334
13950,1115.085567,1115.1626,1,33452567,33454878,2311,0.7468837011528929
13951,1115.217567,1115.2353,1,33456527,33457059,532,0.589767958342376
13952,1115.254167,1115.337867,1,33457625,33460136,2511,0.7808124558257216
13953,1115.354467,1115.358533,1,33460634,33460755,121,
13954,1115.677367,1115.757233,1,33470321,33472716,2395,0.7710818958672458
13955,1115.7593,1115.827467,1,33472779,33474824,2045,0.7918802066557935
13956,1115.8317,1115.838067,1,33474951,33475142,191,0.13628111103007579
13957,1115.849467,1115.932067,1,33475484,33477962,2478,0.7507005209647126
13958,1116.276167,1116.279667,1,33488285,33488390,105,0.6889336021006608
13959,1116.285933,1116.302833,1,33488577,33489084,507,0.3616096495130676
13960,1116.3052,1116.308833,1,33489156,33489264,108,0.5446940742223401
13961,1116.331733,1116.351833,1,33489951,33490554,603,0.5356845389339664
13962,1116.554967,1116.639267,1,33496649,33499178,2529,0.7813304959220769
13963,1116.6417,1116.657067,1,33499250,33499712,462,0.7238882918479783
13964,1116.659833,1116.699567,1,33499794,33500987,1193,0.7688627732605723
13965,1116.7008,1116.781233,1,33501024,33503436,2412,0.7328753201899617
13966,1117.134833,1117.2672,1,33514044,33518016,3972,0.788921238865289
13967,1117.278,1117.282333,1,33518340,33518469,129,0.5175574827145772
13968,1117.289833,1117.321833,1,33518694,33519654,960,0.7011842153528777
13969,1117.340667,1117.346533,1,33520220,33520395,175,
13970,1117.378633,1117.385467,1,33521358,33521564,206,-0.09530454300681351
13971,1117.386667,1117.396867,1,33521600,33521906,306,0.026498765091542226
13972,1117.401867,1117.4061,1,33522056,33522182,126,-0.07120180868979249
13973,1117.438767,1117.474567,1,33523163,33524237,1074,0.6309400774116201
13974,1117.475567,1117.561633,1,33524267,33526848,2581,0.7126104110323297
13975,1117.801967,1117.966867,1,33534059,33539006,4947,0.7800630469101372
13976,1117.974867,1117.997433,1,33539246,33539922,676,0.7693859400493989
13977,1118.003767,1118.187433,1,33540113,33545622,5509,0.7608972355049785
13978,1118.4649,1118.4703,1,33553947,33554109,162,0.5328534093035557
13979,1118.486233,1118.491233,1,33554586,33554736,150,0.6238880468813226
13980,1118.492433,1118.497133,1,33554772,33554913,141,0.17271756797144852
13981,1118.505733,1118.582767,1,33555171,33557483,2312,0.7477483039590568
13982,1118.588133,1118.6143,1,33557643,33558429,786,0.6514919888447317
13983,1118.617167,1118.743867,1,33558515,33562316,3801,0.7057309577059717
13984,1118.752467,1118.7698,1,33562574,33563094,520,0.24232987690011437
13985,1118.8158,1118.835133,1,33564474,33565053,579,0.6916647896199116
13986,1118.839433,1118.8961,1,33565182,33566883,1701,0.7417148979586545
13987,1119.219367,1119.2361,1,33576581,33577083,502,0.21367364754262522
13988,1119.237667,1119.361233,1,33577130,33580836,3706,0.7828133097548835
13989,1119.382867,1119.547267,1,33581486,33586418,4932,0.7765924418469814
13990,1119.5487,1119.552467,1,33586461,33586574,113,0.22453774318642322
13991,1119.899233,1119.9659,1,33596976,33598977,2001,0.8083761766177046
13992,1119.9685,1120.0479,1,33599055,33601437,2382,0.7884318467831446
13993,1120.063433,1120.078633,1,33601902,33602358,456,0.4708876283632063
13994,1120.080333,1120.2597,1,33602409,33607791,5382,0.6835732199802081
13995,1120.261433,1120.2912,1,33607842,33608736,894,0.7601744590792722
13996,1120.310033,1120.313767,1,33609300,33609413,113,-0.15119104151403098
13997,1120.339033,1120.361,1,33610170,33610830,660,0.6443612279113151
13998,1120.377467,1120.394,1,33611324,33611820,496,0.6179123681958832
13999,1120.3983,1120.402067,1,33611949,33612062,113,0.6666992057017106
14000,1120.404533,1120.408367,1,33612135,33612251,116,0.5918760764285895
14001,1120.429767,1120.4526,1,33612893,33613578,685,0.698930115487263
14002,1120.458867,1120.556767,1,33613766,33616703,2937,0.6407057501503517
14003,1120.557967,1120.561433,1,33616739,33616842,103,0.35487468582227044
14004,1120.903967,1120.907433,1,33627119,33627222,103,-0.05828991721611368
14005,1120.915867,1121.046933,1,33627476,33631407,3931,0.8090885885085022
14006,1121.0526,1121.12,1,33631578,33633600,2022,0.7313141143151274
14007,1121.1279,1121.2061,1,33633837,33636183,2346,0.8034544018679316
14008,1121.209333,1121.247533,1,33636279,33637425,1146,0.7000213055497255
14009,1121.2823,1121.286167,1,33638469,33638585,116,0.5484403009271106
14010,1121.316967,1121.362633,1,33639509,33640878,1369,0.6444060264432607
14011,1121.3687,1121.426333,1,33641061,33642789,1728,0.8109092290142275
14012,1121.6963,1121.8212,1,33650889,33654636,3747,0.8413094541977476
14013,1121.8393,1121.913433,1,33655179,33657402,2223,0.7925268711078164
14014,1121.9147,1122.022267,1,33657441,33660668,3227,0.7922908355871646
14015,1122.343433,1122.3495,1,33670302,33670485,183,0.6367344991860157
14016,1122.393867,1122.397233,1,33671816,33671916,100,0.6533473657251581
14017,1122.3993,1122.423433,1,33671979,33672702,723,0.31645425586213743
14018,1122.446733,1122.481867,1,33673401,33674456,1055,0.7231989069318635
14019,1122.497833,1122.522733,1,33674934,33675681,747,0.8433060591091823
14020,1122.524933,1122.590333,1,33675747,33677709,1962,0.7517881954305116
14021,1122.6171,1122.6312,1,33678513,33678936,423,-0.08251958867885048
14022,1122.636033,1122.646733,1,33679080,33679401,321,0.18735304479325732
14023,1122.649933,1122.654567,1,33679497,33679637,140,
14024,1123.359367,1123.386567,1,33700781,33701597,816,0.6285367804635618
14025,1123.388067,1123.392933,1,33701642,33701787,145,0.5057368251877286
14026,1123.465867,1123.473633,1,33703976,33704208,232,0.5534146973680519
14027,1123.5039,1123.510467,1,33705117,33705314,197,0.5616569229940302
14028,1123.5183,1123.534167,1,33705549,33706025,476,0.6526724588679007
14029,1123.584533,1123.591167,1,33707535,33707735,200,0.6470633125684896
14030,1123.595,1123.606533,1,33707850,33708195,345,0.6518172069351207
14031,1123.640767,1123.6538,1,33709223,33709614,391,0.6797384451830302
14032,1123.7897,1123.822233,1,33713691,33714666,975,0.6285807657279784
14033,1123.823267,1123.905767,1,33714698,33717173,2475,0.7941463347199734
14034,1124.1911,1124.197233,1,33725733,33725916,183,0.4243928329858595
14035,1124.203467,1124.214133,1,33726104,33726423,319,0.5680377750489469
14036,1124.2154,1124.3603,1,33726462,33730809,4347,0.7508697199459302
14037,1124.369967,1124.465433,1,33731099,33733962,2863,0.7719538098977456
14038,1124.488933,1124.600967,1,33734667,33738029,3362,0.7438914437851031
14039,1124.9525,1124.959533,1,33748575,33748785,210,0.7185786871282566
14040,1124.9708,1125.006867,1,33749124,33750206,1082,0.7931660926975399
14041,1125.0282,1125.0355,1,33750846,33751065,219,0.7304025025215805
14042,1125.040933,1125.0497,1,33751227,33751491,264,0.7466686336197729
14043,1125.0595,1125.076167,1,33751785,33752285,500,0.3450375984737648
14044,1125.092133,1125.111,1,33752763,33753330,567,0.6453155185125261
14045,1125.1182,1125.138567,1,33753546,33754157,611,0.7003709387742177
14046,1125.159433,1125.173833,1,33754782,33755214,432,0.7231626272983752
14047,1125.192467,1125.227433,1,33755774,33756822,1048,0.7075556172298317
14048,1125.239067,1125.247033,1,33757172,33757410,238,0.32238964043784185
14049,1125.272133,1125.3181,1,33758163,33759543,1380,0.11190393031377924
14050,1125.3438,1125.346867,1,33760314,33760406,92,
14051,1125.352767,1125.464033,1,33760583,33763920,3337,0.8031699054572069
14052,1125.648367,1125.848333,1,33769451,33775449,5998,0.7189036675122635
14053,1125.8749,1125.8833,1,33776247,33776499,252,0.3148292150943941
14054,1126.123167,1126.130767,1,33783695,33783923,228,0.7295377791027907
14055,1126.131867,1126.1363,1,33783956,33784089,133,0.4148558443575159
14056,1126.137367,1126.1741,1,33784121,33785223,1102,0.7864822698029377
14057,1126.177067,1126.284167,1,33785312,33788525,3213,0.7689791061223017
14058,1126.304033,1126.307433,1,33789120,33789222,102,-0.12640688068257683
14059,1126.3091,1126.316067,1,33789273,33789482,209,0.18817943768688294
14060,1126.317667,1126.339667,1,33789530,33790190,660,0.07851238459955548
14061,1126.3434,1126.348967,1,33790302,33790469,167,-0.2042518618561705
14062,1126.472667,1126.486333,1,33794180,33794589,409,0.7820514910682237
14063,1126.4885,1126.522233,1,33794655,33795666,1011,0.7857388942875765
14064,1126.5249,1126.572267,1,33795747,33797168,1421,0.8200470815036162
14065,1126.6045,1126.616367,1,33798135,33798491,356,-0.02023492150375386
14066,1126.620867,1126.628567,1,33798626,33798857,231,0.14063294170587212
14067,1126.6752,1126.83,1,33800256,33804900,4644,0.8081184354149751
14068,1126.871433,1126.876433,1,33806142,33806292,150,0.3506510132893419
14069,1127.123467,1127.1292,1,33813704,33813876,172,0.6600952077770642
14070,1127.132967,1127.1386,1,33813989,33814158,169,0.4288735538384407
14071,1127.146233,1127.175367,1,33814386,33815261,875,0.802318186935265
14072,1127.1766,1127.224867,1,33815298,33816746,1448,0.6822435134471219
14073,1127.234467,1127.2417,1,33817034,33817251,217,0.7359390849862292
14074,1127.243333,1127.3474,1,33817299,33820422,3123,0.8198309837601424
14075,1127.353833,1127.386767,1,33820614,33821603,989,0.7419630019365168
14076,1127.414667,1127.439367,1,33822440,33823181,741,-0.032859550050709396
14077,1127.4416,1127.451,1,33823248,33823530,282,0.14875233871078197
14078,1127.460333,1127.466867,1,33823809,33824006,197,0.5638460152463614
14079,1127.4871,1127.490433,1,33824613,33824712,99,0.7026392582882852
14080,1127.496233,1127.5161,1,33824886,33825483,597,0.8200125150471146
14081,1127.517633,1127.665367,1,33825528,33829961,4433,0.7311411096953757
14082,1127.674033,1127.752467,1,33830220,33832574,2354,0.8014101086166148
14083,1127.762633,1127.767533,1,33832878,33833025,147,-0.0689932617613769
14084,1127.793833,1127.7972,1,33833814,33833916,102,0.14957253903725395
14085,1129.9743,1130.019867,1,33899229,33900596,1367,0.6209594297813134
14086,1130.024567,1130.034933,1,33900737,33901047,310,0.14178970034807523
14087,1130.036167,1130.076133,1,33901085,33902283,1198,0.8147516721217296
14088,1130.2587,1130.262367,1,33907761,33907871,110,-0.008263554187824875
14089,1130.451167,1130.4588,1,33913535,33913764,229,0.25853014329280605
14090,1130.507933,1130.516367,1,33915237,33915491,254,0.9050484722634394
14091,1130.596133,1130.600833,1,33917883,33918024,141,0.6003359711075713
14092,1130.607433,1130.6136,1,33918222,33918408,186,0.5701883313371032
14093,1130.658933,1130.668367,1,33919767,33920051,284,0.5684741953034007
14094,1130.7291,1130.742367,1,33921873,33922271,398,0.627885614315039
14095,1130.7671,1130.7737,1,33923013,33923211,198,0.5151535392528512
14096,1130.775933,1130.7913,1,33923277,33923739,462,0.5520440899982946
14097,1130.822533,1130.842767,1,33924675,33925283,608,0.5308681312006833
14098,1130.8466,1130.8505,1,33925398,33925515,117,-0.10950837270492648
14099,1130.8595,1130.8789,1,33925785,33926367,582,0.32180960267694003
14100,1130.880767,1130.8889,1,33926423,33926667,244,0.1700937218312226
14101,1130.907133,1130.965233,1,33927213,33928956,1743,0.6504186870777031
14102,1130.9666,1130.9958,1,33928998,33929874,876,0.49869987480851563
14103,1130.997333,1131.0359,1,33929919,33931077,1158,0.6986921359061555
14104,1131.036933,1131.101767,1,33931107,33933053,1946,0.13362853461766894
14105,1131.114,1131.141,1,33933420,33934230,810,0.6412849519458043
14106,1131.1536,1131.187333,1,33934608,33935619,1011,0.7139201502629525
14107,1131.196767,1131.206467,1,33935903,33936194,291,0.4919857139886346
14108,1131.210867,1131.213933,1,33936326,33936417,91,0.2503488173262516
14109,1131.218833,1131.2219,1,33936564,33936657,93,0.5695628192310053
14110,1131.227967,1131.2562,1,33936839,33937686,847,0.7976142971230498
14111,1131.260967,1131.270133,1,33937829,33938103,274,0.4229605961158408
14112,1131.2877,1131.293367,1,33938631,33938801,170,0.5852274002035248
14113,1131.303,1131.320033,1,33939090,33939600,510,0.6041245883290771
14114,1131.3673,1131.371167,1,33941019,33941135,116,
14115,1131.3761,1131.3822,1,33941283,33941466,183,0.4141535234456069
14116,1131.501333,1131.504933,1,33945039,33945147,108,
14117,1131.510067,1131.5485,1,33945302,33946455,1153,0.37577424718537733
14118,1131.568,1131.5711,1,33947040,33947133,93,
14119,1131.596233,1131.600367,1,33947886,33948011,125,-0.1825344931064301
14120,1131.681233,1131.693,1,33950436,33950790,354,0.5158898882030009
14121,1131.694533,1131.783033,1,33950835,33953490,2655,0.7717172585095785
14122,1131.814367,1131.829433,1,33954431,33954882,451,-0.1082632662692881
14123,1132.2668,1132.3381,1,33968004,33970143,2139,0.6315636851302598
14124,1132.340333,1132.395667,1,33970209,33971870,1661,0.5392087589818471
14125,1132.404567,1132.527367,1,33972137,33975821,3684,0.7169893909315536
14126,1132.5438,1132.552267,1,33976314,33976568,254,0.33081725929525135
14127,1132.5617,1132.591567,1,33976851,33977747,896,-0.015081935658341884
14128,1132.593,1132.602833,1,33977790,33978084,294,0.18156789095886872
14129,1132.605,1132.612867,1,33978150,33978386,236,-0.09043958445902421
14130,1132.6959,1132.9093,1,33980877,33987279,6402,0.826818443291651
14131,1132.911467,1133.065433,1,33987344,33991962,4618,0.7242423285249608
14132,1133.080767,1133.089867,1,33992423,33992696,273,0.04014215432908588
14133,1133.699233,1133.728167,1,34010976,34011845,869,0.6294469749560901
14134,1133.783533,1133.802733,1,34013505,34014081,576,0.7193917373196592
14135,1133.9892,1134.004367,1,34019676,34020131,455,0.553804977980327
14136,1134.0073,1134.017267,1,34020219,34020518,299,0.44814678957644605
14137,1134.055567,1134.062233,1,34021667,34021866,199,0.7323882483496926
14138,1134.064033,1134.070467,1,34021920,34022114,194,0.7461321464133822
14139,1134.218633,1134.222467,1,34026558,34026674,116,-0.07800315814473792
14140,1134.223967,1134.3427,1,34026719,34030281,3562,0.7828532459880123
14141,1134.3639,1134.367067,1,34030917,34031012,95,
14142,1134.6505,1134.6737,1,34039515,34040211,696,0.8190768249819766
14143,1134.677267,1134.781767,1,34040318,34043453,3135,0.8445001647475088
14144,1134.790233,1134.870267,1,34043706,34046108,2402,0.7692204909017524
14145,1134.873733,1134.886667,1,34046211,34046600,389,0.6398172186696053
14146,1134.8898,1134.897567,1,34046694,34046927,233,0.4770121084046589
14147,1134.9144,1135.007633,1,34047432,34050228,2796,0.79478866567768
14148,1135.012767,1135.029433,1,34050383,34050882,499,0.6468588897178598
14149,1135.034367,1135.090833,1,34051031,34052724,1693,0.702259801553086
14150,1135.094333,1135.098667,1,34052829,34052960,131,0.5250035347577747
14151,1135.1005,1135.164767,1,34053015,34054943,1928,0.7500704895549082
14152,1135.1751,1135.190833,1,34055253,34055724,471,0.6799667653824912
14153,1135.1954,1135.2065,1,34055862,34056195,333,0.3134410384151474
14154,1135.207533,1135.211233,1,34056225,34056336,111,0.2899875853021629
14155,1135.230133,1135.234033,1,34056903,34057020,117,-0.07572867738033418
14156,1135.241133,1135.257233,1,34057233,34057716,483,0.21318621917100714
14157,1135.265867,1135.277133,1,34057976,34058313,337,0.14337666123419718
14158,1135.278433,1135.2876,1,34058352,34058628,276,-0.0480749010926238
14159,1135.329067,1135.4651,1,34059872,34063953,4081,0.7750501893765849
14160,1135.468267,1135.472367,1,34064048,34064171,123,0.5660019284797065
14161,1135.4757,1135.528567,1,34064271,34065857,1586,0.8278577757529416
14162,1135.545467,1135.550467,1,34066364,34066514,150,0.07758368782872119
14163,1135.552367,1135.584067,1,34066571,34067522,951,0.8333725676896595
14164,1135.591067,1135.5986,1,34067732,34067958,226,-0.010775331616618696
14165,1135.603467,1135.611667,1,34068104,34068350,246,0.6216746633463296
14166,1135.624567,1135.6292,1,34068737,34068876,139,
14167,1135.6334,1135.640767,1,34069002,34069223,221,-0.09036945519460425
14168,1135.681733,1135.689233,1,34070451,34070676,225,0.49526820138734123
14169,1135.690333,1135.797667,1,34070709,34073930,3221,0.7973149652675168
14170,1135.825333,1135.829233,1,34074759,34074876,117,
14171,1135.833567,1135.842233,1,34075007,34075266,259,0.0977743882423136
14172,1135.8466,1135.855233,1,34075398,34075656,258,0.03176583265460048
14173,1136.008767,1136.1312,1,34080263,34083936,3673,0.8210008411031717
14174,1136.146833,1136.152267,1,34084404,34084568,164,-0.053587069748593286
14175,1136.160933,1136.1652,1,34084827,34084956,129,0.6292363398275402
14176,1136.826,1136.8309,1,34104780,34104927,147,0.17997507416771852
14177,1136.844567,1136.8527,1,34105337,34105581,244,0.5505829820899731
14178,1136.853767,1136.858233,1,34105613,34105746,133,0.3768326218494065
14179,1136.8862,1136.9146,1,34106586,34107438,852,0.7538312227383526
14180,1136.9396,1136.959133,1,34108188,34108773,585,0.6778995544713846
14181,1136.998167,1137.003067,1,34109945,34110092,147,0.5148469465581278
14182,1137.0135,1137.0287,1,34110405,34110861,456,0.5099465782897762
14183,1137.051633,1137.0633,1,34111548,34111899,351,0.6520822351887278
14184,1137.115167,1137.130367,1,34113455,34113911,456,0.5945936953460944
14185,1137.223667,1137.2297,1,34116710,34116891,181,-0.013930881756862974
14186,1137.2693,1137.272667,1,34118079,34118180,101,-0.44776992498097573
14187,1137.2799,1137.392733,1,34118397,34121781,3384,0.7821504624622829
14188,1137.394333,1137.416633,1,34121829,34122498,669,0.6612409809208067
14189,1137.429267,1137.5107,1,34122878,34125321,2443,0.7853206535467705
14190,1137.527933,1137.6087,1,34125837,34128261,2424,0.7978440780029267
14191,1138.029367,1138.0464,1,34140881,34141392,511,0.4629308763509382
14192,1138.072533,1138.143967,1,34142175,34144319,2144,0.7266773962010947
14193,1138.446067,1138.471033,1,34153382,34154130,748,0.6316436706095014
14194,1138.506433,1138.604433,1,34155192,34158132,2940,0.7889493826835658
14195,1138.900433,1138.939167,1,34167012,34168175,1163,0.5815173745830591
14196,1138.953067,1139.049767,1,34168592,34171493,2901,0.8143253863783747
14197,1139.068533,1139.074333,1,34172055,34172229,174,-0.056742101945427434
14198,1139.3676,1139.528367,1,34181028,34185851,4823,0.8079853761720649
14199,1139.5295,1139.534867,1,34185885,34186046,161,-0.012025318050136936
14200,1139.536267,1139.540867,1,34186088,34186226,138,0.21144559120424927
14201,1139.544067,1139.547567,1,34186322,34186427,105,
14202,1139.6052,1139.691267,1,34188156,34190738,2582,0.7945805461828764
14203,1139.7128,1139.716467,1,34191384,34191494,110,
14204,1140.168833,1140.176833,1,34205064,34205304,240,0.6842040583609666
14205,1140.1784,1140.183633,1,34205352,34205508,156,0.6610859353739351
14206,1140.184667,1140.210967,1,34205540,34206329,789,0.5971435322928791
14207,1140.226533,1140.231833,1,34206795,34206954,159,0.5206625341058214
14208,1140.233067,1140.2483,1,34206992,34207449,457,0.6427478380051639
14209,1140.249533,1140.256567,1,34207485,34207697,212,0.46671303732590996
14210,1140.259367,1140.2625,1,34207781,34207875,94,
14211,1140.267033,1140.276833,1,34208010,34208304,294,0.6489876567176995
14212,1140.332133,1140.340167,1,34209963,34210205,242,-0.13914364050316386
14213,1140.350167,1140.3587,1,34210505,34210761,256,-0.12375853308034077
14214,1140.360733,1140.3677,1,34210821,34211031,210,-0.06576509159749909
14215,1140.503367,1140.507833,1,34215101,34215234,133,0.7343542911669806
14216,1140.525367,1140.5582,1,34215761,34216746,985,0.7476889515911668
14217,1140.572967,1140.5862,1,34217189,34217586,397,0.8378283422991121
14218,1140.6018,1140.615833,1,34218054,34218474,420,0.6365105577229585
14219,1140.6169,1140.658167,1,34218507,34219745,1238,0.691817632961136
14220,1140.6676,1140.673033,1,34220028,34220190,162,0.5331045270269639
14221,1140.6743,1140.704733,1,34220229,34221141,912,0.5907891069545135
14222,1140.724667,1140.730567,1,34221740,34221917,177,0.38050804378390113
14223,1140.745467,1140.7636,1,34222364,34222908,544,0.06163589265013355
14224,1140.7653,1140.781867,1,34222959,34223456,497,0.19700216042494725
14225,1140.815267,1140.872733,1,34224458,34226181,1723,0.8209829698167758
14226,1140.874767,1140.919867,1,34226243,34227596,1353,0.6784296114047973
14227,1140.9314,1140.935567,1,34227942,34228067,125,-0.09008921881170749
14228,1140.946033,1140.953067,1,34228380,34228592,212,-0.07687289364433673
14229,1140.9544,1140.9657,1,34228632,34228971,339,0.010233263215254335
14230,1140.993833,1141.2244,1,34229814,34236732,6918,0.8016376858542311
14231,1141.253933,1141.267233,1,34237617,34238016,399,0.3353230322154909
14232,1141.2843,1141.2895,1,34238529,34238685,156,0.6857961604875454
14233,1141.609667,1141.6955,1,34248290,34250865,2575,0.8275452910344792
14234,1142.205633,1142.2188,1,34266168,34266564,396,0.7194936586403663
14235,1142.2231,1142.241467,1,34266693,34267244,551,0.5426707707832412
14236,1142.275233,1142.3056,1,34268256,34269168,912,0.870920856877249
14237,1142.313233,1142.367333,1,34269396,34271019,1623,0.5798885420302933
14238,1142.391467,1142.4126,1,34271744,34272378,634,0.23832097233680097
14239,1142.4246,1142.478533,1,34272738,34274355,1617,0.3939420550267446
14240,1142.4862,1142.4918,1,34274586,34274754,168,0.47018854270656685
14241,1142.499933,1142.523267,1,34274997,34275698,701,0.7059471217460631
14242,1142.530633,1142.543733,1,34275918,34276311,393,0.15193650553316645
14243,1142.551567,1142.554767,1,34276547,34276643,96,-0.07819807842109044
14244,1142.5802,1142.5896,1,34277406,34277688,282,0.1984174304572164
14245,1142.590833,1142.594467,1,34277724,34277834,110,
14246,1142.629633,1142.7922,1,34278888,34283766,4878,0.7626433747903042
14247,1142.8067,1142.8752,1,34284201,34286256,2055,0.7955793148190738
14248,1142.990567,1143.0757,1,34289717,34292271,2554,0.7780603216498809
14249,1143.080467,1143.086467,1,34292414,34292594,180,0.474054293475373
14250,1143.087733,1143.0925,1,34292631,34292775,144,0.27571162526556914
14251,1143.760033,1143.773767,1,34312800,34313213,413,0.5658033343609189
14252,1143.777833,1143.7974,1,34313334,34313922,588,0.523890830317724
14253,1143.8207,1143.839367,1,34314621,34315181,560,0.5859130520596475
14254,1143.899167,1143.908633,1,34316975,34317258,283,0.7789974322925519
14255,1144.1191,1144.225667,1,34323573,34326770,3197,0.7892986597216256
14256,1144.478533,1144.649,1,34334355,34339470,5115,0.7909563795736138
14257,1144.650267,1144.706667,1,34339508,34341200,1692,0.7244450026007653
14258,1144.733533,1144.7599,1,34342005,34342797,792,0.7700353496186945
14259,1144.7641,1144.853167,1,34342923,34345595,2672,0.7822146303538038
14260,1144.854967,1144.864167,1,34345649,34345925,276,0.34104282600149977
14261,1144.884867,1144.8896,1,34346546,34346688,142,-0.5645106451786426
14262,1145.366,1145.3785,1,34360980,34361355,375,0.704225968484032
14263,1145.3847,1145.3893,1,34361541,34361679,138,0.6166646781687711
14264,1145.405767,1145.419433,1,34362173,34362582,409,0.7318187852566188
14265,1145.4286,1145.466367,1,34362858,34363991,1133,0.7595994600927737
14266,1145.4806,1145.548067,1,34364418,34366442,2024,0.7547256535811568
14267,1145.552367,1145.632333,1,34366571,34368969,2398,0.7245770404673401
14268,1145.641733,1145.671167,1,34369251,34370135,884,0.7240572254836823
14269,1145.689033,1145.730467,1,34370670,34371914,1244,0.7654033958540215
14270,1145.7396,1145.7477,1,34372188,34372431,243,0.707157261198205
14271,1145.759967,1145.767033,1,34372799,34373010,211,0.06062486964732433
14272,1145.782,1145.8032,1,34373460,34374096,636,0.006204826742566537
14273,1145.804633,1145.822067,1,34374138,34374662,524,0.04913565036954655
14274,1145.823367,1145.830933,1,34374701,34374927,226,
14275,1145.8537,1145.965333,1,34375611,34378959,3348,0.7347332165406837
14276,1145.976333,1145.983333,1,34379289,34379499,210,-0.06909953180082859
14277,1145.984633,1145.9989,1,34379538,34379967,429,-0.0011363428691179695
14278,1146.001667,1146.0094,1,34380050,34380282,232,-0.00250293547982067
14279,1146.012267,1146.2058,1,34380368,34386174,5806,0.638045366341135
14280,1146.2256,1146.2346,1,34386768,34387038,270,-0.06347390075636657
14281,1146.238333,1146.247167,1,34387149,34387415,266,-0.16702775700328398
14282,1146.2513,1146.2609,1,34387539,34387827,288,0.09707210179632057
14283,1146.265033,1146.272533,1,34387950,34388175,225,-0.159197533834543
14284,1146.4085,1146.418467,1,34392255,34392554,299,-0.018731224558362174
14285,1146.422133,1146.4422,1,34392663,34393266,603,0.5892362995722693
14286,1146.692367,1146.851233,1,34400771,34405536,4765,0.7221013981594314
14287,1146.852667,1146.910367,1,34405580,34407311,1731,0.7892957811851765
14288,1146.9124,1146.925633,1,34407372,34407768,396,0.6991796031043871
14289,1146.928433,1146.936933,1,34407852,34408107,255,0.574905080318828
14290,1146.954367,1147.0121,1,34408631,34410363,1732,0.7497375247690505
14291,1147.018533,1147.032233,1,34410555,34410966,411,0.6436011894905471
14292,1147.040267,1147.105633,1,34411208,34413168,1960,0.788977892416427
14293,1147.579533,1147.587067,1,34427385,34427612,227,0.6951539358263445
14294,1147.5964,1147.684,1,34427892,34430520,2628,0.7068722087939565
14295,1147.685833,1147.749433,1,34430574,34432482,1908,0.7230905333712786
14296,1147.751633,1147.874267,1,34432548,34436228,3680,0.7854290585925267
14297,1147.902133,1147.9153,1,34437063,34437459,396,-0.07291595347083596
14298,1147.9193,1147.947567,1,34437579,34438427,848,0.139427099254687
14299,1147.959,1148.1345,1,34438770,34444035,5265,0.8017442301558909
14300,1148.138567,1148.224533,1,34444157,34446735,2578,0.7690473357567907
14301,1148.2777,1148.2836,1,34448331,34448508,177,0.12118973431359317
14302,1149.303967,1149.314167,1,34479119,34479425,306,0.6894297952319463
14303,1149.3153,1149.3371,1,34479459,34480113,654,0.5340810682691081
14304,1149.3642,1149.383533,1,34480926,34481505,579,0.6521064754378646
14305,1149.401733,1149.4101,1,34482051,34482303,252,0.5426858649092134
14306,1149.6882,1149.737833,1,34490646,34492134,1488,0.6775602535487154
14307,1149.741533,1149.825333,1,34492245,34494759,2514,0.8264946426268146
14308,1149.856467,1149.859833,1,34495694,34495794,100,
14309,1150.073633,1150.086333,1,34502208,34502589,381,0.7730619900697587
14310,1150.087667,1150.124667,1,34502630,34503740,1110,0.7821605774052085
14311,1150.125967,1150.1777,1,34503779,34505331,1552,0.8061127598378611
14312,1150.193033,1150.2044,1,34505790,34506132,342,0.27432528562963965
14313,1150.2159,1150.2252,1,34506477,34506756,279,-0.3587969714570896
14314,1150.226367,1150.2295,1,34506791,34506885,94,
14315,1150.266833,1150.383167,1,34508004,34511495,3491,0.8633771936253845
14316,1150.395767,1150.402233,1,34511873,34512066,193,0.14332492826425577
14317,1150.660467,1150.668233,1,34519814,34520046,232,0.707853278483674
14318,1150.6696,1150.840833,1,34520088,34525224,5136,0.7840266261870172
14319,1150.849933,1150.89,1,34525497,34526700,1203,0.6783751277146147
14320,1150.9138,1150.975467,1,34527414,34529264,1850,0.8061835405880471
14321,1150.9809,1150.998133,1,34529427,34529943,516,0.743043350247693
14322,1151.0059,1151.0123,1,34530177,34530369,192,0.04568324426559489
14323,1151.013333,1151.0179,1,34530399,34530537,138,-0.02464517027366593
14324,1151.034767,1151.040033,1,34531043,34531200,157,0.1381323485979011
14325,1151.042133,1151.045733,1,34531263,34531371,108,0.15406051387754122
14326,1151.049333,1151.060067,1,34531479,34531802,323,-0.0014777410496879708
14327,1151.061367,1151.071167,1,34531841,34532135,294,0.07380560005328875
14328,1151.095167,1151.2579,1,34532855,34537737,4882,0.773787164328993
14329,1151.261433,1151.288,1,34537842,34538640,798,0.7305003959106374
14330,1151.303,1151.319233,1,34539090,34539576,486,0.8761912363692381
14331,1151.3951,1151.398267,1,34541853,34541948,95,0.24952843782681397
14332,1151.565967,1151.5867,1,34546979,34547601,622,0.7481554945741755
14333,1151.606667,1151.612767,1,34548200,34548383,183,-0.17724231524015516
14334,1151.840133,1151.979033,1,34555203,34559370,4167,0.8089005418946702
14335,1152.003367,1152.173067,1,34560101,34565192,5091,0.7566028527150834
14336,1152.2066,1152.2135,1,34566198,34566405,207,-0.06480615189850535
14337,1152.217667,1152.222333,1,34566530,34566669,139,0.040326717324688774
14338,1152.288633,1152.4753,1,34568658,34574259,5601,0.7896340367237693
14339,1152.486567,1152.5478,1,34574597,34576434,1837,0.736509645148924
14340,1152.557967,1152.589167,1,34576739,34577675,936,0.8348509104960757
14341,1152.592067,1152.691067,1,34577762,34580732,2970,0.8101700794680065
14342,1152.6934,1152.7763,1,34580802,34583289,2487,0.8192572747559688
14343,1152.778533,1152.793733,1,34583355,34583811,456,0.7139113793035147
14344,1152.806667,1152.924233,1,34584200,34587726,3526,0.7836802656540518
14345,1152.927167,1153.0452,1,34587815,34591356,3541,0.7658470375446559
14346,1153.048767,1153.1592,1,34591463,34594776,3313,0.6690422629691711
14347,1153.162367,1153.166067,1,34594871,34594982,111,0.7139336138559585
14348,1153.1736,1153.268,1,34595208,34598040,2832,0.7951831661705681
14349,1153.2706,1153.2969,1,34598118,34598907,789,0.7663782452868744
14350,1153.2998,1153.4193,1,34598994,34602579,3585,0.7876812640413209
14351,1153.427,1153.507967,1,34602810,34605239,2429,0.7821929595686653
14352,1153.510567,1153.550433,1,34605317,34606512,1195,0.7685049110902685
14353,1153.554767,1153.6786,1,34606643,34610358,3715,0.6411797536336923
14354,1153.679933,1153.763533,1,34610397,34612905,2508,0.7897176608709744
14355,1153.780033,1153.784567,1,34613400,34613537,137,
14356,1153.786,1153.7894,1,34613580,34613682,102,-0.10628663104678097
14357,1153.792633,1153.802233,1,34613778,34614066,288,0.09459365134810767
14358,1153.808867,1153.8155,1,34614266,34614465,199,0.04383613614440277
14359,1154.514267,1154.539967,1,34635428,34636199,771,0.5020737250480994
14360,1154.541333,1154.548033,1,34636239,34636440,201,0.7140284422831455
14361,1154.596567,1154.6867,1,34637897,34640601,2704,0.7350783344470672
14362,1155.066733,1155.076867,1,34652001,34652306,305,0.5722605673925201
14363,1155.0912,1155.099633,1,34652736,34652988,252,0.4548613745693435
14364,1155.105667,1155.156,1,34653170,34654680,1510,0.50379857360823
14365,1155.1753,1155.205167,1,34655259,34656155,896,0.4672986612114176
14366,1155.225267,1155.2425,1,34656758,34657275,517,0.5555209163339773
14367,1155.246033,1155.2667,1,34657380,34658001,621,0.6173424335934659
14368,1155.2791,1155.288067,1,34658373,34658642,269,0.5777917319550746
14369,1155.323833,1155.329233,1,34659714,34659876,162,0.15681314706526275
14370,1155.334467,1155.342467,1,34660034,34660274,240,-0.05028742467312518
14371,1155.344367,1155.365633,1,34660331,34660968,637,0.10557135370544574
14372,1155.4741,1155.665167,1,34664223,34669955,5732,0.8306733855725394
14373,1155.688367,1155.758267,1,34670651,34672748,2097,0.7613322722195033
14374,1155.761067,1155.854433,1,34672832,34675632,2800,0.7736294541694873
14375,1155.856833,1155.889833,1,34675704,34676694,990,0.6839086077135628
14376,1155.913267,1155.928033,1,34677398,34677840,442,0.2641925159977874
14377,1155.929467,1155.941267,1,34677884,34678238,354,0.004118912431185003
14378,1155.975033,1156.0348,1,34679250,34681044,1794,0.7514950760490442
14379,1156.036767,1156.075167,1,34681103,34682255,1152,0.6998644794607674
14380,1156.079933,1156.0846,1,34682397,34682538,141,-0.2987328579681095
14381,1156.107067,1156.1161,1,34683212,34683483,271,-0.04208419080489655
14382,1156.117433,1156.1239,1,34683522,34683717,195,0.054411694290654344
14383,1156.137533,1156.309833,1,34684125,34689294,5169,0.831721459121983
14384,1156.334567,1156.34,1,34690037,34690200,163,-0.09363177525217944
14385,1156.3412,1156.348033,1,34690236,34690440,204,-0.1897375940846746
14386,1156.356833,1156.367133,1,34690704,34691013,309,-0.18082327366250667
14387,1156.688667,1156.698667,1,34700660,34700960,300,0.6821672277613547
14388,1156.7049,1156.7158,1,34701147,34701474,327,0.5101930851724019
14389,1156.740567,1156.820333,1,34702217,34704609,2392,0.7786662992818297
14390,1156.8316,1156.834967,1,34704948,34705049,101,-0.11279793405484558
14391,1157.378967,1157.39,1,34721369,34721700,331,0.5636726339977387
14392,1157.3927,1157.4006,1,34721781,34722018,237,0.14186062025451132
14393,1157.406933,1157.4177,1,34722207,34722531,324,0.30680091809243365
14394,1157.439,1157.4534,1,34723170,34723602,432,0.6718050120567947
14395,1157.459467,1157.4651,1,34723784,34723953,169,0.801504152316677
14396,1157.482567,1157.4883,1,34724477,34724649,172,0.786273005161991
14397,1157.503433,1157.520467,1,34725102,34725614,512,0.6975384998174015
14398,1157.717733,1157.729233,1,34731531,34731876,345,0.5500905529782203
14399,1157.7311,1157.791733,1,34731933,34733751,1818,0.7006657860164938
14400,1157.793233,1157.824633,1,34733796,34734738,942,0.812387431114085
14401,1157.868367,1157.8719,1,34736051,34736157,106,
14402,1157.877167,1157.885533,1,34736315,34736565,250,0.011333547837188169
14403,1158.038933,1158.043467,1,34741167,34741304,137,0.5053001622054091
14404,1158.0446,1158.3057,1,34741338,34749171,7833,0.7748060808088959
14405,1158.356367,1158.3669,1,34750691,34751007,316,0.2507306644059787
14406,1158.884667,1158.888633,1,34766540,34766658,118,0.6497318362777736
14407,1158.8899,1158.909133,1,34766697,34767273,576,0.5844152171404846
14408,1158.914967,1158.976233,1,34767449,34769286,1837,0.6987158968919664
14409,1158.987467,1159.0543,1,34769624,34771629,2005,0.7280719698815677
14410,1159.060133,1159.139267,1,34771803,34774178,2375,0.6914927956145264
14411,1159.1417,1159.1721,1,34774251,34775163,912,0.6181423335284986
14412,1159.1855,1159.1905,1,34775565,34775715,150,0.03277537938765816
14413,1159.193333,1159.199533,1,34775799,34775985,186,-0.112888808652045
14414,1159.2011,1159.2119,1,34776033,34776357,324,0.009765599148271962
14415,1159.213067,1159.225567,1,34776392,34776767,375,0.25752801755889276
14416,1159.2267,1159.236133,1,34776801,34777083,282,-0.06208135148799355
14417,1159.460433,1159.573433,1,34783812,34787202,3390,0.7819573684988848
14418,1159.580867,1159.696267,1,34787426,34790888,3462,0.823363434851418
14419,1159.722067,1159.804667,1,34791662,34794140,2478,0.7727809863389623
14420,1159.823267,1159.828967,1,34794698,34794869,171,-0.023845005214808337
14421,1159.8304,1159.8421,1,34794912,34795263,351,0.358364448994731
14422,1159.846067,1159.8494,1,34795382,34795482,100,-0.3848975918662952
14423,1159.9207,1159.928033,1,34797621,34797840,219,0.5463913315164438
14424,1159.929767,1159.9823,1,34797893,34799469,1576,0.7381693277307154
14425,1159.989367,1160.036933,1,34799681,34801107,1426,0.6866538877486764
14426,1160.057967,1160.061167,1,34801739,34801835,96,
14427,1160.062533,1160.0679,1,34801875,34802037,162,-0.09343298458553322
14428,1160.069633,1160.0894,1,34802088,34802682,594,-0.005965748194492504
14429,1160.094533,1160.101167,1,34802835,34803035,200,
14430,1160.1023,1160.261733,1,34803069,34807851,4782,0.6513560695446625
14431,1160.263033,1160.290133,1,34807890,34808703,813,0.767596336659913
14432,1160.292467,1160.3407,1,34808774,34810221,1447,0.8191109887753918
14433,1160.346933,1160.4186,1,34810407,34812558,2151,0.8428041960334605
14434,1160.425167,1160.429433,1,34812755,34812882,127,-0.004637832148482492
14435,1160.431067,1160.464733,1,34812932,34813941,1009,0.7293195558085802
14436,1160.490833,1160.497067,1,34814724,34814912,188,-0.08902210465024232
14437,1160.499133,1160.502433,1,34814973,34815072,99,-0.10368844803723049
14438,1160.505333,1160.521267,1,34815159,34815638,479,0.12208298367437208
14439,1160.5261,1160.5333,1,34815783,34815999,216,-0.2797463470670166
14440,1160.539533,1160.6572,1,34816185,34819716,3531,0.7831556595664575
14441,1160.670667,1160.699267,1,34820120,34820978,858,0.032666326881874215
14442,1160.703533,1160.716733,1,34821105,34821501,396,0.23089164420955027
14443,1160.740033,1160.860567,1,34822200,34825817,3617,0.8105574277808568
14444,1160.882667,1160.8968,1,34826480,34826904,424,-0.08412262418101711
14445,1160.9022,1160.909867,1,34827066,34827296,230,-0.02935020934398892
14446,1160.913533,1160.922533,1,34827405,34827675,270,-0.02570752314697419
14447,1160.9293,1160.932867,1,34827879,34827986,107,0.11108158296174166
14448,1160.963133,1161.127467,1,34828893,34833824,4931,0.8158083270334399
14449,1161.135,1161.138267,1,34834050,34834148,98,-0.21748868674123262
14450,1161.139333,1161.1456,1,34834179,34834368,189,0.4278082884614855
14451,1161.148367,1161.172333,1,34834451,34835169,718,0.7634656675995123
14452,1161.173433,1161.218633,1,34835202,34836558,1356,0.7510769696054101
14453,1161.237867,1161.3363,1,34837136,34840089,2953,0.8453380513383363
14454,1161.354567,1161.36,1,34840637,34840800,163,-0.06551997047343608
14455,1161.3719,1161.380967,1,34841157,34841429,272,0.16945044457484032
14456,1161.382067,1161.394567,1,34841462,34841837,375,0.3244693398513684
14457,1161.6357,1161.662467,1,34849071,34849874,803,0.6383673717635636
14458,1161.666267,1161.6721,1,34849988,34850163,175,0.5501861999412008
14459,1161.6874,1161.767833,1,34850622,34853034,2412,0.7774144710165171
14460,1161.778367,1161.782333,1,34853351,34853469,118,0.08141880009537676
14461,1161.7874,1161.791433,1,34853622,34853742,120,-0.0324171958570291
14462,1161.888667,1162.0501,1,34856660,34861503,4843,0.7240210048269898
14463,1162.066533,1162.110833,1,34861995,34863324,1329,0.7914292441379708
14464,1162.112467,1162.184833,1,34863374,34865544,2170,0.7494079968437081
14465,1162.212833,1162.236567,1,34866384,34867097,713,0.7296000237447514
14466,1162.2414,1162.3065,1,34867242,34869195,1953,0.7524062257874417
14467,1162.308533,1162.329767,1,34869255,34869893,638,0.6549835550176587
14468,1162.351967,1162.357567,1,34870559,34870727,168,-0.10249766707556959
14469,1162.368867,1162.374967,1,34871066,34871249,183,0.056165371099871735
14470,1162.377133,1162.391233,1,34871313,34871736,423,-0.024671433464394647
14471,1162.3959,1162.400233,1,34871877,34872006,129,0.21512782558632706
14472,1162.610033,1162.6171,1,34878300,34878513,213,0.28753046283394684
14473,1162.6363,1162.6598,1,34879089,34879794,705,0.7986977058271181
14474,1162.682467,1162.711033,1,34880474,34881330,856,0.9372245420139931
14475,1162.712867,1162.7159,1,34881386,34881477,91,0.7609786493684909
14476,1162.717667,1162.7402,1,34881530,34882206,676,0.7010337380785137
14477,1162.7423,1162.770333,1,34882269,34883109,840,0.7273354033294606
14478,1162.7774,1162.8169,1,34883322,34884507,1185,0.767924115214141
14479,1162.824033,1162.8558,1,34884720,34885674,954,0.6818299913300077
14480,1162.8685,1162.9453,1,34886055,34888359,2304,0.8096284228332082
14481,1162.9483,1162.965767,1,34888449,34888973,524,0.5483334890800252
14482,1162.9718,1162.9942,1,34889154,34889826,672,0.8226660337771252
14483,1163.008133,1163.0248,1,34890243,34890744,501,-0.022199862613215528
14484,1163.0291,1163.0442,1,34890873,34891326,453,-0.07736657421446405
14485,1163.045233,1163.067967,1,34891356,34892039,683,0.10776804883820065
14486,1163.09,1163.2365,1,34892700,34897095,4395,0.8298034145239516
14487,1163.255767,1163.279533,1,34897673,34898385,712,0.7532679361135227
14488,1163.2843,1163.374133,1,34898529,34901223,2694,0.8148069242033811
14489,1163.386933,1163.390867,1,34901607,34901726,119,-0.10294378518308525
14490,1163.495967,1163.518,1,34904879,34905540,661,0.8013344964665816
14491,1163.521,1163.626833,1,34905630,34908804,3174,0.7976111285379784
14492,1163.637467,1163.642,1,34909124,34909260,136,0.19635971038136704
14493,1163.653667,1163.662933,1,34909610,34909887,277,0.2667359832448135
14494,1163.671067,1163.6931,1,34910132,34910793,661,0.00916932878059965
14495,1163.6981,1163.701833,1,34910943,34911054,111,0.3511674568987033
14496,1163.703133,1163.706733,1,34911093,34911201,108,-0.23820812689301352
14497,1163.7123,1163.7189,1,34911369,34911567,198,0.19637180458728845
14498,1163.889,1163.9665,1,34916670,34918995,2325,0.8190141888157055
14499,1163.9735,1164.113067,1,34919205,34923392,4187,0.7851114606063079
14500,1164.121633,1164.196767,1,34923648,34925903,2255,0.5522309905071847
14501,1164.201267,1164.289267,1,34926038,34928678,2640,0.3640268783342744
14502,1164.2923,1164.420333,1,34928769,34932609,3840,0.7573825964469063
14503,1164.453433,1164.459,1,34933602,34933770,168,0.2524236311822355
14504,1164.466867,1164.470733,1,34934006,34934121,115,
14505,1164.5196,1164.723767,1,34935588,34941713,6125,0.8266210492478743
14506,1164.7423,1164.745733,1,34942269,34942371,102,0.47944739106779677
14507,1164.7618,1164.781967,1,34942854,34943459,605,-0.014015609483575987
14508,1164.783067,1164.790533,1,34943492,34943715,223,-0.03492328443721289
14509,1164.831867,1164.920933,1,34944956,34947627,2671,0.71331949339456
14510,1164.922233,1164.948967,1,34947666,34948469,803,0.8228556745316422
14511,1165.520133,1165.553867,1,34965603,34966616,1013,0.6968483893082947
14512,1165.612867,1165.624633,1,34968386,34968738,352,0.36165503217678435
14513,1165.765533,1165.788333,1,34972965,34973649,684,0.505385096487236
14514,1165.827067,1165.833,1,34974812,34974990,178,0.6415301162718469
14515,1165.8343,1165.843567,1,34975029,34975307,278,0.6201927866391771
14516,1165.965567,1166.165,1,34978967,34984950,5983,0.8065112158465665
14517,1166.17,1166.2228,1,34985100,34986684,1584,0.8220668580453662
14518,1166.2323,1166.2488,1,34986969,34987464,495,0.7015607198792854
14519,1166.255767,1166.3112,1,34987673,34989336,1663,0.7822619842142219
14520,1166.317267,1166.320567,1,34989518,34989617,99,0.43541358663441343
14521,1166.322267,1166.326267,1,34989668,34989788,120,0.12720141261493173
14522,1166.3441,1166.348033,1,34990323,34990440,117,0.1133985149534365
14523,1166.540033,1166.589833,1,34996200,34997694,1494,0.22552532176874135
14524,1166.6006,1166.646133,1,34998018,34999383,1365,0.8308928231642239
14525,1166.6611,1166.6741,1,34999833,35000223,390,-0.071506271663694
14526,1166.683633,1166.696567,1,35000508,35000897,389,0.08338587897706425
14527,1166.698133,1166.709567,1,35000943,35001287,344,0.07929132467896509
14528,1166.7231,1166.727867,1,35001693,35001836,143,0.6113559011603086
14529,1166.730667,1166.8797,1,35001920,35006391,4471,0.8331709187712251
14530,1166.881833,1166.885233,1,35006454,35006556,102,
14531,1166.899567,1166.907467,1,35006987,35007224,237,0.42441153609984755
14532,1166.924,1166.9546,1,35007720,35008638,918,-0.0759450438299563
14533,1166.958767,1166.9688,1,35008763,35009064,301,0.010964852690219304
14534,1166.9701,1166.980267,1,35009103,35009408,305,-0.16131290875058224
14535,1167.055667,1167.0697,1,35011670,35012091,421,0.5723705290433749
14536,1167.073933,1167.2197,1,35012217,35016591,4374,0.8349379218942103
14537,1167.222633,1167.3303,1,35016678,35019909,3231,0.8202887423201249
14538,1167.346367,1167.349933,1,35020391,35020497,106,-0.1377652548413785
14539,1167.4359,1167.6074,1,35023077,35028222,5145,0.7364018513108962
14540,1167.608433,1167.7137,1,35028252,35031411,3159,0.8016889857840702
14541,1167.717967,1167.740533,1,35031539,35032215,676,0.014221861150221067
14542,1167.746033,1167.762733,1,35032380,35032881,501,0.22277792575714206
14543,1167.765767,1167.774133,1,35032973,35033223,250,0.24644751646763463
14544,1167.810533,1167.926267,1,35034315,35037788,3473,0.7919170235785079
14545,1168.008067,1168.011333,1,35040242,35040339,97,
14546,1168.6562,1168.6642,1,35059686,35059926,240,0.44162330064679206
14547,1168.6681,1168.6829,1,35060043,35060487,444,0.526046027658539
14548,1168.723067,1168.737067,1,35061692,35062112,420,0.04360285343676851
14549,1168.791067,1168.805667,1,35063732,35064170,438,0.7181978111417091
14550,1168.973633,1168.9907,1,35069208,35069721,513,0.438225523571753
14551,1168.9932,1169.000267,1,35069796,35070008,212,0.40347260819938713
14552,1169.0407,1169.050767,1,35071221,35071523,302,0.6679505548419767
14553,1169.3172,1169.324667,1,35079516,35079740,224,0.41434277210382464
14554,1169.325833,1169.340933,1,35079774,35080227,453,0.7445820152350524
14555,1169.3422,1169.378467,1,35080266,35081354,1088,0.7944188058066908
14556,1169.3801,1169.385167,1,35081403,35081555,152,0.7112779338404396
14557,1169.389933,1169.431933,1,35081697,35082957,1260,0.7575685996684114
14558,1169.449533,1169.466867,1,35083485,35084006,521,-0.0780472993526788
14559,1169.472433,1169.480833,1,35084172,35084424,252,0.24582742180883516
14560,1169.489633,1169.493667,1,35084688,35084810,122,-0.15460225607309377
14561,1169.4947,1169.498633,1,35084841,35084958,117,
14562,1169.6206,1169.650967,1,35088618,35089529,911,0.6916066568958816
14563,1169.654,1169.667133,1,35089620,35090013,393,0.6012332633600849
14564,1169.673733,1169.757233,1,35090211,35092716,2505,0.7580953920865537
14565,1169.915133,1169.936,1,35097453,35098080,627,0.14985998293342
14566,1169.937567,1169.9467,1,35098127,35098401,274,0.02035054622715533
14567,1169.9589,1169.976533,1,35098767,35099295,528,-0.13167385476451332
14568,1169.98,1169.992467,1,35099400,35099774,374,-0.06924435464223565
14569,1169.993667,1170.009133,1,35099810,35100273,463,0.6689422915656263
14570,1170.073733,1170.166333,1,35102211,35104989,2778,0.7950178704531372
14571,1170.1688,1170.209467,1,35105064,35106284,1220,0.4978076387987045
14572,1170.2164,1170.267,1,35106492,35108010,1518,0.6918172366430619
14573,1170.270067,1170.3139,1,35108102,35109417,1315,0.7304452132410838
14574,1170.3373,1170.416667,1,35110119,35112500,2381,0.7399626846145338
14575,1170.428633,1170.4388,1,35112858,35113164,306,-0.05342082341135458
14576,1170.442267,1170.490933,1,35113268,35114727,1459,-0.022852549314418637
14577,1170.652267,1170.697767,1,35119568,35120933,1365,0.5940213031272927
14578,1170.702233,1170.804533,1,35121066,35124135,3069,0.7924789782066206
14579,1170.8066,1170.907767,1,35124198,35127233,3035,0.7665840397885809
14580,1170.917833,1170.948133,1,35127534,35128443,909,-0.02660729050172466
14581,1170.952067,1170.969267,1,35128562,35129078,516,-0.010342976777497962
14582,1170.9891,1170.994067,1,35129673,35129822,149,0.5496916804810394
14583,1170.996733,1171.195267,1,35129901,35135858,5957,0.8076964087687644
14584,1171.222767,1171.2289,1,35136683,35136867,184,0.599877432002726
14585,1171.232733,1171.262067,1,35136981,35137862,881,-0.10133628846564147
14586,1171.264167,1171.270033,1,35137925,35138100,175,0.267555578843997
14587,1171.2746,1171.281033,1,35138238,35138430,192,0.02365875056760607
14588,1171.347,1171.506733,1,35140410,35145201,4791,0.8251427565171581
14589,1171.516567,1171.56,1,35145497,35146800,1303,0.7492999023541697
14590,1171.588333,1171.612933,1,35147649,35148387,738,0.7168986952777944
14591,1171.616867,1171.6724,1,35148506,35150172,1666,0.272367662061874
14592,1171.673867,1171.678067,1,35150216,35150342,126,0.27706500388055716
14593,1171.681467,1171.719067,1,35150444,35151572,1128,0.6798105199077166
14594,1171.748933,1171.751967,1,35152467,35152559,92,
14595,1171.753433,1171.773633,1,35152602,35153208,606,-0.06184252856200389
14596,1171.788367,1171.9081,1,35153651,35157243,3592,0.8435659500498403
14597,1171.926133,1172.022167,1,35157783,35160665,2882,0.7736454988922565
14598,1172.070333,1172.075067,1,35162109,35162252,143,0.45050239205966325
14599,1172.646233,1172.683667,1,35179386,35180510,1124,0.5986722301263705
14600,1172.7039,1172.7226,1,35181117,35181678,561,0.5760851857322694
14601,1172.9971,1173.097333,1,35189913,35192919,3006,0.7941727019498825
14602,1173.739,1173.7512,1,35212170,35212536,366,0.6706330831324324
14603,1173.753067,1173.757367,1,35212592,35212721,129,0.682204054988985
14604,1173.7593,1173.773333,1,35212779,35213199,420,0.6242380537761651
14605,1173.822367,1173.846467,1,35214671,35215394,723,0.7502797105731652
14606,1174.039,1174.054867,1,35221170,35221646,476,0.5714229671506467
14607,1174.057833,1174.067233,1,35221734,35222016,282,0.7519280437089395
14608,1174.103833,1174.1213,1,35223114,35223639,525,0.6247178613719147
14609,1174.632333,1174.658567,1,35238969,35239757,788,0.09823669864266708
14610,1174.6658,1174.7347,1,35239974,35242041,2067,0.3258677890245146
14611,1174.739267,1174.746833,1,35242178,35242404,226,0.33493194771108337
14612,1174.747967,1174.780533,1,35242439,35243415,976,0.6874120901614054
14613,1174.8024,1174.819367,1,35244072,35244581,509,0.794391429898696
14614,1174.833667,1174.851433,1,35245010,35245542,532,0.776832761010863
14615,1174.8547,1174.933333,1,35245641,35247999,2358,0.7135014299687461
14616,1174.9687,1174.9718,1,35249061,35249154,93,
14617,1177.698133,1177.7104,1,35330943,35331312,369,0.47406291211215007
14618,1177.8937,1177.9175,1,35336811,35337525,714,0.5473094649641435
14619,1177.919067,1177.924833,1,35337572,35337744,172,0.3700720557413302
14620,1177.925833,1177.9297,1,35337774,35337891,117,0.44557652158064687
14621,1177.947067,1177.952333,1,35338412,35338569,157,0.5943894382243808
14622,1177.953733,1177.967,1,35338611,35339010,399,0.5670188552543499
14623,1177.9848,1177.995867,1,35339544,35339876,332,0.7170381724058541
14624,1178.0246,1178.0834,1,35340738,35342502,1764,0.5972015856696851
14625,1178.097267,1178.1144,1,35342918,35343432,514,0.7599639253875098
14626,1178.130633,1178.166667,1,35343918,35345000,1082,0.7157451577393072
14627,1178.187567,1178.1907,1,35345627,35345721,94,
14628,1178.1922,1178.196767,1,35345766,35345903,137,0.13283959395123449
14629,1178.414367,1178.430033,1,35352431,35352900,469,0.48978268742107656
14630,1178.431367,1178.471233,1,35352941,35354136,1195,0.1633101289871761
14631,1178.474233,1178.4979,1,35354226,35354937,711,0.12276425989981926
14632,1178.5284,1178.528567,1,35355852,35355857,5,
14633,1178.5405,1178.554033,1,35356215,35356620,405,0.4895404225516073
14634,1178.557367,1178.573,1,35356721,35357190,469,0.4366791414047726
14635,1178.574033,1178.577067,1,35357220,35357312,92,
14636,1178.593467,1178.758233,1,35357804,35362746,4942,0.8099835013604213
14637,1178.764867,1178.808267,1,35362946,35364248,1302,0.8016250707062931
14638,1178.834067,1178.862433,1,35365022,35365872,850,0.5412266527312357
14639,1178.899767,1178.908567,1,35366993,35367257,264,0.30656723559614
14640,1178.915867,1178.924233,1,35367476,35367726,250,-0.04060384489377431
14641,1178.9274,1178.939967,1,35367822,35368199,377,0.3789130632889881
14642,1178.941267,1178.952033,1,35368238,35368560,322,0.14933750829493078
14643,1179.0242,1179.0283,1,35370726,35370849,123,0.677385160182077
14644,1179.0331,1179.056067,1,35370993,35371682,689,0.4588336523901147
14645,1179.0583,1179.065867,1,35371749,35371976,227,0.30925615660682915
14646,1179.0686,1179.072267,1,35372058,35372168,110,0.42117916971563446
14647,1179.073633,1179.097,1,35372208,35372910,702,0.06299276102935263
14648,1179.0981,1179.119367,1,35372943,35373581,638,0.045990182800698456
14649,1179.120433,1179.1241,1,35373612,35373723,111,
14650,1179.147067,1179.153367,1,35374412,35374601,189,0.6506072226623262
14651,1179.1653,1179.328867,1,35374959,35379866,4907,0.7742431073979317
14652,1179.3364,1179.387767,1,35380092,35381633,1541,0.8123108604171942
14653,1179.414467,1179.444033,1,35382434,35383320,886,0.7030851411330036
14654,1179.472333,1179.579167,1,35384169,35387375,3206,0.6840301186424691
14655,1179.820333,1179.8243,1,35394609,35394729,120,0.21738439896273284
14656,1179.843033,1179.854933,1,35395290,35395647,357,0.8848861004619742
14657,1179.858967,1179.904033,1,35395769,35397120,1351,0.8019878962636329
14658,1179.9058,1179.955133,1,35397174,35398653,1479,0.8268358307104173
14659,1179.981633,1179.9849,1,35399448,35399547,99,-0.06558472986481341
14660,1179.996367,1180.008533,1,35399891,35400255,364,0.06917422041381575
14661,1180.0119,1180.016633,1,35400357,35400498,141,-0.07238185738397182
14662,1180.653567,1180.657967,1,35419607,35419739,132,-0.2814485162888438
14663,1180.672633,1180.754133,1,35420178,35422623,2445,0.7821978528988672
14664,1180.7608,1180.848733,1,35422824,35425461,2637,0.7261124648493564
14665,1180.853267,1180.8699,1,35425598,35426097,499,0.798537814051984
14666,1180.873467,1180.887633,1,35426204,35426628,424,0.6376483585468784
14667,1181.130733,1181.247767,1,35433921,35437433,3512,0.8002445342683
14668,1181.2869,1181.300367,1,35438607,35439011,404,0.3505883882609038
14669,1181.304867,1181.329367,1,35439146,35439881,735,0.018078062780035514
14670,1181.334167,1181.451567,1,35440025,35443547,3522,0.8034894487238059
14671,1181.457833,1181.464833,1,35443734,35443944,210,-0.15417543702888087
14672,1181.467267,1181.473667,1,35444018,35444210,192,0.06948003565280654
14673,1181.9904,1181.998,1,35459712,35459940,228,0.8353612780009403
14674,1182.0038,1182.024533,1,35460114,35460735,621,0.5569135596946705
14675,1182.066667,1182.0805,1,35462000,35462415,415,0.5450333541012209
14676,1182.424867,1182.566367,1,35472746,35476991,4245,0.6472021999348149
14677,1182.7398,1182.850033,1,35482194,35485500,3306,0.7873353590251999
14678,1182.8584,1182.864733,1,35485752,35485941,189,-0.10112347761918158
14679,1183.2197,1183.2245,1,35496591,35496735,144,0.46808953221467725
14680,1183.230267,1183.2566,1,35496908,35497698,790,0.4895841167759328
14681,1183.2943,1183.3253,1,35498829,35499759,930,0.8700397855692409
14682,1183.3293,1183.404167,1,35499879,35502125,2246,0.693513268043661
14683,1183.408033,1183.485267,1,35502240,35504558,2318,0.7145933652566924
14684,1183.491167,1183.5163,1,35504735,35505489,754,0.6811181534929611
14685,1183.521967,1183.5404,1,35505659,35506212,553,0.7358228519860185
14686,1183.575967,1183.584433,1,35507279,35507532,253,0.04921012017993331
14687,1183.588633,1183.5959,1,35507658,35507877,219,-0.05143175511695911
14688,1183.597833,1183.617833,1,35507934,35508534,600,0.03071366800784557
14689,1183.631267,1183.645,1,35508938,35509350,412,0.31396070863652303
14690,1183.649067,1183.8425,1,35509472,35515275,5803,0.7826300285237003
14691,1183.873533,1183.8776,1,35516205,35516328,123,0.4470627141303376
14692,1183.909233,1183.915267,1,35517276,35517458,182,0.3046446737112766
14693,1184.1032,1184.140367,1,35523096,35524211,1115,0.2703106072166681
14694,1184.200567,1184.213267,1,35526017,35526398,381,0.44857253250717677
14695,1184.214633,1184.3566,1,35526438,35530698,4260,0.7980700365714797
14696,1184.380367,1184.423867,1,35531411,35532716,1305,0.7802413959209368
14697,1184.4446,1184.4837,1,35533338,35534511,1173,0.7292193476971262
14698,1184.508933,1184.586533,1,35535267,35537595,2328,0.8103667810039803
14699,1184.613067,1184.6169,1,35538392,35538507,115,0.09409412181304457
14700,1185.4371,1185.442133,1,35563113,35563263,150,0.5705837636553408
14701,1185.4448,1185.4484,1,35563344,35563452,108,0.5663194154185828
14702,1185.480433,1185.490233,1,35564412,35564706,294,0.6992074658590004
14703,1185.5145,1185.526,1,35565435,35565780,345,0.8981759123712991
14704,1185.563633,1185.567933,1,35566908,35567037,129,0.25962480088024487
14705,1185.575133,1185.579233,1,35567253,35567376,123,0.06358648185936731
14706,1185.582133,1185.5877,1,35567463,35567631,168,0.8460050275331389
14707,1185.599867,1185.607733,1,35567996,35568231,235,0.6816035201977227
14708,1185.652033,1185.6672,1,35569560,35570016,456,0.5743795950621601
14709,1185.707667,1185.7107,1,35571230,35571321,91,0.1618313837716374
14710,1185.7547,1185.767233,1,35572641,35573016,375,0.3990168901472335
14711,1185.813833,1185.8216,1,35574414,35574648,234,0.688410168085459
14712,1185.825767,1185.832967,1,35574773,35574989,216,0.5934595423358169
14713,1185.8718,1185.878367,1,35576154,35576351,197,0.1657714066846888
14714,1186.012867,1186.0278,1,35580386,35580834,448,0.6961431372088334
14715,1186.028867,1186.0701,1,35580866,35582103,1237,0.8165885936214666
14716,1186.0713,1186.095,1,35582139,35582850,711,0.4083623745945069
14717,1186.098833,1186.119,1,35582964,35583570,606,0.6966961810571137
14718,1186.144267,1186.328,1,35584328,35589840,5512,0.7681244666277892
14719,1186.332067,1186.3542,1,35589962,35590626,664,0.7638668928426549
14720,1186.356733,1186.416,1,35590701,35592480,1779,0.775497216192117
14721,1186.436667,1186.440467,1,35593100,35593214,114,-0.02626475282760111
14722,1186.441467,1186.4499,1,35593244,35593497,253,-0.31069003681677393
14723,1186.9932,1187.0339,1,35609796,35611017,1221,0.6714158816861066
14724,1187.299,1187.309267,1,35618970,35619278,308,0.8014423794191059
14725,1187.310967,1187.3406,1,35619329,35620218,889,0.6901235308479517
14726,1187.341733,1187.349433,1,35620251,35620482,231,0.49907768125106017
14727,1187.356033,1187.378533,1,35620680,35621355,675,0.6939818143267175
14728,1187.420267,1187.447867,1,35622608,35623436,828,0.6403784468350439
14729,1187.456467,1187.497367,1,35623694,35624921,1227,0.7459920097793883
14730,1187.498867,1187.5026,1,35624966,35625078,112,-0.38015002415499194
14731,1187.503867,1187.534,1,35625116,35626020,904,0.6864878521013476
14732,1187.537367,1187.554867,1,35626121,35626646,525,0.3952104523892967
14733,1187.556833,1187.562667,1,35626704,35626880,176,0.4473826049970865
14734,1187.577367,1187.638667,1,35627321,35629160,1839,0.5018652174495914
14735,1187.644533,1187.660467,1,35629335,35629814,479,0.6796318552303519
14736,1187.666467,1187.744533,1,35629994,35632335,2341,0.7788749528844578
14737,1187.763633,1187.766833,1,35632908,35633004,96,-0.038365066055271006
14738,1187.8602,1188.0523,1,35635806,35641569,5763,0.7699697827950623
14739,1188.542367,1188.551933,1,35656271,35656557,286,0.8091665360636371
14740,1188.553633,1188.564167,1,35656608,35656925,317,0.49945395921204017
14741,1188.580467,1188.5965,1,35657414,35657895,481,0.8773737507687053
14742,1188.6,1188.615233,1,35658000,35658456,456,0.8246333451940101
14743,1188.621567,1188.625167,1,35658647,35658755,108,0.776070504962124
14744,1188.6593,1188.666733,1,35659779,35660001,222,0.65293888926231
14745,1188.678767,1188.6881,1,35660363,35660643,280,0.5006403192355419
14746,1188.724567,1188.755567,1,35661737,35662667,930,0.5279648226250775
14747,1188.789633,1188.801133,1,35663688,35664033,345,0.5615088036286192
14748,1188.802767,1188.806433,1,35664083,35664192,109,-0.100969291135213
14749,1188.820533,1188.863133,1,35664615,35665893,1278,0.6796074449542603
14750,1188.8878,1188.9045,1,35666634,35667135,501,0.7031405653322484
14751,1188.923033,1188.928167,1,35667690,35667845,155,-0.1191561339004553
14752,1189.284467,1189.335767,1,35678534,35680073,1539,0.7130303546018869
14753,1189.341333,1189.4198,1,35680239,35682594,2355,0.813495825523073
14754,1190.075767,1190.114367,1,35702273,35703431,1158,0.5117400692390308
14755,1190.128867,1190.149167,1,35703866,35704475,609,0.6807446234904238
14756,1190.172467,1190.181967,1,35705174,35705459,285,0.7564198621678206
14757,1190.2005,1190.2114,1,35706015,35706342,327,0.8904471192762617
14758,1190.295333,1190.298967,1,35708859,35708969,110,0.20952249525071814
14759,1190.374,1190.378133,1,35711220,35711343,123,0.5684162633165609
14760,1190.3863,1190.434,1,35711589,35713020,1431,0.7823635647925152
14761,1190.4402,1190.487633,1,35713206,35714628,1422,0.724893218870375
14762,1190.520233,1190.5299,1,35715606,35715897,291,0.34738647476731516
14763,1190.542,1190.545033,1,35716260,35716350,90,-0.19902244379498032
14764,1190.733633,1190.751467,1,35722008,35722544,536,0.6925206250362004
14765,1190.971167,1191.122367,1,35729135,35733671,4536,0.7572611727866113
14766,1191.123667,1191.169333,1,35733710,35735079,1369,0.7100375678098279
14767,1191.173333,1191.238433,1,35735199,35737152,1953,0.7835981268102481
14768,1191.248733,1191.2566,1,35737461,35737698,237,0.3652564448885648
14769,1191.257933,1191.284467,1,35737737,35738534,797,0.7408603689447396
14770,1191.353633,1191.3585,1,35740608,35740755,147,
14771,1191.852567,1191.900267,1,35755577,35757008,1431,0.1606108136329831
14772,1191.9015,1191.926633,1,35757045,35757798,753,0.3472374218576269
14773,1191.927933,1191.952267,1,35757837,35758568,731,0.5671861377079106
14774,1191.979367,1191.9979,1,35759381,35759937,556,0.7070690443767564
14775,1192.021067,1192.052267,1,35760632,35761568,936,0.6493722153621004
14776,1192.074233,1192.0788,1,35762226,35762364,138,0.5354633108226162
14777,1192.080033,1192.090233,1,35762400,35762706,306,0.5740211720649123
14778,1192.0922,1192.113033,1,35762766,35763390,624,0.5298596581408372
14779,1192.126967,1192.147233,1,35763809,35764416,607,0.5769070017535228
14780,1192.148267,1192.157367,1,35764448,35764721,273,0.4570610305748519
14781,1192.160633,1192.1638,1,35764818,35764914,96,0.618858644321189
14782,1192.199033,1192.206333,1,35765970,35766189,219,0.5957645509810112
14783,1192.207433,1192.2177,1,35766222,35766531,309,0.6540529974465913
14784,1192.2378,1192.244133,1,35767134,35767323,189,0.6999574983800138
14785,1192.255333,1192.2721,1,35767659,35768163,504,0.7146951690585721
14786,1192.413333,1192.4819,1,35772399,35774457,2058,0.8055046451163345
14787,1192.4831,1192.543267,1,35774493,35776298,1805,0.850508030299156
14788,1192.559033,1192.563933,1,35776770,35776917,147,
14789,1192.5676,1192.589,1,35777028,35777670,642,0.716777878153779
14790,1192.590633,1192.669133,1,35777718,35780073,2355,0.809076098490894
14791,1192.771667,1192.8422,1,35783150,35785266,2116,0.7651361854200202
14792,1192.844833,1192.962467,1,35785344,35788874,3530,0.8143936443404431
14793,1192.973167,1192.978,1,35789195,35789340,145,0.18779506310023344
14794,1192.980833,1192.9848,1,35789424,35789544,120,0.6247512904132516
14795,1193.010633,1193.035367,1,35790318,35791061,743,0.0009524415861482369
14796,1193.049867,1193.063867,1,35791496,35791916,420,0.894329273991683
14797,1193.067533,1193.155167,1,35792025,35794655,2630,0.724932644642621
14798,1193.163,1193.1742,1,35794890,35795226,336,0.3634780299025649
14799,1193.187633,1193.1912,1,35795628,35795736,108,
14800,1193.196767,1193.206667,1,35795903,35796200,297,0.2850200465309301
14801,1193.212967,1193.2163,1,35796389,35796489,100,0.3372899810753373
14802,1193.279,1193.362533,1,35798370,35800875,2505,0.8000786891996963
14803,1193.366933,1193.418133,1,35801007,35802543,1536,0.8065126910825606
14804,1193.420567,1193.429567,1,35802617,35802887,270,0.5316160706009633
14805,1193.442133,1193.473967,1,35803263,35804219,956,0.05831660829413811
14806,1193.4761,1193.495567,1,35804283,35804867,584,0.19610582592085976
14807,1193.515333,1193.5321,1,35805459,35805963,504,0.7079355126653293
14808,1193.5335,1193.568,1,35806005,35807040,1035,0.7553046136232283
14809,1193.582367,1193.6246,1,35807471,35808738,1267,0.8141252491739884
14810,1193.640467,1193.656333,1,35809214,35809689,475,-0.08385512628778617
14811,1193.658467,1193.669767,1,35809754,35810093,339,0.12034467973927586
14812,1193.678367,1193.6833,1,35810351,35810499,148,0.09726494535182177
14813,1193.748433,1193.8334,1,35812452,35815002,2550,0.7000282194572458
14814,1193.8361,1193.8783,1,35815083,35816349,1266,0.6424151978727728
14815,1193.893767,1193.900567,1,35816813,35817017,204,-0.07441552045487713
14816,1193.906067,1193.9309,1,35817182,35817927,745,0.2731155451059045
14817,1193.9325,1193.941533,1,35817975,35818245,270,0.062407179668081125
14818,1193.984333,1194.060433,1,35819529,35821812,2283,0.776097574909069
14819,1194.0645,1194.103333,1,35821935,35823099,1164,0.6429847500459829
14820,1194.111333,1194.122867,1,35823339,35823686,347,-0.1003242311660656
14821,1194.132433,1194.142867,1,35823972,35824286,314,-0.06509639001643572
14822,1194.144567,1194.177767,1,35824337,35825333,996,0.18102038004573995
14823,1194.212867,1194.215933,1,35826386,35826477,91,0.25226398293221375
14824,1194.219533,1194.288533,1,35826585,35828655,2070,0.8228698922676321
14825,1194.290967,1194.368,1,35828729,35831040,2311,0.6980696922416149
14826,1194.3699,1194.383833,1,35831097,35831514,417,-0.04488147648451282
14827,1194.399433,1194.447233,1,35831982,35833416,1434,0.08338753874353315
14828,1194.4795,1194.611,1,35834385,35838330,3945,0.8080848362058977
14829,1194.6259,1194.6358,1,35838777,35839074,297,0.4481524720369189
14830,1194.6368,1194.668133,1,35839104,35840043,939,0.0720696714211721
14831,1194.6702,1194.700367,1,35840106,35841011,905,0.11912060553691109
14832,1194.71,1194.8402,1,35841300,35845206,3906,0.7975449416786282
14833,1194.852133,1194.859167,1,35845563,35845775,212,
14834,1194.865133,1194.8858,1,35845953,35846574,621,0.3865486190355103
14835,1194.887767,1194.8939,1,35846633,35846817,184,0.39074878353506337
14836,1194.8996,1194.944933,1,35846988,35848347,1359,0.02519801369038623
14837,1194.945933,1194.953633,1,35848377,35848608,231,-0.0627667139986275
14838,1194.9633,1195.067567,1,35848899,35852027,3128,0.721348697386299
14839,1195.0688,1195.104367,1,35852064,35853131,1067,0.6381111388466577
14840,1195.6405,1195.644333,1,35869215,35869329,114,0.286734177979422
14841,1195.645933,1195.6491,1,35869377,35869473,96,-0.4196217222478668
14842,1195.772,1195.8341,1,35873160,35875023,1863,0.7801923341480327
14843,1195.837133,1195.8581,1,35875113,35875743,630,0.9116781090616246
14844,1195.8995,1195.924967,1,35876985,35877749,764,0.2617954711118116
14845,1195.999367,1196.014567,1,35879981,35880437,456,0.3521004437007072
14846,1196.023533,1196.1019,1,35880705,35883057,2352,0.08820277264650613
14847,1196.103367,1196.1117,1,35883101,35883351,250,0.2412247745212575
14848,1196.1352,1196.187633,1,35884056,35885628,1572,0.8098164368164754
14849,1196.188667,1196.195333,1,35885660,35885859,199,0.4353241865057858
14850,1196.1983,1196.2406,1,35885949,35887218,1269,0.8162984223567972
14851,1196.5419,1196.547167,1,35896257,35896415,158,0.197933014127771
14852,1196.569,1196.608633,1,35897070,35898258,1188,0.7715821870240833
14853,1196.609667,1196.666767,1,35898290,35900003,1713,0.8414119601700141
14854,1196.671667,1196.701,1,35900150,35901030,880,0.8223344862475638
14855,1196.702933,1196.787833,1,35901087,35903634,2547,0.7916402782870092
14856,1196.8275,1196.8375,1,35904825,35905125,300,0.4892827577411946
14857,1196.842767,1196.850833,1,35905283,35905524,241,-0.08719699663914303
14858,1196.851833,1196.855133,1,35905554,35905653,99,
14859,1197.073433,1197.2158,1,35912202,35916474,4272,0.8182432617815475
14860,1197.221167,1197.236833,1,35916635,35917104,469,0.6335676532006979
14861,1197.239233,1197.307,1,35917176,35919210,2034,0.8495987749965429
14862,1197.323167,1197.338933,1,35919695,35920167,472,0.8230300184347437
14863,1197.353467,1197.36,1,35920604,35920800,196,0.2146001131813318
14864,1197.380067,1197.400133,1,35921402,35922003,601,0.12699099526136953
14865,1197.405767,1197.414333,1,35922173,35922429,256,
14866,1197.5199,1197.655433,1,35925597,35929662,4065,0.8509586578780592
14867,1197.705,1197.710233,1,35931150,35931306,156,0.6290026862196977
14868,1197.723267,1197.734733,1,35931698,35932041,343,-0.05532519020279485
14869,1197.929367,1197.956167,1,35937881,35938685,804,0.6861787328368651
14870,1197.962833,1198.124433,1,35938884,35943732,4848,0.7835679341723832
14871,1198.1344,1198.147533,1,35944032,35944425,393,0.5704686099780765
14872,1198.278667,1198.2942,1,35948360,35948826,466,0.6549241482880157
14873,1198.3323,1198.3519,1,35949969,35950557,588,0.4770371910648694
14874,1198.355467,1198.415167,1,35950664,35952455,1791,0.12240417377522264
14875,1198.4746,1198.480067,1,35954238,35954402,164,0.8202714795917765
14876,1198.481967,1198.5436,1,35954459,35956308,1849,0.7779508626805205
14877,1198.5479,1198.572833,1,35956437,35957184,747,0.8146707626125766
14878,1199.2277,1199.3233,1,35976831,35979699,2868,0.7662092102062819
14879,1199.4293,1199.433033,1,35982879,35982990,111,
14880,1199.526167,1199.5357,1,35985785,35986071,286,0.6004884617147506
14881,1199.556633,1199.6211,1,35986698,35988633,1935,0.23076805995842117
14882,1199.622733,1199.675233,1,35988681,35990256,1575,0.7405692509350558
14883,1199.677733,1199.724033,1,35990331,35991720,1389,0.8591819751935279
14884,1199.7462,1199.753933,1,35992386,35992617,231,0.4837258475411059
14885,1199.769233,1199.7756,1,35993076,35993268,192,-0.0792411596421937
14886,1199.779533,1199.791567,1,35993385,35993747,362,0.19495802379738736
14887,1199.793633,1199.800533,1,35993808,35994015,207,-0.006417386711768164
14888,1199.887667,1199.8965,1,35996630,35996895,265,0.5793373410563376
14889,1199.9161,1199.931833,1,35997483,35997954,471,0.44798472690086544
14890,1199.940467,1199.977133,1,35998214,35999313,1099,0.06314786678906165
14891,1199.978767,1199.9919,1,35999363,35999757,394,0.19199085909381974
14892,1199.9932,1199.999033,1,35999796,35999970,174,-0.238141320596364
14893,1200.0136,1200.123033,1,36000408,36003690,3282,0.7952319428902531
14894,1200.1555,1200.169333,1,36004665,36005079,414,0.5521275671719921
14895,1200.174633,1200.191567,1,36005238,36005747,509,0.03243386833295876
14896,1200.193533,1200.220833,1,36005805,36006624,819,0.22007269672948856
14897,1200.221933,1200.2283,1,36006657,36006849,192,0.2623307525245459
14898,1200.280867,1200.288133,1,36008426,36008643,217,0.35587545184087727
14899,1200.296667,1200.385367,1,36008900,36011561,2661,0.1050686923429028
14900,1200.394667,1200.504933,1,36011840,36015147,3307,0.7501711638632581
14901,1200.863833,1200.9032,1,36025914,36027096,1182,0.6844174163165273
14902,1200.916033,1200.934033,1,36027480,36028020,540,0.6991581845500155
14903,1200.937167,1200.9597,1,36028115,36028791,676,0.6926288869680123
14904,1200.984567,1201.0014,1,36029537,36030042,505,0.5353858171750667
14905,1201.025067,1201.054967,1,36030752,36031649,897,0.6220194476596971
14906,1201.070133,1201.0858,1,36032103,36032574,471,0.5008022949685266
14907,1201.091633,1201.1124,1,36032748,36033372,624,0.617583232163632
14908,1201.1637,1201.225967,1,36034911,36036779,1868,0.11416000793987591
14909,1201.243233,1201.2468,1,36037296,36037404,108,0.4860609026007596
14910,1201.248467,1201.395533,1,36037454,36041865,4411,0.7148034751812413
14911,1201.759833,1201.778767,1,36052794,36053363,569,0.7925476457587428
14912,1201.786133,1201.877767,1,36053583,36056333,2750,0.6710808171624972
14913,1202.358833,1202.370567,1,36070764,36071117,353,0.7527096694896457
14914,1202.371733,1202.3899,1,36071151,36071697,546,0.5845243147430332
14915,1202.427467,1202.449233,1,36072824,36073476,652,0.7304190746363901
14916,1202.469667,1202.480633,1,36074090,36074418,328,0.49616261881390156
14917,1202.490633,1202.498633,1,36074718,36074958,240,-0.014066702906205646
14918,1202.5265,1202.549567,1,36075795,36076487,692,0.5481089254881857
14919,1202.5508,1202.611367,1,36076524,36078341,1817,0.5603507537417608
14920,1202.625467,1202.644267,1,36078764,36079328,564,0.60995420290834
14921,1202.646967,1202.666233,1,36079409,36079986,577,0.5203719769998972
14922,1202.696267,1202.7025,1,36080888,36081075,187,0.5968114475136977
14923,1202.707567,1202.7271,1,36081227,36081813,586,0.6111968867528297
14924,1202.743533,1202.768267,1,36082305,36083048,743,0.6046483134504707
14925,1202.785567,1202.790333,1,36083567,36083709,142,0.1265867979228687
14926,1202.8014,1202.807367,1,36084042,36084221,179,-0.1080766971246871
14927,1202.811833,1202.847633,1,36084354,36085428,1074,0.14656810022417552
14928,1202.872767,1203.0763,1,36086183,36092289,6106,0.8045063367035202
14929,1203.102967,1203.106033,1,36093089,36093180,91,
14930,1203.863167,1203.887767,1,36115895,36116633,738,0.3120705343347139
14931,1203.9649,1203.9732,1,36118947,36119196,249,0.6222013796854245
14932,1204.015733,1204.026867,1,36120471,36120806,335,0.5683398582787949
14933,1204.082,1204.0877,1,36122460,36122631,171,0.4487444070224666
14934,1204.089533,1204.0996,1,36122685,36122988,303,0.5980111258714947
14935,1204.125067,1204.131367,1,36123752,36123941,189,0.5272478271290854
14936,1204.134933,1204.149733,1,36124047,36124491,444,0.6497296024074866
14937,1204.160233,1204.166333,1,36124806,36124989,183,0.03901054816916792
14938,1204.1796,1204.183467,1,36125388,36125504,116,0.29863107955873
14939,1204.204833,1204.2145,1,36126144,36126435,291,-0.10171944551314709
14940,1204.220233,1204.237267,1,36126606,36127118,512,0.017396238655070746
14941,1204.245233,1204.2487,1,36127356,36127461,105,0.42343594507249194
14942,1204.255667,1204.4132,1,36127670,36132396,4726,0.7441575066151682
14943,1204.455133,1204.531967,1,36133653,36135959,2306,0.7871129856189357
14944,1204.533267,1204.555267,1,36135998,36136658,660,0.6522255598740279
14945,1204.979833,1205.0094,1,36149394,36150282,888,0.7459003235026439
14946,1205.0105,1205.047533,1,36150315,36151425,1110,0.8168470943346792
14947,1205.050667,1205.104967,1,36151520,36153149,1629,0.7946895761254189
14948,1205.112667,1205.143133,1,36153380,36154293,913,0.7697805252744375
14949,1205.1541,1205.190633,1,36154623,36155718,1095,0.7769150103379764
14950,1205.1926,1205.218233,1,36155778,36156546,768,0.7125887143114746
14951,1205.222033,1205.2292,1,36156660,36156876,216,0.5096134013353105
14952,1205.230533,1205.251333,1,36156915,36157539,624,0.7127701042169057
14953,1205.2557,1205.297067,1,36157671,36158912,1241,0.7330718663488172
14954,1205.304867,1205.310233,1,36159146,36159306,160,0.5963560173448874
14955,1205.318567,1205.348733,1,36159557,36160461,904,0.6072927973736494
14956,1205.783133,1205.786133,1,36173493,36173583,90,0.8249826502729743
14957,1205.789833,1205.921333,1,36173694,36177639,3945,0.7755449751707085
14958,1205.922533,1205.928467,1,36177675,36177854,179,0.47449429142920185
14959,1205.931,1205.958567,1,36177930,36178757,827,0.6682259638816542
14960,1205.961067,1205.9766,1,36178832,36179298,466,0.833847380518097
14961,1205.985167,1206.059667,1,36179555,36181790,2235,0.7416371052924345
14962,1206.069533,1206.074167,1,36182085,36182225,140,0.10855848385386008
14963,1206.0803,1206.111333,1,36182409,36183339,930,0.7525800116701078
14964,1206.459333,1206.468967,1,36193779,36194069,290,0.5631004892035374
14965,1206.6494,1206.669633,1,36199482,36200088,606,0.18699779874118658
14966,1206.706667,1206.7111,1,36201200,36201333,133,0.5320926858865775
14967,1206.776333,1206.9575,1,36203289,36208725,5436,0.731860235430186
14968,1206.959067,1206.989233,1,36208772,36209676,904,0.759335467016763
14969,1206.990467,1206.996,1,36209714,36209880,166,0.09052908866407726
14970,1207.001233,1207.0247,1,36210036,36210741,705,0.7843930064174501
14971,1207.164267,1207.169767,1,36214928,36215093,165,0.3921482710921417
14972,1207.586367,1207.597733,1,36227591,36227931,340,0.605762967965154
14973,1207.6068,1207.6231,1,36228204,36228693,489,0.6229077188420201
14974,1207.653767,1207.691033,1,36229613,36230730,1117,0.6751895170730499
14975,1207.6937,1207.705467,1,36230811,36231164,353,0.5384161175855326
14976,1207.716367,1207.721733,1,36231491,36231651,160,0.29362936202685874
14977,1207.767367,1207.804667,1,36233021,36234140,1119,0.6216069676677239
14978,1207.8299,1207.851967,1,36234897,36235559,662,0.6090202028025827
14979,1207.854533,1207.903633,1,36235635,36237108,1473,0.6621271192745729
14980,1207.9141,1207.921,1,36237423,36237630,207,0.5339387522544625
14981,1207.928967,1207.9402,1,36237869,36238206,337,0.5124314553101121
14982,1207.944033,1207.9598,1,36238320,36238794,474,0.5639806946579025
14983,1207.9941,1208.0547,1,36239823,36241641,1818,0.20586950574838736
14984,1208.0687,1208.072,1,36242061,36242160,99,0.05768487458141769
14985,1208.0791,1208.264467,1,36242373,36247934,5561,0.731995325278591
14986,1208.2657,1208.324367,1,36247971,36249731,1760,0.5001146581820847
14987,1208.445967,1208.449233,1,36253379,36253476,97,-0.13136115986615698
14988,1208.758133,1208.766667,1,36262743,36263000,257,0.46708980554611307
14989,1208.7805,1208.8324,1,36263415,36264972,1557,0.7905466176595268
14990,1208.837233,1208.944733,1,36265116,36268341,3225,0.7670468397187644
14991,1208.946667,1208.964933,1,36268400,36268947,547,0.7090935159429022
14992,1208.971633,1209.098,1,36269148,36272940,3792,0.8042654284323936
14993,1210.199,1210.208367,1,36305970,36306251,281,0.5445267370263902
14994,1210.214033,1210.228,1,36306420,36306840,420,0.5049699781461998
14995,1210.2932,1210.302733,1,36308796,36309081,285,0.5896577616856448
14996,1210.347067,1210.3583,1,36310412,36310749,337,0.580590184585368
14997,1210.4067,1210.414567,1,36312201,36312437,236,0.632217176892277
14998,1210.416933,1210.429667,1,36312507,36312890,383,0.5733025235356742
14999,1210.449267,1210.458767,1,36313478,36313763,285,0.611830383406887
15000,1210.464267,1210.477833,1,36313928,36314334,406,0.5347637060417438
15001,1210.527133,1210.5331,1,36315813,36315993,180,0.3606540009789942
15002,1210.548333,1210.558133,1,36316449,36316743,294,0.18961521437438159
15003,1210.629567,1210.7698,1,36318887,36323094,4207,0.7079936925575306
15004,1211.344067,1211.436967,1,36340322,36343109,2787,0.7639965597167696
15005,1211.737933,1211.742267,1,36352137,36352268,131,0.15411531978758247
15006,1211.828933,1211.839067,1,36354867,36355172,305,0.15468846863403837
15007,1211.843033,1211.8782,1,36355290,36356346,1056,0.2710474560590082
15008,1211.906733,1211.912667,1,36357201,36357380,179,-0.07720578805031623
15009,1211.913933,1211.9172,1,36357417,36357516,99,
15010,1211.9444,1211.948233,1,36358332,36358446,114,0.059574219494291786
15011,1211.9913,1212.003167,1,36359739,36360095,356,0.3309565297230381
15012,1212.022767,1212.027667,1,36360683,36360830,147,0.6213654409064915
15013,1212.052267,1212.057733,1,36361568,36361731,163,0.8257464375292015
15014,1212.059767,1212.0867,1,36361793,36362601,808,0.7558037396350906
15015,1212.087767,1212.1069,1,36362633,36363207,574,0.8275327638216162
15016,1212.1119,1212.142,1,36363357,36364260,903,0.7627349427277629
15017,1212.1582,1212.2011,1,36364746,36366033,1287,0.7724948060492456
15018,1212.208733,1212.267567,1,36366261,36368027,1766,0.790227376878421
15019,1212.284633,1212.322133,1,36368538,36369663,1125,0.7156616062557658
15020,1213.1907,1213.201933,1,36395721,36396057,336,0.06127136673533952
15021,1213.212633,1213.218667,1,36396378,36396560,182,-0.07050623041202815
15022,1213.2267,1213.233833,1,36396801,36397014,213,0.5222749417674432
15023,1213.248967,1213.269533,1,36397469,36398085,616,0.33226192838861446
15024,1213.297867,1213.305067,1,36398936,36399152,216,0.06478034466738919
15025,1213.306367,1213.3181,1,36399191,36399543,352,-0.08756297258102316
15026,1213.408967,1213.438067,1,36402269,36403142,873,0.6006481225300816
15027,1213.4716,1213.4856,1,36404148,36404568,420,0.6932235109890831
15028,1213.493133,1213.511433,1,36404793,36405342,549,0.7646907661150945
15029,1213.5567,1213.567667,1,36406701,36407030,329,0.29892677886856883
15030,1213.5909,1213.599633,1,36407727,36407988,261,-0.025991098699523617
15031,1213.601533,1213.612567,1,36408045,36408377,332,0.04922310349731954
15032,1213.617833,1213.625233,1,36408534,36408756,222,-0.24044256991987403
15033,1213.674933,1213.690367,1,36410247,36410711,464,0.4475106460331872
15034,1213.6943,1213.705233,1,36410829,36411156,327,0.6038215683389306
15035,1213.7436,1213.7516,1,36412308,36412548,240,0.5723876497468927
15036,1213.752967,1213.7594,1,36412589,36412782,193,0.5816038680617343
15037,1213.786133,1213.7894,1,36413583,36413682,99,
15038,1213.799333,1213.814867,1,36413979,36414446,467,0.49064724357545153
15039,1213.821467,1213.824633,1,36414644,36414738,94,0.44223501909851115
15040,1213.833133,1213.872667,1,36414993,36416180,1187,0.010697583296512197
15041,1213.8773,1213.884967,1,36416319,36416549,230,0.0733927801588763
15042,1213.895033,1213.901667,1,36416850,36417050,200,0.4104697506288972
15043,1213.9176,1213.929,1,36417528,36417870,342,0.3136659586360269
15044,1213.943,1213.967367,1,36418290,36419021,731,0.2996222562333288
15045,1213.9824,1214.011267,1,36419472,36420338,866,-0.014858188551147629
15046,1214.015433,1214.026367,1,36420462,36420791,329,-0.01724957505622539
15047,1214.027367,1214.030367,1,36420821,36420911,90,
15048,1214.097067,1214.201733,1,36422912,36426051,3139,0.7216247941496067
15049,1214.212167,1214.228167,1,36426365,36426845,480,0.40435390361362683
15050,1214.2293,1214.242133,1,36426879,36427263,384,0.12581776141352813
15051,1214.249533,1214.2813,1,36427485,36428439,954,0.11138586301987712
15052,1214.284367,1214.300033,1,36428531,36429000,469,0.01565591319071555
15053,1214.3055,1214.3156,1,36429165,36429468,303,0.15263217551932004
15054,1214.3344,1214.345567,1,36430032,36430367,335,0.2550792895352722
15055,1214.3561,1214.417667,1,36430683,36432530,1847,0.09501899591145153
15056,1214.4224,1214.4432,1,36432672,36433296,624,0.1483793261280581
15057,1214.506233,1214.511733,1,36435186,36435351,165,-0.1558842130986855
15058,1214.517967,1214.541967,1,36435539,36436259,720,0.16048545668926992
15059,1214.543367,1214.552167,1,36436301,36436565,264,0.15738725323969097
15060,1214.572567,1214.585133,1,36437177,36437553,376,0.05214502424018356
15061,1214.586467,1214.594433,1,36437594,36437832,238,0.0906191561439706
15062,1214.598633,1214.606067,1,36437958,36438182,224,-0.23728269089201318
15063,1214.768667,1214.773733,1,36443060,36443211,151,0.533549110697567
15064,1214.776267,1214.785433,1,36443288,36443562,274,0.6840183705019207
15065,1214.812333,1214.819133,1,36444369,36444573,204,0.6716865013684172
15066,1214.848,1214.857267,1,36445440,36445718,278,0.7807283383220227
15067,1214.884233,1214.8888,1,36446526,36446664,138,0.6111078713626102
15068,1214.943167,1214.9584,1,36448295,36448752,457,0.5220064310036485
15069,1214.985433,1215.0073,1,36449562,36450219,657,0.5777142594255348
15070,1215.0652,1215.080367,1,36451956,36452411,455,0.7142987118506411
15071,1215.109767,1215.115333,1,36453293,36453459,166,0.5847285850448486
15072,1215.120967,1215.1284,1,36453629,36453852,223,0.45548561929066184
15073,1215.139467,1215.1484,1,36454184,36454452,268,-0.14619374646199493
15074,1215.1558,1215.163,1,36454674,36454890,216,0.32824999801779675
15075,1215.1843,1215.193833,1,36455529,36455814,285,-0.02433053423600947
15076,1215.199067,1215.204133,1,36455972,36456123,151,
15077,1215.306967,1215.394167,1,36459209,36461825,2616,0.6851909250209377
15078,1215.404833,1215.408833,1,36462144,36462264,120,
15079,1215.4267,1215.432767,1,36462801,36462983,182,0.36180024267898425
15080,1215.4446,1215.4781,1,36463338,36464343,1005,0.12241533087592268
15081,1215.4826,1215.497067,1,36464478,36464912,434,0.16083760301174338
15082,1215.498567,1215.511367,1,36464957,36465341,384,0.048374848736637
15083,1215.512867,1215.5178,1,36465386,36465534,148,-0.029600242356517436
15084,1215.5283,1215.540067,1,36465849,36466202,353,0.33131592553803274
15085,1215.545767,1215.554533,1,36466373,36466635,262,0.06720925830122673
15086,1215.564733,1215.5752,1,36466941,36467256,315,0.06163024543558042
15087,1215.576867,1215.591067,1,36467306,36467732,426,-0.0029531430428667914
15088,1215.600167,1215.731833,1,36468005,36471954,3949,0.5826721953543502
15089,1215.733567,1215.750167,1,36472007,36472505,498,-0.04662658163234216
15090,1215.7568,1215.779633,1,36472704,36473388,684,0.11754623829724728
15091,1215.785733,1215.799033,1,36473571,36473970,399,0.09127013948680604
15092,1215.801433,1215.906167,1,36474042,36477185,3143,0.5346614261147761
15093,1215.9994,1216.0024,1,36479982,36480072,90,
15094,1216.3444,1216.3496,1,36490332,36490488,156,0.5841303347840221
15095,1216.3629,1216.4781,1,36490887,36494343,3456,0.6426623005648889
15096,1216.4838,1216.5036,1,36494514,36495108,594,0.6265256077678425
15097,1216.5051,1216.510667,1,36495153,36495320,167,0.8785510605615614
15098,1216.513167,1216.5735,1,36495395,36497205,1810,0.5640466303849585
15099,1216.586433,1216.6022,1,36497592,36498066,474,0.6573541942780889
15100,1216.619,1216.658667,1,36498570,36499760,1190,0.52981628573091
15101,1216.673467,1216.6774,1,36500204,36500322,118,0.20853694440650786
15102,1216.6875,1216.695567,1,36500625,36500867,242,0.644833985999843
15103,1216.7005,1216.709433,1,36501015,36501282,267,0.6020427098930682
15104,1216.7369,1216.95,1,36502107,36508500,6393,0.35658872904470773
15105,1217.384033,1217.4028,1,36521520,36522084,564,0.6970682215979642
15106,1217.447967,1217.464533,1,36523439,36523935,496,0.6282918504103208
15107,1217.497533,1217.506367,1,36524925,36525191,266,0.5031176391189277
15108,1217.518133,1217.529967,1,36525543,36525899,356,0.41691705144549546
15109,1217.5682,1217.5902,1,36527046,36527706,660,0.4938010733984972
15110,1217.646733,1217.653933,1,36529401,36529617,216,0.3370993862690816
15111,1217.678867,1217.694,1,36530366,36530820,454,0.37285621198743546
15112,1217.741533,1217.749233,1,36532245,36532476,231,0.6067811384809699
15113,1217.751,1217.759633,1,36532530,36532788,258,0.5399855521514969
15114,1217.7843,1217.793533,1,36533529,36533805,276,0.6556318821662352
15115,1217.8024,1217.8197,1,36534072,36534591,519,0.5759761771173348
15116,1217.861133,1217.873267,1,36535833,36536198,365,-0.11115416307153411
15117,1217.874433,1217.889967,1,36536232,36536699,467,0.06765413973780413
15118,1217.8918,1217.906,1,36536754,36537180,426,0.21758489206649823
15119,1217.907733,1217.9122,1,36537231,36537366,135,0.11580292193598803
15120,1217.9461,1218.017267,1,36538383,36540518,2135,0.7821247846557601
15121,1218.0188,1218.057,1,36540564,36541710,1146,0.817837259764988
15122,1218.096633,1218.1015,1,36542898,36543045,147,0.2968509073524974
15123,1218.310967,1218.332733,1,36549329,36549981,652,0.5875164758561063
15124,1218.342033,1218.4415,1,36550260,36553245,2985,0.8217033521528823
15125,1218.888133,1218.9149,1,36566643,36567447,804,0.6054199348215419
15126,1218.925333,1218.975133,1,36567759,36569253,1494,0.7300765723839284
15127,1218.987367,1218.9905,1,36569621,36569715,94,0.846570188999539
15128,1218.9943,1219.0378,1,36569829,36571134,1305,0.3564410908031029
15129,1219.058,1219.0754,1,36571740,36572262,522,0.8070076019933211
15130,1219.085367,1219.109267,1,36572561,36573278,717,0.6990542933552035
15131,1219.1134,1219.1676,1,36573402,36575028,1626,0.6896703450807232
15132,1219.187,1219.2235,1,36575610,36576705,1095,0.7867532199967954
15133,1219.2401,1219.268933,1,36577203,36578067,864,0.8408376443575845
15134,1219.284533,1219.292367,1,36578535,36578771,236,0.5754389076928002
15135,1219.2993,1219.353367,1,36578979,36580601,1622,0.02554990529392656
15136,1219.376867,1219.5541,1,36581306,36586623,5317,0.7662954803364196
15137,1219.559333,1219.582567,1,36586779,36587477,698,0.6258926676357733
15138,1219.5848,1219.653433,1,36587544,36589602,2058,0.7969736001980995
15139,1219.700867,1219.713667,1,36591026,36591410,384,-0.032005808299680805
15140,1220.347733,1220.351167,1,36610431,36610535,104,0.45324771980532724
15141,1220.394767,1220.412733,1,36611843,36612381,538,0.6597531375838114
15142,1220.445467,1220.4512,1,36613364,36613536,172,0.6533153065993379
15143,1220.4596,1220.4706,1,36613788,36614118,330,0.5815416221786562
15144,1220.4878,1220.502133,1,36614634,36615063,429,0.7100160666092138
15145,1220.5356,1220.540033,1,36616068,36616200,132,0.47163013202217735
15146,1220.5523,1220.562333,1,36616569,36616869,300,0.6528278298848981
15147,1220.5873,1220.605933,1,36617619,36618177,558,0.5539985325770683
15148,1220.6572,1220.663,1,36619716,36619890,174,0.7246671904061448
15149,1220.6666,1220.675167,1,36619998,36620255,257,0.6109114078195568
15150,1220.7134,1220.7223,1,36621402,36621669,267,0.6026680287026218
15151,1220.868733,1220.9415,1,36626061,36628245,2184,0.7462289597930618
15152,1220.9443,1221.059633,1,36628329,36631788,3459,0.7268209508365178
15153,1221.0626,1221.077,1,36631878,36632310,432,0.6971664676725886
15154,1221.0983,1221.157867,1,36632949,36634736,1787,0.720205163892077
15155,1221.167833,1221.181567,1,36635034,36635447,413,0.5787081729570873
15156,1221.1889,1221.1946,1,36635667,36635838,171,0.33052735617428597
15157,1221.2023,1221.208333,1,36636069,36636249,180,0.42456437899927785
15158,1221.2234,1221.231767,1,36636702,36636953,251,-0.050619054304544775
15159,1221.240033,1221.250633,1,36637200,36637518,318,0.1100543177093876
15160,1221.452833,1221.457833,1,36643584,36643734,150,0.5798661193679435
15161,1221.461767,1221.625133,1,36643853,36648753,4900,0.768139476408781
15162,1221.6498,1221.656833,1,36649494,36649704,210,0.455524488396605
15163,1221.6729,1221.683567,1,36650187,36650507,320,-0.0535562831916596
15164,1221.688367,1221.713433,1,36650651,36651402,751,0.1287677109154021
15165,1221.717833,1221.723067,1,36651534,36651692,158,0.42582217219518115
15166,1221.802933,1221.8094,1,36654087,36654282,195,-0.019860090763162905
15167,1221.836633,1221.853567,1,36655098,36655607,509,0.5846088020192077
15168,1221.855667,1221.860233,1,36655670,36655806,136,-0.06598684032903618
15169,1222.130933,1222.165733,1,36663927,36664971,1044,0.6451755028259174
15170,1222.178,1222.1875,1,36665340,36665625,285,0.44112642726042495
15171,1222.2313,1222.2594,1,36666939,36667782,843,0.683048807472476
15172,1222.2604,1222.3284,1,36667812,36669852,2040,0.6336657388084312
15173,1222.342433,1222.384833,1,36670272,36671544,1272,0.7128444237475026
15174,1222.3905,1222.3962,1,36671715,36671886,171,-0.1837284147836345
15175,1222.405567,1222.433967,1,36672167,36673019,852,0.017182665277239946
15176,1222.435133,1222.456367,1,36673053,36673691,638,0.002625087658970521
15177,1222.4593,1222.4667,1,36673779,36674001,222,0.5060754689819765
15178,1222.472033,1222.6244,1,36674160,36678732,4572,0.7463555375860967
15179,1222.640267,1222.6811,1,36679208,36680433,1225,0.726648271560467
15180,1222.705533,1222.737767,1,36681165,36682133,968,0.7914118714651267
15181,1222.7519,1222.762667,1,36682557,36682880,323,-0.13509782466128342
15182,1222.766667,1222.792633,1,36683000,36683778,778,-0.03674176370620271
15183,1222.8599,1222.863567,1,36685797,36685907,110,
15184,1222.868733,1222.919433,1,36686061,36687582,1521,0.4768530038301954
15185,1222.947867,1222.9514,1,36688436,36688542,106,-0.16391945316836976
15186,1223.3295,1223.3383,1,36699885,36700149,264,0.6825376289458136
15187,1223.363733,1223.3939,1,36700911,36701817,906,0.7633817287687032
15188,1223.439733,1223.450133,1,36703191,36703503,312,0.46118429415711876
15189,1223.4546,1223.459833,1,36703638,36703794,156,0.5751354089298018
15190,1223.482,1223.509633,1,36704460,36705288,828,0.1403661423720697
15191,1223.534267,1223.556667,1,36706028,36706700,672,0.5095786006353729
15192,1223.563967,1223.568233,1,36706919,36707046,127,-0.1300864940306281
15193,1223.597233,1223.6592,1,36707916,36709776,1860,0.4960861679385287
15194,1223.6788,1223.851033,1,36710364,36715530,5166,0.7575786196990367
15195,1223.854167,1223.865667,1,36715625,36715970,345,0.6238354446559375
15196,1223.890333,1223.966667,1,36716709,36719000,2291,0.7082158136403499
15197,1224.000867,1224.0192,1,36720026,36720576,550,-0.023164578741989354
15198,1224.020833,1224.0436,1,36720624,36721308,684,0.12310853166317574
15199,1224.137767,1224.2589,1,36724133,36727767,3634,0.3767114613157478
15200,1224.2612,1224.2651,1,36727836,36727953,117,0.6732218282575443
15201,1224.422333,1224.426133,1,36732669,36732783,114,0.1927898324449316
15202,1224.4309,1224.4953,1,36732927,36734859,1932,0.7449378527452329
15203,1224.497533,1224.5503,1,36734925,36736509,1584,0.8160759149169412
15204,1224.559467,1224.5888,1,36736784,36737664,880,0.8125740041441072
15205,1224.591133,1224.6315,1,36737733,36738945,1212,0.6168875823541307
15206,1224.660133,1224.724267,1,36739803,36741728,1925,0.7160193337966922
15207,1224.747633,1224.7764,1,36742428,36743292,864,0.6341289053681489
15208,1224.7806,1224.784033,1,36743418,36743520,102,
15209,1224.819533,1224.8569,1,36744585,36745707,1122,-0.0017138464983158773
15210,1224.908367,1225.026233,1,36747251,36750786,3535,0.7865615827234945
15211,1225.151067,1225.235,1,36754532,36757050,2518,0.4292144718464586
15212,1225.244333,1225.250233,1,36757329,36757506,177,-0.07937151526286801
15213,1225.663233,1225.774633,1,36769896,36773238,3342,0.48241797830498667
15214,1225.8064,1225.8387,1,36774192,36775161,969,0.5317234530722698
15215,1225.854867,1225.861433,1,36775646,36775842,196,0.5101050306417119
15216,1225.907233,1225.9277,1,36777216,36777831,615,-0.0012717339713384302
15217,1225.9291,1225.939433,1,36777873,36778182,309,-0.09316477010384139
15218,1225.955167,1225.9625,1,36778655,36778875,220,-0.01221833626537175
15219,1225.9638,1225.9828,1,36778914,36779484,570,0.0801103320909066
15220,1226.0134,1226.069433,1,36780402,36782082,1680,0.6454049740141361
15221,1226.071367,1226.1123,1,36782141,36783369,1228,0.7339622942795238
15222,1226.125967,1226.159767,1,36783779,36784793,1014,-0.008114323219293803
15223,1226.166567,1226.177633,1,36784997,36785328,331,0.1402350078954652
15224,1226.233067,1226.2558,1,36786992,36787674,682,0.23508921537421912
15225,1226.260233,1226.2866,1,36787806,36788598,792,0.12858131672574316
15226,1226.296467,1226.300067,1,36788894,36789002,108,0.2266598502441307
15227,1226.3016,1226.4158,1,36789048,36792474,3426,0.44624959084960597
15228,1226.419333,1226.423633,1,36792579,36792708,129,0.04376236191149626
15229,1226.434767,1226.4397,1,36793043,36793191,148,0.12312679479718275
15230,1226.4629,1226.466067,1,36793887,36793982,95,-0.19374112409060887
15231,1226.469367,1226.478733,1,36794081,36794361,280,0.5609145407625784
15232,1226.529867,1226.59,1,36795896,36797700,1804,0.5851585966818119
15233,1226.5936,1226.636867,1,36797808,36799106,1298,0.7285287444422105
15234,1226.664667,1226.692567,1,36799940,36800777,837,0.7201921223186216
15235,1226.710267,1226.724733,1,36801308,36801741,433,0.3133155610401359
15236,1226.7271,1226.770733,1,36801813,36803121,1308,0.6134572581506939
15237,1226.780767,1226.7885,1,36803423,36803655,232,0.5055880079955375
15238,1226.792367,1226.8188,1,36803771,36804564,793,0.689795038903858
15239,1226.842667,1226.907167,1,36805280,36807215,1935,0.36542823280104825
15240,1226.9125,1226.919267,1,36807375,36807578,203,-0.01372195303737512
15241,1226.9265,1227.0923,1,36807795,36812769,4974,0.6514661200879805
15242,1227.105933,1227.167433,1,36813177,36815022,1845,0.6720537407917822
15243,1227.171033,1227.178233,1,36815130,36815346,216,0.2913168387612199
15244,1227.189,1227.210667,1,36815670,36816320,650,-0.04921468600302331
15245,1227.213633,1227.2328,1,36816408,36816984,576,0.08232901200294988
15246,1227.2631,1227.266233,1,36817893,36817986,93,
15247,1227.274033,1227.292633,1,36818220,36818778,558,0.09498816974309761
15248,1227.2976,1227.329567,1,36818928,36819887,959,0.1548776158388653
15249,1227.331233,1227.340533,1,36819936,36820215,279,0.07426815902021863
15250,1227.3438,1227.354167,1,36820314,36820625,311,0.5404121827840721
15251,1227.3888,1227.496767,1,36821664,36824903,3239,0.25811658347643396
15252,1227.497933,1227.526233,1,36824937,36825786,849,0.2950258183857314
15253,1227.5315,1227.5546,1,36825945,36826638,693,0.3268888801483852
15254,1227.556167,1227.581867,1,36826685,36827456,771,0.2042227436611786
15255,1227.618733,1227.625467,1,36828561,36828764,203,-0.08881395965608622
15256,1227.638367,1227.643433,1,36829151,36829302,151,-0.005589530976300216
15257,1227.7266,1227.733167,1,36831798,36831995,197,0.6511678041612146
15258,1228.036967,1228.043067,1,36841109,36841292,183,0.6996670155725556
15259,1228.044467,1228.054733,1,36841334,36841641,307,0.6580362821019433
15260,1228.0618,1228.1482,1,36841854,36844446,2592,0.8175282330927957
15261,1228.163067,1228.1993,1,36844892,36845979,1087,0.7425573529468372
15262,1228.211733,1228.2186,1,36846351,36846558,207,0.6008139158462404
15263,1228.245767,1228.253233,1,36847373,36847596,223,0.07196902987824999
15264,1228.2594,1228.270467,1,36847782,36848114,332,-0.0031038909524546843
15265,1228.271667,1228.291867,1,36848150,36848756,606,-0.05063420687783594
15266,1228.293733,1228.306467,1,36848811,36849194,383,0.21900875216572857
15267,1228.3206,1228.328233,1,36849618,36849846,228,0.5157583652058862
15268,1228.329967,1228.3946,1,36849899,36851838,1939,0.7728099003044774
15269,1228.3959,1228.465,1,36851877,36853950,2073,0.7946646895356446
15270,1228.497367,1228.500633,1,36854921,36855018,97,-0.10199937362524376
15271,1228.918567,1228.923767,1,36867557,36867713,156,0.20211082461107036
15272,1228.926133,1228.931133,1,36867783,36867933,150,0.2312594043719174
15273,1228.943067,1228.9739,1,36868292,36869217,925,0.6013295825311505
15274,1228.999533,1229.0123,1,36869985,36870369,384,0.8498427362260117
15275,1229.0624,1229.088633,1,36871872,36872658,786,0.43861463599286415
15276,1229.128467,1229.137967,1,36873854,36874139,285,0.5558242205257793
15277,1229.141833,1229.145833,1,36874254,36874374,120,0.3700701003105509
15278,1229.166433,1229.188833,1,36874992,36875664,672,0.5799895408970976
15279,1229.198867,1229.212933,1,36875966,36876387,421,0.5100102432200776
15280,1229.216267,1229.220533,1,36876488,36876615,127,0.5961329070778847
15281,1229.223633,1229.230667,1,36876708,36876920,212,0.6564335380357007
15282,1229.2447,1229.2825,1,36877341,36878475,1134,0.7101573872432984
15283,1229.290833,1229.307933,1,36878724,36879237,513,0.4491157079427604
15284,1229.310567,1229.323533,1,36879317,36879705,388,0.7219052930513098
15285,1229.927833,1229.9564,1,36897834,36898692,858,0.5262972588974276
15286,1229.9577,1230.000033,1,36898731,36900000,1269,0.2699970348214342
15287,1230.446967,1230.450367,1,36913409,36913511,102,0.6860542377368802
15288,1230.4607,1230.472533,1,36913821,36914175,354,0.527346695150868
15289,1230.5002,1230.518433,1,36915006,36915552,546,0.42506832699657854
15290,1230.560533,1230.569967,1,36916815,36917099,284,0.6321735745163066
15291,1230.582033,1230.5889,1,36917460,36917667,207,0.5982913890100758
15292,1230.594333,1230.608467,1,36917829,36918254,425,0.4013438216816289
15293,1230.642967,1230.698367,1,36919289,36920951,1662,0.7712934605646706
15294,1230.7078,1230.759667,1,36921234,36922790,1556,0.6230033846102397
15295,1230.7824,1230.790833,1,36923472,36923724,252,0.6695478962196353
15296,1230.793933,1230.813833,1,36923817,36924414,597,0.638335832145518
15297,1230.837167,1230.874667,1,36925115,36926240,1125,0.5095729050690435
15298,1230.905633,1230.918733,1,36927168,36927561,393,0.7047210680001357
15299,1230.937533,1230.9504,1,36928125,36928512,387,0.729714171257599
15300,1230.961633,1230.9701,1,36928848,36929103,255,0.7023755701845511
15301,1231.508067,1231.553167,1,36945242,36946595,1353,0.6376353821059734
15302,1231.572333,1231.587067,1,36947169,36947612,443,0.5879830763877072
15303,1232.023967,1232.038133,1,36960719,36961143,424,0.685155183423514
15304,1232.048733,1232.055267,1,36961461,36961658,197,0.3507816984178382
15305,1232.057167,1232.061567,1,36961715,36961847,132,0.6253461920410511
15306,1232.0771,1232.080933,1,36962313,36962427,114,0.10315085328173473
15307,1232.0824,1232.093633,1,36962472,36962808,336,0.5144034303909385
15308,1232.104067,1232.109033,1,36963122,36963270,148,0.3939229890032533
15309,1232.112267,1232.124867,1,36963368,36963746,378,0.6815688115343339
15310,1232.153167,1232.163767,1,36964595,36964913,318,0.5606980432361918
15311,1232.165033,1232.211633,1,36964950,36966348,1398,0.6551641583059187
15312,1232.237633,1232.2466,1,36967128,36967398,270,0.7219968812971362
15313,1232.2492,1232.270933,1,36967476,36968127,651,0.6137501906272743
15314,1232.291133,1232.3135,1,36968733,36969405,672,0.6425198578481592
15315,1232.364433,1232.367767,1,36970932,36971033,101,0.5479112721119125
15316,1232.370667,1232.382133,1,36971120,36971463,343,0.598942972451872
15317,1232.4057,1232.412,1,36972171,36972360,189,0.5662697785683539
15318,1232.419067,1232.4381,1,36972572,36973143,571,0.6771154414421864
15319,1232.9519,1232.961933,1,36988557,36988857,300,0.5216209443568481
15320,1232.963967,1233.059767,1,36988919,36991793,2874,0.3368720442567884
15321,1233.061533,1233.070167,1,36991845,36992105,260,0.2043019194535997
15322,1233.073967,1233.078933,1,36992219,36992367,148,0.02713122702663121
15323,1233.080033,1233.2282,1,36992400,36996846,4446,0.6001403022814767
15324,1233.231867,1233.238133,1,36996956,36997143,187,0.33499645326453503
15325,1233.239133,1233.242133,1,36997173,36997263,90,0.4532457161120296
15326,1233.247867,1233.264467,1,36997436,36997934,498,0.40653139889762807
15327,1233.288367,1233.292467,1,36998651,36998774,123,
15328,1233.294267,1233.297367,1,36998828,36998921,93,
15329,1233.304767,1233.3252,1,36999143,36999756,613,0.4572193793156675
15330,1233.331,1233.334833,1,36999930,37000044,114,0.7760958350513198
15331,1233.3421,1233.3554,1,37000263,37000662,399,0.158302806974893
15332,1233.359833,1233.3642,1,37000794,37000926,132,0.4879665089993118
15333,1233.384233,1233.398767,1,37001526,37001963,437,0.01800725324197565
15334,1233.403767,1233.417933,1,37002113,37002537,424,-0.011315131216421245
15335,1233.428033,1233.443333,1,37002840,37003299,459,0.6214196888516293
15336,1233.474567,1233.4783,1,37004237,37004349,112,0.03935151035745848
15337,1233.497667,1233.523867,1,37004930,37005716,786,0.21362078620548416
15338,1233.5262,1233.549133,1,37005786,37006473,687,0.03304485590834961
15339,1233.554667,1233.5608,1,37006640,37006824,184,-0.06254760412537
15340,1233.5642,1233.573,1,37006926,37007190,264,0.5602328314368767
15341,1233.6259,1233.6308,1,37008777,37008924,147,0.4806340533618892
15342,1233.6623,1233.669867,1,37009869,37010096,227,0.16757268702072017
15343,1233.685633,1233.710367,1,37010568,37011311,743,0.06871138237680377
15344,1233.7205,1233.726567,1,37011615,37011797,182,0.17253620785307064
15345,1233.7766,1233.7823,1,37013298,37013469,171,0.112363145770712
15346,1233.821767,1233.826133,1,37014653,37014783,130,-0.08279855045790584
15347,1233.827867,1233.831667,1,37014836,37014950,114,-0.126220095708454
15348,1233.8836,1233.8903,1,37016508,37016709,201,0.2737313328783153
15349,1233.902933,1233.910967,1,37017087,37017329,242,0.1416500284252134
15350,1233.911967,1233.925167,1,37017359,37017755,396,-0.07455544890291033
15351,1233.930467,1233.9496,1,37017914,37018488,574,0.007466697353566763
15352,1233.951133,1233.957267,1,37018533,37018718,185,0.3876699391221431
15353,1233.970533,1233.9755,1,37019115,37019265,150,0.3532638672974848
15354,1234.024867,1234.0375,1,37020746,37021125,379,0.27046038809039313
15355,1234.041467,1234.0648,1,37021244,37021944,700,-0.04253314491053909
15356,1234.080167,1234.094867,1,37022405,37022846,441,0.19471668478914905
15357,1234.111067,1234.122933,1,37023332,37023687,355,0.3864208613187822
15358,1234.128767,1234.1332,1,37023863,37023996,133,
15359,1234.137333,1234.145933,1,37024119,37024377,258,-0.08327462562475366
15360,1234.1523,1234.176033,1,37024569,37025280,711,0.013989663296925432
15361,1234.182233,1234.192267,1,37025466,37025768,302,0.2708715288330672
15362,1234.196833,1234.202833,1,37025904,37026084,180,0.4446566491368161
15363,1234.361967,1234.369,1,37030859,37031070,211,-0.018615238899479494
15364,1234.374633,1234.4017,1,37031238,37032051,813,0.0072823649268184765
15365,1234.413767,1234.4184,1,37032413,37032552,139,0.4827383682722817
15366,1234.463167,1234.4671,1,37033895,37034013,118,0.35603968021150434
15367,1234.4805,1234.4845,1,37034415,37034535,120,
15368,1234.496933,1234.519133,1,37034907,37035573,666,0.1677649034841918
15369,1234.521167,1234.5256,1,37035635,37035768,133,-0.047415694895745576
15370,1234.535167,1234.545233,1,37036055,37036356,301,0.6286632390187139
15371,1234.551433,1234.555333,1,37036542,37036659,117,
15372,1234.575267,1234.5783,1,37037258,37037349,91,0.16409147373763924
15373,1234.589733,1234.595533,1,37037691,37037865,174,-0.36336433258245887
15374,1234.605067,1234.626133,1,37038152,37038783,631,0.05780815728161099
15375,1234.642567,1234.645667,1,37039277,37039370,93,
15376,1234.647033,1234.650167,1,37039410,37039505,95,
15377,1234.667533,1234.675367,1,37040025,37040261,236,0.1920915015572657
15378,1234.687667,1234.6951,1,37040630,37040853,223,0.2491766448015417
15379,1234.7426,1234.771533,1,37042278,37043145,867,0.14041093321673206
15380,1234.791967,1234.7957,1,37043759,37043871,112,0.004715779473788477
15381,1234.797767,1234.8016,1,37043933,37044048,115,0.7328134625133989
15382,1234.803067,1234.819833,1,37044092,37044594,502,0.7113557669715518
15383,1234.853333,1234.861767,1,37045599,37045853,254,0.3031972014699785
15384,1234.865633,1234.869833,1,37045968,37046094,126,0.5186577006803479
15385,1234.873633,1234.898067,1,37046208,37046942,734,0.012212837448870537
15386,1234.9099,1234.9219,1,37047297,37047657,360,0.06870439672414835
15387,1234.934367,1234.940933,1,37048031,37048227,196,0.0750131753822204
15388,1234.9778,1234.981367,1,37049334,37049441,107,0.23968774624728373
15389,1235.000133,1235.025133,1,37050003,37050753,750,0.09001001616174166
15390,1235.0406,1235.063067,1,37051218,37051892,674,0.1784075096000837
15391,1235.137833,1235.162233,1,37054134,37054866,732,0.10614506847270402
15392,1235.168067,1235.176433,1,37055042,37055292,250,-0.11541016471342089
15393,1235.1805,1235.1899,1,37055415,37055697,282,0.7599534057097425
15394,1235.268567,1235.2935,1,37058057,37058805,748,-0.006297653541899022
15395,1235.3432,1235.3477,1,37060296,37060431,135,
15396,1235.376767,1235.382667,1,37061303,37061480,177,0.009721584322392524
15397,1235.396133,1235.421733,1,37061883,37062651,768,0.017977395688399254
15398,1235.437267,1235.444067,1,37063118,37063322,204,0.19339773858369694
15399,1235.4717,1235.476667,1,37064151,37064300,149,0.1052469607419717
15400,1235.478767,1235.483,1,37064363,37064490,127,
15401,1235.516733,1235.5406,1,37065501,37066218,717,0.13007597360497108
15402,1235.5771,1235.584867,1,37067313,37067546,233,0.5463039488195789
15403,1235.603833,1235.608733,1,37068114,37068261,147,
15404,1235.620433,1235.6455,1,37068612,37069365,753,-0.005395440367270507
15405,1235.659533,1235.662633,1,37069785,37069878,93,
15406,1235.7114,1235.715133,1,37071342,37071453,111,
15407,1235.729,1235.751833,1,37071870,37072554,684,0.10741448779667304
15408,1235.7633,1235.7764,1,37072899,37073292,393,0.22859069177939606
15409,1235.79,1235.8029,1,37073700,37074087,387,0.3189542329275648
15410,1235.813867,1235.818133,1,37074416,37074543,127,0.6113793249963362
15411,1235.820133,1235.828367,1,37074603,37074851,248,-0.030892882867615042
15412,1235.837,1235.858667,1,37075110,37075760,650,0.12142463651319094
15413,1235.860633,1235.864733,1,37075818,37075941,123,0.34195551142840613
15414,1235.947733,1235.9668,1,37078431,37079004,573,0.045985128716916956
15415,1236.035633,1236.041833,1,37081068,37081254,186,-0.1327067381593719
15416,1236.0668,1236.078467,1,37082004,37082354,350,-0.09254246845871836
15417,1236.080633,1236.093133,1,37082418,37082793,375,0.33231221273432204
15418,1236.104267,1236.123333,1,37083128,37083699,571,0.12083158574436503
15419,1236.1312,1236.150033,1,37083936,37084500,564,-0.04717394445385739
15420,1236.162267,1236.181333,1,37084868,37085439,571,0.16015363670012014
15421,1236.19,1236.211967,1,37085700,37086359,659,0.0303893306026578
15422,1236.223467,1236.242333,1,37086704,37087269,565,0.14772215067512925
15423,1236.254367,1236.272233,1,37087631,37088166,535,0.14278983666041495
15424,1236.287133,1236.304967,1,37088613,37089149,536,-0.04104569661531806
15425,1236.321433,1236.341467,1,37089642,37090244,602,0.15644095523673723
15426,1236.3558,1236.3635,1,37090674,37090905,231,0.183905797509195
15427,1236.365433,1236.3763,1,37090962,37091289,327,0.16633429774846442
15428,1236.389233,1236.407833,1,37091676,37092234,558,0.0614582877769508
15429,1236.425167,1236.431833,1,37092755,37092954,199,0.03113987280581016
15430,1236.4331,1236.443167,1,37092993,37093295,302,-0.105830054421568
15431,1236.4599,1236.476433,1,37093797,37094292,495,0.13518293577587034
15432,1236.4955,1236.508433,1,37094865,37095252,387,0.09779126952384685
15433,1236.511367,1236.545367,1,37095341,37096361,1020,-0.032641722207240514
15434,1236.550067,1236.6056,1,37096502,37098168,1666,0.0316125375065543
15435,1236.606767,1236.6101,1,37098203,37098303,100,0.12058480190325829
15436,1236.6119,1236.632567,1,37098357,37098977,620,0.07762843846149972
15437,1236.6337,1236.640467,1,37099011,37099214,203,-0.08648471315692778
15438,1236.6598,1236.663,1,37099794,37099890,96,
15439,1236.678167,1236.6826,1,37100345,37100478,133,0.6544612939866583
15440,1236.686833,1236.691333,1,37100604,37100739,135,-0.18404318404718084
15441,1236.7312,1236.7392,1,37101936,37102176,240,0.4720608333742473
15442,1236.748933,1236.756167,1,37102467,37102685,218,-0.2037381602719126
15443,1236.7659,1236.769833,1,37102977,37103094,117,
15444,1236.8366,1236.842633,1,37105098,37105278,180,0.32482996640508566
15445,1236.851667,1236.8575,1,37105550,37105725,175,0.2683461169153116
15446,1236.8607,1236.881467,1,37105821,37106444,623,0.17590234178583375
15447,1236.899467,1236.906633,1,37106984,37107198,214,0.5720520620952145
15448,1237.0346,1237.038633,1,37111038,37111158,120,0.41633919652661144
15449,1237.130867,1237.155167,1,37113926,37114655,729,0.07831907037542239
15450,1237.400267,1237.4034,1,37122008,37122102,94,
15451,1237.4207,1237.423833,1,37122621,37122714,93,
15452,1237.4312,1237.436433,1,37122936,37123092,156,0.08877761078189483
15453,1237.447,1237.4554,1,37123410,37123662,252,0.1954856093773804
15454,1237.461167,1237.4872,1,37123835,37124616,781,0.06823148821297156
15455,1237.529967,1237.533733,1,37125899,37126011,112,
15456,1237.5498,1237.5694,1,37126494,37127082,588,-0.039583959178506455
15457,1237.586333,1237.5913,1,37127589,37127739,150,0.22277725530364825
15458,1237.696467,1237.699467,1,37130894,37130984,90,
15459,1237.713567,1237.733267,1,37131407,37131998,591,0.05778201291042763
15460,1237.804,1237.8263,1,37134120,37134789,669,0.05427827222022206
15461,1237.832067,1237.836133,1,37134962,37135083,121,
15462,1237.903,1237.906067,1,37137090,37137182,92,
15463,1237.921233,1237.941967,1,37137636,37138259,623,0.12275948845434499
15464,1237.9772,1237.980467,1,37139316,37139414,98,
15465,1238.005033,1238.009567,1,37140150,37140287,137,-0.2195301211400562
15466,1238.010667,1238.043567,1,37140320,37141307,987,-0.051290865899825296
15467,1238.074067,1238.0777,1,37142222,37142331,109,-0.0036086396143488403
15468,1238.079667,1238.088967,1,37142390,37142669,279,0.22162834952797383
15469,1238.111967,1238.1365,1,37143359,37144095,736,0.056296649389630964
15470,1238.141133,1238.155433,1,37144233,37144662,429,0.13417972107033724
15471,1238.1732,1238.177633,1,37145196,37145328,132,-0.13035039278250768
15472,1238.194967,1238.198267,1,37145849,37145948,99,0.16385649072598468
15473,1238.202,1238.221633,1,37146060,37146648,588,0.09130297596690634
15474,1238.2268,1238.2329,1,37146804,37146987,183,0.10244414517435604
15475,1238.234,1238.245567,1,37147020,37147367,347,
15476,1238.308967,1238.335167,1,37149269,37150055,786,0.07773084239459152
15477,1238.3442,1238.351133,1,37150326,37150533,207,-0.14355053458335398
15478,1238.3522,1238.355633,1,37150566,37150668,102,
15479,1238.375433,1238.378433,1,37151262,37151352,90,0.3102785816803262
15480,1238.3804,1238.384867,1,37151412,37151546,134,0.5218245032767385
15481,1238.386533,1238.390267,1,37151595,37151708,113,0.019077929123575928
15482,1238.399933,1238.4318,1,37151997,37152954,957,0.11292020192412981
15483,1238.436667,1238.454533,1,37153100,37153635,535,0.18071014378182404
15484,1238.489967,1238.499667,1,37154699,37154990,291,0.20866600293861
15485,1238.508367,1238.529567,1,37155251,37155887,636,0.1345334496234521
15486,1238.5351,1238.539333,1,37156053,37156179,126,0.2728304871564527
15487,1238.5422,1238.5521,1,37156266,37156563,297,0.06444942721887971
15488,1238.5905,1238.5964,1,37157715,37157892,177,0.3841625181490506
15489,1238.616067,1238.642133,1,37158482,37159263,781,0.22550310460099945
15490,1238.644533,1238.6624,1,37159335,37159872,537,0.39173017664569554
15491,1238.671833,1238.6756,1,37160154,37160268,114,0.48478650111828936
15492,1238.684867,1238.6921,1,37160546,37160763,217,
15493,1238.718433,1238.737633,1,37161552,37162128,576,0.021455182661643493
15494,1238.7413,1238.7457,1,37162239,37162371,132,0.05689641677046996
15495,1238.752767,1238.758067,1,37162583,37162742,159,0.2685460496738537
15496,1238.7703,1238.778433,1,37163109,37163352,243,
15497,1238.803067,1238.806933,1,37164092,37164207,115,0.4252048786750342
15498,1238.827033,1238.831967,1,37164810,37164959,149,
15499,1238.833067,1238.840167,1,37164992,37165205,213,
15500,1238.851867,1238.8624,1,37165556,37165872,316,-0.06459546378955323
15501,1238.868833,1238.880533,1,37166064,37166415,351,0.6110713008864853
15502,1239.5119,1239.516167,1,37185357,37185485,128,-0.18484382423351375
15503,1239.666033,1239.669433,1,37189980,37190082,102,0.22540247544388675
15504,1239.969033,1239.98,1,37199070,37199400,330,-0.18042671080369937
15505,1240.761767,1240.785533,1,37222853,37223565,712,0.22609557468809605
15506,1240.787033,1240.8056,1,37223610,37224168,558,0.3449390349859348
15507,1240.8066,1240.8143,1,37224198,37224429,231,0.3876162476833605
15508,1240.816233,1240.9005,1,37224486,37227015,2529,0.2665427192652657
15509,1240.902233,1240.905833,1,37227066,37227174,108,-0.3461867263574816
15510,1240.907367,1240.919033,1,37227221,37227570,349,-0.11060372251649257
15511,1241.4014,1241.444767,1,37242042,37243343,1301,0.5152829130235123
15512,1241.453967,1241.4571,1,37243619,37243713,94,-0.058923056194150863
15513,1242.025933,1242.0294,1,37260777,37260882,105,
15514,1242.032033,1242.043633,1,37260960,37261308,348,0.8605724349940957
15515,1242.046833,1242.135733,1,37261404,37264071,2667,0.8470460825763385
15516,1243.1399,1243.2424,1,37294197,37297272,3075,0.8000279856625511
15517,1243.335733,1243.339767,1,37300071,37300193,122,
15518,1243.3408,1243.360033,1,37300224,37300800,576,-0.014630278966682307
15519,1243.369967,1243.395,1,37301099,37301850,751,-0.008977526416637205
15520,1243.798967,1243.9605,1,37313969,37318815,4846,0.7436777869308492
15521,1243.9813,1244.029933,1,37319439,37320897,1458,0.6467977167575659
15522,1244.0348,1244.064367,1,37321044,37321931,887,0.5576467862739055
15523,1244.0686,1244.093767,1,37322058,37322813,755,0.6949549499110362
15524,1244.0965,1244.1289,1,37322895,37323867,972,0.6800876142635763
15525,1244.129933,1244.179,1,37323897,37325370,1473,0.6944736576295208
15526,1244.182433,1244.186367,1,37325472,37325591,119,0.23561237846263483
15527,1244.191,1244.2213,1,37325730,37326639,909,0.7098415806865426
15528,1244.222767,1244.231867,1,37326683,37326956,273,0.2586237101868076
15529,1244.2489,1244.253567,1,37327467,37327607,140,0.563398465734068
15530,1244.2577,1244.274767,1,37327731,37328243,512,0.5775398178027674
15531,1244.276467,1244.2828,1,37328294,37328484,190,0.4145306229568351
15532,1244.325733,1244.3405,1,37329771,37330215,444,0.3878611978401741
15533,1244.347533,1244.382433,1,37330425,37331472,1047,-0.007533666696802796
15534,1244.387567,1244.393133,1,37331627,37331793,166,-0.17345326137665548
15535,1244.8475,1244.974133,1,37345425,37349223,3798,0.7640525815023665
15536,1245.046767,1245.147233,1,37351403,37354416,3013,0.8128010714611863
15537,1245.1613,1245.165233,1,37354839,37354956,117,-0.054594814961226444
15538,1245.498833,1245.5046,1,37364964,37365138,174,0.6366707507964846
15539,1245.514167,1245.518333,1,37365425,37365549,124,0.4147972849850775
15540,1245.5197,1245.523833,1,37365591,37365714,123,-0.17191646888422007
15541,1245.542867,1245.562133,1,37366286,37366863,577,0.6279934626164095
15542,1245.564467,1245.588233,1,37366934,37367646,712,0.7961059012356556
15543,1245.589267,1245.618067,1,37367678,37368542,864,0.8384586200700265
15544,1245.627267,1245.652633,1,37368818,37369578,760,0.6426638639427417
15545,1245.664267,1245.7083,1,37369928,37371249,1321,0.7898143366156407
15546,1245.718967,1245.734067,1,37371569,37372022,453,0.7329606652077925
15547,1245.738167,1245.75,1,37372145,37372500,355,0.6467052532355293
15548,1245.8619,1245.885933,1,37375857,37376577,720,0.6412258659816771
15549,1245.898,1245.902333,1,37376940,37377069,129,-0.04557476188600994
15550,1245.9174,1245.994367,1,37377522,37379831,2309,0.7916294314750806
15551,1246.0149,1246.0181,1,37380447,37380543,96,-0.048443248528228025
15552,1246.3388,1246.454167,1,37390164,37393625,3461,0.8493515192504095
15553,1246.665167,1246.694467,1,37399955,37400834,879,0.7505755036061388
15554,1246.6956,1246.789133,1,37400868,37403673,2805,0.8393042862582003
15555,1247.1192,1247.2999,1,37413576,37418997,5421,0.8229737446593193
15556,1247.3047,1247.328633,1,37419141,37419858,717,0.7733609992124716
15557,1247.3304,1247.3598,1,37419912,37420794,882,0.7884830332341246
15558,1247.3614,1247.3644,1,37420842,37420932,90,-0.10542610224267257
15559,1247.3867,1247.414033,1,37421601,37422420,819,0.77301702859561
15560,1247.415067,1247.467733,1,37422452,37424031,1579,0.828149633287789
15561,1247.4725,1247.501667,1,37424175,37425050,875,0.8159339870201282
15562,1247.5527,1247.645633,1,37426581,37429368,2787,0.759941807674217
15563,1247.955367,1247.959633,1,37438661,37438788,127,
15564,1247.962133,1248.166433,1,37438863,37444992,6129,0.7658200179068299
15565,1248.175033,1248.191,1,37445250,37445730,480,0.9421859434871863
15566,1248.2706,1248.3207,1,37448118,37449621,1503,0.6749408442696551
15567,1248.3323,1248.4175,1,37449969,37452525,2556,0.824989449237576
15568,1248.418733,1248.4242,1,37452561,37452726,165,-0.1534870393630239
15569,1248.7121,1248.871167,1,37461363,37466135,4772,0.850150247562446
15570,1248.8779,1248.9253,1,37466337,37467759,1422,0.8404647022424667
15571,1248.939667,1248.9822,1,37468190,37469466,1276,0.7982558217773681
15572,1248.986267,1249.038833,1,37469588,37471164,1576,0.8117938397195468
15573,1249.050867,1249.064967,1,37471526,37471949,423,0.674650860913487
15574,1249.071533,1249.155633,1,37472145,37474668,2523,0.7848772086534705
15575,1249.1774,1249.181767,1,37475322,37475453,131,-0.17334761483966132
15576,1249.5809,1249.589267,1,37487427,37487678,251,0.7322883465667634
15577,1249.5905,1249.638467,1,37487715,37489154,1439,0.773702011430287
15578,1249.648433,1249.654333,1,37489452,37489629,177,0.011859892099342644
15579,1249.655933,1249.6592,1,37489677,37489776,99,-0.04607396955889336
15580,1249.995767,1250.1218,1,37499873,37503654,3781,0.8115678210330628
15581,1250.133667,1250.137367,1,37504010,37504121,111,0.14403010878610134
15582,1250.472333,1250.555033,1,37514169,37516650,2481,0.8255788904019278
15583,1250.557,1250.763633,1,37516710,37522908,6198,0.7872230373015099
15584,1250.769233,1250.773333,1,37523076,37523199,123,0.3750142864397958
15585,1251.2611,1251.2841,1,37537833,37538523,690,0.6553211814145221
15586,1251.292467,1251.297467,1,37538774,37538924,150,0.6106038182559403
15587,1251.320867,1251.338567,1,37539626,37540157,531,0.630421617647905
15588,1251.346133,1251.3684,1,37540383,37541052,669,0.7533379653576402
15589,1251.395633,1251.4508,1,37541868,37543524,1656,0.7267988427796809
15590,1251.470467,1251.5157,1,37544114,37545471,1357,0.7435699392600498
15591,1251.523633,1251.576467,1,37545708,37547294,1586,0.7182966808781918
15592,1251.5945,1251.616467,1,37547835,37548494,659,0.7307708837120065
15593,1251.630467,1251.643033,1,37548914,37549290,376,0.8729169497871295
15594,1251.649867,1251.674567,1,37549496,37550237,741,0.7765727138726634
15595,1251.694767,1251.6982,1,37550843,37550946,103,
15596,1251.7004,1251.704367,1,37551012,37551131,119,0.27718035673176256
15597,1251.706967,1251.717667,1,37551209,37551530,321,0.023555589213425106
15598,1251.719367,1251.722833,1,37551581,37551684,103,
15599,1252.027467,1252.0322,1,37560824,37560966,142,0.5707108205231821
15600,1252.038567,1252.050067,1,37561157,37561502,345,0.5301246620618892
15601,1252.053433,1252.217167,1,37561602,37566515,4913,0.8182509031054181
15602,1252.236267,1252.381467,1,37567088,37571444,4356,0.775817539505434
15603,1252.3827,1252.385967,1,37571481,37571579,98,-0.2604249209372904
15604,1252.390733,1252.4068,1,37571721,37572204,483,0.7737616643534301
15605,1252.411967,1252.482567,1,37572359,37574477,2118,0.7907525323011843
15606,1252.4903,1252.4943,1,37574709,37574829,120,0.35277540888715897
15607,1252.515433,1252.519433,1,37575462,37575582,120,0.47697912870234993
15608,1252.525333,1252.530433,1,37575759,37575912,153,0.2623392379084466
15609,1252.873933,1252.879533,1,37586217,37586385,168,0.620072931974116
15610,1252.880733,1252.9071,1,37586421,37587213,792,0.6671415690153839
15611,1252.9402,1252.974167,1,37588206,37589225,1019,0.7966698546386631
15612,1252.976733,1253.028533,1,37589301,37590855,1554,0.6574148845621586
15613,1253.0365,1253.082433,1,37591095,37592472,1377,0.70302754383277
15614,1253.105167,1253.140533,1,37593155,37594215,1060,0.6992328655773085
15615,1253.144767,1253.149767,1,37594343,37594493,150,0.5718176881992629
15616,1253.150767,1253.2053,1,37594523,37596159,1636,0.755518741702334
15617,1253.224433,1253.260333,1,37596732,37597809,1077,0.7674283766388266
15618,1253.276333,1253.306467,1,37598289,37599194,905,0.8188001732608002
15619,1253.311167,1253.318567,1,37599335,37599557,222,0.43953326258881564
15620,1253.327933,1253.3708,1,37599837,37601124,1287,-0.023174490434693943
15621,1253.3725,1253.3785,1,37601175,37601355,180,-0.17834432123573757
15622,1253.4142,1253.5077,1,37602426,37605231,2805,0.6981911594507788
15623,1253.519667,1253.5539,1,37605590,37606617,1027,0.7367158370231001
15624,1253.5559,1253.592533,1,37606677,37607775,1098,0.7632590371085122
15625,1253.597633,1253.6596,1,37607928,37609788,1860,0.8095275102091173
15626,1253.6976,1253.7096,1,37610928,37611288,360,-0.05381594693789869
15627,1253.711167,1253.715633,1,37611335,37611468,133,-0.11885049255307213
15628,1253.722033,1253.729333,1,37611660,37611879,219,0.06621126104518221
15629,1253.738633,1253.744867,1,37612158,37612346,188,-0.003267486829430702
15630,1253.749567,1253.756833,1,37612487,37612704,217,0.03232338758070303
15631,1253.764933,1253.769767,1,37612947,37613093,146,0.05733350187750357
15632,1253.971367,1253.974833,1,37619141,37619244,103,0.7948552711650906
15633,1253.975967,1253.990633,1,37619279,37619718,439,0.6525138608042192
15634,1254.031,1254.056433,1,37620930,37621692,762,0.6457632938373585
15635,1254.354433,1254.360467,1,37630632,37630814,182,0.28202234172955054
15636,1254.378467,1254.3823,1,37631354,37631469,115,
15637,1254.389433,1254.394833,1,37631682,37631844,162,0.3027108466560291
15638,1254.4101,1254.4192,1,37632303,37632576,273,-0.08415180847448162
15639,1254.427033,1254.431233,1,37632810,37632936,126,
15640,1254.432433,1254.4357,1,37632972,37633071,99,0.6236324910439605
15641,1254.450933,1254.461533,1,37633527,37633845,318,0.6427626318674523
15642,1254.5208,1254.529967,1,37635624,37635899,275,0.5255998573183027
15643,1254.544933,1254.557533,1,37636347,37636725,378,-0.07672611991864249
15644,1254.580033,1254.5893,1,37637400,37637679,279,-0.24099192187814655
15645,1254.6564,1254.836667,1,37639692,37645100,5408,0.8245631096968548
15646,1254.838267,1254.851133,1,37645148,37645533,385,0.7000645926879577
15647,1254.8719,1254.9379,1,37646157,37648137,1980,0.8104867081912992
15648,1254.9585,1254.9884,1,37648755,37649652,897,0.7804602914772876
15649,1255.321667,1255.550567,1,37659650,37666517,6867,0.7941749047645827
15650,1255.5725,1255.771067,1,37667175,37673132,5957,0.8078198039145206
15651,1256.4157,1256.5489,1,37692471,37696467,3996,0.8325256008846739
15652,1256.5641,1256.661167,1,37696923,37699835,2912,0.8219159937825584
15653,1256.758867,1256.803833,1,37702766,37704114,1348,0.6776144814652648
15654,1256.818133,1256.8751,1,37704543,37706253,1710,0.7403564499904349
15655,1256.8771,1256.889467,1,37706313,37706684,371,0.2442142932924524
15656,1257.377,1257.380533,1,37721310,37721415,105,
15657,1257.3835,1257.4774,1,37721505,37724322,2817,0.7853242317052853
15658,1257.504233,1257.509067,1,37725126,37725272,146,0.08403548650440343
15659,1257.927067,1257.930267,1,37737812,37737908,96,0.14867463862565453
15660,1257.945767,1258.0428,1,37738373,37741284,2911,0.8173179158415976
15661,1258.064767,1258.069433,1,37741943,37742082,139,-0.005455468914761052
15662,1258.0719,1258.075267,1,37742157,37742258,101,
15663,1258.3517,1258.357733,1,37750551,37750731,180,0.6075537266994347
15664,1258.3642,1258.520367,1,37750926,37755611,4685,0.849580139356512
15665,1258.5223,1258.6477,1,37755669,37759431,3762,0.7755260425070469
15666,1258.665467,1258.6693,1,37759964,37760079,115,-0.11733557112891094
15667,1259.057933,1259.064567,1,37771737,37771937,200,0.6524360136469551
15668,1259.066167,1259.073733,1,37771985,37772211,226,0.7482443362883546
15669,1259.086233,1259.113867,1,37772586,37773416,830,0.8472591264775665
15670,1259.129433,1259.166267,1,37773882,37774988,1106,0.856121667052262
15671,1259.169067,1259.1923,1,37775072,37775769,697,0.7206730466570965
15672,1259.221,1259.224067,1,37776630,37776722,92,
15673,1259.230167,1259.237333,1,37776905,37777119,214,0.5487646177557847
15674,1259.2456,1259.262333,1,37777368,37777869,501,0.4986323330702135
15675,1259.282767,1259.2981,1,37778483,37778943,460,0.4996608647418616
15676,1259.343567,1259.350467,1,37780307,37780514,207,0.7527310246197417
15677,1259.352133,1259.360933,1,37780563,37780827,264,0.612667510568072
15678,1259.385033,1259.395967,1,37781550,37781879,329,0.5329798320247913
15679,1259.401367,1259.4122,1,37782041,37782366,325,0.7130489903351321
15680,1259.473233,1259.481933,1,37784196,37784457,261,-0.12296530048829023
15681,1259.529467,1259.6055,1,37785884,37788165,2281,0.7712554926436506
15682,1259.607133,1259.640133,1,37788213,37789203,990,0.6385092028503196
15683,1259.6477,1259.823,1,37789431,37794690,5259,0.7454639074545144
15684,1259.826767,1259.840933,1,37794803,37795227,424,0.7884156875453575
15685,1259.848767,1259.911433,1,37795463,37797342,1879,0.8182130401550646
15686,1260.319167,1260.33,1,37809575,37809900,325,0.5839803679239681
15687,1260.3319,1260.3602,1,37809957,37810806,849,0.6483453632861894
15688,1260.3735,1260.408833,1,37811205,37812264,1059,0.7140023328434681
15689,1260.413567,1260.440133,1,37812407,37813203,796,0.7112346311495451
15690,1260.443567,1260.468567,1,37813307,37814057,750,0.6328982895874845
15691,1260.473833,1260.4963,1,37814214,37814889,675,0.7164632777359584
15692,1260.5042,1260.545033,1,37815126,37816350,1224,0.661082585746205
15693,1260.548333,1260.583233,1,37816449,37817496,1047,0.7720227287220777
15694,1260.5942,1260.6094,1,37817826,37818282,456,0.732837415171897
15695,1260.610667,1260.6707,1,37818320,37820121,1801,0.7856080619854421
15696,1260.677867,1260.6851,1,37820336,37820553,217,0.3867767599476723
15697,1260.686767,1260.712167,1,37820603,37821365,762,0.639423445929469
15698,1260.745267,1260.7625,1,37822358,37822875,517,-0.038601130962228655
15699,1261.051267,1261.055433,1,37831538,37831662,124,0.2890932477597556
15700,1261.0588,1261.137467,1,37831764,37834124,2360,0.8279025794067598
15701,1261.142167,1261.268567,1,37834265,37838057,3792,0.8465624103023287
15702,1261.281133,1261.4367,1,37838433,37843101,4668,0.7710597847821892
15703,1261.479733,1261.484567,1,37844391,37844537,146,0.28802583829874745
15704,1261.817467,1261.8217,1,37854524,37854651,127,-0.019819558882959578
15705,1261.8289,1261.885167,1,37854867,37856555,1688,0.8150139774398611
15706,1261.889833,1261.969767,1,37856694,37859093,2399,0.7876973070514326
15707,1261.989633,1262.031033,1,37859688,37860930,1242,0.7721384585618315
15708,1262.032033,1262.166767,1,37860960,37865003,4043,0.773855069544023
15709,1262.168333,1262.180333,1,37865049,37865409,360,0.671204015453498
15710,1262.182833,1262.213133,1,37865484,37866393,909,0.6703200810996003
15711,1262.2855,1262.305333,1,37868565,37869159,594,0.5783364630240139
15712,1262.3225,1262.406033,1,37869675,37872180,2505,0.7993038025038183
15713,1262.701567,1262.959567,1,37881047,37888787,7740,0.8357239560182999
15714,1262.962733,1262.970767,1,37888881,37889123,242,0.3278803509258266
15715,1262.973233,1263.0268,1,37889196,37890804,1608,0.8343791004056107
15716,1263.031633,1263.046,1,37890948,37891380,432,0.7671980006821526
15717,1263.052667,1263.1329,1,37891580,37893987,2407,0.7790853295310838
15718,1263.182567,1263.186567,1,37895477,37895597,120,-0.15243764473220628
15719,1263.482133,1263.486667,1,37904463,37904600,137,-0.02125032185071928
15720,1263.505933,1263.676967,1,37905177,37910309,5132,0.7308341439505558
15721,1263.683867,1263.7062,1,37910516,37911186,670,0.5388245937444253
15722,1263.7088,1263.712,1,37911264,37911360,96,
15723,1263.723367,1263.737933,1,37911701,37912137,436,-0.0729873054598519
15724,1263.744033,1263.747133,1,37912320,37912413,93,
15725,1263.769467,1263.886467,1,37913084,37916594,3510,0.795007355367337
15726,1263.8973,1263.902333,1,37916919,37917069,150,-0.02238129000430406
15727,1263.908333,1263.914367,1,37917249,37917431,182,0.08484986318498172
15728,1264.146033,1264.1522,1,37924380,37924566,186,0.18331363750823026
15729,1264.1536,1264.268567,1,37924608,37928057,3449,0.8492461772258912
15730,1264.289,1264.3074,1,37928670,37929222,552,0.7274608435313299
15731,1264.312967,1264.431933,1,37929389,37932957,3568,0.8091644516062828
15732,1264.4584,1264.475767,1,37933752,37934273,521,0.2572520646302735
15733,1264.787467,1264.8045,1,37943624,37944135,511,0.7806697592528814
15734,1264.808833,1264.812267,1,37944264,37944368,104,0.803837088812539
15735,1264.8566,1264.8871,1,37945698,37946613,915,0.6824815322540896
15736,1264.909433,1264.9469,1,37947282,37948407,1125,0.7217542786029982
15737,1264.9797,1264.986167,1,37949391,37949585,194,0.6707783114194221
15738,1265.007067,1265.048633,1,37950212,37951458,1246,0.6252975511793902
15739,1265.075233,1265.093233,1,37952256,37952796,540,0.5420268811622797
15740,1265.129,1265.19,1,37953870,37955700,1830,0.017126749789786233
15741,1265.2098,1265.318167,1,37956294,37959545,3251,0.7864542747251672
15742,1265.346,1265.364733,1,37960380,37960941,561,-0.020149641162294153
15743,1265.370667,1265.3751,1,37961120,37961253,133,0.08435994260629627
15744,1265.458233,1265.461833,1,37963746,37963854,108,
15745,1265.472433,1265.488567,1,37964172,37964657,485,0.25016537277742534
15746,1265.4905,1265.497633,1,37964715,37964928,213,0.8051348659780734
15747,1265.503267,1265.5715,1,37965098,37967145,2047,0.04409187288132346
15748,1265.5815,1265.605733,1,37967445,37968171,726,0.7177607541507615
15749,1265.609767,1265.664767,1,37968293,37969943,1650,0.8742801535281449
15750,1265.6665,1265.738233,1,37969995,37972146,2151,0.8261408759918184
15751,1265.755767,1265.8375,1,37972673,37975125,2452,0.752651055606721
15752,1265.8426,1265.8659,1,37975278,37975977,699,0.8442034602668024
15753,1266.137667,1266.257467,1,37984130,37987724,3594,0.6326907213532778
15754,1266.277367,1266.282333,1,37988321,37988469,148,0.6555723286795575
15755,1266.2856,1266.294667,1,37988568,37988840,272,0.6138218338570256
15756,1266.3187,1266.328233,1,37989561,37989846,285,0.5952541689050209
15757,1266.3387,1266.345,1,37990161,37990350,189,0.6866717409902139
15758,1266.388367,1266.403267,1,37991651,37992098,447,-0.08139069432976137
15759,1266.406267,1266.423,1,37992188,37992690,502,-0.03217702226435788
15760,1266.424933,1266.428967,1,37992747,37992869,122,
15761,1266.4511,1266.486667,1,37993533,37994600,1067,0.7304924547002115
15762,1266.489033,1266.5336,1,37994670,37996008,1338,0.8347518053263165
15763,1266.535467,1266.588733,1,37996064,37997661,1597,0.8122115010762476
15764,1266.6162,1266.622433,1,37998486,37998672,186,-0.09447606746252595
15765,1266.6243,1266.6321,1,37998729,37998963,234,-0.06087756433350187
15766,1266.640533,1266.649433,1,37999215,37999482,267,0.18175405541215459
15767,1266.659067,1266.662333,1,37999772,37999869,97,
15768,1266.722133,1266.793967,1,38001663,38003819,2156,0.07840175073419742
15769,1266.797433,1266.8054,1,38003922,38004162,240,0.08532177063350217
15770,1266.8076,1266.8106,1,38004228,38004318,90,-0.008674494227748965
15771,1266.821033,1266.869933,1,38004630,38006097,1467,0.7551144480052807
15772,1266.872767,1266.919633,1,38006183,38007588,1405,0.8202359043139761
15773,1266.9502,1266.954667,1,38008506,38008640,134,-0.14898899255846845
15774,1266.957067,1266.9668,1,38008712,38009004,292,0.04160676073120222
15775,1266.9759,1266.979567,1,38009277,38009387,110,0.22610393212260615
15776,1267.133633,1267.144233,1,38014008,38014326,318,-0.09629287475560254
15777,1267.151867,1267.174167,1,38014556,38015225,669,0.6447005831871786
15778,1267.1752,1267.186333,1,38015256,38015589,333,0.03191748526606951
15779,1267.191,1267.195,1,38015730,38015850,120,0.3734632256900337
15780,1267.407433,1267.430267,1,38022222,38022908,686,0.8191305105076083
15781,1267.4324,1267.438767,1,38022972,38023163,191,0.5688983290402808
15782,1267.440467,1267.546933,1,38023214,38026407,3193,0.7268008251888594
15783,1267.548833,1267.585833,1,38026464,38027574,1110,0.7660566818027503
15784,1267.587,1267.6186,1,38027610,38028558,948,0.7388997397081885
15785,1267.630167,1267.715133,1,38028905,38031453,2548,0.8180363263877835
15786,1267.731733,1267.743233,1,38031951,38032296,345,-0.06507224720838409
15787,1268.033933,1268.042433,1,38041017,38041272,255,0.4615569170438741
15788,1268.0435,1268.0579,1,38041305,38041737,432,0.8019864802293586
15789,1268.0603,1268.1647,1,38041809,38044941,3132,0.8046167635060563
15790,1268.172633,1268.272633,1,38045178,38048178,3000,0.793238455710289
15791,1268.2738,1268.281767,1,38048214,38048453,239,0.5916888580950657
15792,1268.297367,1268.356467,1,38048921,38050694,1773,0.789112354774256
15793,1268.366667,1268.392667,1,38051000,38051780,780,0.7159319345418435
15794,1268.404167,1268.492967,1,38052125,38054789,2664,0.7906527603581507
15795,1268.5164,1268.527433,1,38055492,38055822,330,-0.008051940486682238
15796,1268.936633,1268.9481,1,38068098,38068443,345,0.5909734761198121
15797,1268.964533,1268.968633,1,38068935,38069058,123,0.9094446469114243
15798,1268.972033,1268.9765,1,38069160,38069295,135,0.5648424613285039
15799,1269.008033,1269.0155,1,38070240,38070465,225,0.6661213543939835
15800,1269.0636,1269.0722,1,38071908,38072166,258,0.5717523620024741
15801,1269.088733,1269.093,1,38072661,38072790,129,0.932427723962155
15802,1269.127033,1269.137933,1,38073810,38074137,327,0.6937883775314451
15803,1269.174933,1269.187233,1,38075247,38075616,369,0.6983033282023359
15804,1269.29,1269.2931,1,38078700,38078793,93,0.5972042768295196
15805,1269.298867,1269.499933,1,38078966,38084997,6031,0.7941247236183188
15806,1269.806333,1269.899833,1,38094189,38096994,2805,0.8315025310785287
15807,1269.9501,1270.062933,1,38098503,38101887,3384,0.7287632455839902
15808,1270.063967,1270.080233,1,38101919,38102406,487,0.479841686256945
15809,1270.090867,1270.100733,1,38102726,38103021,295,0.06632641580288787
15810,1270.392867,1270.402833,1,38111786,38112084,298,0.6427732859220238
15811,1270.408433,1270.616167,1,38112252,38118485,6233,0.7891993965590481
15812,1270.628433,1270.636433,1,38118852,38119092,240,0.4122514147632503
15813,1270.9085,1270.9218,1,38127255,38127654,399,0.7484405261160653
15814,1270.922867,1270.958233,1,38127686,38128746,1060,0.7986334153894535
15815,1270.959367,1270.966867,1,38128781,38129006,225,0.8084735545489504
15816,1270.9699,1271.0088,1,38129097,38130264,1167,0.8031139590107516
15817,1271.04,1271.048567,1,38131200,38131457,257,0.09446936679256346
15818,1271.347833,1271.3626,1,38140434,38140878,444,0.6501003254152194
15819,1271.3892,1271.453633,1,38141676,38143608,1932,0.8409410907758799
15820,1271.477733,1271.483567,1,38144331,38144507,176,0.5429202022217781
15821,1271.488233,1271.5078,1,38144646,38145234,588,0.6208815317528125
15822,1271.5216,1271.5683,1,38145648,38147049,1401,0.5994095757559293
15823,1271.595467,1271.610533,1,38147864,38148315,451,0.7174004355366519
15824,1271.636,1271.6713,1,38149080,38150139,1059,0.7601507190095179
15825,1271.681633,1271.689533,1,38150448,38150685,237,0.10251515039723617
15826,1271.704633,1271.720967,1,38151138,38151629,491,0.022763793313926875
15827,1271.726,1271.732567,1,38151780,38151977,197,-0.07004123599218551
15828,1271.741833,1271.747633,1,38152254,38152428,174,-0.08440323907907334
15829,1271.748967,1271.752967,1,38152469,38152589,120,0.1075976572685605
15830,1271.7698,1271.7736,1,38153094,38153208,114,0.047254928408408406
15831,1271.775633,1271.9016,1,38153268,38157048,3780,0.8117904943223229
15832,1272.196667,1272.271,1,38165900,38168130,2230,0.7974146966140697
15833,1272.2843,1272.2993,1,38168529,38168979,450,0.8264374393385614
15834,1272.3011,1272.391633,1,38169033,38171748,2715,0.8417963693741249
15835,1272.393633,1272.406567,1,38171808,38172197,389,0.686717222778487
15836,1272.411233,1272.417133,1,38172336,38172513,177,0.6197367425712039
15837,1272.4364,1272.4988,1,38173092,38174964,1872,0.8017512458290611
15838,1272.5034,1272.535167,1,38175102,38176055,953,0.7059083210427146
15839,1272.793967,1272.9014,1,38183819,38187042,3223,0.8315160816135252
15840,1273.159333,1273.229333,1,38194779,38196879,2100,0.8053097219522347
15841,1273.2309,1273.247633,1,38196927,38197428,501,0.6662090991513562
15842,1273.251467,1273.465533,1,38197544,38203965,6421,0.7734671240687893
15843,1273.470933,1273.502033,1,38204127,38205060,933,0.7371040543630225
15844,1273.514967,1273.521667,1,38205449,38205650,201,
15845,1273.5296,1273.5334,1,38205888,38206002,114,
15846,1273.546,1273.558467,1,38206380,38206754,374,0.1763510563108827
15847,1273.560867,1273.580333,1,38206826,38207409,583,0.15545370387147373
15848,1273.712733,1273.717,1,38211381,38211510,129,0.8309543454172867
15849,1273.718533,1273.7295,1,38211555,38211885,330,0.5677711142653264
15850,1273.733733,1273.811933,1,38212011,38214357,2346,0.8107561916996765
15851,1273.813467,1273.847833,1,38214404,38215434,1030,0.8098314813585329
15852,1273.849767,1273.8589,1,38215493,38215767,274,0.8137251365629935
15853,1274.148267,1274.2704,1,38224448,38228112,3664,0.8000762970773331
15854,1274.316967,1274.348367,1,38229509,38230451,942,0.11912009251144731
15855,1274.35,1274.4226,1,38230500,38232678,2178,0.49394605966373856
15856,1274.445333,1274.454133,1,38233359,38233623,264,7.301463888731278e-05
15857,1274.455133,1274.542833,1,38233653,38236284,2631,0.1517416419911791
15858,1274.546433,1274.575767,1,38236392,38237273,881,0.15316725174948606
15859,1274.5804,1274.586667,1,38237412,38237600,188,0.21283837927344337
15860,1274.599,1274.608833,1,38237970,38238264,294,0.4147629811285905
15861,1274.609967,1274.6532,1,38238299,38239596,1297,0.20914847261947192
15862,1274.6712,1274.7045,1,38240136,38241135,999,0.45493660420079074
15863,1274.7121,1274.731233,1,38241363,38241936,573,0.2020874195918353
15864,1274.7336,1274.742533,1,38242008,38242275,267,0.361144928373911
15865,1274.746067,1274.783967,1,38242382,38243519,1137,0.13149510839477888
15866,1274.7916,1274.858133,1,38243748,38245743,1995,0.6163975917121743
15867,1274.8594,1274.869267,1,38245782,38246078,296,0.357804624865844
15868,1274.8939,1274.972267,1,38246817,38249168,2351,0.6697029027089639
15869,1275.006633,1275.020267,1,38250198,38250608,410,0.6804883738276033
15870,1275.023833,1275.0974,1,38250714,38252922,2208,0.6040454714518103
15871,1275.114933,1275.120767,1,38253447,38253623,176,0.440618843489456
15872,1275.121967,1275.1729,1,38253659,38255187,1528,0.7298050793030223
15873,1275.187633,1275.191567,1,38255628,38255747,119,0.5262323488202463
15874,1275.1966,1275.211567,1,38255898,38256347,449,0.6945444876181411
15875,1275.2148,1275.221,1,38256444,38256630,186,0.5021628976145361
15876,1275.575333,1275.723933,1,38267259,38271717,4458,0.8329100055230171
15877,1275.9922,1276.1012,1,38279766,38283036,3270,0.7106626634308383
15878,1276.112667,1276.137967,1,38283380,38284139,759,0.7126447753249998
15879,1276.1395,1276.198167,1,38284185,38285945,1760,0.6566334851512208
15880,1276.202,1276.2523,1,38286060,38287569,1509,0.6824263359127353
15881,1276.253433,1276.3129,1,38287602,38289387,1785,0.7531310499688935
15882,1276.3176,1276.325933,1,38289528,38289777,249,0.1493784928804873
15883,1276.3386,1276.347767,1,38290158,38290433,275,0.7012251113469268
15884,1276.352867,1276.375267,1,38290586,38291258,672,0.7637113559848085
15885,1276.424167,1276.433167,1,38292725,38292995,270,0.04453484428776792
15886,1276.4362,1276.459867,1,38293086,38293796,710,0.17828861228995405
15887,1276.5156,1276.572233,1,38295468,38297166,1698,0.7872156491685958
15888,1276.573467,1276.638633,1,38297204,38299158,1954,0.7932738058934241
15889,1276.7935,1276.8163,1,38303805,38304489,684,0.6656322944664774
15890,1276.885,1276.889867,1,38306550,38306696,146,0.48178357615489154
15891,1277.0015,1277.0794,1,38310045,38312382,2337,0.6576566330411825
15892,1277.081,1277.112867,1,38312430,38313386,956,0.7600915959863072
15893,1277.3764,1277.3825,1,38321292,38321475,183,0.31670979686739975
15894,1277.4111,1277.4192,1,38322333,38322576,243,0.6349950892868197
15895,1277.542567,1277.554067,1,38326277,38326622,345,0.164448661579233
15896,1277.5779,1277.588733,1,38327337,38327661,324,0.3888233060448987
15897,1277.6237,1277.628967,1,38328711,38328869,158,-0.10724960423651644
15898,1277.679633,1277.6898,1,38330388,38330694,306,0.7518543305995693
15899,1277.703533,1277.725233,1,38331105,38331756,651,0.7691098279588241
15900,1277.734467,1277.746367,1,38332034,38332391,357,0.9027437526902667
15901,1277.756,1277.759267,1,38332680,38332778,98,0.33990664847097973
15902,1277.762667,1277.7787,1,38332880,38333361,481,0.7394071761864353
15903,1277.799833,1277.823667,1,38333994,38334710,716,0.7988690409114652
15904,1277.841733,1277.895767,1,38335251,38336873,1622,0.741416065133892
15905,1277.919333,1277.9603,1,38337579,38338809,1230,0.574184136271423
15906,1277.976567,1278.005367,1,38339297,38340161,864,0.07120538077542847
15907,1278.0073,1278.022533,1,38340219,38340675,456,0.3532434848974143
15908,1278.023767,1278.0308,1,38340713,38340924,211,0.32945552388534033
15909,1278.074733,1278.235233,1,38342241,38347056,4815,0.8593272131952907
15910,1278.250533,1278.2921,1,38347515,38348763,1248,0.7943126958240654
15911,1278.309467,1278.314933,1,38349284,38349447,163,0.024200894515435396
15912,1278.809267,1278.838,1,38364278,38365140,862,0.6186406753168754
15913,1278.967267,1278.974933,1,38369018,38369247,229,0.1049912892603686
15914,1279.437367,1279.5281,1,38383121,38385843,2722,0.7418795446366625
15915,1279.5443,1279.549467,1,38386329,38386484,155,0.7072153417553856
15916,1279.563633,1279.591767,1,38386908,38387753,845,0.014037885744211229
15917,1279.5965,1279.623367,1,38387895,38388701,806,-0.0913096462863657
15918,1279.678967,1279.710767,1,38390369,38391323,954,0.38278303043184353
15919,1279.7118,1279.748033,1,38391354,38392440,1086,0.25468491552512923
15920,1279.749133,1279.759,1,38392473,38392770,297,0.21475453515815446
15921,1279.772067,1279.777967,1,38393162,38393339,177,0.45732357640095816
15922,1279.7802,1279.894667,1,38393406,38396840,3434,0.8446953948816525
15923,1279.9069,1279.915433,1,38397207,38397462,255,0.008022150148441272
15924,1279.940367,1279.943733,1,38398211,38398311,100,0.18958920726419579
15925,1279.959967,1279.965533,1,38398799,38398965,166,0.21317646973336069
15926,1280.165833,1280.189633,1,38404974,38405688,714,0.6846286402797083
15927,1280.1938,1280.208867,1,38405814,38406266,452,0.7262711999230569
15928,1280.256967,1280.274433,1,38407709,38408232,523,0.7550650926295892
15929,1280.300767,1280.347133,1,38409023,38410413,1390,0.7230304116486527
15930,1280.371167,1280.3871,1,38411135,38411613,478,0.7789435841241874
15931,1280.406867,1280.4238,1,38412206,38412714,508,0.6780517345494691
15932,1280.4251,1280.439733,1,38412753,38413191,438,0.747608776622773
15933,1280.458533,1280.462967,1,38413755,38413889,134,
15934,1280.4641,1280.477067,1,38413923,38414312,389,0.0882500517343754
15935,1280.478133,1280.518933,1,38414343,38415567,1224,0.16323244411034604
15936,1280.547733,1280.558767,1,38416431,38416763,332,0.6893619764896727
15937,1280.561,1280.654233,1,38416830,38419626,2796,0.7918288544161816
15938,1280.669333,1280.681033,1,38420079,38420430,351,0.49832052074807887
15939,1280.6914,1280.727733,1,38420742,38421831,1089,0.006824862802003327
15940,1280.7327,1280.902867,1,38421981,38427086,5105,0.7871497085520417
15941,1280.917967,1280.922467,1,38427539,38427674,135,-0.023433698306152523
15942,1280.925867,1280.929533,1,38427776,38427885,109,
15943,1281.069967,1281.0869,1,38432099,38432607,508,0.4340064254652523
15944,1281.091533,1281.0978,1,38432745,38432934,189,-0.16906553161534477
15945,1281.107233,1281.125533,1,38433216,38433765,549,-0.015496079949363362
15946,1281.131833,1281.157267,1,38433954,38434718,764,0.21111967152361272
15947,1281.2133,1281.327333,1,38436399,38439819,3420,0.6583996752650932
15948,1281.358567,1281.3762,1,38440757,38441286,529,0.5949002528673306
15949,1281.378067,1281.470133,1,38441342,38444103,2761,0.6619958283644638
15950,1281.4918,1281.499333,1,38444754,38444979,225,0.5965714405049418
15951,1281.505767,1281.5342,1,38445173,38446026,853,0.630850257864749
15952,1281.575467,1281.616333,1,38447264,38448489,1225,0.023683298344754737
15953,1281.6425,1281.725033,1,38449275,38451750,2475,0.7274763218820459
15954,1281.729767,1281.753533,1,38451893,38452605,712,0.7932881315564394
15955,1281.981233,1281.9999,1,38459436,38459997,561,0.5596629061732005
15956,1282.021533,1282.044033,1,38460645,38461320,675,0.5839054735908464
15957,1282.058633,1282.242767,1,38461758,38467283,5525,0.7962261886888472
15958,1282.686433,1282.690067,1,38480592,38480702,110,0.63872826264772
15959,1282.6921,1282.697533,1,38480763,38480925,162,0.3660012501402276
15960,1282.7121,1282.730133,1,38481363,38481903,540,0.8020308232805733
15961,1282.758867,1282.784933,1,38482766,38483547,781,0.8613205953172752
15962,1282.8587,1282.868967,1,38485761,38486069,308,0.5025715842899587
15963,1282.877233,1282.882933,1,38486316,38486487,171,0.5912807604182638
15964,1282.897333,1282.9075,1,38486919,38487225,306,0.3264924688635941
15965,1282.928867,1282.9603,1,38487866,38488809,943,0.579221595661506
15966,1282.9923,1282.999767,1,38489769,38489993,224,0.6879764967070492
15967,1283.003133,1283.010667,1,38490093,38490320,227,0.5381961765586187
15968,1283.035267,1283.0449,1,38491058,38491347,289,0.5188815496943987
15969,1283.050833,1283.062167,1,38491524,38491865,341,0.6098486144950546
15970,1283.092767,1283.099567,1,38492783,38492987,204,0.48645425767713646
15971,1283.110267,1283.1356,1,38493308,38494068,760,-0.04875638772491531
15972,1283.1379,1283.150833,1,38494137,38494524,387,0.39252294051852465
15973,1283.152333,1283.158333,1,38494569,38494749,180,0.1077979058643865
15974,1283.165167,1283.169267,1,38494955,38495078,123,0.5308847221815918
15975,1283.1771,1283.230167,1,38495313,38496905,1592,0.7440116965560399
15976,1283.231333,1283.3151,1,38496939,38499453,2514,0.7751229064072438
15977,1283.676533,1283.840867,1,38510295,38515226,4931,0.773428285009604
15978,1283.843433,1283.849533,1,38515302,38515485,183,0.34168202736396996
15979,1283.862033,1283.905433,1,38515860,38517162,1302,0.7190072967319222
15980,1284.445167,1284.4508,1,38533355,38533524,169,0.7219065997338605
15981,1284.457567,1284.464733,1,38533727,38533941,214,0.5018284622674613
15982,1284.4934,1284.515367,1,38534802,38535461,659,0.6209990032876141
15983,1284.517467,1284.520567,1,38535524,38535617,93,-0.4634630345154308
15984,1284.567167,1284.579967,1,38537015,38537399,384,0.5802724961133854
15985,1284.587,1284.5921,1,38537610,38537763,153,0.5182573165615485
15986,1284.599733,1284.612133,1,38537991,38538363,372,0.7998146220739191
15987,1284.6571,1284.695167,1,38539713,38540855,1142,0.5939527605011133
15988,1284.718733,1284.740433,1,38541561,38542212,651,0.5952477263662459
15989,1284.742067,1284.746933,1,38542262,38542407,145,0.48746943102480667
15990,1284.752767,1284.785867,1,38542583,38543576,993,0.7021824441496971
15991,1284.8038,1284.810667,1,38544114,38544320,206,0.2973597311496529
15992,1284.815633,1284.826133,1,38544468,38544783,315,0.603362546081804
15993,1284.833433,1284.847067,1,38545002,38545412,410,0.6142071702450347
15994,1284.8983,1284.910667,1,38546949,38547320,371,0.09383968944320219
15995,1284.911833,1284.924533,1,38547354,38547735,381,0.21959362358744652
15996,1284.930167,1284.934233,1,38547905,38548026,121,0.5933981700776261
15997,1284.954667,1284.958633,1,38548640,38548758,118,0.5350618050922914
15998,1284.9682,1285.034833,1,38549046,38551044,1998,0.861559937808564
15999,1285.037133,1285.077233,1,38551113,38552316,1203,0.7666298843524785
16000,1285.078333,1285.176067,1,38552349,38555282,2933,0.7199596245649235
16001,1285.178067,1285.182967,1,38555342,38555489,147,0.6543041382165561
16002,1285.185067,1285.217067,1,38555552,38556512,960,0.72857329048061
16003,1285.5778,1285.581867,1,38567334,38567456,122,0.21253574784261633
16004,1285.586667,1285.590767,1,38567600,38567723,123,0.5095570021858167
16005,1285.965433,1286.010433,1,38578962,38580312,1350,0.1411900007968931
16006,1286.0148,1286.022433,1,38580444,38580672,228,0.12699898834890683
16007,1286.0237,1286.0678,1,38580711,38582034,1323,0.788588106958473
16008,1286.072267,1286.1454,1,38582168,38584362,2194,0.8000560956529056
16009,1286.146867,1286.1761,1,38584406,38585283,877,0.777604237072018
16010,1286.180833,1286.1911,1,38585424,38585733,309,0.5236821211139601
16011,1286.193433,1286.1968,1,38585802,38585904,102,-0.20997258748522143
16012,1286.2131,1286.275433,1,38586393,38588262,1869,0.8163967448846842
16013,1286.2856,1286.3252,1,38588568,38589756,1188,0.7086160928162495
16014,1286.542367,1286.548133,1,38596271,38596443,172,-0.12143155739707076
16015,1286.684533,1286.6883,1,38600535,38600649,114,0.3743129102535528
16016,1287.5175,1287.5289,1,38625525,38625867,342,0.6745941795883519
16017,1287.531967,1287.546667,1,38625959,38626400,441,0.43030428914011515
16018,1287.606967,1287.622767,1,38628209,38628683,474,0.6829841819584115
16019,1287.7704,1287.782767,1,38633112,38633483,371,0.5611290432126095
16020,1287.788567,1287.797267,1,38633657,38633918,261,0.6172413378459801
16021,1287.8412,1287.848333,1,38635236,38635449,213,0.40356341319449496
16022,1288.073467,1288.078733,1,38642204,38642361,157,0.28140806006281965
16023,1288.413633,1288.4205,1,38652408,38652615,207,0.6566779738693099
16024,1288.4252,1288.440067,1,38652756,38653202,446,0.625445620595854
16025,1288.442467,1288.446533,1,38653274,38653395,121,0.5769156895720472
16026,1288.447767,1288.4516,1,38653433,38653548,115,0.5124919156908119
16027,1288.461267,1288.4816,1,38653838,38654448,610,0.5558872239848569
16028,1288.490733,1288.509133,1,38654721,38655273,552,0.6619670152968892
16029,1288.6445,1288.6477,1,38659335,38659431,96,0.7842783824114431
16030,1288.651233,1288.663567,1,38659536,38659907,371,0.6841776205884955
16031,1288.705067,1288.724033,1,38661152,38661720,568,0.5741052882304426
16032,1288.7841,1288.7916,1,38663523,38663748,225,0.4865114662159315
16033,1288.8034,1288.820967,1,38664102,38664629,527,-0.09941040553126071
16034,1288.8817,1288.886067,1,38666451,38666582,131,-0.19508875154468666
16035,1288.896,1289.0146,1,38666880,38670438,3558,0.5495263641435773
16036,1289.042467,1289.045867,1,38671274,38671376,102,
16037,1289.051333,1289.077733,1,38671539,38672331,792,0.065008268204983
16038,1289.0799,1289.153767,1,38672397,38674613,2216,0.15469284066384598
16039,1289.157133,1289.180133,1,38674713,38675403,690,0.11582604328824815
16040,1289.209967,1289.216833,1,38676299,38676504,205,0.6948090517571199
16041,1289.2546,1289.258267,1,38677638,38677748,110,-0.02498417266090174
16042,1289.263533,1289.268567,1,38677905,38678057,152,0.5043536787737739
16043,1289.270233,1289.280933,1,38678106,38678427,321,0.5170038309629371
16044,1289.286033,1289.2937,1,38678580,38678811,231,0.5502921186618082
16045,1289.313533,1289.3314,1,38679405,38679942,537,0.7820087616460486
16046,1289.333867,1289.3511,1,38680016,38680533,517,0.4527847257405387
16047,1289.355833,1289.384767,1,38680674,38681543,869,0.49483357159349056
16048,1289.3882,1289.410867,1,38681646,38682326,680,0.6413604558120436
16049,1289.412067,1289.4513,1,38682362,38683539,1177,0.7480192214042062
16050,1289.4705,1289.5302,1,38684115,38685906,1791,0.6167219363828379
16051,1289.542667,1289.5597,1,38686280,38686791,511,0.6344872568942883
16052,1289.5613,1289.577,1,38686839,38687310,471,0.6756686657102304
16053,1289.609533,1289.613833,1,38688285,38688414,129,0.10436142401043741
16054,1289.626867,1289.654767,1,38688806,38689643,837,-0.0095676507864257
16055,1289.655867,1289.679033,1,38689676,38690370,694,0.17538133869014697
16056,1289.6859,1289.6923,1,38690577,38690769,192,-0.10439367289852745
16057,1289.764,1289.873033,1,38692920,38696190,3270,0.7848781095579539
16058,1289.8936,1289.905167,1,38696808,38697155,347,0.2188006226367863
16059,1289.916667,1289.95,1,38697500,38698500,1000,0.1735918452307171
16060,1289.9514,1289.9584,1,38698542,38698752,210,0.08758317087256565
16061,1289.9621,1289.973267,1,38698863,38699198,335,0.14252501194039102
16062,1289.982067,1289.9874,1,38699462,38699622,160,-0.16557599373450438
16063,1290.103267,1290.207433,1,38703098,38706222,3124,0.7729468425384513
16064,1290.213867,1290.319733,1,38706416,38709591,3175,0.8308087886831566
16065,1290.337033,1290.3425,1,38710110,38710275,165,0.6277399614089907
16066,1290.346067,1290.376767,1,38710382,38711303,921,0.7702578928819308
16067,1290.406267,1290.411367,1,38712188,38712341,153,-0.10625683920520541
16068,1290.4178,1290.428233,1,38712534,38712846,312,-0.11513924123537808
16069,1290.528733,1290.535333,1,38715861,38716059,198,0.7517884714818359
16070,1290.561767,1290.5954,1,38716853,38717862,1009,0.7384053374139651
16071,1290.601033,1290.623233,1,38718030,38718696,666,0.734899521280606
16072,1290.625067,1290.636933,1,38718752,38719107,355,0.23774057921456002
16073,1290.656767,1290.690333,1,38719703,38720709,1006,0.8112979251147412
16074,1290.697867,1290.741933,1,38720936,38722257,1321,0.732180129173714
16075,1290.7485,1290.7582,1,38722455,38722746,291,0.4174018967364631
16076,1290.759767,1290.780467,1,38722793,38723414,621,0.8045655095211773
16077,1290.7839,1290.789333,1,38723517,38723679,162,0.7644354681605813
16078,1290.796933,1290.818033,1,38723907,38724540,633,0.8142512051678347
16079,1291.148567,1291.152767,1,38734457,38734583,126,0.2921968105440644
16080,1291.171467,1291.200167,1,38735144,38736005,861,0.7939443672163119
16081,1291.232133,1291.2418,1,38736963,38737254,291,0.7262526845514539
16082,1291.244767,1291.2717,1,38737343,38738151,808,0.7466647912110195
16083,1291.2758,1291.3027,1,38738274,38739081,807,0.6866890006702918
16084,1291.309133,1291.331933,1,38739273,38739957,684,0.7288390003354152
16085,1291.3387,1291.422733,1,38740161,38742681,2520,0.8288116459799302
16086,1291.4328,1291.5099,1,38742984,38745297,2313,0.8157205677572675
16087,1291.513767,1291.565633,1,38745413,38746968,1555,0.7120450033332395
16088,1291.573767,1291.581433,1,38747213,38747442,229,-0.08468989594674996
16089,1291.585433,1291.603433,1,38747562,38748102,540,0.12810467990101443
16090,1291.608867,1291.6282,1,38748266,38748846,580,0.21814197967896687
16091,1291.820133,1291.825967,1,38754603,38754779,176,0.7909411237438335
16092,1291.842533,1291.851033,1,38755275,38755530,255,0.5741903472970882
16093,1291.852567,1291.885467,1,38755577,38756564,987,0.7502117806113873
16094,1291.8954,1291.938033,1,38756862,38758140,1278,0.7928007956055458
16095,1291.941367,1292.029567,1,38758241,38760887,2646,0.7340435022951296
16096,1292.036567,1292.1703,1,38761097,38765109,4012,0.8213202973949444
16097,1292.174233,1292.232867,1,38765226,38766986,1760,0.755843351252743
16098,1292.2427,1292.258867,1,38767281,38767766,485,0.7362253975465988
16099,1292.2642,1292.2745,1,38767926,38768235,309,0.4280956207727084
16100,1292.288233,1292.293433,1,38768646,38768802,156,0.016605948617396525
16101,1292.302933,1292.306567,1,38769087,38769197,110,
16102,1292.324267,1292.328167,1,38769728,38769845,117,-0.03247182129237362
16103,1292.333267,1292.338433,1,38769998,38770152,154,
16104,1292.349667,1292.365233,1,38770490,38770956,466,0.1455043629684815
16105,1292.4401,1292.449367,1,38773203,38773481,278,0.5405806753257678
16106,1292.452767,1292.458933,1,38773583,38773767,184,0.5900639594772419
16107,1292.468267,1292.4721,1,38774048,38774163,115,-0.15834928326607917
16108,1292.5247,1292.5313,1,38775741,38775939,198,0.29936292799632186
16109,1292.5704,1292.576767,1,38777112,38777303,191,0.147501352558816
16110,1292.5931,1292.599567,1,38777793,38777987,194,0.43996222357999637
16111,1292.6258,1292.632533,1,38778774,38778975,201,-0.05555699897175118
16112,1292.644367,1292.650467,1,38779331,38779514,183,-0.06264283079699882
16113,1292.657933,1292.660933,1,38779737,38779827,90,
16114,1292.7354,1292.854067,1,38782062,38785622,3560,0.831792157507754
16115,1292.8628,1292.917833,1,38785884,38787534,1650,0.7960092085664942
16116,1292.920767,1292.928633,1,38787623,38787858,235,0.6549621149957943
16117,1292.959367,1293.049733,1,38788781,38791491,2710,0.8143294213380091
16118,1293.055267,1293.079267,1,38791658,38792378,720,0.7008002287637021
16119,1293.081033,1293.1072,1,38792430,38793216,786,0.6384377437075552
16120,1293.1099,1293.129867,1,38793297,38793896,599,0.7889785223349919
16121,1293.1392,1293.213567,1,38794176,38796407,2231,0.8121220817340753
16122,1293.234767,1293.266367,1,38797043,38797991,948,0.7410711107083308
16123,1293.270933,1293.301167,1,38798127,38799035,908,0.7866009587489748
16124,1293.317333,1293.335767,1,38799519,38800073,554,0.646170535702988
16125,1293.363967,1293.367233,1,38800919,38801016,97,0.03253048850079629
16126,1293.372233,1293.376433,1,38801166,38801292,126,
16127,1293.384067,1293.3899,1,38801522,38801697,175,-0.10883052893322623
16128,1293.403867,1293.409167,1,38802116,38802275,159,0.8811704140338733
16129,1293.591567,1293.597633,1,38807747,38807928,181,0.5833688903524474
16130,1293.6038,1293.6117,1,38808114,38808351,237,0.8348491606748725
16131,1293.668133,1293.6715,1,38810043,38810145,102,0.46203152479244763
16132,1293.672567,1293.723267,1,38810177,38811698,1521,0.6905044188980223
16133,1293.7288,1293.759933,1,38811864,38812797,933,0.6637229025308939
16134,1293.761633,1293.795533,1,38812848,38813865,1017,0.7362845813613679
16135,1293.8133,1293.831333,1,38814399,38814939,540,0.7184434971287346
16136,1293.833333,1293.843567,1,38814999,38815307,308,0.7008568637433218
16137,1293.872733,1293.878,1,38816181,38816340,159,0.22830944499172998
16138,1293.884233,1293.9361,1,38816526,38818083,1557,0.7886680984481464
16139,1293.942067,1293.957767,1,38818262,38818733,471,0.7249159735300671
16140,1293.965133,1293.974033,1,38818953,38819220,267,0.5804202201892871
16141,1294.011467,1294.017133,1,38820344,38820513,169,-0.2530394766296438
16142,1294.298667,1294.314867,1,38828960,38829446,486,0.7563705743238938
16143,1294.3203,1294.436833,1,38829609,38833104,3495,0.7481029129275222
16144,1294.440067,1294.4452,1,38833202,38833356,154,-0.2850263377736719
16145,1294.469033,1294.4799,1,38834070,38834397,327,0.7562042714123327
16146,1294.484,1294.510833,1,38834520,38835324,804,0.7965273375698043
16147,1294.5183,1294.5271,1,38835549,38835813,264,0.55204904435219
16148,1294.5319,1294.535633,1,38835957,38836068,111,0.5665515535269094
16149,1294.538433,1294.551767,1,38836152,38836553,401,0.4986001030306987
16150,1294.589,1294.6035,1,38837670,38838105,435,-0.08529951716401267
16151,1294.6277,1294.6926,1,38838831,38840778,1947,0.7980665994577616
16152,1294.6958,1294.804833,1,38840874,38844144,3270,0.7137788392202075
16153,1294.833833,1294.925033,1,38845014,38847750,2736,0.725716914449839
16154,1294.933467,1294.948,1,38848004,38848440,436,0.33053778344587437
16155,1294.949467,1295.032267,1,38848484,38850968,2484,0.7840741636768358
16156,1295.037233,1295.059433,1,38851116,38851782,666,0.8276474624803237
16157,1295.0626,1295.068467,1,38851878,38852054,176,0.5503721003443702
16158,1295.069633,1295.148967,1,38852088,38854469,2381,0.7863854977050594
16159,1295.150067,1295.174767,1,38854502,38855243,741,0.7459023490801292
16160,1295.1759,1295.261167,1,38855277,38857835,2558,0.7418353669017526
16161,1295.2635,1295.267233,1,38857905,38858016,111,0.5539275706896553
16162,1295.2769,1295.3699,1,38858307,38861097,2790,0.8028298467764746
16163,1295.3861,1295.415567,1,38861583,38862467,884,-0.07367639718241949
16164,1295.424833,1295.4322,1,38862744,38862966,222,0.10148353378277064
16165,1295.554033,1295.573433,1,38866620,38867202,582,0.758569340491381
16166,1295.580833,1295.625267,1,38867424,38868758,1334,0.794590306019654
16167,1295.6271,1295.6332,1,38868813,38868996,183,0.5592333685708162
16168,1295.651133,1295.7557,1,38869533,38872671,3138,0.772462280099176
16169,1295.774133,1295.777467,1,38873223,38873324,101,-0.16409131764219873
16170,1295.780467,1295.785467,1,38873414,38873564,150,
16171,1295.787833,1295.7977,1,38873634,38873931,297,0.09611364073308944
16172,1296.221,1296.2276,1,38886630,38886828,198,0.6594693979320503
16173,1296.2431,1296.2533,1,38887293,38887599,306,0.5728716389727322
16174,1296.255,1296.317867,1,38887650,38889536,1886,0.6460790002109197
16175,1296.341,1296.369567,1,38890230,38891087,857,0.6097348937667075
16176,1296.394367,1296.407867,1,38891831,38892236,405,0.5389138989128099
16177,1296.410667,1296.429967,1,38892320,38892899,579,0.6074612093040367
16178,1296.441133,1296.447967,1,38893233,38893439,206,-0.050964278751883585
16179,1296.574833,1296.59,1,38897244,38897700,456,0.4707768484845627
16180,1296.591333,1296.688567,1,38897739,38900657,2918,0.8361507948849599
16181,1296.9666,1297.0031,1,38908998,38910093,1095,0.791963654703428
16182,1297.2761,1297.336933,1,38918283,38920107,1824,0.7915299404028476
16183,1297.343333,1297.386767,1,38920299,38921603,1304,0.7584627529755008
16184,1297.405333,1297.432967,1,38922159,38922989,830,0.7813270402496238
16185,1297.434433,1297.463067,1,38923032,38923892,860,0.801591632513367
16186,1297.4644,1297.478267,1,38923932,38924348,416,0.6508566521392288
16187,1297.501467,1297.576433,1,38925044,38927292,2248,0.79321001838386
16188,1298.017233,1298.0289,1,38940516,38940867,351,0.674247053198303
16189,1298.036,1298.0684,1,38941080,38942052,972,0.4852394660228944
16190,1298.0822,1298.0995,1,38942466,38942985,519,0.5016025147982213
16191,1298.1259,1298.129367,1,38943777,38943881,104,0.6364440271931747
16192,1298.147533,1298.1618,1,38944425,38944854,429,0.8538405453454709
16193,1298.278567,1298.286633,1,38948357,38948598,241,0.6232392689554472
16194,1298.338433,1298.344167,1,38950152,38950325,173,0.7084355038425751
16195,1298.345367,1298.355,1,38950361,38950650,289,0.5404643329835567
16196,1298.657467,1298.6744,1,38959724,38960232,508,0.7118676322081023
16197,1298.680733,1298.696233,1,38960421,38960886,465,0.905956831233175
16198,1298.699567,1298.817,1,38960987,38964510,3523,0.8240065204972556
16199,1298.833633,1298.8515,1,38965008,38965545,537,0.8104388409025312
16200,1298.854233,1298.901767,1,38965626,38967053,1427,0.7789617956837519
16201,1298.903133,1298.907567,1,38967093,38967227,134,0.824037690559069
16202,1298.919567,1299.0014,1,38967587,38970042,2455,0.793012360182028
16203,1299.0048,1299.035667,1,38970144,38971070,926,0.8357800093656657
16204,1299.258,1299.2882,1,38977740,38978646,906,0.6632255793225774
16205,1299.293367,1299.384967,1,38978801,38981549,2748,0.8206678380578765
16206,1299.617567,1299.7462,1,38988527,38992386,3859,0.7850343027652343
16207,1300.631233,1300.6347,1,39018936,39019041,105,0.8208883759148382
16208,1300.638967,1300.6529,1,39019169,39019587,418,0.678688813544635
16209,1300.761533,1300.7806,1,39022845,39023418,573,0.5805767869347228
16210,1300.782067,1300.812867,1,39023462,39024386,924,0.6606887390921172
16211,1300.8252,1300.853033,1,39024756,39025590,834,0.68606421483229
16212,1300.943433,1301.033467,1,39028302,39031004,2702,0.7171324285565753
16213,1301.4769,1301.636933,1,39044307,39049107,4800,0.7806891616023535
16214,1301.653767,1301.678,1,39049613,39050340,727,0.7424952612344885
16215,1301.6791,1301.725367,1,39050373,39051761,1388,0.6988366553632132
16216,1301.749233,1301.808867,1,39052476,39054266,1790,0.6819859737354709
16217,1301.8158,1301.845733,1,39054474,39055371,897,0.6733407401897235
16218,1301.967067,1301.986567,1,39059012,39059597,585,0.5367816124760841
16219,1301.995933,1302.094633,1,39059877,39062838,2961,0.7475020383702711
16220,1302.639267,1302.770367,1,39079178,39083111,3933,0.8032073790624243
16221,1303.308833,1303.323867,1,39099264,39099716,452,0.5527343926531306
16222,1303.3398,1303.348167,1,39100194,39100445,251,0.620729350048174
16223,1303.3788,1303.389667,1,39101364,39101690,326,0.6909417464445861
16224,1303.4342,1303.4711,1,39103026,39104133,1107,0.6874863556628833
16225,1303.4991,1303.5045,1,39104973,39105135,162,0.7118264050452825
16226,1303.506533,1303.528067,1,39105195,39105842,647,0.6288253736425875
16227,1303.542467,1303.550733,1,39106274,39106521,247,0.6715764587063502
16228,1303.557367,1303.5758,1,39106721,39107274,553,0.6488823684303328
16229,1303.694067,1303.840467,1,39110822,39115214,4392,0.7698541768370968
16230,1303.846633,1303.9246,1,39115398,39117738,2340,0.7595882073042246
16231,1304.2241,1304.228433,1,39126723,39126852,129,0.3593673147970738
16232,1304.234967,1304.535033,1,39127049,39136050,9001,0.7721433219774108
16233,1304.801467,1304.9831,1,39144044,39149493,5449,0.8180596167220742
16234,1305.01,1305.0384,1,39150300,39151152,852,0.7201452095935408
16235,1305.2338,1305.240333,1,39157014,39157209,195,0.6105659546270732
16236,1305.246167,1305.5042,1,39157385,39165126,7741,0.7708893695548946
16237,1305.5139,1305.517767,1,39165417,39165533,116,-0.07829025077582637
16238,1305.842167,1305.849067,1,39175265,39175472,207,-0.02138506466080858
16239,1305.8529,1305.867833,1,39175587,39176034,447,0.8915671076369837
16240,1305.871567,1305.961367,1,39176147,39178841,2694,0.7950894378245696
16241,1306.237133,1306.328267,1,39187113,39189848,2735,0.7033752714565092
16242,1306.346733,1306.442467,1,39190401,39193274,2873,0.6959695203000492
16243,1306.443567,1306.4681,1,39193307,39194043,736,0.526095923072597
16244,1306.469767,1306.576133,1,39194093,39197283,3190,0.8047490075436241
16245,1306.638033,1306.641867,1,39199140,39199256,116,0.29496311627533434
16246,1306.6429,1306.656367,1,39199287,39199691,404,0.6561830717814552
16247,1306.671433,1306.713267,1,39200142,39201398,1256,0.6995564485510597
16248,1307.013,1307.067567,1,39210390,39212027,1637,0.7983174997346847
16249,1307.068567,1307.1275,1,39212057,39213825,1768,0.8184105818361114
16250,1307.395733,1307.4024,1,39221871,39222072,201,0.2386869350633203
16251,1307.4036,1307.526833,1,39222108,39225804,3696,0.8386722139265964
16252,1308.2223,1308.255333,1,39246669,39247659,990,0.600673585602135
16253,1308.325367,1308.333533,1,39249761,39250005,244,0.590872533406012
16254,1308.521233,1308.537333,1,39255636,39256119,483,0.6550249565580711
16255,1308.580333,1308.589067,1,39257409,39257672,263,0.41125106602992617
16256,1314.108033,1314.115167,1,39423240,39423455,215,-0.016395263843719487
16257,1314.123933,1314.143667,1,39423717,39424310,593,0.3342153915277203
16258,1314.1534,1314.177633,1,39424602,39425328,726,0.3247051976438059
16259,1314.182667,1314.209367,1,39425480,39426281,801,0.16394952678672023
16260,1314.2109,1314.2263,1,39426327,39426789,462,
16261,1314.3742,1314.382033,1,39431226,39431460,234,0.45165166411513546
16262,1314.386,1314.3902,1,39431580,39431706,126,-0.11245438644881385
16263,1317.461267,1317.4652,1,39523838,39523956,118,
16264,1317.473467,1317.4911,1,39524204,39524733,529,0.2848018918173098
16265,1317.492367,1317.495967,1,39524771,39524879,108,-0.24202053546927318
16266,1317.5178,1317.529233,1,39525534,39525876,342,0.17961398546308155
16267,1317.537367,1317.5439,1,39526121,39526317,196,0.38304583128126135
16268,1317.6373,1317.652733,1,39529119,39529581,462,0.3866632339898378
16269,1317.656567,1317.688633,1,39529697,39530658,961,0.11220915381483564
16270,1317.693267,1317.697533,1,39530798,39530925,127,-0.04687481892635883
16271,1317.704033,1317.764567,1,39531120,39532937,1817,0.5477971856236521
16272,1317.774933,1317.799333,1,39533247,39533979,732,0.02799152207723013
16273,1317.8018,1317.838867,1,39534054,39535166,1112,0.31722626784375413
16274,1317.842633,1317.849567,1,39535278,39535487,209,0.4770481626906701
16275,1317.854333,1317.869867,1,39535629,39536096,467,0.4583048119016521
16276,1317.8972,1317.9042,1,39536916,39537126,210,-0.12664422018104332
16277,1317.9106,1317.914733,1,39537318,39537441,123,
16278,1317.919733,1317.941533,1,39537591,39538245,654,0.053711071635784306
16279,1317.951633,1317.9627,1,39538548,39538881,333,-0.020394728134744168
16280,1317.9757,1317.9872,1,39539271,39539616,345,-0.0785064113539201
16281,1317.9882,1317.9984,1,39539646,39539952,306,0.11715500076145967
16282,1318.021233,1318.036767,1,39540636,39541103,467,0.11690578042330388
16283,1318.045167,1318.0482,1,39541355,39541446,91,
16284,1318.0708,1318.0811,1,39542124,39542433,309,0.15366179590832513
16285,1318.089133,1318.094333,1,39542673,39542829,156,0.08438885898195085
16286,1318.0961,1318.102733,1,39542883,39543081,198,-0.15252559486399123
16287,1318.1038,1318.1273,1,39543114,39543819,705,0.03410112418889242
16288,1318.129867,1318.133633,1,39543896,39544008,112,0.5286682095596158
16289,1318.134833,1318.144733,1,39544044,39544341,297,0.42960014132290825
16290,1318.145733,1318.152633,1,39544371,39544578,207,0.39976836908926605
16291,1318.156567,1318.160433,1,39544697,39544812,115,0.5249714360295442
16292,1318.205033,1318.2188,1,39546150,39546564,414,0.1892072329902276
16293,1318.225633,1318.245133,1,39546768,39547353,585,0.0019851100239704567
16294,1318.257633,1318.273167,1,39547728,39548195,467,0.13294742233310938
16295,1318.281033,1318.2891,1,39548430,39548673,243,0.22531506131578044
16296,1318.3462,1318.350933,1,39550386,39550527,141,0.2857032395271539
16297,1318.3678,1318.3949,1,39551034,39551847,813,0.033471979114683595
16298,1318.439,1318.4421,1,39553170,39553263,93,0.24193538102135734
16299,1318.4893,1318.492433,1,39554679,39554772,93,
16300,1318.512633,1318.516167,1,39555378,39555485,107,0.11898768730902602
16301,1318.576067,1318.5913,1,39557282,39557739,457,0.153761355485233
16302,1318.595067,1318.613233,1,39557852,39558396,544,0.14813120743259098
16303,1318.695467,1318.706933,1,39560864,39561207,343,0.012203782248121905
16304,1318.7106,1318.734833,1,39561318,39562044,726,0.04241248361359062
16305,1318.810533,1318.819233,1,39564315,39564576,261,0.09633250812649445
16306,1318.828067,1318.8565,1,39564842,39565695,853,0.09080514607224692
16307,1318.8931,1318.897833,1,39566793,39566934,141,0.07297044088577431
16308,1319.0293,1319.0405,1,39570879,39571215,336,-0.10234976042641326
16309,1319.045233,1319.0529,1,39571356,39571587,231,-0.10065990537404895
16310,1319.065333,1319.0849,1,39571959,39572547,588,0.11533538479030177
16311,1319.091933,1319.099267,1,39572757,39572978,221,0.00303947356888743
16312,1319.1265,1319.134133,1,39573795,39574023,228,
16313,1319.207967,1319.2275,1,39576239,39576825,586,-0.02391766048172098
16314,1319.393567,1319.417233,1,39581807,39582516,709,0.12422493234725003
16315,1319.5095,1319.5318,1,39585285,39585954,669,0.025807931715332393
16316,1319.542933,1319.545933,1,39586287,39586377,90,
16317,1319.5794,1319.587067,1,39587382,39587612,230,0.03348326486799998
16318,1319.597367,1319.6021,1,39587921,39588063,142,0.6891352901244019
16319,1319.6037,1319.626033,1,39588111,39588780,669,0.1515102006453331
16320,1319.628533,1319.633133,1,39588855,39588993,138,0.27271379653047106
16321,1319.6342,1319.6404,1,39589026,39589212,186,0.6177336148124916
16322,1319.718033,1319.742967,1,39591540,39592289,749,0.11598199911726162
16323,1319.851167,1319.8745,1,39595535,39596235,700,0.12302723775786628
16324,1319.890367,1319.894067,1,39596711,39596822,111,
16325,1319.999933,1320.0117,1,39599997,39600351,354,0.04855938102441045
16326,1320.0181,1320.026067,1,39600543,39600782,239,0.3895196744710013
16327,1320.027567,1320.035567,1,39600827,39601067,240,-0.009974842932159765
16328,1320.054667,1320.066267,1,39601640,39601988,348,0.8239176803930477
16329,1320.083233,1320.101,1,39602496,39603030,534,0.37986738929626557
16330,1320.114967,1320.1236,1,39603449,39603708,259,-0.04334154691778163
16331,1320.1716,1320.181733,1,39605148,39605451,303,0.0058793976802560995
16332,1320.193467,1320.2271,1,39605804,39606813,1009,-0.032021262828815865
16333,1320.235067,1320.239833,1,39607052,39607194,142,
16334,1320.312567,1320.317833,1,39609377,39609534,157,0.44724629019978673
16335,1320.352833,1320.357367,1,39610584,39610721,137,
16336,1320.3896,1320.3944,1,39611688,39611832,144,
16337,1320.4306,1320.459467,1,39612918,39613784,866,0.06646910313368083
16338,1320.460867,1320.464467,1,39613826,39613934,108,0.3887840738843234
16339,1320.4888,1320.493033,1,39614664,39614790,126,0.15617807791356297
16340,1320.494533,1320.506633,1,39614835,39615198,363,0.109565898289598
16341,1320.508967,1320.519033,1,39615269,39615570,301,0.7966965038875636
16342,1320.541433,1320.5449,1,39616242,39616347,105,0.04902087850136484
16343,1320.546133,1320.549733,1,39616383,39616491,108,
16344,1320.560367,1320.5939,1,39616811,39617817,1006,0.04389184375383717
16345,1320.598033,1320.607433,1,39617940,39618222,282,0.04403420514892358
16346,1320.611833,1320.6153,1,39618354,39618459,105,
16347,1320.632533,1320.638,1,39618975,39619140,165,-0.14422988458228153
16348,1320.6396,1320.644133,1,39619188,39619323,135,0.051459180977235196
16349,1320.6597,1320.6676,1,39619791,39620028,237,0.06657236570356147
16350,1320.670833,1320.673933,1,39620124,39620217,93,
16351,1320.691233,1320.695667,1,39620736,39620870,134,0.4426037542235763
16352,1320.7039,1320.707767,1,39621117,39621233,116,0.17269956099083916
16353,1320.708867,1320.719533,1,39621266,39621585,319,0.2435355880723983
16354,1320.7302,1320.769133,1,39621906,39623073,1167,-0.030152158231481097
16355,1320.773467,1320.781567,1,39623204,39623447,243,
16356,1320.795367,1320.8064,1,39623861,39624192,331,-0.08567210476085851
16357,1320.821067,1320.824467,1,39624632,39624734,102,0.2670427250340111
16358,1320.8618,1320.869733,1,39625854,39626091,237,-0.13052236678704865
16359,1320.8757,1320.89,1,39626271,39626700,429,-0.11807145557760579
16360,1320.8965,1320.902033,1,39626895,39627060,165,0.6509637129028286
16361,1320.903867,1320.909467,1,39627116,39627284,168,-0.36136902738609766
16362,1320.918567,1320.9216,1,39627557,39627648,91,
16363,1320.922733,1320.927033,1,39627681,39627810,129,
16364,1320.928033,1320.9328,1,39627840,39627984,144,0.4619259136729696
16365,1320.9446,1320.959667,1,39628338,39628790,452,-0.09451882337509585
16366,1320.968367,1320.982233,1,39629051,39629466,415,0.014218674744638558
16367,1320.987833,1321.009267,1,39629634,39630278,644,0.014039519579758354
16368,1321.0248,1321.032767,1,39630744,39630983,239,0.14123869667738115
16369,1321.047633,1321.057267,1,39631428,39631718,290,0.30152739764856085
16370,1321.069533,1321.072767,1,39632085,39632183,98,
16371,1321.086367,1321.0954,1,39632591,39632862,271,-0.16820074418916034
16372,1321.108167,1321.1195,1,39633245,39633585,340,-0.000631607295672804
16373,1321.129167,1321.140267,1,39633875,39634208,333,0.15841344976865618
16374,1321.145533,1321.150267,1,39634365,39634508,143,0.2506583372909867
16375,1321.166867,1321.170967,1,39635006,39635129,123,0.2669330850526096
16376,1321.248733,1321.2732,1,39637461,39638196,735,0.07200041006367686
16377,1321.2877,1321.300133,1,39638631,39639003,372,0.2874289542936105
16378,1321.302833,1321.306633,1,39639084,39639198,114,0.035735455275569594
16379,1321.3103,1321.3134,1,39639309,39639402,93,
16380,1321.379767,1321.393333,1,39641393,39641799,406,0.1537442133497766
16381,1321.396267,1321.41,1,39641888,39642300,412,-0.0966206230215128
16382,1321.490567,1321.500433,1,39644717,39645012,295,0.4820993342719201
16383,1321.502567,1321.5061,1,39645077,39645183,106,
16384,1321.5107,1321.533433,1,39645321,39646002,681,0.016703669845053427
16385,1321.5435,1321.5631,1,39646305,39646893,588,0.11086097968306681
16386,1321.568267,1321.5727,1,39647048,39647181,133,
16387,1321.665733,1321.672267,1,39649971,39650168,197,-0.05544963676908075
16388,1321.6757,1321.678867,1,39650271,39650366,95,
16389,1321.683867,1321.7065,1,39650516,39651195,679,0.08025061697542012
16390,1321.743567,1321.753233,1,39652307,39652596,289,-0.030782282155737258
16391,1321.778833,1321.783533,1,39653364,39653505,141,-0.029505893379205752
16392,1321.8114,1321.816567,1,39654342,39654497,155,0.47556878419633664
16393,1321.923267,1321.926533,1,39657698,39657795,97,-0.13529492723456082
16394,1321.930133,1321.944567,1,39657903,39658337,434,0.06256872290494013
16395,1321.9555,1321.968733,1,39658665,39659061,396,0.11222754755519807
16396,1321.970733,1321.975567,1,39659121,39659267,146,0.5870591132874698
16397,1322.1223,1322.1264,1,39663669,39663792,123,0.35529768479919516
16398,1322.188467,1322.193567,1,39665654,39665807,153,-0.15454385045969338
16399,1322.221433,1322.227,1,39666642,39666810,168,0.49963405201217065
16400,1322.272933,1322.276067,1,39668187,39668282,95,
16401,1322.373667,1322.383833,1,39671210,39671514,304,
16402,1322.461167,1322.4666,1,39673835,39673998,163,0.6820578316145376
16403,1322.4713,1322.4759,1,39674139,39674277,138,0.23452513009119122
16404,1322.4867,1322.493967,1,39674601,39674819,218,0.013533616404004481
16405,1322.510533,1322.514967,1,39675315,39675449,134,
16406,1322.522233,1322.528733,1,39675666,39675861,195,-0.0961141268696285
16407,1322.561467,1322.566133,1,39676844,39676983,139,-0.19507541520994262
16408,1322.568233,1322.5735,1,39677046,39677205,159,
16409,1322.589333,1322.5927,1,39677679,39677781,102,
16410,1322.606667,1322.616433,1,39678200,39678492,292,-0.15414719515405256
16411,1322.623333,1322.631767,1,39678699,39678953,254,0.09812294330130869
16412,1322.708467,1322.7154,1,39681254,39681462,208,-0.1916608755648493
16413,1322.7199,1322.7337,1,39681597,39682011,414,0.2900097738063789
16414,1322.7359,1322.7646,1,39682077,39682938,861,0.10733442251208745
16415,1322.769867,1322.775167,1,39683096,39683255,159,
16416,1322.788233,1322.811667,1,39683646,39684350,704,0.06349471029070489
16417,1322.820267,1322.826467,1,39684608,39684794,186,0.22460109514300797
16418,1322.8393,1322.8429,1,39685179,39685287,108,0.3225963604154962
16419,1322.855367,1322.8642,1,39685661,39685926,265,0.37021338071638643
16420,1322.867433,1322.874367,1,39686022,39686231,209,
16421,1322.8853,1322.895133,1,39686559,39686853,294,0.6303536451171707
16422,1322.9037,1322.919167,1,39687111,39687575,464,0.058998062729738364
16423,1322.930267,1322.934167,1,39687908,39688025,117,-0.3277692065237309
16424,1322.9355,1322.9391,1,39688065,39688173,108,
16425,1322.952933,1322.9579,1,39688587,39688737,150,0.6894324130585118
16426,1322.959,1322.9658,1,39688770,39688974,204,0.6305793822959744
16427,1322.9704,1322.979567,1,39689112,39689387,275,0.47610541169827636
16428,1322.9859,1322.999,1,39689577,39689970,393,-0.04686830778034177
16429,1323.003567,1323.013567,1,39690107,39690407,300,-0.20885292702279576
16430,1323.016,1323.029167,1,39690480,39690875,395,-0.04358779054383541
16431,1323.0679,1323.073933,1,39692037,39692217,180,
16432,1323.181767,1323.1851,1,39695453,39695553,100,
16433,1323.215367,1323.218667,1,39696461,39696560,99,0.6394714661555165
16434,1323.221333,1323.2279,1,39696639,39696837,198,-0.22046452883471512
16435,1323.233533,1323.259167,1,39697005,39697775,770,0.013251197111405872
16436,1323.262733,1323.283333,1,39697881,39698499,618,0.05721203687208549
16437,1323.2885,1323.295967,1,39698655,39698879,224,0.07356075724230174
16438,1323.307633,1323.318033,1,39699228,39699540,312,0.03360838992100424
16439,1323.337767,1323.3533,1,39700133,39700599,466,0.053865763527949084
16440,1323.3603,1323.3685,1,39700809,39701055,246,0.3621882294818154
16441,1323.3735,1323.377067,1,39701205,39701312,107,
16442,1323.3781,1323.392633,1,39701343,39701778,435,0.06250686663769421
16443,1323.396733,1323.4078,1,39701901,39702234,333,0.24279530487223785
16444,1323.413367,1323.427133,1,39702401,39702813,412,0.4168723118419318
16445,1323.455133,1323.469,1,39703653,39704070,417,0.42494684108720115
16446,1323.471567,1323.500333,1,39704147,39705009,862,-0.08453801752815963
16447,1328.544767,1328.6161,1,39856343,39858483,2140,0.5282002797883986
16448,1328.617633,1328.6335,1,39858528,39859005,477,-0.08462006696158081
16449,1328.6348,1328.6682,1,39859044,39860046,1002,-0.06268019941630183
16450,1328.6718,1328.711233,1,39860154,39861336,1182,0.4968838583049454
16451,1328.713967,1328.7233,1,39861419,39861699,280,-0.1064910570979955
16452,1328.725833,1328.7703,1,39861774,39863109,1335,0.0391975658199883
16453,1328.980167,1328.9855,1,39869405,39869565,160,0.36226476399771673
16454,1328.986967,1328.9923,1,39869609,39869769,160,0.17377631594489246
16455,1328.997633,1329.001633,1,39869928,39870048,120,-0.18128062396752043
16456,1329.002733,1329.034433,1,39870081,39871032,951,0.034807293043904355
16457,1329.045067,1329.0893,1,39871352,39872679,1327,0.12679011931575876
16458,1329.2548,1329.258833,1,39877644,39877764,120,-0.17818717895065594
16459,1329.2631,1329.2844,1,39877893,39878532,639,-0.06812260745603445
16460,1329.396733,1329.400833,1,39881901,39882024,123,
16461,1329.492133,1329.4984,1,39884763,39884952,189,0.05559330506206508
16462,1329.502667,1329.511267,1,39885080,39885338,258,0.20516521997938225
16463,1329.525067,1329.528133,1,39885752,39885843,91,
16464,1329.605233,1329.610867,1,39888156,39888326,170,0.10796387743964025
16465,1329.617733,1329.620967,1,39888531,39888629,98,-0.1327504718995031
16466,1329.627,1329.636867,1,39888810,39889106,296,0.06726493082199475
16467,1329.652767,1329.669467,1,39889583,39890084,501,0.15797159297518096
16468,1329.674767,1329.682,1,39890243,39890460,217,-0.035117056269353686
16469,1329.755567,1329.7633,1,39892667,39892899,232,-0.002683492290991277
16470,1329.8572,1329.8674,1,39895716,39896022,306,0.15224293863403462
16471,1329.9554,1329.980333,1,39898662,39899409,747,0.11672625554110078
16472,1329.9966,1330.004,1,39899898,39900120,222,-0.06979851515505851
16473,1330.0051,1330.013133,1,39900153,39900393,240,
16474,1330.014333,1330.020833,1,39900429,39900624,195,-0.02809339191443869
16475,1330.029267,1330.0338,1,39900878,39901014,136,-0.09827360181977726
16476,1330.0373,1330.041867,1,39901119,39901256,137,-0.17342916504474346
16477,1330.052567,1330.057433,1,39901577,39901722,145,0.07492677397229516
16478,1330.152867,1330.156667,1,39904586,39904700,114,
16479,1330.1632,1330.175433,1,39904896,39905262,366,-0.1434794388889953
16480,1330.176733,1330.182567,1,39905301,39905477,176,
16481,1330.185667,1330.199033,1,39905570,39905970,400,0.09985974547990241
16482,1330.203167,1330.221733,1,39906095,39906651,556,0.32332978830261144
16483,1330.2961,1330.3037,1,39908883,39909111,228,0.36810620562255625
16484,1330.3394,1330.345867,1,39910182,39910376,194,0.3613634472899369
16485,1330.349933,1330.354067,1,39910497,39910622,125,-0.04129989985462034
16486,1330.355167,1330.366,1,39910655,39910980,325,0.5024295101466957
16487,1330.430167,1330.4354,1,39912905,39913062,157,0.7008227943279791
16488,1330.436467,1330.441633,1,39913094,39913248,154,0.13303903245379683
16489,1330.446567,1330.460467,1,39913397,39913814,417,0.20008472320491177
16490,1330.474233,1330.4826,1,39914226,39914478,252,0.07197210384697476
16491,1330.487467,1330.4906,1,39914624,39914718,94,-0.09731330810500305
16492,1330.500767,1330.5144,1,39915023,39915432,409,0.16609894884015974
16493,1330.517033,1330.526167,1,39915510,39915785,275,-0.17202352811934396
16494,1330.5273,1330.537233,1,39915819,39916116,297,-0.09215262485907681
16495,1330.538367,1330.553767,1,39916151,39916613,462,-0.005830267297264856
16496,1331.174967,1331.178733,1,39935249,39935361,112,
16497,1331.1887,1331.200033,1,39935661,39936000,339,-0.06456657544116727
16498,1331.212433,1331.230667,1,39936372,39936920,548,0.25685641985787483
16499,1332.722367,1332.727233,1,39981671,39981816,145,0.4072997390909144
16500,1332.736467,1332.749267,1,39982094,39982478,384,0.047850888890404945
16501,1332.750333,1332.838133,1,39982509,39985143,2634,0.7291642836775848
16502,1332.8873,1332.8924,1,39986619,39986772,153,-0.0490686997508028
16503,1332.8962,1332.904633,1,39986886,39987138,252,-0.034207737851434813
16504,1332.911333,1332.914367,1,39987339,39987431,92,
16505,1332.915567,1332.920067,1,39987467,39987602,135,0.3772688184874215
16506,1333.1244,1333.1307,1,39993732,39993921,189,0.3676439719950515
16507,1333.131933,1333.1375,1,39993957,39994125,168,0.4706200853951599
16508,1333.1515,1333.169267,1,39994545,39995078,533,0.15438791658017748
16509,1333.191867,1333.195767,1,39995756,39995873,117,-0.06334882589283843
16510,1333.1982,1333.2073,1,39995946,39996219,273,0.19932524350377806
16511,1334.2752,1334.2784,1,40028256,40028352,96,
16512,1335.512333,1335.5185,1,40065369,40065555,186,0.3164757569690402
16513,1335.5237,1335.5985,1,40065711,40067955,2244,0.7665890118689384
16514,1335.604067,1335.623667,1,40068122,40068710,588,0.8941445142735543
16515,1335.654133,1335.685367,1,40069623,40070561,938,0.7153514047658813
16516,1335.686367,1335.752667,1,40070591,40072580,1989,0.6443986774431719
16517,1335.776233,1335.785833,1,40073286,40073574,288,0.5902588470428038
16518,1335.789867,1335.802767,1,40073696,40074083,387,0.5693488626011058
16519,1336.3211,1336.324867,1,40089633,40089746,113,0.41175020397347334
16520,1336.328667,1336.540633,1,40089860,40096218,6358,0.8124702013405132
16521,1336.561767,1336.571367,1,40096853,40097141,288,0.8376220675627677
16522,1337.0097,1337.017133,1,40110291,40110513,222,0.6597177599781069
16523,1337.047267,1337.071467,1,40111418,40112144,726,0.6800604438121093
16524,1337.081467,1337.126567,1,40112444,40113797,1353,0.8009097366405242
16525,1337.141967,1337.168433,1,40114259,40115052,793,0.805138170493322
16526,1337.183333,1337.293533,1,40115499,40118805,3306,0.7803563137054425
16527,1337.298867,1337.3533,1,40118966,40120599,1633,0.6732347783128887
16528,1337.354833,1337.454933,1,40120644,40123647,3003,0.7437346313216867
16529,1337.490133,1337.497533,1,40124703,40124925,222,-0.1214378752255281
16530,1337.9213,1337.924333,1,40137639,40137729,90,0.6532670618003401
16531,1337.9291,1337.933233,1,40137873,40137996,123,0.833154148802582
16532,1338.0339,1338.043633,1,40141017,40141308,291,0.7535324073098398
16533,1338.0481,1338.052233,1,40141443,40141566,123,0.6193355201033672
16534,1338.063533,1338.102633,1,40141905,40143078,1173,0.5850605775366955
16535,1338.1284,1338.1321,1,40143852,40143963,111,0.5722606212923405
16536,1338.135267,1338.141233,1,40144058,40144236,178,0.520049495713155
16537,1338.2715,1338.4339,1,40148145,40153017,4872,0.7719115204360347
16538,1339.301167,1339.3125,1,40179035,40179375,340,0.5041782170537084
16539,1339.3148,1339.330633,1,40179444,40179918,474,0.6110632462877165
16540,1339.371033,1339.374467,1,40181130,40181234,104,0.365130448478579
16541,1339.397067,1339.4033,1,40181912,40182099,187,0.5893991541756947
16542,1339.431133,1339.440967,1,40182933,40183229,296,0.5241779483403018
16543,1339.444367,1339.459633,1,40183331,40183788,457,0.525161987473307
16544,1339.506733,1339.515067,1,40185201,40185452,251,0.23713837298668705
16545,1339.517667,1339.5286,1,40185530,40185858,328,0.6589518754332091
16546,1339.5558,1339.560167,1,40186674,40186805,131,0.37422517897280505
16547,1339.562767,1339.5757,1,40186883,40187271,388,0.6587924198928753
16548,1339.722033,1339.787733,1,40191660,40193631,1971,0.8031984370712784
16549,1339.788733,1339.840067,1,40193661,40195202,1541,0.7263664509556227
16550,1339.850633,1340.057867,1,40195518,40201736,6218,0.8256968401863408
16551,1340.060233,1340.073733,1,40201806,40202211,405,0.5917485960779996
16552,1340.074933,1340.1195,1,40202247,40203585,1338,0.7895304442460013
16553,1340.1458,1340.173767,1,40204374,40205213,839,0.7223415410130214
16554,1340.558967,1340.705833,1,40216769,40221174,4405,0.7798973574643073
16555,1340.721433,1340.7532,1,40221642,40222596,954,0.8455161482769714
16556,1340.755567,1340.7618,1,40222667,40222854,187,-0.09814469457208146
16557,1340.7638,1340.777267,1,40222914,40223318,404,0.8074350037675073
16558,1340.7821,1340.8114,1,40223463,40224342,879,0.8686854138441391
16559,1340.858867,1340.862367,1,40225766,40225871,105,0.6948017184685334
16560,1340.863367,1340.951233,1,40225901,40228536,2635,0.8213836559667785
16561,1340.972533,1340.9765,1,40229175,40229295,120,-0.07103295596378512
16562,1340.9866,1340.990233,1,40229598,40229706,108,
16563,1341.635067,1341.6466,1,40249052,40249398,346,0.6351113047773205
16564,1341.654333,1341.661167,1,40249629,40249835,206,0.5061605439041665
16565,1341.705567,1341.7212,1,40251167,40251636,469,0.8758781272915784
16566,1341.742767,1341.746733,1,40252283,40252401,118,0.369711228569008
16567,1341.807233,1341.812267,1,40254216,40254368,152,0.46698038440052686
16568,1341.820967,1341.824267,1,40254629,40254728,99,0.2607737513717059
16569,1341.8384,1341.848967,1,40255152,40255469,317,-0.050641939267830643
16570,1341.867267,1341.885367,1,40256018,40256561,543,0.5751559936936358
16571,1341.886867,1341.898333,1,40256606,40256949,343,0.10843540882222574
16572,1341.931333,1341.935933,1,40257939,40258077,138,0.5839523595456951
16573,1341.939,1341.947467,1,40258170,40258424,254,0.486973172700473
16574,1341.9831,1341.989667,1,40259493,40259690,197,0.4979695702420546
16575,1342.130533,1342.2522,1,40263915,40267566,3651,0.7961755653034983
16576,1342.275867,1342.375333,1,40268276,40271259,2983,0.7261213651083414
16577,1342.382933,1342.404533,1,40271487,40272135,648,0.7474524009031994
16578,1342.411633,1342.458833,1,40272348,40273764,1416,0.8478053539191382
16579,1342.468567,1342.482867,1,40274057,40274486,429,0.769622431724505
16580,1342.4903,1342.501433,1,40274709,40275042,333,0.541575711434943
16581,1342.8479,1342.8567,1,40285437,40285701,264,0.5936748723563141
16582,1342.857833,1343.025467,1,40285734,40290764,5030,0.8471373207157408
16583,1343.0267,1343.030567,1,40290801,40290917,116,0.016738770129875246
16584,1343.033733,1343.0487,1,40291011,40291461,450,0.8353819399050325
16585,1343.052633,1343.125467,1,40291578,40293764,2186,0.7644978543721942
16586,1343.128333,1343.1547,1,40293849,40294641,792,0.757566798894545
16587,1343.155867,1343.182,1,40294676,40295460,784,0.7357514501792757
16588,1343.183467,1343.202667,1,40295504,40296080,576,0.7964071137654838
16589,1343.2058,1343.2138,1,40296174,40296414,240,0.5637874156481878
16590,1343.2153,1343.3015,1,40296459,40299045,2586,0.7631866549526586
16591,1343.345,1343.349567,1,40300350,40300487,137,0.302968626497065
16592,1343.366167,1343.375633,1,40300985,40301268,283,0.15172922015964613
16593,1343.739733,1343.771133,1,40312191,40313133,942,0.5762418587772974
16594,1343.796667,1343.815567,1,40313900,40314467,567,0.5200947237319057
16595,1343.965233,1343.969067,1,40318956,40319072,116,0.2751827616555886
16596,1343.979133,1344.180067,1,40319373,40325402,6029,0.7605815723913277
16597,1344.207933,1344.299933,1,40326237,40328997,2760,0.7389563684423497
16598,1344.301767,1344.306867,1,40329053,40329206,153,-0.3061447296773189
16599,1344.3089,1344.315167,1,40329267,40329455,188,0.25010444647165886
16600,1344.601467,1344.629867,1,40338044,40338896,852,0.7012251321090864
16601,1344.6433,1344.695533,1,40339299,40340865,1566,0.828576310797495
16602,1344.697233,1344.7011,1,40340916,40341033,117,0.7024237705914554
16603,1344.702933,1344.738133,1,40341087,40342143,1056,0.8168927871286435
16604,1344.7592,1344.790933,1,40342776,40343727,951,0.5868329056408597
16605,1344.791967,1344.846567,1,40343759,40345397,1638,0.6007629351079323
16606,1344.867333,1344.873033,1,40346019,40346190,171,0.7657176061691859
16607,1344.874367,1344.884333,1,40346231,40346529,298,0.7885419319804893
16608,1344.9039,1344.917167,1,40347117,40347515,398,0.8133157266386108
16609,1344.9289,1344.949367,1,40347867,40348481,614,0.7530757437193025
16610,1344.951367,1344.9968,1,40348541,40349904,1363,0.0427639579160577
16611,1344.9987,1345.020267,1,40349961,40350608,647,0.10863612864050542
16612,1345.048833,1345.0577,1,40351464,40351731,267,0.9121361682128661
16613,1345.0614,1345.119933,1,40351842,40353597,1755,0.6812869716767106
16614,1345.121433,1345.134,1,40353642,40354020,378,0.3878717715193414
16615,1345.143433,1345.252833,1,40354302,40357584,3282,0.8562516731294721
16616,1345.5901,1345.596333,1,40367703,40367889,186,0.6802547998649189
16617,1345.597833,1345.731633,1,40367934,40371948,4014,0.7969836472054894
16618,1345.735667,1345.743633,1,40372070,40372308,238,0.6929102063361828
16619,1345.744833,1345.769133,1,40372344,40373073,729,0.7706737889795876
16620,1345.770733,1345.803533,1,40373121,40374105,984,0.5736146098132318
16621,1345.805667,1345.81,1,40374170,40374300,130,0.5385317700615799
16622,1345.8363,1345.842133,1,40375089,40375263,174,0.8318763302223178
16623,1345.850233,1345.911733,1,40375506,40377351,1845,0.7969422169713095
16624,1345.9128,1345.931333,1,40377384,40377939,555,0.8490039549325279
16625,1345.932433,1346.069633,1,40377972,40382088,4116,0.7090208240278907
16626,1346.1024,1346.105567,1,40383072,40383167,95,
16627,1346.109467,1346.114767,1,40383284,40383443,159,-0.1016568672527229
16628,1346.327567,1346.3335,1,40389827,40390005,178,0.10365047542722845
16629,1346.3471,1346.4251,1,40390413,40392753,2340,0.7862110051991236
16630,1346.4324,1346.4925,1,40392972,40394775,1803,0.8229615568876244
16631,1346.494233,1346.5048,1,40394826,40395144,318,0.6745524771039613
16632,1346.507767,1346.518133,1,40395233,40395543,310,0.1651690011095553
16633,1346.533633,1346.620767,1,40396008,40398623,2615,0.7630410721653482
16634,1346.624467,1346.641467,1,40398734,40399244,510,0.6167767547035083
16635,1346.643,1346.646567,1,40399290,40399397,107,0.7048785906245777
16636,1346.649567,1346.698733,1,40399487,40400961,1474,0.5589017494016026
16637,1346.7034,1346.767833,1,40401102,40403034,1932,0.7930496949131437
16638,1346.773733,1346.8083,1,40403211,40404249,1038,0.6421626747468515
16639,1346.823767,1346.8379,1,40404713,40405137,424,-0.02004162022254737
16640,1346.839933,1346.872567,1,40405197,40406177,980,0.07997751392904814
16641,1346.9005,1347.035767,1,40407015,40411073,4058,0.8111791919455942
16642,1347.040133,1347.100267,1,40411203,40413008,1805,0.8378634804893801
16643,1347.1226,1347.158233,1,40413678,40414746,1068,0.7837133478947145
16644,1347.1684,1347.1803,1,40415052,40415409,357,-0.05587437377131214
16645,1347.1825,1347.189167,1,40415475,40415675,200,-0.09222185828716983
16646,1347.2008,1347.208733,1,40416024,40416261,237,0.08337209174888909
16647,1347.220367,1347.226733,1,40416611,40416801,190,-0.010414164947198873
16648,1347.229733,1347.342933,1,40416891,40420287,3396,0.8315986347628126
16649,1347.356867,1347.395233,1,40420706,40421856,1150,0.003724540089970335
16650,1347.682033,1347.6926,1,40430460,40430778,318,0.609978020443102
16651,1347.6968,1347.701933,1,40430904,40431057,153,0.5039282750045647
16652,1347.703267,1347.707533,1,40431098,40431225,127,0.46825586322319845
16653,1347.745,1347.754867,1,40432350,40432646,296,0.5060141789548657
16654,1347.774833,1347.780233,1,40433244,40433406,162,0.7116245761304882
16655,1347.800833,1347.8138,1,40434024,40434414,390,0.8895385110572737
16656,1347.842067,1347.9523,1,40435262,40438569,3307,0.7478842878161371
16657,1348.078267,1348.177233,1,40442348,40445316,2968,0.8107911648748267
16658,1348.190833,1348.211233,1,40445724,40446336,612,-0.005788668746974244
16659,1348.2127,1348.219967,1,40446381,40446599,218,0.2325375284970871
16660,1348.2213,1348.2339,1,40446639,40447017,378,0.24295402601949959
16661,1348.236667,1348.244,1,40447100,40447320,220,0.34801365006958324
16662,1348.2691,1348.386733,1,40448073,40451601,3528,0.8053887780549638
16663,1348.3903,1348.455567,1,40451709,40453667,1958,0.7660011329896318
16664,1348.4632,1348.481533,1,40453896,40454445,549,0.8099581152176375
16665,1348.498167,1348.504467,1,40454945,40455134,189,0.4742486436747668
16666,1348.512933,1348.557167,1,40455387,40456715,1328,0.04272387331370041
16667,1348.5626,1348.567967,1,40456878,40457039,161,-0.25771901640500866
16668,1348.571333,1348.731533,1,40457139,40461945,4806,0.8501311355348431
16669,1348.7546,1348.7805,1,40462638,40463415,777,-0.01839699470951843
16670,1348.782133,1348.793633,1,40463463,40463808,345,0.14469735233139716
16671,1348.795067,1348.802567,1,40463852,40464077,225,0.40979101010877655
16672,1348.830467,1348.8479,1,40464914,40465437,523,0.7385986084954804
16673,1348.8489,1348.946267,1,40465467,40468388,2921,0.8138585611043971
16674,1348.997333,1349.0273,1,40469919,40470819,900,-0.06204033800508289
16675,1349.036667,1349.2023,1,40471100,40476069,4969,0.7842214816717005
16676,1349.208033,1349.2653,1,40476240,40477959,1719,0.8237237084453621
16677,1349.270867,1349.2886,1,40478126,40478658,532,0.709987486272814
16678,1349.291733,1349.3776,1,40478751,40481328,2577,0.8154139316481165
16679,1349.393633,1349.401167,1,40481808,40482035,227,-0.013134921820675483
16680,1349.463933,1349.4699,1,40483917,40484097,180,0.37153327279772036
16681,1349.480967,1349.491133,1,40484429,40484733,304,0.7557862052125398
16682,1349.512267,1349.531267,1,40485368,40485938,570,0.6851134556126453
16683,1349.535333,1349.588767,1,40486059,40487663,1604,0.7224831101877899
16684,1349.593367,1349.7134,1,40487801,40491402,3601,0.7728632338791058
16685,1349.717467,1349.728267,1,40491524,40491848,324,0.6390592766123258
16686,1349.7388,1349.745833,1,40492164,40492374,210,0.46350431013333954
16687,1349.753267,1349.763167,1,40492598,40492895,297,0.7405567659068185
16688,1349.767267,1349.862667,1,40493018,40495880,2862,0.7906257605812866
16689,1349.864467,1349.8888,1,40495934,40496664,730,0.40271930003657225
16690,1349.891033,1349.9712,1,40496730,40499136,2406,0.7818727159775093
16691,1349.9734,1349.997567,1,40499202,40499927,725,0.4911220710445001
16692,1350.000133,1350.088533,1,40500003,40502655,2652,0.8161093916469386
16693,1350.0911,1350.116233,1,40502733,40503486,753,0.8765746318985188
16694,1350.119233,1350.210967,1,40503576,40506329,2753,0.7963983853063067
16695,1350.2126,1350.238433,1,40506378,40507152,774,0.7941612700190989
16696,1350.2405,1350.333667,1,40507215,40510010,2795,0.7880886208623255
16697,1350.335867,1350.3622,1,40510076,40510866,790,0.8453275720441954
16698,1350.365933,1350.4583,1,40510977,40513749,2772,0.839453995438709
16699,1350.460033,1350.487667,1,40513800,40514630,830,0.8087272139720463
16700,1350.489767,1350.5834,1,40514693,40517502,2809,0.8238204944012025
16701,1350.585867,1350.612,1,40517576,40518360,784,0.8231009293057402
16702,1350.6152,1350.711033,1,40518456,40521330,2874,0.8169315735125363
16703,1350.713333,1350.738633,1,40521399,40522158,759,0.8508928070691303
16704,1350.7422,1350.836667,1,40522266,40525100,2834,0.8365151976114169
16705,1350.8399,1350.866367,1,40525197,40525991,794,0.8687770521716192
16706,1350.8682,1350.966133,1,40526046,40528983,2937,0.8478413735558799
16707,1350.968533,1350.994967,1,40529055,40529849,794,0.8819682585024717
16708,1350.9989,1351.0959,1,40529967,40532877,2910,0.7744525144665092
16709,1351.099933,1351.1262,1,40532997,40533786,789,0.8301498358717034
16710,1351.1291,1351.223067,1,40533873,40536692,2819,0.791729260793319
16711,1351.224967,1351.2525,1,40536749,40537575,826,0.7958355703193705
16712,1351.255667,1351.339133,1,40537670,40540173,2503,0.7837652565063397
16713,1351.341567,1351.350533,1,40540247,40540515,268,0.7095346989217862
16714,1351.365833,1351.4472,1,40540974,40543416,2442,0.7834735639938345
16715,1351.463667,1351.484433,1,40543910,40544532,622,0.012883980894610365
16716,1351.494167,1351.569567,1,40544825,40547087,2262,0.7967046097973145
16717,1351.594933,1351.600167,1,40547847,40548005,158,-0.003635801872465619
16718,1351.618367,1351.6227,1,40548551,40548681,130,
16719,1351.8486,1351.855067,1,40555458,40555652,194,0.7660323886160625
16720,1351.858,1351.861,1,40555740,40555830,90,
16721,1351.879233,1351.921933,1,40556376,40557657,1281,0.8017470449263534
16722,1351.9293,1351.9383,1,40557879,40558149,270,0.6228404023479027
16723,1351.946467,1351.963467,1,40558394,40558904,510,0.661958528380728
16724,1351.968733,1352.017233,1,40559061,40560516,1455,0.621754161461349
16725,1352.032667,1352.060833,1,40560980,40561824,844,0.7411823235605722
16726,1352.0818,1352.119133,1,40562454,40563573,1119,0.6928541824176249
16727,1352.1325,1352.1425,1,40563975,40564275,300,0.5873035929043919
16728,1352.150267,1352.1558,1,40564508,40564674,166,0.807756745842467
16729,1352.1688,1352.185233,1,40565064,40565556,492,0.08606560476570195
16730,1352.186833,1352.2158,1,40565604,40566474,870,0.1309208716953427
16731,1352.221367,1352.2266,1,40566641,40566798,157,-0.27888238674238625
16732,1352.233267,1352.404267,1,40566998,40572128,5130,0.7933446677677151
16733,1352.407433,1352.494133,1,40572222,40574823,2601,0.8343684692547624
16734,1352.499367,1352.556467,1,40574981,40576694,1713,0.7921027263937206
16735,1352.576067,1352.582633,1,40577282,40577478,196,0.009940335323649125
16736,1352.606933,1352.611367,1,40578207,40578341,134,
16737,1352.6534,1352.708,1,40579602,40581240,1638,0.7586810260749601
16738,1352.717,1352.765733,1,40581510,40582971,1461,0.7350607724361622
16739,1352.778667,1352.7865,1,40583360,40583595,235,-0.1077095854021222
16740,1352.788167,1352.792867,1,40583645,40583786,141,
16741,1352.7958,1352.7999,1,40583874,40583997,123,
16742,1353.786,1353.802033,1,40613580,40614060,480,0.15650596937664954
16743,1353.8111,1353.893967,1,40614333,40616819,2486,0.2532509834309857
16744,1353.901567,1353.930433,1,40617047,40617912,865,0.0567097099636173
16745,1353.9402,1353.9976,1,40618206,40619928,1722,0.1135034963615952
16746,1354.001267,1354.0095,1,40620038,40620285,247,0.13467808955625019
16747,1354.039633,1354.074167,1,40621188,40622225,1037,0.4932165942856343
16748,1354.090733,1354.098733,1,40622721,40622961,240,-0.08785151100030507
16749,1354.100033,1354.1261,1,40623000,40623783,783,0.027414276148411285
16750,1354.127533,1354.151267,1,40623825,40624538,713,0.3439717089621361
16751,1354.1631,1354.189333,1,40624893,40625679,786,0.14932973781765327
16752,1354.1904,1354.211733,1,40625712,40626351,639,0.02006465399942546
16753,1354.215667,1354.233733,1,40626470,40627011,541,0.18355350758881542
16754,1354.2402,1354.245933,1,40627206,40627377,171,0.12582644814508934
16755,1354.2542,1354.273033,1,40627626,40628190,564,0.469727350686914
16756,1354.2793,1354.2972,1,40628379,40628916,537,-0.08408626639964979
16757,1354.4216,1354.425533,1,40632648,40632765,117,-0.18327234241265677
16758,1354.433267,1354.5693,1,40632998,40637079,4081,0.5783066997500895
16759,1354.570567,1354.5783,1,40637117,40637349,232,-0.05744054906698515
16760,1354.583433,1354.643,1,40637502,40639290,1788,0.10843352260310787
16761,1354.8733,1354.882033,1,40646199,40646460,261,0.05939933213549054
16762,1354.8861,1354.8945,1,40646583,40646835,252,-0.025872808314300107
16763,1354.904033,1354.91,1,40647120,40647300,180,0.3809966250409412
16764,1354.917867,1354.9211,1,40647536,40647633,97,
16765,1354.9221,1354.9436,1,40647663,40648308,645,0.029311283781395577
16766,1354.945533,1354.9504,1,40648365,40648512,147,
16767,1354.9718,1354.981567,1,40649154,40649447,293,0.3249657497204288
16768,1355.024033,1355.029733,1,40650720,40650891,171,-0.003357200527895987
16769,1355.056633,1355.0614,1,40651698,40651842,144,
16770,1355.071933,1355.081333,1,40652157,40652439,282,0.10982862035515091
16771,1355.094333,1355.099233,1,40652829,40652976,147,0.4403657875160329
16772,1355.141967,1355.151567,1,40654259,40654547,288,0.14883662023125657
16773,1355.1608,1355.191433,1,40654824,40655742,918,0.022904489974359978
16774,1355.207167,1355.247333,1,40656215,40657419,1204,0.14694515861618562
16775,1355.248333,1355.2593,1,40657449,40657779,330,0.13984937793373015
16776,1355.263933,1355.297267,1,40657917,40658918,1001,0.07349305984463529
16777,1355.3071,1355.3478,1,40659213,40660434,1221,0.33492570840400043
16778,1355.3504,1355.362667,1,40660512,40660880,368,0.2824104530023545
16779,1355.3698,1355.373133,1,40661094,40661193,99,0.10962630070786528
16780,1355.375067,1355.383133,1,40661252,40661493,241,0.06858286837095681
16781,1355.421033,1355.436067,1,40662630,40663082,452,0.28114655847095227
16782,1355.4396,1355.469733,1,40663188,40664091,903,0.07067440213746239
16783,1355.4813,1355.536567,1,40664439,40666097,1658,0.2433513460007935
16784,1355.550233,1355.5554,1,40666506,40666662,156,0.0765339641240868
16785,1355.5768,1355.583467,1,40667304,40667504,200,0.02773999865877772
16786,1355.588933,1355.591967,1,40667667,40667759,92,
16787,1355.600633,1355.6164,1,40668018,40668492,474,0.22963122278075562
16788,1355.618067,1355.650767,1,40668542,40669523,981,-0.06136661159372394
16789,1355.658467,1355.694533,1,40669754,40670835,1081,0.061187030493756296
16790,1355.707933,1355.764067,1,40671237,40672922,1685,0.004741295093409519
16791,1355.7659,1355.7766,1,40672977,40673298,321,-0.05324194217503836
16792,1355.786467,1355.798167,1,40673594,40673945,351,0.15357854205334387
16793,1355.801133,1355.820033,1,40674033,40674600,567,0.052745004671137734
16794,1355.8305,1355.865667,1,40674915,40675970,1055,0.06828985876259554
16795,1355.869167,1355.886333,1,40676075,40676589,514,0.24102250439323855
16796,1356.006333,1356.010233,1,40680189,40680306,117,
16797,1356.016467,1356.0354,1,40680494,40681062,568,0.33710358471011365
16798,1356.037967,1356.057633,1,40681139,40681728,589,0.01858848639467702
16799,1356.063967,1356.0791,1,40681919,40682373,454,0.45144480909276075
16800,1356.082233,1356.100867,1,40682466,40683026,560,-0.03885194619007522
16801,1356.104533,1356.111467,1,40683135,40683344,209,0.1015676406242597
16802,1356.115767,1356.128433,1,40683473,40683852,379,0.4706238536241229
16803,1356.129967,1356.1418,1,40683899,40684254,355,-0.04961312535831491
16804,1356.1722,1356.183333,1,40685166,40685499,333,0.05287964704445232
16805,1356.2417,1356.2472,1,40687251,40687416,165,0.6211566838617761
16806,1356.470167,1356.481367,1,40694105,40694441,336,0.42814468217839896
16807,1356.537867,1356.545367,1,40696136,40696361,225,0.009542588836608926
16808,1356.551367,1356.574333,1,40696541,40697229,688,0.061427369631472946
16809,1356.5995,1356.606867,1,40697985,40698206,221,-0.09220604734950116
16810,1356.625667,1356.6406,1,40698770,40699218,448,-0.06281191818255648
16811,1356.650367,1356.6715,1,40699511,40700145,634,0.03906657961467624
16812,1356.673033,1356.694333,1,40700190,40700829,639,0.053810047348119706
16813,1356.7007,1356.7155,1,40701021,40701465,444,-0.017978192459010372
16814,1356.727867,1356.748967,1,40701836,40702469,633,-0.060906563233089746
16815,1356.756733,1356.763033,1,40702701,40702890,189,0.03409346990627195
16816,1356.780067,1356.783067,1,40703402,40703492,90,
16817,1356.7847,1356.805733,1,40703541,40704171,630,0.08018731238402187
16818,1356.8263,1356.845633,1,40704789,40705368,579,-0.08807300616597717
16819,1356.8609,1356.870433,1,40705827,40706112,285,0.0923160192846782
16820,1356.8721,1356.882567,1,40706163,40706477,314,0.11073908983380265
16821,1356.885033,1356.8907,1,40706550,40706721,171,0.5634165317584698
16822,1356.894367,1356.897633,1,40706831,40706928,97,0.26451170946632424
16823,1356.905167,1356.9373,1,40707155,40708119,964,0.08227141604187699
16824,1356.957367,1356.962,1,40708721,40708860,139,
16825,1356.974067,1356.983867,1,40709222,40709516,294,-0.06854781017357985
16826,1357.007667,1357.057667,1,40710230,40711730,1500,0.0399366965239818
16827,1357.771433,1357.774733,1,40733142,40733241,99,
16828,1358.758533,1358.764033,1,40762755,40762920,165,0.3830581455737212
16829,1358.779733,1358.7833,1,40763391,40763499,108,0.6669036901188086
16830,1358.7844,1358.791,1,40763532,40763730,198,0.13401141163926497
16831,1358.792067,1358.863833,1,40763762,40765914,2152,0.029017607079660928
16832,1358.865,1358.8783,1,40765950,40766349,399,0.10316102626070905
16833,1358.880433,1358.898467,1,40766412,40766954,542,0.07564217383073314
16834,1360.8267,1360.8416,1,40824801,40825248,447,0.5638720967373854
16835,1360.8501,1360.856467,1,40825503,40825694,191,0.6730434171402773
16836,1360.883667,1360.9007,1,40826510,40827021,511,0.6264091986343254
16837,1360.933467,1360.980033,1,40828004,40829400,1396,0.6638562477871416
16838,1361.003467,1361.0094,1,40830104,40830282,178,0.6598521809286341
16839,1361.010933,1361.027333,1,40830327,40830819,492,0.7122928029484739
16840,1361.041833,1361.054233,1,40831254,40831626,372,0.7165376387266985
16841,1361.057633,1361.0745,1,40831728,40832235,507,0.743646721350182
16842,1361.195567,1361.213967,1,40835867,40836419,552,0.5759814541569144
16843,1361.215633,1361.223667,1,40836468,40836710,242,0.47616937488728944
16844,1361.263067,1361.276367,1,40837892,40838291,399,0.7143131910993372
16845,1361.338,1361.350867,1,40840140,40840526,386,0.6570732946886931
16846,1361.352333,1361.358533,1,40840569,40840755,186,0.061300957648753616
16847,1361.629633,1361.6333,1,40848888,40848999,111,0.7329572032763736
16848,1361.645767,1361.7969,1,40849373,40853907,4534,0.7644667237366156
16849,1361.817633,1361.863733,1,40854528,40855911,1383,0.7471802833529458
16850,1361.8891,1361.9044,1,40856673,40857132,459,0.6634124096284189
16851,1361.921167,1361.975733,1,40857635,40859271,1636,0.7549322048022595
16852,1361.987867,1362.0271,1,40859636,40860813,1177,0.5946205182218921
16853,1362.082567,1362.098733,1,40862477,40862961,484,0.5290390747552917
16854,1362.116033,1362.1201,1,40863480,40863603,123,0.6969945262609313
16855,1362.1215,1362.235267,1,40863645,40867058,3413,0.7006269308484742
16856,1362.237433,1362.2417,1,40867122,40867251,129,0.6808374005861837
16857,1362.242867,1362.292333,1,40867286,40868769,1483,0.7486851594773519
16858,1362.304233,1362.318833,1,40869126,40869564,438,0.5853591814710705
16859,1362.3256,1362.391333,1,40869768,40871739,1971,0.7840087129467034
16860,1362.3936,1362.399733,1,40871808,40871991,183,-0.048041487181514124
16861,1362.452033,1362.455333,1,40873560,40873659,99,-0.043837613414263545
16862,1362.4665,1362.568133,1,40873995,40877043,3048,0.8446819440323012
16863,1362.5843,1362.589,1,40877529,40877670,141,-0.06369285593660225
16864,1362.8685,1362.905333,1,40886055,40887159,1104,0.7753060881717714
16865,1362.921367,1362.9535,1,40887641,40888605,964,0.8854130656627938
16866,1362.9568,1362.972967,1,40888704,40889189,485,0.8091139145243373
16867,1362.975033,1362.9783,1,40889250,40889349,99,0.16801795909559408
16868,1362.981133,1363.008167,1,40889433,40890245,812,0.6377197794394678
16869,1363.009633,1363.033,1,40890288,40890990,702,0.695995791911331
16870,1363.043767,1363.060833,1,40891313,40891824,511,0.7362618839789145
16871,1363.063,1363.171233,1,40891890,40895136,3246,0.7619221737634828
16872,1363.179667,1363.187467,1,40895390,40895624,234,0.5900660598711439
16873,1363.194367,1363.218367,1,40895831,40896551,720,0.7715617926826334
16874,1363.240033,1363.2505,1,40897200,40897515,315,-0.08285182127653032
16875,1363.2529,1363.271467,1,40897587,40898144,557,0.14393781200334607
16876,1363.272833,1363.2908,1,40898184,40898724,540,0.13543428924247447
16877,1363.3136,1363.473867,1,40899408,40904216,4808,0.8115638080291617
16878,1363.475067,1363.4877,1,40904252,40904631,379,0.7703900992050023
16879,1363.508233,1363.511667,1,40905246,40905350,104,
16880,1363.5154,1363.603233,1,40905462,40908096,2634,0.805424009357642
16881,1364.034633,1364.037633,1,40921038,40921128,90,0.005969505767746077
16882,1364.129033,1364.1371,1,40923870,40924113,243,0.7662168718146103
16883,1364.145967,1364.163533,1,40924379,40924905,526,0.5934499031136923
16884,1364.1849,1364.197,1,40925547,40925910,363,0.6144033915974138
16885,1364.216367,1364.219567,1,40926491,40926587,96,0.21705560871245888
16886,1364.227033,1364.2338,1,40926810,40927014,204,0.8108623215161698
16887,1364.2503,1364.262967,1,40927509,40927889,380,0.6936472838465675
16888,1364.2862,1364.299367,1,40928586,40928981,395,0.35770749570433535
16889,1364.3046,1364.329533,1,40929138,40929885,747,0.12010534098716538
16890,1364.3358,1364.353633,1,40930074,40930608,534,0.2392788383564502
16891,1364.362633,1364.366433,1,40930878,40930992,114,
16892,1364.367667,1364.370667,1,40931030,40931120,90,
16893,1364.477367,1364.484633,1,40934321,40934538,217,0.3073288868558738
16894,1364.5295,1364.650633,1,40935885,40939518,3633,0.8654551746397814
16895,1364.904733,1364.924567,1,40947141,40947737,596,0.6528785424562508
16896,1364.932133,1364.941767,1,40947963,40948253,290,0.6972870003530197
16897,1364.990567,1365.0071,1,40949717,40950213,496,0.715130676335058
16898,1365.0307,1365.036833,1,40950921,40951104,183,0.6266700466443491
16899,1365.038767,1365.0524,1,40951163,40951572,409,0.6905628207969544
16900,1365.059767,1365.076033,1,40951793,40952280,487,0.8940465694924213
16901,1365.108267,1365.118567,1,40953248,40953557,309,0.5847246632341778
16902,1365.141267,1365.175533,1,40954238,40955265,1027,0.6347184049699652
16903,1365.188533,1365.196033,1,40955655,40955880,225,0.649336138559022
16904,1365.200133,1365.225467,1,40956003,40956764,761,0.021450770112030847
16905,1365.227533,1365.236467,1,40956825,40957094,269,0.22370601054389636
16906,1365.2376,1365.254633,1,40957128,40957638,510,0.17615372611181357
16907,1365.266433,1365.270933,1,40957992,40958127,135,-0.08491039739797511
16908,1365.275367,1365.3726,1,40958261,40961178,2917,0.689900118517725
16909,1365.377633,1365.400367,1,40961328,40962011,683,0.6637073655078476
16910,1365.447067,1365.5381,1,40963412,40966143,2731,0.47167726766920104
16911,1365.5967,1365.656,1,40967901,40969680,1779,0.7898362453983471
16912,1365.6608,1365.7072,1,40969824,40971216,1392,0.7979284659111788
16913,1365.7105,1365.714067,1,40971315,40971422,107,0.751094441418666
16914,1365.715367,1365.774933,1,40971461,40973247,1786,0.7618352779543678
16915,1365.776733,1365.8055,1,40973301,40974165,864,0.7153051004696677
16916,1365.823233,1365.853933,1,40974696,40975617,921,0.679305281797197
16917,1365.881233,1365.893167,1,40976436,40976795,359,-0.059696399465370205
16918,1365.894933,1365.903267,1,40976847,40977098,251,0.09518606978272995
16919,1371.082933,1371.0863,1,41132487,41132589,102,0.5951784558743426
16920,1399.292233,1399.296867,1,41978766,41978906,140,0.5277379382930592
16921,1415.794133,1415.797267,1,42473823,42473918,95,-0.18725910335319346
16922,1416.5714,1416.575367,1,42497142,42497261,119,0.30190029573555405
16923,1434.8245,1434.8404,1,43044735,43045212,477,0.18243587577148695
16924,1434.8434,1434.846633,1,43045302,43045398,96,0.34664356294626497
16925,1434.873433,1434.879433,1,43046202,43046382,180,0.5455009023087335
16926,1434.880533,1434.926967,1,43046415,43047809,1394,0.1552106250843812
16927,1434.938367,1434.999233,1,43048151,43049976,1825,0.13963911415141625
16928,1435.0085,1435.022267,1,43050255,43050668,413,0.10761274696419865
16929,1435.037167,1435.0522,1,43051115,43051566,451,0.16599606275662118
16930,1435.053833,1435.057,1,43051614,43051710,96,
16931,1435.096467,1435.1063,1,43052894,43053189,295,0.15937128108452703
16932,1436.283933,1436.309667,1,43088517,43089290,773,0.6609356984756275
16933,1436.3134,1436.424567,1,43089402,43092737,3335,0.7767244020171922
16934,1436.425767,1436.481033,1,43092773,43094430,1657,0.7728811896552327
16935,1436.484333,1436.5471,1,43094529,43096413,1884,0.7131455535818193
16936,1436.5699,1436.5996,1,43097097,43097988,891,0.6933519294327711
16937,1436.6145,1436.6415,1,43098435,43099245,810,0.6363739511993801
16938,1437.156367,1437.164067,1,43114691,43114922,231,0.43356064516033826
16939,1437.1676,1437.311867,1,43115028,43119356,4328,0.7807957887235982
16940,1437.322433,1437.386967,1,43119672,43121609,1937,0.7850782636944466
16941,1437.3911,1437.413967,1,43121733,43122419,686,0.8570532420850551
16942,1437.4467,1437.526067,1,43123401,43125782,2381,0.8205327517982536
16943,1437.532,1437.5364,1,43125960,43126092,132,0.15791050066966522
16944,1437.546167,1437.5495,1,43126385,43126485,100,0.06482546095622596
16945,1437.551267,1437.554933,1,43126538,43126647,109,0.3246264449617086
16946,1438.043667,1438.112033,1,43141310,43143360,2050,0.8052360971543352
16947,1438.116967,1438.2295,1,43143509,43146885,3376,0.8590861423829084
16948,1438.2319,1438.2434,1,43146957,43147302,345,0.5022789370563838
16949,1438.265533,1438.354233,1,43147965,43150626,2661,0.803603934454611
16950,1438.357,1438.3963,1,43150710,43151889,1179,0.7146541508190699
16951,1438.404333,1438.425933,1,43152129,43152777,648,0.692405277010903
16952,1438.429567,1438.5217,1,43152887,43155651,2764,0.831097512427879
16953,1438.909933,1439.1066,1,43167297,43173198,5901,0.8152628383108287
16954,1439.1102,1439.1328,1,43173306,43173984,678,0.7435108439234047
16955,1439.134333,1439.172433,1,43174029,43175172,1143,0.7676204708170752
16956,1439.174867,1439.199367,1,43175246,43175981,735,0.6659709767517282
16957,1439.201567,1439.256433,1,43176047,43177692,1645,0.7940903519703344
16958,1439.259367,1439.265,1,43177781,43177950,169,0.19900070292881175
16959,1439.269133,1439.353433,1,43178073,43180602,2529,0.8091550088048125
16960,1439.389,1439.4074,1,43181670,43182222,552,0.24019303893426017
16961,1439.707567,1439.838633,1,43191227,43195158,3931,0.8413917343060048
16962,1439.841867,1439.846167,1,43195256,43195385,129,0.23352570642786538
16963,1440.196367,1440.279333,1,43205891,43208379,2488,0.7636882660510157
16964,1440.3012,1440.307667,1,43209036,43209230,194,0.22732526847714285
16965,1440.665033,1440.7671,1,43219950,43223013,3063,0.8449446129639804
16966,1440.777733,1440.7832,1,43223331,43223496,165,-0.09336586720412403
16967,1441.215,1441.2214,1,43236450,43236642,192,0.3500398947031878
16968,1441.283233,1441.297467,1,43238496,43238924,428,0.881062375493662
16969,1441.306867,1441.313967,1,43239206,43239419,213,0.7537085223803041
16970,1441.344333,1441.370733,1,43240329,43241121,792,0.8375905497013659
16971,1441.404133,1441.415333,1,43242123,43242459,336,0.6557568303546634
16972,1441.433933,1441.479633,1,43243017,43244388,1371,0.6558396337415581
16973,1441.4863,1441.490267,1,43244589,43244708,119,0.5459132078833354
16974,1441.502067,1441.5204,1,43245062,43245612,550,0.5689554826426605
16975,1441.5747,1441.584867,1,43247241,43247546,305,-0.10461290670263572
16976,1441.592267,1441.608267,1,43247768,43248248,480,0.2572593237471252
16977,1441.632433,1441.771,1,43248972,43253130,4158,0.8168583355619367
16978,1441.796433,1441.8917,1,43253892,43256751,2859,0.7450881883188886
16979,1441.8931,1441.913367,1,43256793,43257401,608,0.6971106017713954
16980,1441.9158,1441.993133,1,43257474,43259793,2319,0.7777008844126135
16981,1442.0163,1442.0217,1,43260489,43260651,162,0.24001360419417478
16982,1442.397833,1442.588467,1,43271934,43277654,5720,0.8333478354555431
16983,1442.6096,1442.636,1,43278288,43279080,792,0.8410229691451558
16984,1442.637933,1442.7725,1,43279137,43283175,4038,0.7591403508235778
16985,1443.164467,1443.173433,1,43294934,43295202,268,0.6713988768874094
16986,1443.192067,1443.239433,1,43295762,43297182,1420,0.7120117476007675
16987,1443.245867,1443.256433,1,43297376,43297692,316,0.8569268424562633
16988,1443.2643,1443.2972,1,43297929,43298916,987,0.526052976216971
16989,1443.298967,1443.3549,1,43298969,43300647,1678,0.6331532131887017
16990,1443.368733,1443.386033,1,43301061,43301580,519,0.6343246638229947
16991,1443.389067,1443.413833,1,43301672,43302414,742,0.5929264533516128
16992,1443.435567,1443.4731,1,43303067,43304193,1126,0.5691343457056792
16993,1443.486067,1443.5075,1,43304582,43305225,643,0.5468566529066583
16994,1443.553967,1443.5598,1,43306619,43306794,175,0.6753241517353995
16995,1443.561133,1443.569967,1,43306833,43307099,266,0.6519126052765926
16996,1443.5928,1443.599133,1,43307784,43307973,189,0.5792598940233327
16997,1443.6052,1443.6268,1,43308156,43308804,648,0.7811357313930446
16998,1443.733667,1443.738067,1,43312010,43312142,132,0.5851313683686782
16999,1443.7397,1443.755,1,43312191,43312650,459,0.8611591681362354
17000,1443.756267,1443.853267,1,43312688,43315598,2910,0.8238517902198248
17001,1443.886,1443.889333,1,43316580,43316679,99,
17002,1443.901467,1443.9117,1,43317044,43317351,307,0.05496184977851175
17003,1443.921267,1443.925,1,43317638,43317750,112,0.22909351311209597
17004,1443.9295,1443.935533,1,43317885,43318065,180,
17005,1444.046533,1444.216467,1,43321395,43326494,5099,0.8044420218177792
17006,1444.450833,1444.468033,1,43333524,43334040,516,0.7544614810826293
17007,1444.687733,1444.6938,1,43340631,43340814,183,0.3871227122307073
17008,1444.706433,1444.750833,1,43341192,43342524,1332,0.6737345765819202
17009,1444.7582,1444.769633,1,43342746,43343088,342,0.7483990054802558
17010,1444.814567,1444.928967,1,43344437,43347869,3432,0.7447705149265793
17011,1444.938667,1445.018733,1,43348160,43350561,2401,0.8054924404580596
17012,1445.0198,1445.1284,1,43350594,43353852,3258,0.7514639381184381
17013,1445.153067,1445.2194,1,43354592,43356582,1990,0.8091185924348416
17014,1445.566033,1445.648333,1,43366980,43369449,2469,0.688737054435724
17015,1445.6569,1445.787933,1,43369707,43373637,3930,0.821865932759069
17016,1446.069167,1446.226433,1,43382075,43386792,4717,0.8586849724342034
17017,1446.237767,1446.4115,1,43387133,43392345,5212,0.7365666840990399
17018,1446.4192,1446.4223,1,43392576,43392669,93,0.2779003366170166
17019,1446.686567,1446.692167,1,43400597,43400765,168,-0.11937791486425764
17020,1446.713233,1446.867367,1,43401396,43406021,4625,0.7497619124389331
17021,1446.937767,1446.942633,1,43408133,43408278,145,0.19604281613868058
17022,1446.943667,1446.960667,1,43408310,43408820,510,0.7232822401211112
17023,1446.962133,1446.965667,1,43408863,43408970,107,-0.5504188585787444
17024,1446.979567,1446.9972,1,43409387,43409916,529,0.6482189163270775
17025,1446.999333,1447.0622,1,43409979,43411866,1887,0.8333696134633461
17026,1447.324467,1447.447333,1,43419734,43423419,3685,0.8531617837498986
17027,1447.468233,1447.612233,1,43424046,43428366,4320,0.8006297967319305
17028,1447.647067,1447.653233,1,43429412,43429596,184,0.04147683991005838
17029,1447.665433,1447.669333,1,43429962,43430079,117,0.5927765264533813
17030,1447.9655,1447.9775,1,43438965,43439325,360,-0.086690832688789
17031,1448.0051,1448.008667,1,43440153,43440260,107,0.8103050724347296
17032,1448.0225,1448.037333,1,43440675,43441119,444,0.576922137992937
17033,1448.043233,1448.050467,1,43441296,43441514,218,0.5950190737369943
17034,1448.068567,1448.0717,1,43442057,43442151,94,0.5645785778253924
17035,1448.0826,1448.103133,1,43442478,43443093,615,0.7424351937809464
17036,1448.137833,1448.141733,1,43444134,43444251,117,0.56125119795846
17037,1448.143867,1448.1688,1,43444316,43445064,748,0.6179633326289841
17038,1448.2069,1448.2298,1,43446207,43446894,687,0.5087673783573281
17039,1448.263467,1448.270467,1,43447904,43448114,210,0.44067577027485855
17040,1448.2762,1448.293867,1,43448286,43448816,530,0.4953922010768346
17041,1448.310133,1448.329033,1,43449303,43449870,567,0.48539328681064176
17042,1448.330033,1448.361833,1,43449900,43450854,954,0.5630325780723119
17043,1448.38,1448.385467,1,43451400,43451564,164,0.5245963988034597
17044,1448.3872,1448.397067,1,43451616,43451912,296,0.6541489910001024
17045,1448.4178,1448.429867,1,43452534,43452896,362,0.6318090188121679
17046,1448.4367,1448.450233,1,43453101,43453506,405,0.6108728734190838
17047,1448.472133,1448.484933,1,43454163,43454547,384,0.009454475707820776
17048,1448.488,1448.511333,1,43454640,43455339,699,0.07241840313479098
17049,1448.512333,1448.527833,1,43455369,43455834,465,0.13713343341414289
17050,1448.549167,1448.566933,1,43456475,43457007,532,0.5967532172156513
17051,1448.569333,1448.653367,1,43457079,43459601,2522,0.7805035069697749
17052,1448.668767,1448.674567,1,43460063,43460237,174,-0.029250001812535203
17053,1448.686733,1448.691567,1,43460601,43460747,146,-0.0554959938022439
17054,1448.692933,1448.709333,1,43460787,43461279,492,-0.004199564829064102
17055,1448.711133,1448.714733,1,43461333,43461441,108,
17056,1448.715867,1448.723133,1,43461476,43461693,217,0.49596768923501183
17057,1448.729667,1448.736067,1,43461890,43462082,192,0.04097921791372906
17058,1448.8083,1448.822067,1,43464249,43464662,413,0.5530288410897035
17059,1448.8231,1448.865833,1,43464693,43465974,1281,0.2871965271033801
17060,1448.8697,1448.967233,1,43466091,43469016,2925,0.8231386021732962
17061,1448.968733,1449.0443,1,43469061,43471329,2268,0.8014354524255406
17062,1449.057467,1449.168967,1,43471724,43475069,3345,0.7514528263105684
17063,1449.212667,1449.2915,1,43476380,43478745,2365,0.7680632955719123
17064,1449.586433,1449.593167,1,43487592,43487795,203,0.7482290322549646
17065,1449.598367,1449.6087,1,43487951,43488261,310,0.7646640105166831
17066,1449.6225,1449.654533,1,43488675,43489635,960,0.8442315969075822
17067,1449.6588,1449.771067,1,43489764,43493132,3368,0.8226908776391026
17068,1449.772467,1449.7916,1,43493174,43493748,574,0.5521151600015083
17069,1449.794067,1449.8684,1,43493822,43496052,2230,0.7667260482423053
17070,1449.871733,1449.942967,1,43496151,43498289,2138,0.8431765708013635
17071,1449.945067,1449.961533,1,43498352,43498845,493,0.7623315834834697
17072,1449.9677,1450.0528,1,43499031,43501584,2553,0.8159337574416669
17073,1450.084967,1450.0945,1,43502549,43502835,286,-0.1374620974021433
17074,1450.435367,1450.475567,1,43513061,43514267,1206,0.7778851023880899
17075,1450.4767,1450.4923,1,43514301,43514769,468,0.4369700784227943
17076,1450.519233,1450.554967,1,43515576,43516649,1073,0.8331206486404504
17077,1450.5604,1450.622433,1,43516812,43518672,1860,0.7843009158701585
17078,1450.645533,1450.6765,1,43519365,43520295,930,0.5898507659389666
17079,1450.691567,1450.6984,1,43520747,43520952,205,-0.1266344604025493
17080,1450.705467,1450.709833,1,43521164,43521294,130,
17081,1450.724533,1450.7606,1,43521735,43522818,1083,0.6770524104337327
17082,1450.761767,1450.771,1,43522853,43523130,277,0.5476711990672113
17083,1450.773233,1450.7854,1,43523196,43523562,366,0.5662312846962756
17084,1450.7907,1450.855167,1,43523721,43525655,1934,0.7922884742735227
17085,1450.8735,1450.876933,1,43526205,43526307,102,
17086,1450.9838,1451.000833,1,43529514,43530024,510,0.4046333366906345
17087,1451.025033,1451.034,1,43530750,43531020,270,-0.06239546814250115
17088,1451.035667,1451.0443,1,43531070,43531329,259,0.17838014553126771
17089,1451.057167,1451.061667,1,43531715,43531850,135,
17090,1451.0668,1451.1859,1,43532004,43535577,3573,0.8493766333348081
17091,1451.210267,1451.3947,1,43536308,43541841,5533,0.7567408056262505
17092,1451.444667,1451.4492,1,43543340,43543476,136,0.42625336987771567
17093,1451.451467,1451.459533,1,43543544,43543785,241,0.3073144310664927
17094,1451.870867,1451.875733,1,43556126,43556271,145,0.4214637845572748
17095,1451.894333,1451.897867,1,43556829,43556936,107,0.8419594722346372
17096,1451.911867,1451.962033,1,43557356,43558860,1504,0.7376953162544231
17097,1451.964467,1451.967533,1,43558934,43559025,91,0.6297952940270377
17098,1451.9692,1452.016633,1,43559076,43560498,1422,0.6949162141258288
17099,1452.0288,1452.072,1,43560864,43562160,1296,0.6755446665496354
17100,1452.091133,1452.124267,1,43562733,43563728,995,0.7106828475248643
17101,1452.133667,1452.185233,1,43564010,43565556,1546,0.656030958546155
17102,1452.2065,1452.2456,1,43566195,43567368,1173,0.7384051560693748
17103,1452.2595,1452.291667,1,43567785,43568750,965,0.8164794094199301
17104,1452.302367,1452.3281,1,43569071,43569843,772,0.04457957046579593
17105,1452.329267,1452.335433,1,43569878,43570062,184,0.09719743503211753
17106,1452.338933,1452.360167,1,43570167,43570805,638,0.15134261794078624
17107,1452.3921,1452.4642,1,43571763,43573926,2163,0.6456573962214068
17108,1452.4743,1452.478167,1,43574229,43574345,116,0.3821612761325174
17109,1452.491167,1452.56,1,43574735,43576800,2065,0.7904328897253435
17110,1452.9167,1452.921633,1,43587501,43587648,147,0.5542817790897067
17111,1452.9344,1453.0271,1,43588032,43590813,2781,0.7979725328668699
17112,1453.039367,1453.068733,1,43591181,43592061,880,0.766229857913716
17113,1453.0768,1453.130833,1,43592304,43593924,1620,0.8377159661562076
17114,1453.1442,1453.151833,1,43594326,43594554,228,0.8612476629112993
17115,1453.1531,1453.187067,1,43594593,43595612,1019,0.6993088236479142
17116,1453.1952,1453.201567,1,43595856,43596047,191,
17117,1453.206333,1453.2116,1,43596189,43596348,159,0.0131092125746841
17118,1453.215733,1453.2223,1,43596471,43596669,198,0.0891668081516268
17119,1453.248167,1453.298833,1,43597445,43598964,1519,0.6871890531657706
17120,1453.309633,1453.381633,1,43599288,43601448,2160,0.8250258733089809
17121,1453.382833,1453.3894,1,43601484,43601682,198,-0.16205245496762807
17122,1453.498867,1453.554233,1,43604966,43606626,1660,0.5532502924743017
17123,1453.566167,1453.6042,1,43606985,43608126,1141,0.6357754675487147
17124,1453.6293,1453.636433,1,43608879,43609092,213,-0.04012507285285528
17125,1453.651867,1453.655967,1,43609556,43609679,123,0.28130235531755954
17126,1453.742367,1453.7677,1,43612271,43613031,760,0.7970542539768761
17127,1453.769333,1453.923467,1,43613079,43617704,4625,0.8440185568646257
17128,1453.925133,1453.930133,1,43617753,43617903,150,0.017618303213203616
17129,1453.933633,1453.981333,1,43618008,43619439,1431,0.808700690005662
17130,1454.006633,1454.033033,1,43620198,43620990,792,0.7978386176693086
17131,1454.3013,1454.443467,1,43629039,43633304,4265,0.7845057797663646
17132,1454.451533,1454.482533,1,43633545,43634475,930,0.726724065396461
17133,1454.484,1454.516433,1,43634520,43635492,972,0.5522798789930761
17134,1454.521767,1454.527533,1,43635653,43635825,172,0.76835308018207
17135,1454.546267,1454.627467,1,43636388,43638824,2436,0.7442984133840561
17136,1454.628467,1454.805133,1,43638854,43644153,5299,0.746110337043655
17137,1454.850567,1454.857,1,43645517,43645710,193,0.47072546589083925
17138,1455.303,1455.311367,1,43659090,43659341,251,0.5286065882069134
17139,1455.313,1455.317333,1,43659390,43659519,129,0.5754244837990158
17140,1455.328467,1455.362933,1,43659854,43660887,1033,0.8202609448417386
17141,1455.384633,1455.4059,1,43661538,43662177,639,0.7525755056954252
17142,1455.4171,1455.4331,1,43662513,43662993,480,0.6229410791423082
17143,1455.450633,1455.4549,1,43663518,43663647,129,0.5406777552864984
17144,1455.456033,1455.467433,1,43663680,43664022,342,0.5835291222475444
17145,1455.483067,1455.496167,1,43664492,43664885,393,0.6287955175121485
17146,1455.514867,1455.520767,1,43665446,43665623,177,0.823638057571562
17147,1455.521933,1455.5351,1,43665657,43666053,396,0.8008069718161462
17148,1455.556967,1455.5694,1,43666709,43667082,373,0.6723154179797263
17149,1455.576167,1455.5874,1,43667285,43667622,337,0.6680189417069826
17150,1455.632633,1455.644133,1,43668978,43669323,345,0.2785728309926567
17151,1455.6642,1455.779167,1,43669926,43673375,3449,0.6370888999300902
17152,1455.783267,1455.896433,1,43673498,43676892,3394,0.7178571478202583
17153,1455.9034,1455.9231,1,43677102,43677693,591,0.865182852578368
17154,1455.942533,1455.952367,1,43678275,43678571,296,-0.002597209140294161
17155,1455.953367,1455.9637,1,43678601,43678911,310,0.09897673019601556
17156,1455.9664,1456.019233,1,43678992,43680576,1584,0.33733990744977327
17157,1456.023,1456.029233,1,43680690,43680876,186,0.27759788933876384
17158,1456.037867,1456.047733,1,43681136,43681431,295,0.6194744739213467
17159,1456.049333,1456.124133,1,43681479,43683723,2244,0.17617116092883311
17160,1456.125233,1456.1337,1,43683756,43684011,255,0.039529427029890506
17161,1456.155633,1456.270033,1,43684668,43688100,3432,0.7750558397972185
17162,1456.700733,1456.8361,1,43701021,43705083,4062,0.8523591330985799
17163,1456.857233,1456.869133,1,43705716,43706073,357,0.6952594175607029
17164,1456.8704,1456.905633,1,43706112,43707168,1056,0.6205587289100976
17165,1456.911667,1456.9942,1,43707350,43709826,2476,0.7953852851076597
17166,1457.015467,1457.019967,1,43710464,43710599,135,
17167,1457.5495,1457.5535,1,43726485,43726605,120,
17168,1457.568967,1457.6583,1,43727069,43729749,2680,0.7520281003530244
17169,1457.671567,1457.7032,1,43730147,43731096,949,0.7589039123727275
17170,1457.7053,1457.779033,1,43731159,43733370,2211,0.7869514431620975
17171,1457.788767,1457.811533,1,43733663,43734345,682,0.75554485256631
17172,1457.8197,1457.8338,1,43734591,43735014,423,0.786474674833047
17173,1457.848667,1457.856033,1,43735460,43735680,220,0.26735825479420466
17174,1457.8632,1457.883733,1,43735896,43736511,615,-0.05630754463627775
17175,1457.886,1457.897533,1,43736580,43736925,345,0.21245421904045866
17176,1457.900867,1457.9079,1,43737026,43737237,211,0.5861412637280291
17177,1457.940867,1458.106867,1,43738226,43743206,4980,0.7846135529411036
17178,1458.1165,1458.175,1,43743495,43745250,1755,0.8500871303309452
17179,1458.176067,1458.2048,1,43745282,43746144,862,0.814056722283231
17180,1458.228467,1458.234867,1,43746854,43747046,192,0.5437547781190615
17181,1458.245067,1458.2519,1,43747352,43747557,205,-0.09768445763139363
17182,1458.264033,1458.2685,1,43747920,43748055,135,-0.05465058037284521
17183,1458.2744,1458.2807,1,43748232,43748421,189,0.37527061670162226
17184,1458.285467,1458.289933,1,43748564,43748697,133,0.19653015748679262
17185,1458.5662,1458.675567,1,43756986,43760267,3281,0.7635075926052046
17186,1458.677233,1458.7213,1,43760316,43761639,1323,0.7316350171470484
17187,1458.722733,1458.7508,1,43761681,43762524,843,0.7511579306515505
17188,1458.7528,1458.783067,1,43762584,43763492,908,0.7053112847716141
17189,1458.784333,1458.792233,1,43763529,43763766,237,0.5052975340661042
17190,1458.8108,1458.9804,1,43764324,43769412,5088,0.7882490017842666
17191,1458.982867,1459.0134,1,43769486,43770402,916,0.6300087042386158
17192,1459.023867,1459.1105,1,43770716,43773315,2599,0.7536872781401025
17193,1459.1126,1459.1187,1,43773378,43773561,183,0.7896603838092021
17194,1459.1326,1459.145133,1,43773978,43774353,375,0.04184965944407885
17195,1459.184367,1459.2806,1,43775531,43778418,2887,0.749733318118567
17196,1459.292233,1459.298267,1,43778766,43778948,182,0.034700522163410255
17197,1459.3015,1459.305233,1,43779045,43779156,111,
17198,1459.308033,1459.311733,1,43779240,43779351,111,
17199,1459.717233,1459.724433,1,43791516,43791732,216,0.7389636708835414
17200,1459.7292,1459.743733,1,43791876,43792311,435,0.20340173893437816
17201,1459.774433,1459.793267,1,43793232,43793798,566,0.5310077151951544
17202,1460.4168,1460.425233,1,43812504,43812756,252,0.5475048948064115
17203,1460.437233,1460.443867,1,43813116,43813316,200,0.6970732720763205
17204,1460.458333,1460.487067,1,43813749,43814612,863,0.6180483948032265
17205,1460.489033,1460.499333,1,43814670,43814979,309,0.5492994089431763
17206,1460.522133,1460.547033,1,43815663,43816410,747,0.5998024554208943
17207,1460.567133,1460.5842,1,43817013,43817526,513,0.5743610837234879
17208,1460.5881,1460.609733,1,43817643,43818291,648,0.6055763867443772
17209,1460.623967,1460.630233,1,43818719,43818906,187,0.36716267717312334
17210,1460.698967,1460.703867,1,43820969,43821116,147,-0.13281389624555137
17211,1460.834633,1460.882433,1,43825038,43826472,1434,0.798129057310529
17212,1460.8842,1460.963067,1,43826526,43828892,2366,0.8311986085124987
17213,1460.976767,1461.061633,1,43829303,43831848,2545,0.8497700066694676
17214,1461.4851,1461.493167,1,43844553,43844795,242,0.4348805466042872
17215,1461.4942,1461.574533,1,43844826,43847235,2409,0.819233083724392
17216,1461.5809,1461.585533,1,43847427,43847565,138,0.24606910902999551
17217,1461.601967,1461.605467,1,43848059,43848164,105,
17218,1461.608967,1461.619967,1,43848269,43848599,330,0.12381359226271359
17219,1461.625133,1461.633467,1,43848753,43849004,251,0.7255497112710085
17220,1461.634933,1461.6631,1,43849047,43849893,846,0.7118218476519994
17221,1461.6697,1461.676367,1,43850091,43850291,200,0.7729705892613542
17222,1461.679067,1461.6852,1,43850372,43850556,184,0.5175610178443778
17223,1461.688233,1461.703833,1,43850646,43851114,468,0.5922103313308522
17224,1461.7542,1461.7572,1,43852626,43852716,90,-0.09699850451813029
17225,1461.758667,1461.7636,1,43852760,43852908,148,0.2139626048718434
17226,1461.7675,1461.771033,1,43853025,43853130,105,
17227,1461.891867,1461.997033,1,43856756,43859910,3154,0.8308447126510977
17228,1462.0312,1462.1512,1,43860936,43864536,3600,0.8246532893596146
17229,1462.570467,1462.582,1,43877114,43877460,346,0.7736058131338595
17230,1462.583333,1462.598867,1,43877499,43877966,467,0.662865724883983
17231,1462.600933,1462.613533,1,43878027,43878405,378,0.5487148475091447
17232,1462.633633,1462.648,1,43879008,43879440,432,0.7560046334675964
17233,1462.672067,1462.681967,1,43880162,43880459,297,0.8058584462754949
17234,1462.7018,1462.716467,1,43881054,43881494,440,0.7996320967129459
17235,1462.8535,1462.859133,1,43885605,43885773,168,0.7099005788971859
17236,1462.8628,1462.9248,1,43885884,43887744,1860,0.7766550406589199
17237,1462.9259,1462.981867,1,43887777,43889456,1679,0.7597325892523924
17238,1463.005833,1463.117033,1,43890174,43893510,3336,0.7689030556223977
17239,1463.382267,1463.4053,1,43901468,43902159,691,0.7534984206803453
17240,1463.4073,1463.566833,1,43902219,43907004,4785,0.8388828034857886
17241,1463.569467,1463.5894,1,43907084,43907682,598,0.8027058202503902
17242,1463.6016,1463.609,1,43908048,43908270,222,0.6208287053420396
17243,1463.618267,1463.6274,1,43908548,43908822,274,0.22191533595775562
17244,1463.645133,1463.653533,1,43909353,43909605,252,0.5097061745166821
17245,1463.657833,1463.663067,1,43909734,43909892,158,0.014878476384244246
17246,1463.6921,1463.7143,1,43910763,43911429,666,0.6210112400068775
17247,1463.7308,1463.8087,1,43911924,43914261,2337,0.7978340846983276
17248,1463.822267,1463.8266,1,43914668,43914798,130,0.16120534815357357
17249,1463.829533,1463.9169,1,43914885,43917507,2622,0.8026610762924894
17250,1464.230167,1464.234867,1,43926905,43927046,141,-0.39380611679723654
17251,1464.240833,1464.364733,1,43927224,43930941,3717,0.7835901430258282
17252,1464.421167,1464.546767,1,43932635,43936403,3768,0.7938649188746557
17253,1464.5571,1464.563133,1,43936713,43936893,180,-0.08166566700632501
17254,1464.908733,1465.009933,1,43947261,43950297,3036,0.6673191012080419
17255,1465.024667,1465.0598,1,43950740,43951794,1054,0.7252861267471193
17256,1465.074467,1465.085567,1,43952234,43952567,333,0.36769148037626376
17257,1465.114233,1465.132467,1,43953426,43953974,548,-0.10455865908561027
17258,1465.137167,1465.160667,1,43954115,43954820,705,0.10746863422189004
17259,1465.1831,1465.275567,1,43955493,43958267,2774,0.7553289034221972
17260,1465.2769,1465.303467,1,43958307,43959104,797,0.890995640117652
17261,1465.3224,1465.354067,1,43959672,43960622,950,-0.06542287671942874
17262,1465.3552,1465.3637,1,43960656,43960911,255,0.26694559165802045
17263,1465.3757,1465.379,1,43961271,43961370,99,
17264,1465.417,1465.420633,1,43962510,43962618,108,0.16264720922386383
17265,1465.431,1465.484667,1,43962930,43964540,1610,0.0894160768011979
17266,1465.4965,1465.655633,1,43964895,43969668,4773,0.7784008594029443
17267,1465.673533,1465.8325,1,43970205,43974975,4770,0.7798469703082451
17268,1465.870933,1465.8819,1,43976127,43976457,330,0.19250451363518659
17269,1465.8838,1465.888033,1,43976514,43976640,126,-0.17724705750014974
17270,1466.1134,1466.1415,1,43983402,43984245,843,0.6771280927576405
17271,1466.142833,1466.2467,1,43984284,43987401,3117,0.835158644865704
17272,1466.251333,1466.287667,1,43987539,43988630,1091,0.844568106489278
17273,1466.2897,1466.293367,1,43988691,43988801,110,0.8456319895528882
17274,1466.294933,1466.321667,1,43988847,43989650,803,0.7614971669145131
17275,1466.3237,1466.453233,1,43989711,43993596,3885,0.7977020851218263
17276,1466.456333,1466.4626,1,43993689,43993878,189,0.5429676590563238
17277,1466.473933,1466.4935,1,43994217,43994805,588,0.7511938866829875
17278,1466.495267,1466.502533,1,43994858,43995075,217,0.888875851151139
17279,1466.506133,1466.571833,1,43995183,43997154,1971,0.7522448567541432
17280,1466.5729,1466.589467,1,43997187,43997684,497,0.5717946493113683
17281,1466.6045,1466.613967,1,43998135,43998419,284,-0.10487630479387527
17282,1466.622267,1466.6294,1,43998668,43998882,214,-0.12206996386094411
17283,1466.635867,1466.642933,1,43999076,43999287,211,0.17394785192888731
17284,1466.675033,1466.689,1,44000250,44000670,420,0.6834881259256957
17285,1466.691933,1466.7849,1,44000757,44003547,2790,0.8234840418966333
17286,1466.828967,1466.980933,1,44004869,44009427,4558,0.8443617714362205
17287,1467.008467,1467.022833,1,44010254,44010684,430,-0.07457118860260928
17288,1467.237133,1467.2833,1,44017113,44018499,1386,0.3663686948344269
17289,1467.2959,1467.395467,1,44018877,44021864,2987,0.8042483451972869
17290,1467.396867,1467.408167,1,44021906,44022245,339,0.36316461195741956
17291,1468.167133,1468.180933,1,44045013,44045427,414,0.708462330600326
17292,1468.188367,1468.1936,1,44045651,44045808,157,0.5776169100565094
17293,1468.2427,1468.2658,1,44047281,44047974,693,0.8946099212623472
17294,1468.2765,1468.2806,1,44048295,44048418,123,0.29866744095372727
17295,1468.336833,1468.3468,1,44050104,44050404,300,0.6630914268545378
17296,1468.3504,1468.354133,1,44050512,44050623,111,0.4436517433098806
17297,1468.380167,1468.3861,1,44051405,44051583,178,0.3543453668512323
17298,1468.387433,1468.426233,1,44051622,44052786,1164,0.7458516923068109
17299,1468.4561,1468.4733,1,44053683,44054199,516,0.766755951178565
17300,1468.494133,1468.526233,1,44054823,44055786,963,0.7585401117921966
17301,1468.5656,1468.578567,1,44056968,44057357,389,-0.009340286390385654
17302,1468.579733,1468.591133,1,44057391,44057733,342,0.21865341045073441
17303,1468.5929,1468.601333,1,44057787,44058039,252,
17304,1468.635233,1468.648967,1,44059056,44059469,413,0.7816456905119563
17305,1468.652233,1468.7474,1,44059566,44062422,2856,0.7555707498656588
17306,1468.778033,1468.786033,1,44063340,44063580,240,0.3832827922863024
17307,1468.796067,1468.8225,1,44063882,44064675,793,0.01594001366319932
17308,1468.8312,1468.836333,1,44064936,44065089,153,0.5476835166552182
17309,1468.844467,1468.847567,1,44065334,44065427,93,
17310,1468.899633,1468.906433,1,44066988,44067192,204,0.6046857816500926
17311,1468.9078,1469.072233,1,44067234,44072166,4932,0.8485045782745212
17312,1469.076633,1469.172133,1,44072298,44075163,2865,0.5221099881371611
17313,1469.1903,1469.3025,1,44075709,44079075,3366,0.7945215522039475
17314,1469.749767,1469.770667,1,44092493,44093120,627,0.7158196056152497
17315,1469.7882,1469.7929,1,44093646,44093787,141,0.5343268795661892
17316,1469.7957,1469.818233,1,44093871,44094546,675,0.5353577665403161
17317,1469.827333,1469.853267,1,44094819,44095598,779,0.5351096813752776
17318,1469.8544,1469.9058,1,44095632,44097174,1542,0.8144225516049959
17319,1469.928633,1469.936667,1,44097858,44098100,242,0.6061749390101653
17320,1469.938,1470.097967,1,44098140,44102939,4799,0.7477665926373326
17321,1470.1011,1470.1156,1,44103033,44103468,435,0.7852326030934895
17322,1470.1166,1470.1501,1,44103498,44104503,1005,0.6971248894942078
17323,1470.163933,1470.175267,1,44104917,44105258,341,0.08941557372929486
17324,1470.1848,1470.1881,1,44105544,44105643,99,
17325,1470.195133,1470.2153,1,44105853,44106459,606,0.6272226837540166
17326,1470.231233,1470.305967,1,44106936,44109179,2243,0.7987227845778876
17327,1470.314133,1470.319033,1,44109423,44109570,147,0.18290048927601538
17328,1470.393533,1470.3984,1,44111805,44111952,147,0.12717166843637473
17329,1470.400633,1470.4584,1,44112018,44113752,1734,0.8064519371594047
17330,1470.467133,1470.509967,1,44114013,44115299,1286,0.7291711313957887
17331,1470.527367,1470.556,1,44115821,44116680,859,0.004654396837319034
17332,1470.5606,1470.566333,1,44116818,44116989,171,-0.03537641190415595
17333,1470.579033,1470.6985,1,44117370,44120955,3585,0.8246567719788894
17334,1470.7155,1470.7806,1,44121465,44123418,1953,0.8160873301318212
17335,1470.7962,1470.804133,1,44123886,44124123,237,0.638469201559052
17336,1470.805433,1470.837567,1,44124162,44125127,965,0.6752754017578608
17337,1470.845767,1470.8784,1,44125373,44126352,979,-0.04926202415763105
17338,1470.882633,1470.903733,1,44126478,44127111,633,-0.05219170309939139
17339,1470.916467,1470.9204,1,44127494,44127612,118,0.23355437621851055
17340,1470.924767,1471.006633,1,44127743,44130198,2455,0.8304387080089631
17341,1471.0094,1471.209067,1,44130282,44136272,5990,0.7778439622407191
17342,1471.9882,1472.0147,1,44159646,44160441,795,0.5903283539011384
17343,1472.048467,1472.060333,1,44161454,44161809,355,0.5420470014464894
17344,1472.084767,1472.091067,1,44162543,44162732,189,0.660527223995749
17345,1472.1165,1472.121533,1,44163495,44163645,150,0.3900846748559673
17346,1472.125067,1472.1413,1,44163752,44164239,487,0.5448895380888696
17347,1472.195167,1472.203667,1,44165855,44166110,255,0.22106363830932946
17348,1472.204833,1472.214667,1,44166144,44166440,296,0.5815066861137856
17349,1472.242433,1472.2471,1,44167272,44167413,141,0.40357347106876956
17350,1472.254,1472.266133,1,44167620,44167983,363,0.6266098107864546
17351,1472.370867,1472.374333,1,44171126,44171229,103,
17352,1472.381367,1472.436867,1,44171441,44173106,1665,0.7524791839084333
17353,1472.4435,1472.489933,1,44173305,44174697,1392,0.49404611266759907
17354,1472.533833,1472.5378,1,44176014,44176134,120,0.7505968320642834
17355,1472.5413,1472.658567,1,44176239,44179757,3518,0.8652624484610433
17356,1472.876567,1472.881433,1,44186297,44186442,145,0.11254306339850563
17357,1472.8845,1472.902267,1,44186535,44187068,533,0.5635874738646578
17358,1473.142733,1473.211933,1,44194281,44196357,2076,0.7727174524196306
17359,1473.214533,1473.268933,1,44196435,44198067,1632,0.8538217380098505
17360,1473.290833,1473.372533,1,44198724,44201175,2451,0.7603597535463252
17361,1473.374267,1473.3952,1,44201228,44201856,628,0.6325046835270088
17362,1473.397133,1473.421667,1,44201913,44202650,737,0.8263998549065144
17363,1473.424,1473.439133,1,44202720,44203173,453,0.6592086130363015
17364,1473.442067,1473.528067,1,44203262,44205842,2580,0.7756754029008899
17365,1473.580867,1473.5839,1,44207426,44207517,91,
17366,1473.6582,1473.738367,1,44209746,44212151,2405,0.7606406451895887
17367,1473.7487,1473.7559,1,44212461,44212677,216,-0.1019557530886109
17368,1473.7569,1473.760333,1,44212707,44212809,102,-0.2443242521728527
17369,1473.796633,1473.8018,1,44213898,44214054,156,0.5318085271683369
17370,1474.006067,1474.0277,1,44220182,44220831,649,0.7388417003324638
17371,1474.0541,1474.060467,1,44221623,44221814,191,0.8025622555683003
17372,1474.084367,1474.106133,1,44222531,44223183,652,0.877767818278835
17373,1474.108267,1474.135633,1,44223248,44224068,820,0.6145957107024058
17374,1474.141133,1474.163967,1,44224233,44224919,686,0.8084472019198294
17375,1474.1684,1474.1747,1,44225052,44225241,189,0.5011778100842234
17376,1474.176033,1474.277867,1,44225280,44228336,3056,0.7202055227965877
17377,1474.279167,1474.293333,1,44228375,44228799,424,0.7775202926985589
17378,1474.304467,1474.310167,1,44229134,44229305,171,0.6138944662217498
17379,1474.317667,1474.340133,1,44229530,44230203,673,0.6877105482156918
17380,1474.354133,1474.3578,1,44230623,44230734,111,0.12973796496737436
17381,1474.362,1474.414933,1,44230860,44232447,1587,-0.018649014292626866
17382,1474.418933,1474.422167,1,44232567,44232665,98,-0.18148836567853302
17383,1474.430133,1474.591633,1,44232903,44237748,4845,0.8099587627711445
17384,1474.5928,1474.650133,1,44237784,44239503,1719,0.8307855858897707
17385,1474.6715,1474.6749,1,44240145,44240247,102,0.46267878232402476
17386,1474.676,1474.707433,1,44240280,44241222,942,0.6855342009606812
17387,1474.717767,1474.7401,1,44241533,44242203,670,-0.043881938060097096
17388,1474.744967,1474.757667,1,44242349,44242730,381,0.005850303842665279
17389,1474.759833,1474.764067,1,44242794,44242922,128,-0.07394945766375001
17390,1474.792633,1474.807733,1,44243778,44244231,453,0.04916567716752829
17391,1474.810133,1474.897233,1,44244303,44246916,2613,0.3802463911250246
17392,1474.908333,1474.916867,1,44247249,44247506,257,-0.028015948173043547
17393,1474.918,1474.9259,1,44247540,44247777,237,-0.0749329503049813
17394,1474.941433,1474.947067,1,44248242,44248412,170,0.09892701563293783
17395,1474.9492,1475.0593,1,44248476,44251779,3303,0.8541025545003559
17396,1475.085833,1475.170633,1,44252574,44255118,2544,0.7939708161679266
17397,1475.175733,1475.1809,1,44255271,44255427,156,0.34700385580675214
17398,1475.183533,1475.187033,1,44255505,44255610,105,-0.08123430367954544
17399,1475.188933,1475.1934,1,44255667,44255802,135,0.004241395297052052
17400,1475.196233,1475.200633,1,44255886,44256018,132,-0.06855319332902428
17401,1475.7745,1475.782033,1,44273235,44273460,225,0.6357834793958376
17402,1475.783267,1475.7874,1,44273498,44273622,124,0.6593414184782092
17403,1475.7887,1475.801233,1,44273661,44274036,375,0.7910055418971966
17404,1475.811833,1475.866667,1,44274354,44276000,1646,0.7240333285978574
17405,1475.8827,1475.949267,1,44276481,44278478,1997,0.6779520422061793
17406,1475.953367,1475.9841,1,44278601,44279523,922,0.6191874955509267
17407,1475.9869,1476.0327,1,44279607,44280981,1374,0.6504658584782147
17408,1476.054533,1476.067733,1,44281635,44282031,396,0.6422459255903423
17409,1476.0701,1476.083333,1,44282103,44282499,396,0.6347031594430427
17410,1476.117133,1476.126933,1,44283513,44283807,294,0.10045644627966899
17411,1476.128867,1476.154067,1,44283866,44284622,756,0.08043982675912092
17412,1476.180067,1476.2428,1,44285402,44287284,1882,0.8172007136504117
17413,1476.245833,1476.288167,1,44287374,44288645,1271,0.8181479215944488
17414,1476.3044,1476.333133,1,44289132,44289993,861,-0.027936030179019355
17415,1476.335067,1476.340467,1,44290052,44290214,162,0.09218471596682451
17416,1476.353667,1476.4633,1,44290610,44293899,3289,0.788668040310594
17417,1476.465033,1476.473533,1,44293950,44294205,255,0.388835044337586
17418,1476.475367,1476.553367,1,44294261,44296601,2340,0.7874019772699679
17419,1477.352033,1477.356567,1,44320560,44320697,137,0.6651147528348119
17420,1477.365433,1477.433433,1,44320962,44323002,2040,0.8004688828460513
17421,1477.4415,1477.446833,1,44323245,44323404,159,-0.07566413907060554
17422,1477.448,1477.451967,1,44323440,44323559,119,-0.0683587663069289
17423,1478.3698,1478.382033,1,44351094,44351460,366,0.5892541758268095
17424,1478.397667,1478.402367,1,44351930,44352071,141,0.5277166133452125
17425,1478.435467,1478.451667,1,44353064,44353550,486,0.8290447989846
17426,1478.485567,1478.4932,1,44354567,44354796,229,0.5694333921740569
17427,1478.497333,1478.5378,1,44354919,44356134,1215,0.6561338179370696
17428,1478.564467,1478.5866,1,44356934,44357598,664,0.7162711973128654
17429,1478.604267,1478.6199,1,44358128,44358597,469,0.7605637513222142
17430,1478.623833,1478.636667,1,44358714,44359100,386,0.7746941520801405
17431,1478.8283,1478.8318,1,44364849,44364954,105,0.17923068524780453
17432,1478.836767,1478.850433,1,44365103,44365512,409,0.5110824625485884
17433,1478.852067,1478.947067,1,44365562,44368412,2850,0.8320549912841536
17434,1479.249967,1479.3224,1,44377499,44379672,2173,0.8204336292666676
17435,1479.325,1479.342467,1,44379750,44380274,524,0.8844972402043715
17436,1479.344433,1479.381867,1,44380332,44381456,1124,0.8597374421471896
17437,1479.3887,1479.472667,1,44381661,44384180,2519,0.8163032641780539
17438,1479.475467,1479.478767,1,44384264,44384363,99,0.6399106485986097
17439,1479.487067,1479.5119,1,44384612,44385357,745,0.7336253540727796
17440,1479.866467,1479.871933,1,44395994,44396157,163,0.7181379663365876
17441,1479.873867,1479.882133,1,44396216,44396463,247,0.6672411520894648
17442,1479.904,1479.928967,1,44397120,44397869,749,0.8456920508840109
17443,1479.930033,1479.933567,1,44397900,44398007,107,-0.2504111678138035
17444,1479.941033,1479.997733,1,44398230,44399931,1701,0.7565418120947224
17445,1480.005333,1480.1029,1,44400159,44403087,2928,0.8015316007469576
17446,1480.1226,1480.149567,1,44403678,44404487,809,0.6874008853113471
17447,1480.180833,1480.187233,1,44405424,44405616,192,-0.15317326316758273
17448,1480.192367,1480.203933,1,44405771,44406117,346,0.21810296899526202
17449,1480.443233,1480.448833,1,44413296,44413464,168,0.34133437358300955
17450,1480.458633,1480.5562,1,44413758,44416686,2928,0.7172034933004577
17451,1480.5599,1480.5631,1,44416797,44416893,96,
17452,1480.586867,1480.595167,1,44417606,44417855,249,-0.002483565789690321
17453,1480.620867,1480.624567,1,44418626,44418737,111,
17454,1480.931667,1480.965333,1,44427950,44428959,1009,0.5925514479632379
17455,1480.9667,1480.982133,1,44429001,44429463,462,0.6339157182475366
17456,1480.9838,1481.101467,1,44429514,44433044,3530,0.7997989121962417
17457,1481.103167,1481.133567,1,44433095,44434007,912,0.789675817040944
17458,1481.363667,1481.378267,1,44440910,44441348,438,0.9307889655965627
17459,1481.379367,1481.4806,1,44441381,44444418,3037,0.8324448115942168
17460,1481.5181,1481.5266,1,44445543,44445798,255,0.22009741290568083
17461,1481.779533,1481.907867,1,44453385,44457236,3851,0.7918594180747324
17462,1482.268133,1482.413867,1,44468043,44472416,4373,0.7953045442793313
17463,1482.419267,1482.4507,1,44472578,44473521,943,0.6661615451155771
17464,1482.451733,1482.484033,1,44473551,44474520,969,0.7892894791518275
17465,1482.4855,1482.497967,1,44474565,44474939,374,0.6292201531170353
17466,1482.5342,1482.586033,1,44476026,44477580,1554,0.8300717193455461
17467,1482.5916,1482.6072,1,44477748,44478216,468,0.710554963243079
17468,1482.618167,1482.622233,1,44478545,44478666,121,0.4368579610427978
17469,1482.667333,1482.670767,1,44480019,44480123,104,0.6506393283324232
17470,1482.671967,1482.677233,1,44480159,44480316,157,0.47784889049874607
17471,1483.007633,1483.077067,1,44490228,44492312,2084,0.808458512938752
17472,1483.091233,1483.139633,1,44492736,44494188,1452,0.7754671549853973
17473,1483.149033,1483.253033,1,44494470,44497590,3120,0.797774329938431
17474,1483.2711,1483.3319,1,44498133,44499957,1824,0.8603846850462222
17475,1483.360067,1483.389433,1,44500802,44501682,880,0.830727223666386
17476,1483.393567,1483.397467,1,44501807,44501924,117,-0.024411660852049363
17477,1483.410567,1483.4138,1,44502317,44502414,97,-0.12848670999594267
17478,1483.415767,1483.419433,1,44502473,44502582,109,
17479,1483.430133,1483.438767,1,44502903,44503163,260,0.3398254499473401
17480,1483.444633,1483.4491,1,44503338,44503473,135,0.029916859962044087
17481,1483.650367,1483.655433,1,44509511,44509662,151,0.13869093370139865
17482,1483.6848,1483.6901,1,44510544,44510703,159,0.0565722402644762
17483,1483.754333,1483.7591,1,44512629,44512773,144,0.5314789622858097
17484,1483.7673,1483.781133,1,44513019,44513433,414,0.5030992767637933
17485,1483.782133,1483.897033,1,44513463,44516910,3447,0.8220662753194851
17486,1483.9185,1483.9667,1,44517555,44519001,1446,0.8038375525641882
17487,1483.9705,1484.032967,1,44519115,44520989,1874,0.7634529483044451
17488,1484.048633,1484.0743,1,44521458,44522229,771,0.6949676140939551
17489,1484.0766,1484.102833,1,44522298,44523084,786,0.7505302359299817
17490,1484.109433,1484.129767,1,44523282,44523893,611,0.842215950439124
17491,1484.1345,1484.2288,1,44524035,44526864,2829,0.8035815665232573
17492,1484.249367,1484.2566,1,44527481,44527698,217,0.146957542892485
17493,1484.259733,1484.264033,1,44527791,44527920,129,
17494,1484.690133,1484.704467,1,44540703,44541134,431,0.5503681125127939
17495,1484.7059,1484.717867,1,44541177,44541536,359,0.45973995864515216
17496,1484.761667,1484.7666,1,44542850,44542998,148,0.6014380535010352
17497,1484.787867,1484.795933,1,44543636,44543877,241,0.6321240513135135
17498,1484.997067,1485.020533,1,44549912,44550615,703,0.768751574962443
17499,1485.025,1485.081267,1,44550750,44552438,1688,0.7339824149588398
17500,1485.082367,1485.087933,1,44552471,44552637,166,0.4578555915406512
17501,1485.090567,1485.1169,1,44552717,44553507,790,0.9011972901052494
17502,1485.495767,1485.498967,1,44564873,44564969,96,0.3448512251841451
17503,1485.509,1485.568733,1,44565270,44567061,1791,0.5974144770774855
17504,1485.575,1485.5804,1,44567250,44567412,162,0.2461587215599098
17505,1485.582633,1485.5857,1,44567478,44567571,93,0.584158880786351
17506,1485.588433,1485.600133,1,44567652,44568003,351,0.4509600252830909
17507,1485.633867,1485.682067,1,44569016,44570462,1446,0.5911987579729862
17508,1485.706367,1485.720567,1,44571191,44571617,426,0.586649089395162
17509,1485.725033,1485.745933,1,44571750,44572377,627,0.7058735398211479
17510,1485.761067,1485.7684,1,44572832,44573052,220,0.5858032161052266
17511,1485.792,1485.798667,1,44573760,44573960,200,0.23941452137736025
17512,1485.8059,1485.852267,1,44574177,44575568,1391,0.024829241966465704
17513,1485.853433,1485.856467,1,44575602,44575694,92,0.45281923945913444
17514,1485.8706,1485.873767,1,44576118,44576213,95,-0.07431111546547285
17515,1485.879133,1485.893933,1,44576373,44576817,444,0.7775726045500699
17516,1485.896133,1485.9985,1,44576883,44579955,3072,0.8316098291056165
17517,1486.288867,1486.3663,1,44588666,44590989,2323,0.8097296060588525
17518,1486.3798,1486.484167,1,44591394,44594525,3131,0.7958209221733825
17519,1486.485333,1486.5002,1,44594559,44595006,447,0.7080220175916296
17520,1486.5014,1486.5085,1,44595042,44595255,213,0.45679473289858125
17521,1486.523,1486.597667,1,44595690,44597930,2240,0.8254368731740087
17522,1486.600733,1486.606767,1,44598021,44598203,182,0.7577451978090957
17523,1486.6093,1486.6848,1,44598279,44600544,2265,0.720200474203838
17524,1486.689233,1486.814167,1,44600676,44604425,3749,0.7489739636604342
17525,1486.8435,1486.8474,1,44605305,44605422,117,-0.08879905218363034
17526,1486.849867,1486.853167,1,44605496,44605595,99,0.07266982066391096
17527,1486.857967,1486.8622,1,44605739,44605866,127,
17528,1487.086033,1487.092767,1,44612580,44612783,203,0.6053228490541348
17529,1487.0992,1487.268967,1,44612976,44618069,5093,0.8232461183817129
17530,1487.270233,1487.273433,1,44618106,44618202,96,0.4688223057260841
17531,1487.297233,1487.306467,1,44618916,44619194,278,0.9081224009151881
17532,1487.307967,1487.373733,1,44619239,44621211,1972,0.7913126223109198
17533,1487.651767,1487.661233,1,44629553,44629836,283,0.6917382703461006
17534,1487.679167,1487.684233,1,44630375,44630526,151,0.5945847581487977
17535,1487.6885,1487.6916,1,44630655,44630748,93,0.682030472916911
17536,1487.699533,1487.7056,1,44630985,44631168,183,0.677304679489914
17537,1487.7161,1487.7476,1,44631483,44632428,945,0.6977355655480704
17538,1487.767367,1487.792,1,44633021,44633760,739,0.612157168263805
17539,1487.812,1487.816633,1,44634360,44634498,138,0.1385656135506295
17540,1487.821133,1487.828067,1,44634633,44634842,209,0.40547515535952094
17541,1487.8461,1487.851033,1,44635383,44635530,147,0.24276830429331894
17542,1487.862833,1487.915033,1,44635884,44637450,1566,0.607274640134338
17543,1487.936067,1487.954333,1,44638082,44638629,547,0.6478757992309557
17544,1487.9732,1487.985133,1,44639196,44639553,357,0.607546522779533
17545,1487.993533,1488.0019,1,44639805,44640057,252,0.5220442305228492
17546,1488.048733,1488.058367,1,44641461,44641751,290,-0.03168497278178147
17547,1488.061133,1488.080067,1,44641833,44642402,569,0.06375101470251168
17548,1488.142533,1488.1583,1,44644275,44644749,474,0.5772350032166684
17549,1488.160567,1488.248867,1,44644817,44647466,2649,0.7838505126544163
17550,1488.8086,1488.8141,1,44664258,44664423,165,0.5031094788108478
17551,1488.823133,1488.829533,1,44664693,44664885,192,0.5414948827344293
17552,1488.859833,1488.875867,1,44665794,44666276,482,0.6937859257271131
17553,1488.883567,1488.900467,1,44666507,44667014,507,0.47803766813635346
17554,1488.931,1489.0154,1,44667930,44670462,2532,0.7217707069376149
17555,1489.0457,1489.141367,1,44671371,44674241,2870,0.8077777129928619
17556,1489.241067,1489.246133,1,44677232,44677383,151,
17557,1489.2517,1489.4025,1,44677551,44682075,4524,0.804165665818088
17558,1489.419567,1489.4539,1,44682587,44683617,1030,0.8167207964342311
17559,1489.4764,1489.479733,1,44684292,44684391,99,
17560,1489.487233,1489.491067,1,44684616,44684732,116,0.370337935271184
17561,1489.4931,1489.501433,1,44684793,44685042,249,0.15560328844310065
17562,1489.5057,1489.5087,1,44685171,44685261,90,-0.048299707353799404
17563,1489.5276,1489.679867,1,44685828,44690396,4568,0.8300188679667901
17564,1489.741867,1489.753567,1,44692256,44692607,351,0.07014931896448472
17565,1489.967867,1489.997,1,44699036,44699910,874,0.7818676572740925
17566,1490.016333,1490.0511,1,44700489,44701533,1044,0.7449280633299198
17567,1490.067867,1490.096767,1,44702036,44702903,867,0.7542191408557024
17568,1490.097867,1490.101733,1,44702936,44703051,115,0.620533474913336
17569,1490.1045,1490.152633,1,44703135,44704578,1443,0.7982097214488376
17570,1490.157767,1490.253833,1,44704733,44707614,2881,0.8088462060834025
17571,1490.2558,1490.2595,1,44707674,44707785,111,0.949800667609705
17572,1490.262033,1490.2877,1,44707860,44708631,771,0.3698708090040615
17573,1490.3027,1490.3082,1,44709081,44709246,165,-0.011009986554190106
17574,1490.317733,1490.3297,1,44709531,44709891,360,0.017660026305683463
17575,1490.3366,1490.348433,1,44710098,44710452,354,0.08384082661692646
17576,1490.351967,1490.357867,1,44710559,44710736,177,0.1857397024477569
17577,1490.393667,1490.4099,1,44711810,44712297,487,0.45829144057563553
17578,1490.410967,1490.525867,1,44712329,44715776,3447,0.8397735435299446
17579,1490.5521,1490.6397,1,44716563,44719191,2628,0.8349351824371976
17580,1490.6984,1490.705833,1,44720952,44721174,222,0.269878125747818
17581,1490.714233,1490.717267,1,44721426,44721518,92,-0.1304828109762403
17582,1490.9786,1491.0292,1,44729358,44730876,1518,0.6585473914734625
17583,1491.031533,1491.129,1,44730945,44733870,2925,0.8152023289017548
17584,1491.1312,1491.134567,1,44733936,44734037,101,-0.16074925709078092
17585,1491.1409,1491.166267,1,44734227,44734988,761,0.7250253278478582
17586,1491.1709,1491.237033,1,44735127,44737110,1983,0.770263904028597
17587,1491.2519,1491.256667,1,44737557,44737700,143,0.6381425158546206
17588,1491.261333,1491.2725,1,44737839,44738175,336,-0.10664062715618569
17589,1491.273967,1491.2781,1,44738219,44738343,124,
17590,1491.280933,1491.295,1,44738427,44738850,423,-0.056829706149735267
17591,1491.297667,1491.3144,1,44738930,44739432,502,0.23374670947924428
17592,1491.323067,1491.328967,1,44739692,44739869,177,-0.06162955002839545
17593,1491.333567,1491.4042,1,44740007,44742126,2119,0.8565943816591793
17594,1491.4095,1491.4957,1,44742285,44744871,2586,0.8328429987210815
17595,1491.4967,1491.500033,1,44744901,44745000,99,0.3510992437949531
17596,1491.506967,1491.528767,1,44745209,44745863,654,0.8996467721831445
17597,1491.5703,1491.604633,1,44747109,44748138,1029,0.05587409675426284
17598,1491.619133,1491.622967,1,44748573,44748689,116,0.034342490611973364
17599,1491.6317,1491.684767,1,44748951,44750543,1592,0.8004627699389028
17600,1491.693767,1491.739867,1,44750813,44752196,1383,0.7416734371284395
17601,1491.753233,1491.7594,1,44752596,44752782,186,0.07929962994927185
17602,1491.782233,1491.790567,1,44753466,44753717,251,0.35608106741792706
17603,1491.9407,1491.949867,1,44758221,44758496,275,0.708350129404178
17604,1491.951,1492.130833,1,44758530,44763924,5394,0.7685282305669506
17605,1492.1444,1492.149233,1,44764332,44764476,144,-0.017809682046844258
17606,1492.151733,1492.165767,1,44764551,44764973,422,-0.0331683727782934
17607,1492.167267,1492.1748,1,44765018,44765244,226,0.36951624738177974
17608,1492.175967,1492.188867,1,44765279,44765666,387,0.17915119663464607
17609,1492.1927,1492.197333,1,44765781,44765919,138,0.11981991350620302
17610,1492.2264,1492.4001,1,44766792,44772003,5211,0.8467601744397
17611,1492.4046,1492.421533,1,44772138,44772645,507,0.8781404223044134
17612,1492.433367,1492.4809,1,44773001,44774427,1426,0.8382521621524104
17613,1492.481967,1492.510767,1,44774459,44775323,864,0.8595226256167917
17614,1492.5262,1492.631867,1,44775786,44778956,3170,0.7838246161660127
17615,1492.645433,1492.6489,1,44779362,44779467,105,-0.09497165772917603
17616,1492.6538,1492.659767,1,44779614,44779793,179,-0.13638727899907407
17617,1492.6615,1492.6661,1,44779845,44779983,138,-0.24765010653874778
17618,1492.7307,1492.810567,1,44781921,44784317,2396,0.7557347658324736
17619,1492.8116,1492.824367,1,44784348,44784731,383,0.43293879777749933
17620,1492.841233,1492.882933,1,44785236,44786487,1251,0.754025707849874
17621,1492.893533,1492.897533,1,44786805,44786925,120,
17622,1492.909267,1492.918367,1,44787278,44787551,273,0.8406206982805287
17623,1492.922,1492.955533,1,44787660,44788665,1005,0.7417866391316652
17624,1492.9834,1492.988933,1,44789502,44789667,165,0.6600542749883398
17625,1492.9933,1492.996467,1,44789799,44789894,95,0.47531119404505473
17626,1492.997733,1493.0332,1,44789931,44790996,1065,0.7323345014215444
17627,1493.0353,1493.054733,1,44791059,44791641,582,0.8393115906160367
17628,1493.056933,1493.080667,1,44791707,44792420,713,0.22366736370500048
17629,1493.083733,1493.190333,1,44792511,44795709,3198,0.8006180383797076
17630,1493.191733,1493.2605,1,44795751,44797815,2064,0.8086456127670214
17631,1493.264767,1493.282967,1,44797943,44798489,546,0.7230527156486098
17632,1493.289333,1493.2983,1,44798679,44798949,270,0.5442883116680949
17633,1493.314367,1493.340933,1,44799431,44800227,796,-0.03573883085010726
17634,1493.342933,1493.355533,1,44800287,44800665,378,0.5693289714282712
17635,1493.3601,1493.363533,1,44800803,44800905,102,-0.14533316892271123
17636,1493.386167,1493.395067,1,44801585,44801852,267,0.46504677277513357
17637,1493.400833,1493.6181,1,44802024,44808543,6519,0.8244317235025456
17638,1493.6191,1493.651267,1,44808573,44809538,965,0.6696142117924045
17639,1494.141667,1494.1591,1,44824250,44824773,523,0.6222146835909926
17640,1494.169533,1494.181767,1,44825085,44825453,368,0.5843100359137252
17641,1494.2009,1494.240767,1,44826027,44827223,1196,0.6524584378556287
17642,1494.241967,1494.2471,1,44827259,44827413,154,0.247318364727988
17643,1494.2489,1494.261067,1,44827467,44827832,365,0.5880395181428867
17644,1494.306467,1494.395,1,44829194,44831850,2656,0.8192302871167014
17645,1494.398633,1494.4037,1,44831958,44832111,153,0.0017783791227800772
17646,1494.5102,1494.5906,1,44835306,44837718,2412,0.8085875597886009
17647,1494.598533,1494.674233,1,44837955,44840226,2271,0.785913159654295
17648,1494.690367,1494.705233,1,44840711,44841156,445,0.5432953979099482
17649,1494.713467,1494.719433,1,44841404,44841582,178,-0.05216308933250195
17650,1494.725833,1494.754167,1,44841774,44842625,851,0.26273176575201285
17651,1494.7579,1494.761833,1,44842737,44842854,117,
17652,1494.7819,1494.964967,1,44843457,44848949,5492,0.7880610443737933
17653,1494.985967,1495.094367,1,44849579,44852831,3252,0.8011645487476861
17654,1495.3772,1495.400833,1,44861316,44862024,708,0.7552956994980397
17655,1495.655567,1495.662433,1,44869667,44869872,205,0.7345539629325418
17656,1495.6636,1495.699167,1,44869908,44870975,1067,0.44877732901117673
17657,1495.710567,1495.720667,1,44871317,44871620,303,0.059719410966522425
17658,1495.768333,1495.779167,1,44873049,44873375,326,0.8098467520398713
17659,1495.7805,1495.791733,1,44873415,44873751,336,0.40356984930290984
17660,1495.801267,1495.8112,1,44874038,44874336,298,0.6133464982871759
17661,1495.8154,1495.861233,1,44874462,44875836,1374,0.715503919323109
17662,1495.888167,1495.9129,1,44876645,44877387,742,0.5807227887276563
17663,1495.919533,1495.926233,1,44877585,44877786,201,0.49862355105221406
17664,1495.934167,1495.9758,1,44878025,44879274,1249,-0.01860053438720206
17665,1495.9774,1495.983067,1,44879322,44879492,170,0.10608847946090766
17666,1496.0813,1496.113,1,44882439,44883390,951,0.5739769759187064
17667,1496.114433,1496.117967,1,44883432,44883539,107,-0.5355715476058637
17668,1496.339667,1496.354533,1,44890190,44890635,445,0.5946502727614293
17669,1496.3577,1496.389433,1,44890731,44891682,951,0.8000745507595021
17670,1496.395633,1496.4331,1,44891868,44892993,1125,0.7256537291910178
17671,1496.4447,1496.449933,1,44893341,44893497,156,-0.0966309175788871
17672,1496.450933,1496.4754,1,44893527,44894262,735,-0.07181907253778974
17673,1496.477133,1496.491,1,44894313,44894730,417,-0.09027478199881618
17674,1496.498233,1496.5026,1,44894946,44895078,132,0.47380394786767754
17675,1496.5597,1496.564767,1,44896791,44896943,152,0.5631417645687119
17676,1496.5852,1496.6073,1,44897556,44898219,663,0.2232635318990959
17677,1496.6095,1496.6331,1,44898285,44898993,708,-0.01862948104536474
17678,1496.634967,1496.653267,1,44899049,44899598,549,0.15902618118357256
17679,1496.664733,1496.784233,1,44899941,44903526,3585,0.8101985420237374
17680,1496.788267,1496.792033,1,44903648,44903760,112,-0.3036677091221821
17681,1497.043267,1497.0631,1,44911298,44911893,595,0.6832263214552112
17682,1497.067167,1497.0732,1,44912015,44912196,181,0.6737276638334238
17683,1497.075133,1497.0818,1,44912253,44912454,201,0.6568093910532313
17684,1497.134167,1497.1511,1,44914025,44914533,508,0.601567571518105
17685,1497.1751,1497.220567,1,44915253,44916617,1364,0.6524981828978235
17686,1497.252067,1497.264133,1,44917562,44917923,361,0.7079520463088311
17687,1497.2875,1497.300767,1,44918625,44919023,398,0.6554614247141934
17688,1497.3021,1497.316833,1,44919063,44919504,441,0.6784644383337669
17689,1497.332267,1497.348,1,44919968,44920440,472,0.6295732204391432
17690,1497.354433,1497.3787,1,44920632,44921361,729,0.1324685311240812
17691,1497.3803,1497.3891,1,44921409,44921673,264,0.2549867864072322
17692,1497.390667,1497.4048,1,44921720,44922144,424,0.18851217062751036
17693,1497.4062,1497.4129,1,44922186,44922387,201,0.464169201409998
17694,1497.421233,1497.424533,1,44922636,44922735,99,
17695,1497.429733,1497.486467,1,44922891,44924594,1703,0.6846661327377727
17696,1497.4892,1497.5307,1,44924676,44925921,1245,0.6798173508246241
17697,1497.542967,1497.581767,1,44926289,44927453,1164,0.0033009902284198414
17698,1497.585767,1497.5979,1,44927573,44927937,364,0.3414109008186889
17699,1497.635,1497.643467,1,44929050,44929304,254,0.6125647358788245
17700,1497.6465,1497.674633,1,44929395,44930238,843,0.2663070320852365
17701,1497.679833,1497.696233,1,44930394,44930886,492,-0.06353404164078781
17702,1497.697467,1497.7042,1,44930924,44931126,202,0.09495319228766701
17703,1497.712133,1497.717267,1,44931363,44931518,155,0.10103098685124778
17704,1497.720333,1497.729367,1,44931609,44931881,272,0.15311960186554593
17705,1497.747867,1497.7732,1,44932436,44933196,760,0.6993584243074301
17706,1497.774767,1497.901433,1,44933243,44937042,3799,0.6547165746567551
17707,1497.9042,1497.989933,1,44937126,44939697,2571,0.5325311622891077
17708,1497.9912,1498.028533,1,44939736,44940855,1119,0.4896670395563225
17709,1498.0303,1498.0507,1,44940909,44941521,612,0.2426797906792493
17710,1498.0544,1498.126567,1,44941632,44943797,2165,0.4827202636012621
17711,1498.1359,1498.1685,1,44944077,44945055,978,0.37649998157991266
17712,1498.1707,1498.239167,1,44945121,44947175,2054,0.37097496871127156
17713,1498.241267,1498.245167,1,44947238,44947355,117,-0.07979549615381303
17714,1498.2468,1498.2515,1,44947404,44947545,141,0.3316511836601323
17715,1498.2599,1498.2648,1,44947797,44947944,147,0.3679087518415855
17716,1498.266767,1498.348267,1,44948003,44950448,2445,0.5823165501871274
17717,1498.3641,1498.374333,1,44950923,44951229,306,0.37916153501895083
17718,1498.388467,1498.420933,1,44951654,44952627,973,0.10578340665030411
17719,1498.432367,1498.459,1,44952971,44953770,799,0.4425743882743742
17720,1498.480467,1498.5116,1,44954414,44955348,934,0.087323832513451
17721,1498.525767,1498.530767,1,44955773,44955923,150,0.04389846143458588
17722,1498.5328,1498.67,1,44955984,44960100,4116,0.44577815901984563
17723,1498.674667,1498.679967,1,44960240,44960399,159,0.68692314419899
17724,1498.681133,1498.685833,1,44960433,44960574,141,0.6398144853931955
17725,1498.6882,1498.6949,1,44960646,44960847,201,0.6438302437741482
17726,1498.707,1498.710867,1,44961210,44961326,116,
17727,1498.770133,1498.774967,1,44963103,44963249,146,0.7580182593594683
17728,1498.777933,1498.7837,1,44963337,44963511,174,0.19092724566385622
17729,1498.791133,1498.795167,1,44963733,44963855,122,0.6755056416029718
17730,1498.8063,1498.811833,1,44964189,44964354,165,0.11032608100539067
17731,1498.824067,1498.8346,1,44964722,44965038,316,0.6704516957902232
17732,1498.8441,1498.860533,1,44965323,44965815,492,0.4489996642644012
17733,1498.8822,1498.8865,1,44966466,44966595,129,0.5586594638097264
17734,1498.890133,1498.9033,1,44966703,44967099,396,0.6705473144791226
17735,1498.9062,1498.910867,1,44967186,44967326,140,0.3032394156256673
17736,1498.914933,1498.9183,1,44967447,44967549,102,0.5859830659636381
17737,1498.9195,1498.922633,1,44967585,44967678,93,
17738,1498.9247,1498.932367,1,44967741,44967971,230,0.6495864725068173
17739,1498.940033,1498.945533,1,44968200,44968365,165,0.4978803061957786
17740,1498.978833,1498.989567,1,44969364,44969687,323,0.6228164993530231
17741,1499.0004,1499.055,1,44970012,44971650,1638,0.3763148790581206
17742,1499.0923,1499.122567,1,44972769,44973677,908,-0.08746529971712391
17743,1499.1331,1499.142033,1,44973993,44974260,267,0.3252869746546867
17744,1499.405933,1499.4132,1,44982177,44982396,219,0.5515590018970861
17745,1499.459633,1499.463067,1,44983788,44983892,104,0.6494249148719259
17746,1499.4898,1499.497167,1,44984694,44984915,221,0.573943800121121
17747,1499.541367,1499.5524,1,44986241,44986572,331,0.5343785346402943
17748,1499.6088,1499.6133,1,44988264,44988399,135,0.6865140031045662
17749,1499.6157,1499.6254,1,44988471,44988762,291,0.5976723463687019
17750,1499.659733,1499.672933,1,44989791,44990187,396,0.6688396945485034
17751,1499.797867,1499.813933,1,44993936,44994417,481,0.5563873234203894
17752,1499.8161,1499.8263,1,44994483,44994789,306,0.6127174886755861
17753,1499.827367,1499.873667,1,44994821,44996210,1389,0.6929842760743569
17754,1499.8748,1499.9092,1,44996244,44997276,1032,0.7360873426434814
17755,1499.941967,1499.952933,1,44998259,44998587,328,0.38196965392375765
17756,1499.966,1499.9977,1,44998980,44999931,951,-0.025690528672274653
17757,1500.004367,1500.013833,1,45000131,45000414,283,-0.06305306432748685
17758,1500.0709,1500.076567,1,45002127,45002297,170,0.2964868564880324
17759,1500.084867,1500.100433,1,45002546,45003012,466,0.4582407121634796
17760,1500.107033,1500.153433,1,45003210,45004602,1392,-0.036311588455163
17761,1500.157633,1500.162267,1,45004728,45004868,140,0.30019791273200364
17762,1500.1753,1500.1793,1,45005259,45005379,120,0.6395048297402572
17763,1500.190033,1500.295167,1,45005700,45008855,3155,0.6932916050957006
17764,1500.299733,1500.3284,1,45008991,45009852,861,0.4913737682932331
17765,1500.335833,1500.388033,1,45010074,45011640,1566,0.3105042763202781
17766,1500.389867,1500.424533,1,45011696,45012735,1039,0.36563968420772375
17767,1500.4413,1500.472733,1,45013239,45014181,942,0.5201852398504496
17768,1500.479233,1500.582733,1,45014376,45017481,3105,0.456437192083397
17769,1500.590167,1500.6137,1,45017705,45018411,706,0.4041797646329359
17770,1500.6382,1500.664367,1,45019146,45019931,785,0.5980748294190164
17771,1500.6664,1500.8041,1,45019992,45024123,4131,0.5312141594929254
17772,1500.807033,1500.8781,1,45024210,45026343,2133,0.5707832943321182
17773,1500.884867,1500.8912,1,45026546,45026736,190,0.3485221107610023
17774,1500.8925,1500.8972,1,45026775,45026916,141,0.34582514179763607
17775,1500.908433,1500.932767,1,45027252,45027983,731,0.41258479137634096
17776,1500.962067,1500.9988,1,45028862,45029964,1102,0.4605067962879631
17777,1501.004467,1501.036733,1,45030134,45031101,967,0.35845490034371363
17778,1501.043333,1501.057533,1,45031299,45031725,426,0.3170351794599009
17779,1501.0593,1501.1814,1,45031779,45035442,3663,0.25818174108915154
17780,1501.182767,1501.198833,1,45035483,45035964,481,0.13289874043561745
17781,1501.208767,1501.384,1,45036263,45041520,5257,0.7602629389726454
17782,1501.399333,1501.428933,1,45041979,45042867,888,0.15716071163916448
17783,1501.438533,1501.4755,1,45043155,45044265,1110,0.02448013528165671
17784,1501.4971,1501.5431,1,45044913,45046293,1380,0.2891573786290401
17785,1501.547767,1501.574833,1,45046433,45047244,811,0.05629352409114089
17786,1501.584,1501.592333,1,45047520,45047769,249,-0.0534672898021522
17787,1501.644267,1501.6719,1,45049328,45050157,829,0.28271623147036196
17788,1501.673967,1501.708167,1,45050219,45051245,1026,0.023439645812962543
17789,1501.710467,1501.717967,1,45051314,45051539,225,0.015350579437763539
17790,1501.7304,1501.7379,1,45051912,45052137,225,0.016481144747866185
17791,1501.7633,1501.768767,1,45052899,45053063,164,0.43522317332012367
17792,1501.772767,1501.801367,1,45053183,45054041,858,0.436961669767839
17793,1501.810933,1501.826167,1,45054327,45054785,458,-0.08888204632561832
17794,1501.830333,1501.838567,1,45054909,45055157,248,0.004960493039592062
17795,1501.8572,1501.8649,1,45055716,45055947,231,0.4095955288959367
17796,1501.866033,1501.880533,1,45055980,45056415,435,0.5916320843845148
17797,1501.936333,1501.944633,1,45058089,45058338,249,0.744573853752352
17798,1501.965167,1501.972067,1,45058955,45059162,207,0.44554443688001505
17799,1501.985333,1501.9888,1,45059559,45059664,105,0.4988780157368806
17800,1502.0222,1502.030267,1,45060666,45060908,242,0.6845041824219295
17801,1502.0538,1502.109967,1,45061614,45063299,1685,0.5198805767621657
17802,1502.1209,1502.137467,1,45063627,45064124,497,0.5995786473807821
17803,1502.140033,1502.155467,1,45064200,45064664,464,0.47601952684086407
17804,1502.181367,1502.1911,1,45065441,45065733,292,0.45150241262141294
17805,1502.197133,1502.250633,1,45065913,45067518,1605,0.08439085246162221
17806,1502.2573,1502.2622,1,45067719,45067866,147,0.22473796273534932
17807,1502.268,1502.282533,1,45068040,45068475,435,0.8997106702579609
17808,1502.285033,1502.317033,1,45068550,45069510,960,0.826944101922733
17809,1502.327467,1502.3706,1,45069824,45071118,1294,0.19984214357192778
17810,1502.382167,1502.390033,1,45071465,45071700,235,-0.02653982434026931
17811,1502.391633,1502.3949,1,45071748,45071847,99,
17812,1502.398167,1502.410633,1,45071945,45072318,373,-0.07811938241615386
17813,1502.4561,1502.4792,1,45073683,45074376,693,0.5406811984928329
17814,1502.480933,1502.505433,1,45074427,45075162,735,0.425024328144614
17815,1502.5097,1502.541533,1,45075291,45076245,954,-0.02987899291507111
17816,1502.621967,1502.753167,1,45078659,45082595,3936,0.48519087272240724
17817,1502.775533,1502.7804,1,45083265,45083412,147,0.07047211059964403
17818,1502.8078,1502.812,1,45084234,45084360,126,-0.1600979814880015
17819,1502.921067,1502.927333,1,45087632,45087819,187,0.5068993579238359
17820,1502.937267,1502.948033,1,45088118,45088440,322,0.6783215239254884
17821,1502.953133,1502.9871,1,45088593,45089613,1020,0.6916613316573121
17822,1502.999033,1503.0181,1,45089970,45090543,573,0.8061964368185609
17823,1503.0242,1503.0484,1,45090726,45091452,726,0.7546631414351004
17824,1503.0569,1503.080067,1,45091707,45092402,695,0.7401094459763509
17825,1503.090633,1503.097533,1,45092718,45092925,207,0.3600865937160799
17826,1503.098833,1503.127767,1,45092964,45093833,869,0.8290587355279455
17827,1503.1327,1503.1602,1,45093981,45094806,825,0.7195324913865101
17828,1503.1639,1503.167767,1,45094917,45095033,116,0.5520494785625754
17829,1503.180067,1503.194233,1,45095402,45095826,424,0.3397982717849772
17830,1503.4319,1503.5202,1,45102957,45105606,2649,0.4336821495659514
17831,1503.6836,1503.7114,1,45110508,45111342,834,0.7270236895637135
17832,1503.7161,1503.732867,1,45111483,45111986,503,0.48494287062569064
17833,1503.748967,1503.756567,1,45112469,45112697,228,0.6753038186626177
17834,1503.7737,1503.795333,1,45113211,45113859,648,0.7612082787518578
17835,1503.878033,1503.910567,1,45116340,45117317,977,0.46348995205118615
17836,1503.9138,1504.004067,1,45117414,45120122,2708,0.775280838699026
17837,1504.046967,1504.0521,1,45121409,45121563,154,0.40417190174965
17838,1504.082233,1504.171133,1,45122466,45125133,2667,0.6942538576596401
17839,1504.175733,1504.182567,1,45125271,45125477,206,-0.03939079085940686
17840,1504.302067,1504.3793,1,45129062,45131379,2317,0.7990914885058437
17841,1504.387267,1504.403967,1,45131618,45132119,501,0.43796247657460247
17842,1504.4052,1504.4659,1,45132156,45133977,1821,0.7095633102342944
17843,1504.480633,1504.493967,1,45134418,45134819,401,0.7022819611704307
17844,1504.514033,1504.521167,1,45135420,45135635,215,-0.025803507843207667
17845,1504.522967,1504.542633,1,45135689,45136278,589,0.11334911451505854
17846,1504.5447,1504.559067,1,45136341,45136772,431,0.1676158891738724
17847,1504.576267,1504.7415,1,45137288,45142245,4957,0.8100225039150357
17848,1504.752967,1504.775167,1,45142589,45143255,666,0.7652812226041069
17849,1504.7777,1504.8187,1,45143331,45144561,1230,0.7722411694435225
17850,1504.8328,1504.901333,1,45144984,45147039,2055,0.8103705416187745
17851,1504.908,1504.916933,1,45147240,45147507,267,0.7192803972599439
17852,1504.9291,1504.960233,1,45147873,45148806,933,0.8855848307107361
17853,1504.969867,1505.0143,1,45149096,45150429,1333,0.0665088658661342
17854,1505.016133,1505.023233,1,45150483,45150696,213,0.055302483833587664
17855,1505.0453,1505.060133,1,45151359,45151803,444,0.721960632416635
17856,1505.0614,1505.152033,1,45151842,45154560,2718,0.7639129622679324
17857,1505.172667,1505.188133,1,45155180,45155643,463,-0.04976336779114259
17858,1505.1893,1505.200533,1,45155679,45156015,336,-0.044488719668135036
17859,1505.213367,1505.333667,1,45156401,45160010,3609,0.8525035746836408
17860,1505.353,1505.375367,1,45160590,45161261,671,0.06195510119042916
17861,1505.3771,1505.412267,1,45161313,45162368,1055,0.24353927319619648
17862,1505.428,1505.437567,1,45162840,45163127,287,0.7569172889533108
17863,1505.4631,1505.468067,1,45163893,45164042,149,0.5640052735000955
17864,1505.474,1505.553,1,45164220,45166590,2370,0.6716330186458356
17865,1505.556333,1505.601667,1,45166689,45168050,1361,0.7740981839287576
17866,1505.605233,1505.610533,1,45168156,45168315,159,0.5200658956806345
17867,1505.6203,1505.6469,1,45168609,45169407,798,-0.008657548813777746
17868,1505.823067,1505.906167,1,45174692,45177185,2493,0.838005712741394
17869,1505.908967,1505.969267,1,45177269,45179078,1809,0.04658074949327356
17870,1505.980933,1505.986867,1,45179427,45179606,179,0.6722410028160483
17871,1505.9893,1506.244167,1,45179679,45187325,7646,0.7507402753274395
17872,1506.283967,1506.287067,1,45188519,45188612,93,
17873,1506.367133,1506.377833,1,45191013,45191334,321,0.8058435241838661
17874,1506.379933,1506.387933,1,45191397,45191637,240,0.46296371721874924
17875,1506.397,1506.418867,1,45191910,45192566,656,0.6653914743327345
17876,1506.429533,1506.5421,1,45192885,45196263,3378,0.7536783713620837
17877,1506.544933,1506.625667,1,45196347,45198770,2423,0.8223207093066386
17878,1506.651067,1506.678867,1,45199532,45200366,834,0.756861282773168
17879,1506.682567,1506.6972,1,45200477,45200916,439,0.5238149483104565
17880,1506.7012,1506.730467,1,45201036,45201914,878,0.791727550656123
17881,1506.737233,1506.780267,1,45202116,45203408,1292,0.7246034351890284
17882,1506.781633,1506.8561,1,45203448,45205683,2235,0.799798101520385
17883,1506.857633,1506.898233,1,45205728,45206946,1218,0.7074737836536481
17884,1506.901167,1506.975967,1,45207035,45209279,2244,0.8329659788808241
17885,1506.9795,1506.995,1,45209385,45209850,465,0.7636279787120084
17886,1506.996633,1507.015667,1,45209898,45210470,572,0.7338898747752011
17887,1507.0232,1507.100433,1,45210696,45213012,2316,0.7985469104677875
17888,1507.1031,1507.115367,1,45213093,45213461,368,0.7875402110220479
17889,1507.1195,1507.145933,1,45213585,45214377,792,0.7278389995907933
17890,1507.1486,1507.242133,1,45214458,45217263,2805,0.8068385239396255
17891,1507.245167,1507.270067,1,45217355,45218102,747,0.6988932942100098
17892,1507.273933,1507.367933,1,45218217,45221037,2820,0.7915974400747552
17893,1507.3709,1507.396333,1,45221127,45221889,762,0.8280753225871945
17894,1507.399767,1507.4974,1,45221993,45224922,2929,0.741088117183662
17895,1507.500867,1507.527333,1,45225026,45225819,793,0.8424059382801985
17896,1507.531167,1507.628667,1,45225935,45228860,2925,0.7994808892771147
17897,1507.632167,1507.6588,1,45228965,45229764,799,0.8534632879739922
17898,1507.6621,1507.7598,1,45229863,45232794,2931,0.7912786935145982
17899,1507.7624,1507.789467,1,45232872,45233684,812,0.8015553125188519
17900,1507.793,1507.8872,1,45233790,45236616,2826,0.7688816313359468
17901,1507.892267,1507.916067,1,45236768,45237482,714,0.7904322322006312
17902,1507.9197,1508.0335,1,45237591,45241005,3414,0.7790287881855139
17903,1508.037,1508.103,1,45241110,45243090,1980,0.8027903173251912
17904,1508.1082,1508.121567,1,45243246,45243647,401,0.4388119782012172
17905,1508.133367,1508.1404,1,45244001,45244212,211,0.09230561683408468
17906,1508.145833,1508.151067,1,45244374,45244532,158,0.24705948367736077
17907,1508.171967,1508.182167,1,45245159,45245465,306,0.26569210080428995
17908,1508.1836,1508.189067,1,45245508,45245672,164,0.12611695353581634
17909,1508.2802,1508.292467,1,45248406,45248774,368,0.2776974764488054
17910,1508.311167,1508.429433,1,45249335,45252882,3547,0.7706343911974772
17911,1508.4408,1508.541833,1,45253224,45256254,3030,0.7394715558911163
17912,1508.558467,1508.5738,1,45256754,45257214,460,-0.03937605431765781
17913,1508.5749,1508.578433,1,45257247,45257352,105,
17914,1508.581667,1508.5901,1,45257450,45257703,253,0.24111890392937468
17915,1508.592267,1508.600267,1,45257768,45258008,240,0.18868417067958915
17916,1508.611833,1508.615333,1,45258354,45258459,105,0.5876082439034265
17917,1508.6179,1508.792033,1,45258537,45263760,5223,0.8190196578424439
17918,1508.7946,1508.818367,1,45263838,45264551,713,0.882468158562201
17919,1508.949233,1508.965567,1,45268476,45268967,491,0.6064284895626076
17920,1508.992633,1508.996967,1,45269778,45269909,131,0.13107470566322243
17921,1508.998,1509.002433,1,45269940,45270072,132,0.4904055856577312
17922,1509.2069,1509.213167,1,45276207,45276395,188,0.7016108019720472
17923,1509.214367,1509.2317,1,45276431,45276951,520,0.7469722179016346
17924,1509.251,1509.266533,1,45277530,45277995,465,0.6694549231534519
17925,1509.2797,1509.311933,1,45278391,45279357,966,0.8726226671860977
17926,1509.3132,1509.347033,1,45279396,45280410,1014,0.7013865935226752
17927,1509.348533,1509.371867,1,45280455,45281156,701,0.7657980289841844
17928,1509.375267,1509.452967,1,45281258,45283589,2331,0.7703877166227499
17929,1509.4558,1509.508133,1,45283674,45285243,1569,0.6434536096635981
17930,1509.509967,1509.534267,1,45285299,45286028,729,0.8061121754046909
17931,1509.537867,1509.550967,1,45286136,45286529,393,0.7154233105610163
17932,1509.556833,1509.5666,1,45286704,45286998,294,0.7749555607773886
17933,1509.570267,1509.643833,1,45287108,45289314,2206,0.7725678015626488
17934,1509.6497,1509.6639,1,45289491,45289917,426,0.44013272330877906
17935,1509.6671,1509.671967,1,45290013,45290159,146,0.09913823018704775
17936,1509.9714,1509.982633,1,45299142,45299478,336,0.7663359227745927
17937,1509.9857,1510.1658,1,45299571,45304974,5403,0.8163777317086229
17938,1510.1942,1510.214767,1,45305826,45306443,617,0.7513150361723913
17939,1510.218233,1510.322667,1,45306546,45309680,3134,0.7758629248238406
17940,1510.325233,1510.410933,1,45309756,45312327,2571,0.8106611230287357
17941,1510.413433,1510.418767,1,45312402,45312563,161,-0.08718101140835863
17942,1510.420067,1510.439233,1,45312602,45313176,574,0.8353028399473461
17943,1510.441767,1510.565267,1,45313253,45316958,3705,0.7724589678399867
17944,1510.568,1510.664133,1,45317040,45319923,2883,0.8496270972791304
17945,1510.665533,1510.679833,1,45319965,45320394,429,0.5108330650575812
17946,1510.695267,1510.784667,1,45320858,45323540,2682,0.801987590263194
17947,1510.789467,1510.804533,1,45323684,45324135,451,0.400033506227456
17948,1510.818933,1510.874733,1,45324567,45326241,1674,0.796079040320644
17949,1510.877367,1510.907933,1,45326321,45327237,916,0.8031334084626096
17950,1510.912867,1510.916267,1,45327386,45327488,102,0.8886157310890184
17951,1510.918367,1510.928033,1,45327551,45327840,289,0.6749008369626572
17952,1510.942,1510.979633,1,45328260,45329388,1128,0.7356853771003428
17953,1510.981167,1510.9977,1,45329435,45329931,496,0.6764673165688433
17954,1511.002,1511.008067,1,45330060,45330242,182,0.762224124624466
17955,1511.012167,1511.031633,1,45330365,45330948,583,0.7880515265372531
17956,1511.0366,1511.050833,1,45331098,45331524,426,0.5497144490914452
17957,1511.065667,1511.134,1,45331970,45334020,2050,0.7647654159836446
17958,1511.136333,1511.1579,1,45334089,45334737,648,0.7708004246343227
17959,1511.162333,1511.177733,1,45334869,45335331,462,0.3821530076622524
17960,1511.192733,1511.2929,1,45335781,45338787,3006,0.8022334215107585
17961,1511.2952,1511.3152,1,45338856,45339456,600,0.7350520813344775
17962,1511.3253,1511.425067,1,45339759,45342752,2993,0.8394648469987758
17963,1511.427867,1511.454767,1,45342836,45343643,807,0.883093304434049
17964,1511.4577,1511.556833,1,45343731,45346704,2973,0.7606948836559544
17965,1511.560567,1511.585467,1,45346817,45347564,747,0.8638344051325494
17966,1511.5884,1511.686767,1,45347652,45350603,2951,0.7671493622438965
17967,1511.689633,1511.7164,1,45350688,45351492,804,0.8010370514431538
17968,1511.720033,1511.8204,1,45351600,45354612,3012,0.7825747152790575
17969,1511.8219,1511.848367,1,45354657,45355451,794,0.7749133190758626
17970,1511.852033,1511.9509,1,45355560,45358527,2967,0.6757548379704442
17971,1511.953233,1511.977733,1,45358596,45359331,735,0.6502100144995392
17972,1511.981433,1511.9984,1,45359442,45359952,510,0.6524499800820129
17973,1511.999467,1512.007367,1,45359984,45360221,237,-0.20283907199597592
17974,1513.204533,1513.2088,1,45396135,45396264,129,0.6992000784983399
17975,1513.225133,1513.2303,1,45396753,45396909,156,0.795248680412811
17976,1513.2449,1513.276667,1,45397347,45398300,953,0.752960991347147
17977,1513.2901,1513.302067,1,45398703,45399062,359,0.7636442951483207
17978,1513.305667,1513.3288,1,45399170,45399864,694,0.6741947094549304
17979,1513.332367,1513.3462,1,45399971,45400386,415,0.5127478257821775
17980,1513.366033,1513.3822,1,45400980,45401466,486,0.680559379918945
17981,1513.393767,1513.409233,1,45401813,45402276,463,0.5847664444629199
17982,1513.410767,1513.414967,1,45402323,45402449,126,0.6003090064523029
17983,1513.418667,1513.425033,1,45402560,45402750,190,0.523723265943233
17984,1513.4412,1513.480233,1,45403236,45404406,1170,0.7027128183010767
17985,1513.4848,1513.515967,1,45404544,45405479,935,0.5835355764351707
17986,1513.5276,1513.540433,1,45405828,45406212,384,-0.015421961795209405
17987,1513.542967,1513.5926,1,45406289,45407778,1489,0.34984183005994424
17988,1513.606333,1513.611333,1,45408189,45408339,150,
17989,1513.625133,1513.735267,1,45408753,45412058,3305,0.8378629879530376
17990,1513.7437,1513.750233,1,45412311,45412506,195,0.654373346660673
17991,1513.762167,1513.799,1,45412865,45413970,1105,0.06959273951444761
17992,1513.8023,1513.813867,1,45414069,45414416,347,0.09900070469911117
17993,1513.8177,1513.8276,1,45414531,45414828,297,-0.007303317182864649
17994,1513.8671,1513.874067,1,45416013,45416222,209,0.4920158452579286
17995,1513.878467,1513.891833,1,45416354,45416754,400,0.26854103038420796
17996,1513.898433,1514.090367,1,45416952,45422711,5759,0.8151573475121139
17997,1514.097567,1514.126333,1,45422927,45423789,862,0.7718934893340416
17998,1514.136267,1514.187467,1,45424088,45425624,1536,0.6775893579812904
17999,1514.2021,1514.208067,1,45426063,45426242,179,0.1298988879518974
18000,1514.2115,1514.2209,1,45426345,45426627,282,0.028121293219372658
18001,1514.2231,1514.230467,1,45426693,45426914,221,-0.013975792828061252
18002,1514.2317,1514.240667,1,45426951,45427220,269,0.03912150022993987
18003,1514.270333,1514.273867,1,45428109,45428216,107,
18004,1514.2916,1514.3159,1,45428748,45429477,729,0.6311844227465849
18005,1514.3273,1514.4262,1,45429819,45432786,2967,0.778085966245167
18006,1514.434933,1514.5295,1,45433047,45435885,2838,0.8028470182632828
18007,1514.542,1514.547967,1,45436260,45436439,179,-0.025174683672055408
18008,1514.580533,1514.5851,1,45437415,45437553,138,0.5516725865520705
18009,1514.609533,1514.616633,1,45438285,45438498,213,-0.10793311281845011
18010,1514.621,1514.648533,1,45438630,45439455,825,0.6819597009134213
18011,1514.6552,1514.806133,1,45439656,45444183,4527,0.7794582666853584
18012,1514.807167,1514.8109,1,45444215,45444327,112,0.6127286662988379
18013,1514.812067,1514.8181,1,45444362,45444543,181,0.4365639760132467
18014,1514.839633,1514.859967,1,45445188,45445799,611,0.74124131505822
18015,1514.861333,1514.9058,1,45445839,45447174,1335,0.8058731284638007
18016,1514.9108,1514.925967,1,45447324,45447779,455,0.7929329918477869
18017,1514.931967,1514.9438,1,45447959,45448314,355,0.6114678968955356
18018,1514.955167,1514.958867,1,45448655,45448766,111,0.043537409121685626
18019,1514.9601,1514.9654,1,45448803,45448962,159,0.11886515287984425
18020,1514.966667,1514.977833,1,45449000,45449334,334,0.02154475954306526
18021,1514.980233,1514.991667,1,45449406,45449750,344,0.19837925751910207
18022,1514.994733,1515.013133,1,45449841,45450393,552,0.0981191994404893
18023,1515.014567,1515.02,1,45450437,45450600,163,0.2324832944962361
18024,1515.034433,1515.2206,1,45451032,45456618,5586,0.8514832762971162
18025,1515.230467,1515.2612,1,45456914,45457836,922,0.8116310043891705
18026,1515.265033,1515.340167,1,45457950,45460205,2255,0.805485831658495
18027,1515.346167,1515.354667,1,45460385,45460640,255,0.1258057833939328
18028,1515.357467,1515.367833,1,45460724,45461034,310,-0.08448184543731667
18029,1515.372267,1515.385867,1,45461168,45461576,408,0.06322033083311272
18030,1515.387533,1515.395133,1,45461625,45461853,228,0.17300307782263932
18031,1515.3975,1515.4062,1,45461925,45462186,261,0.22838256344054253
18032,1515.412033,1515.419333,1,45462360,45462579,219,-0.1818269529790588
18033,1515.4211,1515.634467,1,45462633,45469034,6401,0.811713728767086
18034,1515.641433,1515.647033,1,45469242,45469410,168,0.7539150088621718
18035,1515.653033,1515.663133,1,45469590,45469893,303,-0.04127126904836068
18036,1515.664733,1515.686367,1,45469941,45470591,650,0.18937009346249886
18037,1515.687433,1515.700767,1,45470622,45471023,401,0.1624867765826788
18038,1515.706733,1515.712667,1,45471201,45471380,179,-0.06540515873398745
18039,1515.737667,1515.7543,1,45472130,45472629,499,0.7764937142113258
18040,1515.755833,1515.846433,1,45472674,45475392,2718,0.6975627535530607
18041,1515.866033,1515.8819,1,45475980,45476457,477,-0.01967312529841622
18042,1515.9026,1516.0209,1,45477078,45480627,3549,0.8449389902076352
18043,1516.059533,1516.069067,1,45481785,45482072,287,0.6968916284051511
18044,1516.070267,1516.074333,1,45482108,45482229,121,
18045,1516.080633,1516.1043,1,45482418,45483129,711,-0.04652268930815998
18046,1516.1053,1516.112467,1,45483159,45483374,215,0.24554425418023884
18047,1516.113867,1516.1197,1,45483416,45483591,175,0.28000273330686476
18048,1516.120833,1516.1279,1,45483624,45483837,213,0.1668659915505701
18049,1516.141767,1516.155667,1,45484253,45484670,417,0.6350883086580243
18050,1516.1574,1516.2075,1,45484722,45486225,1503,0.7734348886784176
18051,1516.2102,1516.2162,1,45486306,45486486,180,0.15814079172226492
18052,1516.219367,1516.329933,1,45486581,45489897,3316,0.7969807091080848
18053,1516.3358,1516.433533,1,45490074,45493005,2931,0.7947556332973946
18054,1516.436067,1516.4533,1,45493082,45493599,517,0.5994928446985537
18055,1516.458633,1516.508567,1,45493758,45495257,1499,0.5566225565750837
18056,1516.514133,1516.570667,1,45495423,45497120,1697,0.7271967546176009
18057,1516.578933,1516.617167,1,45497367,45498515,1148,0.6489479783934856
18058,1516.630767,1516.654033,1,45498923,45499620,697,0.006805123935650013
18059,1516.655533,1516.663733,1,45499665,45499911,246,0.27462447751629
18060,1516.666067,1516.680833,1,45499982,45500424,442,0.03856657447255505
18061,1516.688067,1516.692667,1,45500642,45500780,138,0.6670551851512322
18062,1516.695267,1516.8348,1,45500858,45505044,4186,0.8495354532151513
18063,1516.8595,1516.941667,1,45505785,45508250,2465,0.7436181704764132
18064,1516.945233,1517.0101,1,45508356,45510303,1947,0.7086631596450342
18065,1517.014067,1517.0957,1,45510422,45512871,2449,0.6573086631743403
18066,1517.0991,1517.1892,1,45512973,45515676,2703,0.8062638342742384
18067,1517.210933,1517.218967,1,45516327,45516569,242,-0.11945400853003477
18068,1517.298133,1517.416,1,45518943,45522480,3537,0.8072113930228207
18069,1517.81,1517.816233,1,45534300,45534486,186,0.6731761744153211
18070,1517.820333,1517.879,1,45534609,45536370,1761,0.5886293700128016
18071,1517.8936,1517.8999,1,45536808,45536997,189,0.5659109547451474
18072,1517.901767,1517.910533,1,45537053,45537315,262,0.5360942095087249
18073,1517.918833,1517.941467,1,45537564,45538244,680,0.33205825844939496
18074,1517.955233,1518.035833,1,45538656,45541074,2418,0.7928750320067863
18075,1518.118567,1518.227567,1,45543557,45546827,3270,0.816749630208426
18076,1518.2817,1518.2905,1,45548451,45548715,264,0.13078494976488683
18077,1518.333767,1518.3501,1,45550013,45550503,490,0.18075936749126073
18078,1518.3511,1518.479367,1,45550533,45554381,3848,0.8115095880766833
18079,1518.480967,1518.489033,1,45554429,45554670,241,0.7140382641892798
18080,1518.503,1518.533533,1,45555090,45556005,915,0.7165234675133187
18081,1518.5465,1518.5862,1,45556395,45557586,1191,0.08368086708390252
18082,1518.591833,1518.595067,1,45557754,45557852,98,-0.15582431158988896
18083,1518.601067,1518.8707,1,45558032,45566121,8089,0.8196552067779089
18084,1518.881633,1518.885,1,45566448,45566550,102,0.7399820468707882
18085,1518.899633,1518.939167,1,45566988,45568175,1187,0.07624397194223874
18086,1518.941367,1518.9479,1,45568241,45568437,196,0.3633275810222111
18087,1518.9592,1519.068233,1,45568776,45572046,3270,0.7935669059336753
18088,1519.080733,1519.1094,1,45572421,45573282,861,-0.0016288886397058957
18089,1519.120733,1519.2846,1,45573621,45578538,4917,0.8534600329775623
18090,1519.302367,1519.329833,1,45579071,45579894,823,-0.06506875481822394
18091,1519.332333,1519.3448,1,45579969,45580344,375,0.07849290611209306
18092,1519.346,1519.353067,1,45580380,45580592,212,0.07323384412013813
18093,1519.380867,1519.403433,1,45581426,45582102,676,0.7854226824305156
18094,1519.404667,1519.5142,1,45582140,45585426,3286,0.832345288746914
18095,1519.5368,1519.670733,1,45586104,45590121,4017,0.7863295281970716
18096,1519.6734,1519.771,1,45590202,45593130,2928,0.755797455379866
18097,1519.782833,1519.809633,1,45593484,45594288,804,0.07534813640396773
18098,1519.810667,1519.827,1,45594320,45594810,490,0.021944273850171326
18099,1519.848067,1519.856033,1,45595442,45595680,238,0.5857361039219411
18100,1519.8587,1519.935533,1,45595761,45598065,2304,0.8461806990435449
18101,1519.9366,1520.063267,1,45598098,45601898,3800,0.8458614648713857
18102,1520.087933,1520.105467,1,45602637,45603164,527,-0.05819380807633904
18103,1520.1095,1520.113033,1,45603285,45603390,105,0.10794835735297262
18104,1520.1149,1520.140167,1,45603447,45604205,758,0.12811221695683314
18105,1520.1443,1520.150733,1,45604329,45604521,192,0.27584111749059675
18106,1520.180033,1520.209367,1,45605400,45606281,881,0.5828330628701547
18107,1520.211133,1520.4582,1,45606333,45613746,7413,0.7252967104338395
18108,1520.459767,1520.486933,1,45613793,45614607,814,0.5478388259963292
18109,1520.488067,1520.542133,1,45614642,45616263,1621,0.7465513729248133
18110,1520.546767,1520.679867,1,45616403,45620396,3993,0.8191189077873982
18111,1520.684233,1520.688067,1,45620526,45620642,116,-0.06943147849891822
18112,1520.690467,1520.694533,1,45620714,45620835,121,-0.08808811258444024
18113,1520.7087,1520.720567,1,45621261,45621617,356,0.08637224553138888
18114,1520.725933,1520.7297,1,45621777,45621891,114,-0.19328080677447487
18115,1520.741433,1520.838867,1,45622242,45625166,2924,0.7949432796944634
18116,1520.8428,1520.845933,1,45625284,45625377,93,0.513867472643547
18117,1520.866233,1520.869733,1,45625986,45626091,105,-0.0779606729278791
18118,1520.929267,1520.932833,1,45627878,45627984,106,
18119,1520.933833,1521.0712,1,45628014,45632136,4122,0.8271686017372863
18120,1521.112633,1521.123233,1,45633378,45633696,318,0.37370272633630774
18121,1521.129333,1521.133667,1,45633879,45634010,131,-0.13514998942343234
18122,1521.135467,1521.159567,1,45634064,45634787,723,-0.07473911999553678
18123,1521.161567,1521.1706,1,45634847,45635118,271,-0.08560562963066488
18124,1521.177,1521.275,1,45635310,45638250,2940,0.8039917224745484
18125,1521.276933,1521.3292,1,45638307,45639876,1569,0.7383831380175416
18126,1521.335433,1521.424533,1,45640062,45642735,2673,0.7244652947002497
18127,1521.4323,1521.436867,1,45642969,45643106,137,-0.06631706085071802
18128,1521.438467,1521.446867,1,45643154,45643406,252,-0.01788472355588984
18129,1521.449467,1521.4531,1,45643484,45643593,109,
18130,1521.4568,1521.463833,1,45643704,45643914,210,-0.052427523080676296
18131,1521.466033,1521.478567,1,45643980,45644357,377,-0.01198442261400388
18132,1521.4843,1521.488733,1,45644529,45644661,132,
18133,1521.499467,1521.6261,1,45644984,45648783,3799,0.7993906351658168
18134,1521.632867,1521.638167,1,45648986,45649145,159,-0.07029974326010001
18135,1521.6398,1521.6451,1,45649194,45649353,159,-0.10999918892068596
18136,1521.6491,1521.662867,1,45649473,45649886,413,-0.02977220853131538
18137,1521.677067,1521.680833,1,45650312,45650424,112,-0.0007487027681426086
18138,1521.684633,1521.814967,1,45650538,45654449,3911,0.7940213373226251
18139,1521.818233,1521.8225,1,45654546,45654675,129,0.37878004919631497
18140,1521.831233,1521.862967,1,45654936,45655889,953,0.053731348611112124
18141,1521.864,1521.875633,1,45655920,45656268,348,0.08485667136996244
18142,1521.8797,1522.063133,1,45656391,45661893,5502,0.6841023390869966
18143,1522.064967,1522.070433,1,45661949,45662112,163,-0.04150673636140596
18144,1522.071667,1522.075267,1,45662150,45662258,108,
18145,1522.076667,1522.085933,1,45662300,45662577,277,0.33936227329314517
18146,1522.090333,1522.094,1,45662709,45662820,111,
18147,1522.117067,1522.2705,1,45663512,45668115,4603,0.8157197925338767
18148,1522.293033,1522.339333,1,45668790,45670179,1389,0.04931728904409224
18149,1522.362233,1522.367667,1,45670866,45671030,164,0.6242394271242975
18150,1522.3689,1522.517733,1,45671067,45675531,4464,0.8370533189131046
18151,1522.5226,1522.5757,1,45675678,45677271,1593,0.10939602398492583
18152,1522.605967,1522.717167,1,45678179,45681515,3336,0.8394817295791794
18153,1522.7191,1522.763533,1,45681573,45682905,1332,0.839132527524796
18154,1522.7685,1522.772,1,45683055,45683160,105,0.5402354370521304
18155,1522.7745,1522.8104,1,45683235,45684312,1077,-0.01424962023870011
18156,1522.811633,1522.815,1,45684348,45684450,102,
18157,1522.858833,1522.862733,1,45685764,45685881,117,0.5261079876210786
18158,1522.866567,1523.0205,1,45685997,45690615,4618,0.8255844310929723
18159,1523.032367,1523.039833,1,45690971,45691194,223,0.458071246070877
18160,1523.046833,1523.065933,1,45691404,45691977,573,0.037056239589340914
18161,1523.0672,1523.077633,1,45692016,45692328,312,0.3008749835885285
18162,1523.079233,1523.084767,1,45692376,45692543,167,0.24653639611505976
18163,1523.0865,1523.0912,1,45692595,45692736,141,-0.10685501330169189
18164,1523.094433,1523.097467,1,45692832,45692924,92,
18165,1523.1288,1523.1331,1,45693864,45693993,129,0.538879447986546
18166,1523.137133,1523.2917,1,45694113,45698751,4638,0.8439936249920983
18167,1523.302667,1523.3189,1,45699080,45699567,487,-0.054815619508462816
18168,1523.336367,1523.365633,1,45700091,45700968,877,0.09460109623928542
18169,1523.396833,1523.609533,1,45701904,45708285,6381,0.543503415624907
18170,1523.613333,1523.623067,1,45708399,45708692,293,-0.15959991496595466
18171,1523.629033,1523.6352,1,45708870,45709056,186,0.0016124148205181146
18172,1523.646133,1523.782533,1,45709383,45713475,4092,0.8040367742177811
18173,1523.793167,1523.798633,1,45713795,45713958,163,0.1554977696756749
18174,1523.800633,1523.867767,1,45714018,45716033,2015,0.26624692948562706
18175,1523.892033,1524.095067,1,45716760,45722852,6092,0.8252228995069132
18176,1524.1017,1524.1831,1,45723051,45725493,2442,0.6721952866952268
18177,1524.188333,1524.2092,1,45725649,45726276,627,0.7478129285997389
18178,1524.216367,1524.236933,1,45726491,45727107,616,0.6880218631326532
18179,1524.240333,1524.2897,1,45727209,45728691,1482,0.04995731509509201
18180,1524.291333,1524.3072,1,45728739,45729216,477,-0.07058858013806302
18181,1524.336733,1524.537033,1,45730101,45736110,6009,0.8325268459870885
18182,1524.5495,1524.5726,1,45736485,45737178,693,0.8510518081565778
18183,1524.5849,1524.6338,1,45737547,45739014,1467,0.8599472320497699
18184,1524.638967,1524.645133,1,45739169,45739353,184,-0.08000401240606973
18185,1524.6496,1524.681833,1,45739488,45740454,966,0.075275296075336
18186,1524.684267,1524.707333,1,45740528,45741219,691,0.14638666909870873
18187,1524.723367,1524.733733,1,45741701,45742011,310,0.4822877624105962
18188,1524.735033,1524.894233,1,45742050,45746826,4776,0.8021714352492297
18189,1524.906033,1524.9769,1,45747180,45749307,2127,0.728527348872415
18190,1525.014033,1525.089867,1,45750420,45752696,2276,0.7626086297949318
18191,1525.105067,1525.109333,1,45753152,45753279,127,
18192,1525.146933,1525.1504,1,45754407,45754512,105,0.5496511188412284
18193,1525.155567,1525.158633,1,45754667,45754758,91,0.636973145784714
18194,1525.186667,1525.196367,1,45755600,45755891,291,0.22927967924151132
18195,1525.206,1525.213367,1,45756180,45756401,221,0.7950490375103594
18196,1525.214833,1525.3124,1,45756444,45759372,2928,0.7920598049114062
18197,1525.3145,1525.365367,1,45759435,45760961,1526,0.764645173429371
18198,1525.3666,1525.411567,1,45760998,45762347,1349,0.8262379047828813
18199,1525.4171,1525.432133,1,45762513,45762963,450,0.7541168483487479
18200,1525.436267,1525.451267,1,45763088,45763538,450,0.6461654612160254
18201,1525.455533,1525.4695,1,45763665,45764085,420,0.3904120953615086
18202,1525.476833,1525.5077,1,45764304,45765231,927,-0.046383031887957754
18203,1525.5089,1525.520667,1,45765267,45765620,353,0.28388578746368626
18204,1525.521933,1525.528533,1,45765657,45765855,198,0.32308236958621933
18205,1525.5385,1525.683467,1,45766155,45770504,4349,0.8390070521916936
18206,1525.690467,1525.720767,1,45770714,45771623,909,0.8086884952689091
18207,1525.747567,1525.752767,1,45772427,45772583,156,0.580108271865466
18208,1525.757733,1525.777567,1,45772731,45773327,596,0.6277325516838986
18209,1525.780067,1525.848733,1,45773402,45775461,2059,0.7322604486579047
18210,1525.8501,1525.922667,1,45775503,45777680,2177,0.7699027901961394
18211,1525.941867,1525.975967,1,45778256,45779279,1023,0.7757035155541498
18212,1526.2075,1526.322667,1,45786225,45789680,3455,0.8356970573687132
18213,1526.331967,1526.346833,1,45789959,45790404,445,0.4556447699971423
18214,1526.3526,1526.359167,1,45790578,45790775,197,0.3965278361527141
18215,1526.362267,1526.3861,1,45790868,45791583,715,-0.03108658712234631
18216,1526.387467,1526.413867,1,45791624,45792416,792,0.2560386293163924
18217,1526.452433,1526.569433,1,45793572,45797082,3510,0.808685577266615
18218,1526.5813,1526.804367,1,45797439,45804131,6692,0.7467321736521032
18219,1526.8501,1526.862667,1,45805503,45805880,377,0.3358386513522015
18220,1526.8724,1526.8961,1,45806172,45806883,711,-0.0365689314155259
18221,1526.897333,1526.911433,1,45806919,45807342,423,0.3260215298224768
18222,1526.9223,1526.9269,1,45807669,45807807,138,
18223,1526.941367,1526.9865,1,45808241,45809595,1354,0.8446998711679767
18224,1526.988333,1527.008333,1,45809649,45810249,600,0.7251766231334831
18225,1527.009967,1527.043633,1,45810299,45811308,1009,0.7544391685818568
18226,1527.046267,1527.092,1,45811388,45812760,1372,0.7168512558963321
18227,1527.119667,1527.125533,1,45813590,45813765,175,0.8567319447104229
18228,1527.128667,1527.151667,1,45813860,45814550,690,0.6852789372625843
18229,1527.1536,1527.3296,1,45814608,45819888,5280,0.7727736723308843
18230,1527.335333,1527.349767,1,45820059,45820493,434,0.6883625367478498
18231,1527.357567,1527.371633,1,45820727,45821148,421,0.48948486633033605
18232,1527.387067,1527.407333,1,45821612,45822219,607,-0.025404266702583795
18233,1527.413267,1527.438833,1,45822398,45823164,766,0.20864794485894
18234,1527.440467,1527.449267,1,45823214,45823478,264,0.14839332006042394
18235,1527.480233,1527.4849,1,45824406,45824547,141,0.4328949105246852
18236,1527.487667,1527.571567,1,45824630,45827147,2517,0.8305959588735996
18237,1527.5742,1527.6948,1,45827226,45830844,3618,0.7863765081250554
18238,1527.7059,1527.7094,1,45831177,45831282,105,0.4124083690497774
18239,1527.7263,1527.747233,1,45831789,45832416,627,-0.022333941042156802
18240,1527.748567,1527.758367,1,45832457,45832751,294,0.1783691807821944
18241,1527.76,1527.779833,1,45832800,45833394,594,0.30898344178682713
18242,1527.780867,1527.784233,1,45833426,45833526,100,
18243,1527.814067,1527.932967,1,45834422,45837989,3567,0.8398156647048726
18244,1527.935,1527.9437,1,45838050,45838311,261,0.6306468578615786
18245,1527.950333,1527.997967,1,45838509,45839939,1430,0.03520777970371503
18246,1528.019267,1528.025367,1,45840578,45840761,183,0.5462108846193483
18247,1528.026933,1528.1538,1,45840807,45844614,3807,0.8418656761337951
18248,1528.159967,1528.233867,1,45844799,45847016,2217,0.7654690996113711
18249,1528.237033,1528.278367,1,45847110,45848351,1241,0.7532134149729383
18250,1528.296667,1528.3835,1,45848900,45851505,2605,0.7947518768911433
18251,1528.397233,1528.4012,1,45851916,45852036,120,-0.09674624784449454
18252,1528.416833,1528.4401,1,45852504,45853203,699,0.7206175395032527
18253,1528.458733,1528.474767,1,45853761,45854243,482,0.5926511891048641
18254,1528.476967,1528.538267,1,45854309,45856148,1839,0.7753233384755307
18255,1528.723967,1528.827933,1,45861719,45864837,3118,0.83086219343079
18256,1528.860433,1528.871133,1,45865812,45866133,321,-0.06809350133800032
18257,1528.8832,1528.8867,1,45866496,45866601,105,-0.07305320220797061
18258,1528.899067,1528.907633,1,45866972,45867228,256,0.2617023975681484
18259,1528.985933,1529.013767,1,45869577,45870413,836,0.8294565361398332
18260,1529.019267,1529.140333,1,45870578,45874209,3631,0.8332445486733312
18261,1529.1444,1529.150067,1,45874332,45874502,170,0.056938985476905464
18262,1529.155167,1529.186867,1,45874655,45875606,951,0.035722652901882236
18263,1529.1921,1529.200133,1,45875763,45876003,240,0.1716583718353937
18264,1529.2012,1529.219867,1,45876036,45876596,560,0.016906048168633964
18265,1529.2289,1529.2323,1,45876867,45876969,102,
18266,1529.2359,1529.240867,1,45877077,45877226,149,-0.0885448259615016
18267,1529.245,1529.383767,1,45877350,45881513,4163,0.824945953237946
18268,1529.393333,1529.405567,1,45881799,45882167,368,0.7346439208632078
18269,1529.408833,1529.486867,1,45882264,45884606,2342,0.8197817531910341
18270,1529.511867,1529.589367,1,45885356,45887681,2325,0.7223048816656343
18271,1529.591067,1529.682167,1,45887732,45890465,2733,0.8155339546124821
18272,1529.6884,1529.722033,1,45890652,45891660,1008,0.8304691816553463
18273,1529.726867,1529.7352,1,45891806,45892056,250,0.4390952956158556
18274,1529.7395,1529.764667,1,45892185,45892940,755,0.002249031057143422
18275,1529.766233,1529.772133,1,45892986,45893163,177,
18276,1529.774033,1529.801233,1,45893220,45894036,816,0.12083187402993815
18277,1529.878133,1529.9423,1,45896343,45898269,1926,0.8051159970264884
18278,1529.947,1529.954233,1,45898410,45898626,216,0.8470308586782744
18279,1529.9557,1530.054467,1,45898671,45901634,2963,0.6684800843471381
18280,1530.072567,1530.1,1,45902177,45903000,823,0.8134750332252215
18281,1530.101767,1530.144333,1,45903053,45904329,1276,0.753107018982571
18282,1530.1692,1530.234167,1,45905076,45907025,1949,0.7953128766065581
18283,1530.240767,1530.258933,1,45907223,45907767,544,0.7687599836098369
18284,1530.2622,1530.2705,1,45907866,45908115,249,0.46760683588734187
18285,1530.271867,1530.281333,1,45908156,45908439,283,0.4422820184611364
18286,1530.293133,1530.3115,1,45908793,45909345,552,-0.06734939728283998
18287,1530.323967,1530.333067,1,45909719,45909992,273,-0.078710841478347
18288,1530.340967,1530.351,1,45910229,45910530,301,-0.06392103721645756
18289,1530.390433,1530.4152,1,45911712,45912456,744,0.6128846864673655
18290,1530.422633,1530.654167,1,45912678,45919625,6947,0.7587589976125577
18291,1530.670567,1530.692167,1,45920117,45920765,648,-0.0594728233937658
18292,1530.693333,1530.700767,1,45920799,45921023,224,0.15552367157200572
18293,1530.702267,1530.713,1,45921068,45921390,322,-0.03887133048224163
18294,1530.718433,1530.722733,1,45921552,45921681,129,
18295,1530.740433,1530.928967,1,45922212,45927869,5657,0.8195357977227028
18296,1530.931167,1530.983767,1,45927935,45929513,1578,0.7978217742298822
18297,1531.001767,1531.007333,1,45930053,45930219,166,0.1740225971772279
18298,1531.013667,1531.0265,1,45930410,45930795,385,0.8339922779962176
18299,1531.028867,1531.133933,1,45930866,45934017,3151,0.8613780352524756
18300,1531.1971,1531.201333,1,45935913,45936039,126,
18301,1531.209867,1531.2196,1,45936296,45936588,292,-0.047595828211632586
18302,1531.3081,1531.364633,1,45939243,45940938,1695,0.22824809464957846
18303,1531.4255,1531.4319,1,45942765,45942957,192,0.1545467880694689
18304,1531.433567,1531.4414,1,45943007,45943242,235,0.18327858092359653
18305,1531.4459,1531.457433,1,45943377,45943722,345,0.5153348410916373
18306,1531.459,1531.5546,1,45943770,45946638,2868,0.7985881708743324
18307,1531.5891,1531.598367,1,45947673,45947951,278,0.5572253463369076
18308,1531.613533,1531.634633,1,45948405,45949038,633,-0.09362617322321702
18309,1531.6367,1531.645367,1,45949101,45949361,260,-0.11026856812699584
18310,1531.650433,1531.6547,1,45949512,45949641,129,0.029128280955265436
18311,1531.664733,1531.893133,1,45949941,45956793,6852,0.8058744838355835
18312,1531.897467,1531.913667,1,45956924,45957410,486,0.6818229180095582
18313,1531.918967,1531.930667,1,45957569,45957920,351,0.6175049602087485
18314,1531.951367,1531.9687,1,45958541,45959061,520,-0.013265424106160321
18315,1531.969733,1531.979067,1,45959091,45959372,281,0.04571723320191641
18316,1531.9803,1531.983633,1,45959409,45959508,99,-0.2690667168758189
18317,1531.993,1532.112633,1,45959790,45963378,3588,0.8553935287679955
18318,1532.125067,1532.1298,1,45963752,45963894,142,0.04768898808065531
18319,1532.136433,1532.153467,1,45964092,45964604,512,-0.004112604064494821
18320,1532.1582,1532.1877,1,45964746,45965631,885,0.110997800017571
18321,1532.234167,1532.249033,1,45967025,45967470,445,0.44007124885000715
18322,1532.250633,1532.289233,1,45967518,45968676,1158,0.8364168615182653
18323,1532.2963,1532.300133,1,45968889,45969003,114,
18324,1532.3012,1532.31,1,45969036,45969300,264,0.8238809546787056
18325,1532.311433,1532.341733,1,45969342,45970251,909,0.8403623011376132
18326,1532.358467,1532.3771,1,45970754,45971313,559,-0.021103461517062678
18327,1532.386767,1532.395933,1,45971603,45971877,274,0.19290709552061713
18328,1532.4002,1532.415567,1,45972006,45972467,461,0.06136125910217609
18329,1532.4167,1532.4247,1,45972501,45972741,240,0.2754452722529304
18330,1532.431567,1532.4354,1,45972947,45973062,115,0.1601114378386787
18331,1532.444233,1532.4535,1,45973326,45973605,279,0.0873847367569927
18332,1532.460367,1532.5246,1,45973811,45975738,1927,0.3489201704812163
18333,1532.6406,1532.7542,1,45979218,45982626,3408,0.7044746291615377
18334,1532.776567,1532.7905,1,45983297,45983715,418,-0.04779771659120175
18335,1532.7936,1532.8015,1,45983808,45984045,237,-0.0659677686983173
18336,1532.8029,1532.810533,1,45984087,45984315,228,0.3260497172363444
18337,1532.814933,1532.820567,1,45984447,45984617,170,-0.006777316521762931
18338,1532.843933,1532.869467,1,45985317,45986084,767,0.7583601721336479
18339,1532.871333,1533.0852,1,45986139,45992556,6417,0.819459439790918
18340,1533.1046,1533.186533,1,45993138,45995595,2457,0.7901859124331811
18341,1533.1969,1533.2052,1,45995907,45996156,249,0.33055818319195546
18342,1533.225433,1533.237167,1,45996762,45997115,353,-0.051324252303266586
18343,1533.246333,1533.2506,1,45997389,45997518,129,-0.07252393978848556
18344,1533.2597,1533.2691,1,45997791,45998073,282,0.5098420189691559
18345,1533.312967,1533.324233,1,45999389,45999726,337,0.5489989938223396
18346,1533.325833,1533.360167,1,45999774,46000805,1031,0.6657453170816698
18347,1533.460933,1533.5798,1,46003827,46007394,3567,0.7924408602938063
18348,1533.5943,1533.600733,1,46007829,46008021,192,-0.06638616415758784
18349,1533.609833,1533.632867,1,46008294,46008986,692,0.05268658709427528
18350,1533.6367,1533.6447,1,46009101,46009341,240,0.07352059861339125
18351,1533.652367,1533.656767,1,46009571,46009703,132,0.023743400256617368
18352,1533.708867,1533.751567,1,46011266,46012547,1281,0.6364480484361299
18353,1533.777367,1533.792467,1,46013321,46013774,453,0.4851995941873862
18354,1533.801767,1533.810433,1,46014053,46014312,259,-0.02711661529030823
18355,1533.825267,1533.833233,1,46014758,46014996,238,-0.05518553367104002
18356,1533.8424,1533.8507,1,46015272,46015521,249,-0.15367211460145433
18357,1533.859533,1533.874267,1,46015785,46016228,443,0.3310306019981588
18358,1533.885567,1533.900933,1,46016567,46017027,460,0.46631110641924617
18359,1533.911333,1533.930867,1,46017339,46017926,587,0.1999897215557586
18360,1533.9477,1533.959033,1,46018431,46018770,339,-0.10185474788652925
18361,1533.960833,1533.965233,1,46018824,46018956,132,0.050996782042427156
18362,1533.9725,1533.977833,1,46019175,46019334,159,-0.06165907088475295
18363,1533.985033,1533.991367,1,46019550,46019741,191,-0.09747349656338754
18364,1534.019633,1534.0679,1,46020588,46022037,1449,0.30764756410458627
18365,1534.0839,1534.095833,1,46022517,46022874,357,-0.030721253781705045
18366,1534.097067,1534.1013,1,46022912,46023039,127,0.04716663022949402
18367,1534.162033,1534.165667,1,46024860,46024970,110,
18368,1534.170267,1534.173567,1,46025108,46025207,99,-0.41443364390615783
18369,1534.197067,1534.2092,1,46025912,46026276,364,0.5791643609453204
18370,1534.313433,1534.316667,1,46029402,46029500,98,0.7036855982324325
18371,1534.3747,1534.3837,1,46031241,46031511,270,0.6634498333212298
18372,1534.386067,1534.391733,1,46031582,46031751,169,0.1652932005237669
18373,1534.419867,1534.423167,1,46032596,46032695,99,0.3357500391102519
18374,1534.424333,1534.441133,1,46032729,46033233,504,0.5182792606506049
18375,1534.443633,1534.461467,1,46033308,46033844,536,0.9158652877071876
18376,1534.4959,1534.5124,1,46034877,46035372,495,0.752793432062888
18377,1534.542033,1534.553333,1,46036260,46036599,339,0.6240667413717529
18378,1534.556667,1534.563733,1,46036700,46036911,211,0.5517344349915958
18379,1534.5877,1534.597967,1,46037631,46037939,308,0.3343465985846601
18380,1534.6036,1534.608467,1,46038108,46038254,146,-0.1856547891899509
18381,1534.612467,1534.6358,1,46038374,46039074,700,0.04480961786704215
18382,1534.636933,1534.644567,1,46039107,46039337,230,0.19263274389425183
18383,1534.6467,1534.661967,1,46039401,46039859,458,0.18580585225853496
18384,1534.663933,1534.673967,1,46039917,46040219,302,0.08552636079763835
18385,1534.719267,1534.831,1,46041578,46044930,3352,0.8169932466035124
18386,1534.845,1534.858333,1,46045350,46045749,399,0.28918916701801756
18387,1534.868667,1534.894,1,46046060,46046820,760,0.055937608342125154
18388,1534.895,1534.914333,1,46046850,46047429,579,0.16447936647778674
18389,1534.921833,1534.93,1,46047654,46047900,246,0.32098607266574536
18390,1534.937933,1534.941,1,46048137,46048230,93,
18391,1534.9683,1534.975033,1,46049049,46049250,201,0.19340116887426242
18392,1534.976367,1534.9821,1,46049291,46049463,172,0.36839100140891373
18393,1534.983133,1535.011967,1,46049493,46050359,866,0.2510318139060268
18394,1535.014467,1535.017933,1,46050434,46050537,103,
18395,1535.027233,1535.035233,1,46050816,46051056,240,-0.051156510701335346
18396,1535.040833,1535.050533,1,46051224,46051515,291,0.3810411141806664
18397,1535.056,1535.066233,1,46051680,46051986,306,0.3393834431328374
18398,1535.280367,1535.291933,1,46058411,46058757,346,0.6719236225289894
18399,1535.294167,1535.321167,1,46058825,46059635,810,0.460183478196503
18400,1535.3325,1535.358633,1,46059975,46060758,783,0.4000177768573952
18401,1535.360733,1535.382133,1,46060821,46061463,642,0.576030055498203
18402,1535.406367,1535.421067,1,46062191,46062632,441,0.49491083334844105
18403,1535.426333,1535.4496,1,46062789,46063488,699,0.6691400912999774
18404,1535.4511,1535.514433,1,46063533,46065432,1899,0.759507847438836
18405,1535.575267,1535.580333,1,46067258,46067409,151,0.5082991651735518
18406,1535.6109,1535.616967,1,46068327,46068509,182,0.4573132083257996
18407,1535.624067,1535.780533,1,46068722,46073415,4693,0.7590761602898471
18408,1535.801233,1535.809333,1,46074036,46074279,243,0.500002975349283
18409,1535.8338,1535.8403,1,46075014,46075209,195,
18410,1535.8642,1535.867233,1,46075926,46076016,90,
18411,1536.2406,1536.244833,1,46087218,46087344,126,0.7629428538735091
18412,1536.2507,1536.2623,1,46087521,46087869,348,0.5615445692384738
18413,1536.263767,1536.318733,1,46087913,46089561,1648,0.6144060096860552
18414,1536.357,1536.391967,1,46090710,46091759,1049,0.7120021320540328
18415,1536.416033,1536.422867,1,46092480,46092686,206,0.7870116758022754
18416,1536.426367,1536.4346,1,46092791,46093038,247,0.7094170211674415
18417,1536.446333,1536.463767,1,46093389,46093913,524,0.6489472373061753
18418,1536.481933,1536.538267,1,46094457,46096148,1691,0.7294059951875753
18419,1536.562033,1536.566633,1,46096860,46096998,138,0.5795248706929716
18420,1536.5681,1536.577667,1,46097043,46097330,287,0.7194541473354722
18421,1536.598167,1536.612033,1,46097945,46098360,415,0.7932676482111171
18422,1536.6163,1536.6273,1,46098489,46098819,330,0.5479251449698601
18423,1536.659333,1536.708433,1,46099779,46101252,1473,0.10976417634671914
18424,1536.741767,1536.873167,1,46102253,46106195,3942,0.7510316204801487
18425,1536.890567,1536.898,1,46106717,46106940,223,-0.025242521563556886
18426,1536.935167,1536.938333,1,46108055,46108149,94,0.10449884902530868
18427,1536.9434,1536.9489,1,46108302,46108467,165,0.09147947558676386
18428,1537.090167,1537.114367,1,46112705,46113431,726,0.7162661994702275
18429,1537.116067,1537.241033,1,46113482,46117230,3748,0.8002560391349917
18430,1537.331,1537.335233,1,46119930,46120056,126,
18431,1537.341367,1537.443333,1,46120241,46123299,3058,0.8068677588496793
18432,1537.461167,1537.5471,1,46123835,46126413,2578,0.8353649462924888
18433,1537.579833,1537.583033,1,46127394,46127490,96,
18434,1537.589933,1537.593733,1,46127697,46127811,114,0.326441181258449
18435,1537.600333,1537.629233,1,46128009,46128876,867,-0.08727277935943978
18436,1537.631267,1537.636,1,46128938,46129080,142,0.3618587877169065
18437,1537.667033,1537.672533,1,46130010,46130175,165,0.7681361653145393
18438,1537.676,1537.8402,1,46130280,46135206,4926,0.8163488780935116
18439,1537.846167,1537.850867,1,46135385,46135526,141,0.4197585200085002
18440,1537.866567,1537.9326,1,46135997,46137978,1981,0.8186567659306927
18441,1537.951333,1537.9853,1,46138539,46139559,1020,0.7593681431907289
18442,1537.994533,1537.999167,1,46139835,46139975,140,0.160096903249833
18443,1538.007133,1538.034,1,46140213,46141020,807,0.030669147864824678
18444,1538.036133,1538.0513,1,46141083,46141539,456,0.06133142769591415
18445,1538.062833,1538.090767,1,46141884,46142723,839,0.7054590903602689
18446,1538.100767,1538.3182,1,46143023,46149546,6523,0.8267151619349487
18447,1538.3208,1538.347867,1,46149624,46150436,812,0.5682199086264621
18448,1538.3571,1538.3806,1,46150713,46151418,705,-0.001634907070368519
18449,1538.382,1538.391233,1,46151460,46151736,276,0.12139370020461232
18450,1538.394133,1538.4046,1,46151823,46152138,315,0.15858864498488764
18451,1538.411367,1538.415167,1,46152341,46152455,114,0.369654212651693
18452,1538.435067,1538.493567,1,46153052,46154807,1755,0.7348560052592564
18453,1538.494733,1538.511567,1,46154841,46155347,506,0.5373671242357639
18454,1538.5129,1538.5421,1,46155387,46156263,876,0.8158318620134556
18455,1538.560467,1538.583167,1,46156814,46157495,681,0.08001014897596595
18456,1538.586267,1538.593467,1,46157588,46157804,216,
18457,1538.604167,1538.770033,1,46158125,46163100,4975,0.8554041004466454
18458,1538.7781,1538.784,1,46163343,46163520,177,0.22115958006683467
18459,1538.7958,1538.815533,1,46163874,46164465,591,-0.05483029462116842
18460,1538.8168,1538.8379,1,46164504,46165137,633,0.1827058787497402
18461,1538.8408,1538.8439,1,46165224,46165317,93,
18462,1538.863967,1538.8872,1,46165919,46166616,697,0.646058715117386
18463,1538.890933,1538.990033,1,46166727,46169700,2973,0.8108239533423712
18464,1539.0249,1539.036233,1,46170747,46171086,339,0.007314308691346386
18465,1539.0388,1539.043533,1,46171164,46171305,141,0.0874323780013833
18466,1539.048833,1539.1834,1,46171464,46175502,4038,0.8035584561241855
18467,1539.272067,1539.282233,1,46178162,46178466,304,0.38049107533146326
18468,1539.2941,1539.3014,1,46178823,46179042,219,0.6246085943280084
18469,1539.3046,1539.345533,1,46179138,46180365,1227,0.6093147698720417
18470,1539.347933,1539.488967,1,46180437,46184669,4232,0.7940408841451668
18471,1539.4992,1539.531033,1,46184976,46185930,954,0.7580521464132302
18472,1539.557233,1539.610967,1,46186716,46188329,1613,0.7502365542417148
18473,1539.6123,1539.632267,1,46188369,46188968,599,0.7856417220250829
18474,1539.634933,1539.658233,1,46189047,46189746,699,0.6521521374162619
18475,1539.661033,1539.7497,1,46189830,46192491,2661,0.8371236573816608
18476,1539.752867,1539.7759,1,46192586,46193277,691,0.22288216732717658
18477,1539.7774,1539.900533,1,46193322,46197015,3693,0.8285911739728787
18478,1539.9019,1539.997033,1,46197057,46199910,2853,0.8260889847479029
18479,1539.9986,1540.0258,1,46199958,46200774,816,0.8536350750224546
18480,1540.029333,1540.125467,1,46200879,46203764,2885,0.8061214936752662
18481,1540.1284,1540.150767,1,46203852,46204523,671,0.8529444579979935
18482,1540.1518,1540.154833,1,46204554,46204644,90,0.818051723069788
18483,1540.158567,1540.246767,1,46204757,46207403,2646,0.7806772286259591
18484,1540.247867,1540.274467,1,46207436,46208234,798,0.8035255866342738
18485,1540.2775,1540.370167,1,46208325,46211105,2780,0.7963859919549297
18486,1540.376167,1540.399333,1,46211285,46211979,694,0.8419530558999181
18487,1540.402633,1540.492067,1,46212078,46214762,2684,0.794097343762939
18488,1540.4994,1540.523033,1,46214982,46215690,708,0.9203279261752519
18489,1540.525333,1540.602767,1,46215759,46218083,2324,0.7641776331021094
18490,1540.6099,1540.6259,1,46218297,46218777,480,0.6468052256296949
18491,1540.6305,1540.644933,1,46218915,46219347,432,0.5694850188461842
18492,1540.6586,1540.663633,1,46219758,46219908,150,0.5180722771781874
18493,1540.6685,1540.677667,1,46220055,46220330,275,-0.0167796288842348
18494,1540.686433,1540.694,1,46220592,46220820,228,-0.061264821075304496
18495,1540.7031,1540.7073,1,46221093,46221219,126,0.16343957937394976
18496,1541.173133,1541.184667,1,46235193,46235540,347,0.7108170223465142
18497,1541.2033,1541.210167,1,46236099,46236305,206,0.6004995403969916
18498,1541.234567,1541.335467,1,46237037,46240064,3027,0.7749219549211548
18499,1541.3698,1541.372833,1,46241094,46241184,90,0.35592818544577204
18500,1541.4085,1541.4513,1,46242255,46243539,1284,0.6056451306281746
18501,1541.459,1541.4891,1,46243770,46244673,903,0.8009627374838234
18502,1541.5281,1541.5376,1,46245843,46246128,285,0.3048408256923113
18503,1541.5461,1541.561833,1,46246383,46246854,471,-0.07921909163672625
18504,1541.563667,1541.581267,1,46246910,46247438,528,0.22840957275624088
18505,1541.5823,1541.593267,1,46247469,46247798,329,0.4795033699050583
18506,1541.5969,1541.7205,1,46247907,46251615,3708,0.8130275645291111
18507,1541.728367,1541.803833,1,46251851,46254114,2263,0.7782358538026434
18508,1541.807433,1541.811433,1,46254222,46254342,120,0.5898782382333814
18509,1541.826967,1541.9138,1,46254809,46257414,2605,0.7618515825729631
18510,1541.921567,1541.937067,1,46257647,46258112,465,-0.018193519340772374
18511,1541.938233,1541.955467,1,46258146,46258664,518,0.16334992263405826
18512,1541.957433,1541.966867,1,46258722,46259006,284,0.2989886477095757
18513,1541.9679,1541.971433,1,46259037,46259142,105,
18514,1541.972767,1541.9777,1,46259183,46259331,148,-0.09063924277477785
18515,1541.9901,1541.9959,1,46259703,46259877,174,0.23646356203052885
18516,1542.002133,1542.018167,1,46260063,46260545,482,0.44238815052869146
18517,1542.020333,1542.1193,1,46260609,46263579,2970,0.7949646201414948
18518,1542.1531,1542.165767,1,46264593,46264973,380,-0.09348701550657165
18519,1542.1697,1542.3393,1,46265091,46270179,5088,0.8235823188407715
18520,1542.3452,1542.422133,1,46270356,46272663,2307,0.8108710206111612
18521,1542.441567,1542.4477,1,46273247,46273431,184,-0.11365190199914957
18522,1542.4546,1542.4709,1,46273638,46274127,489,0.1683017766032934
18523,1542.4756,1542.484567,1,46274268,46274537,269,0.19939025605478986
18524,1542.497367,1542.5006,1,46274921,46275018,97,
18525,1542.552033,1542.677933,1,46276560,46280337,3777,0.8393005672842466
18526,1542.697233,1542.706767,1,46280916,46281203,287,-0.07898579601089847
18527,1542.707767,1542.7111,1,46281233,46281333,100,0.09305323811753949
18528,1542.7121,1542.720067,1,46281363,46281602,239,-0.05677562395351892
18529,1542.728967,1542.7327,1,46281869,46281981,112,
18530,1542.9792,1542.987233,1,46289376,46289616,240,0.6315600402134697
18531,1542.991433,1543.0107,1,46289742,46290321,579,0.4279313554441474
18532,1543.0132,1543.023467,1,46290396,46290704,308,0.5820158343952737
18533,1543.046567,1543.189567,1,46291397,46295687,4290,0.7224091936695263
18534,1543.196867,1543.246633,1,46295906,46297398,1492,0.7724797546466082
18535,1543.265567,1543.286333,1,46297967,46298589,622,-0.01428705500614829
18536,1543.287367,1543.309333,1,46298621,46299279,658,0.24047174904575247
18537,1543.3211,1543.332967,1,46299633,46299989,356,0.5250458959038313
18538,1543.3357,1543.481967,1,46300071,46304459,4388,0.8430763714629447
18539,1543.508467,1543.634633,1,46305254,46309038,3784,0.7331190484983764
18540,1543.639433,1543.7014,1,46309182,46311042,1860,0.8110022786308414
18541,1543.706733,1543.7287,1,46311201,46311861,660,0.7176729919259662
18542,1543.7297,1543.7396,1,46311891,46312188,297,0.2835231420251265
18543,1543.757033,1543.775167,1,46312710,46313255,545,-0.046079348818940435
18544,1543.7765,1543.783233,1,46313295,46313496,201,0.12772282441405544
18545,1543.784367,1543.794867,1,46313531,46313846,315,0.16132894334822756
18546,1543.8055,1543.809333,1,46314165,46314279,114,
18547,1543.829067,1543.9409,1,46314872,46318227,3355,0.7855666664594014
18548,1543.954733,1543.976267,1,46318641,46319288,647,-0.0921559330707312
18549,1544.000867,1544.151533,1,46320026,46324545,4519,0.830929350467981
18550,1544.1837,1544.198567,1,46325511,46325957,446,0.05551599360667134
18551,1544.5998,1544.637,1,46337994,46339110,1116,0.6601714967997317
18552,1544.660533,1544.674,1,46339815,46340220,405,0.7786540364358425
18553,1544.6999,1544.7084,1,46340997,46341252,255,0.8674781729490254
18554,1544.722967,1544.7411,1,46341689,46342233,544,0.696263102031621
18555,1544.778633,1544.786967,1,46343358,46343609,251,0.2960729287813343
18556,1544.794867,1544.8009,1,46343846,46344027,181,-0.05764658752784601
18557,1544.803067,1544.822067,1,46344092,46344662,570,0.17498840646780509
18558,1544.8311,1544.834833,1,46344933,46345044,111,0.01591277989790449
18559,1544.863167,1544.9484,1,46345895,46348452,2557,0.7953579783504688
18560,1544.9525,1544.9573,1,46348575,46348719,144,0.7137142849531085
18561,1544.9621,1544.9685,1,46348863,46349055,192,0.3918806222845957
18562,1544.972633,1545.165333,1,46349178,46354959,5781,0.6876307790775732
18563,1545.941633,1545.9465,1,46378248,46378395,147,0.5694721534964103
18564,1545.9625,1545.967133,1,46378875,46379013,138,0.7367130742357351
18565,1545.988867,1545.998467,1,46379666,46379954,288,0.7742902628651588
18566,1546.0133,1546.037267,1,46380399,46381118,719,0.8509988751273867
18567,1546.088033,1546.094167,1,46382640,46382825,185,0.8352777672939387
18568,1546.1186,1546.121867,1,46383558,46383656,98,0.7366462342572414
18569,1546.132033,1546.1385,1,46383960,46384155,195,0.7129548100091146
18570,1546.151267,1546.163567,1,46384538,46384907,369,0.5134161226469701
18571,1546.185433,1546.199967,1,46385562,46385999,437,0.5075776432067662
18572,1546.2551,1546.263167,1,46387653,46387895,242,0.6708561178329646
18573,1546.264367,1546.2756,1,46387931,46388268,337,0.597873893917787
18574,1546.307633,1546.310633,1,46389228,46389318,90,0.2760240078811372
18575,1546.8209,1546.848033,1,46404627,46405440,813,0.6131628522672651
18576,1546.8492,1546.8603,1,46405476,46405809,333,0.6304597353487104
18577,1546.8831,1546.892067,1,46406493,46406762,269,0.6225780566716459
18578,1546.897133,1546.9232,1,46406913,46407696,783,0.7153185216178508
18579,1546.949533,1547.012833,1,46408485,46410384,1899,0.6714484762612675
18580,1547.029267,1547.032867,1,46410878,46410986,108,0.7690933476150698
18581,1547.034267,1547.0725,1,46411028,46412175,1147,0.7413158611505454
18582,1547.089733,1547.1346,1,46412691,46414038,1347,0.7149407986406097
18583,1547.154033,1547.1706,1,46414620,46415118,498,0.7519046866278937
18584,1547.1901,1547.201633,1,46415703,46416048,345,0.7850125214449073
18585,1547.211067,1547.230867,1,46416332,46416926,594,0.6640422462300849
18586,1547.561167,1547.578167,1,46426835,46427345,510,0.5877582765360508
18587,1547.5916,1547.621967,1,46427748,46428659,911,0.819070429604438
18588,1547.642033,1547.6689,1,46429260,46430067,807,0.8805288995946878
18589,1547.669967,1547.682233,1,46430099,46430466,367,0.6618311546977084
18590,1547.6869,1547.7403,1,46430607,46432209,1602,0.6838603961443178
18591,1547.756367,1547.777933,1,46432691,46433337,646,0.67549651077904
18592,1547.7811,1547.854433,1,46433433,46435632,2199,0.6055485485648509
18593,1547.869133,1547.885133,1,46436073,46436553,480,0.6618497353908056
18594,1547.888433,1547.891433,1,46436652,46436742,90,0.25099285053033255
18595,1547.894233,1547.9133,1,46436826,46437399,573,0.5910797911766963
18596,1547.944967,1547.9525,1,46438349,46438575,226,0.3602208550212265
18597,1547.958133,1547.973633,1,46438743,46439208,465,0.557973528166516
18598,1547.993567,1548.0163,1,46439807,46440489,682,0.7527275564196365
18599,1548.034033,1548.037933,1,46441020,46441137,117,0.7151299769384922
18600,1548.063867,1548.075933,1,46441916,46442277,361,0.05036396986072966
18601,1548.0786,1548.089467,1,46442358,46442684,326,-0.02187443549327506
18602,1548.090767,1548.0994,1,46442723,46442982,259,0.4982832908862764
18603,1548.120033,1548.123333,1,46443600,46443699,99,0.4118606552828745
18604,1548.132433,1548.148867,1,46443972,46444466,494,0.7002428031632245
18605,1548.151233,1548.2192,1,46444536,46446576,2040,0.7991365724674949
18606,1548.2269,1548.2533,1,46446807,46447599,792,0.8138186493155565
18607,1548.305567,1548.310333,1,46449167,46449309,142,0.022361936358313243
18608,1548.314067,1548.323433,1,46449422,46449702,280,0.07893942570216649
18609,1548.324667,1548.333367,1,46449740,46450001,261,-0.12808948932424435
18610,1548.339567,1548.460867,1,46450187,46453826,3639,0.776259819223688
18611,1548.486,1548.4952,1,46454580,46454856,276,-0.014658439355955066
18612,1548.5563,1548.560033,1,46456689,46456800,111,0.3536575226081011
18613,1548.567467,1548.5816,1,46457024,46457448,424,0.7205901330255322
18614,1548.582733,1548.801133,1,46457481,46464033,6552,0.7603761816589123
18615,1548.805667,1548.894167,1,46464170,46466825,2655,0.6177254015420858
18616,1548.9151,1549.001067,1,46467453,46470032,2579,0.8001782922866973
18617,1549.009267,1549.08,1,46470278,46472400,2122,0.8016598184582417
18618,1549.082533,1549.088033,1,46472475,46472640,165,0.345138303217622
18619,1549.0948,1549.111967,1,46472844,46473359,515,0.8096623880117195
18620,1549.122167,1549.131233,1,46473665,46473936,271,-0.29606249312096805
18621,1549.309733,1549.411033,1,46479291,46482330,3039,0.8134326025441582
18622,1549.8768,1549.908767,1,46496304,46497263,959,0.6239015098005098
18623,1549.970033,1549.977067,1,46499100,46499312,212,0.42965040090129963
18624,1550.0792,1550.0882,1,46502376,46502646,270,0.5736388920543783
18625,1550.135867,1550.153767,1,46504076,46504613,537,0.5713407651042536
18626,1550.219167,1550.24,1,46506575,46507200,625,0.29859358338572467
18627,1550.271733,1550.385367,1,46508151,46511561,3410,0.7832346546102893
18628,1550.392833,1550.395967,1,46511784,46511879,95,0.7178452825894521
18629,1550.397433,1550.529633,1,46511922,46515888,3966,0.8174012109793474
18630,1550.595567,1550.694167,1,46517867,46520825,2958,0.7774757287880137
18631,1550.707267,1550.714733,1,46521218,46521441,223,-0.055733142866716504
18632,1551.045767,1551.0508,1,46531373,46531524,151,0.7429364862537486
18633,1551.066667,1551.1021,1,46532000,46533063,1063,0.7999808130760796
18634,1551.106067,1551.1417,1,46533182,46534251,1069,0.7181904133850125
18635,1551.160267,1551.285367,1,46534808,46538561,3753,0.7996678410573285
18636,1551.291933,1551.373067,1,46538757,46541192,2435,0.7786118164562026
18637,1551.376767,1551.4277,1,46541303,46542831,1528,0.6936089229522887
18638,1551.448167,1551.458567,1,46543445,46543757,312,-0.03596549506659179
18639,1551.462333,1551.4907,1,46543869,46544721,852,0.1929262977990245
18640,1551.5084,1551.515167,1,46545252,46545455,203,-0.13960799773419547
18641,1551.5167,1551.692733,1,46545501,46550781,5280,0.7681205951603066
18642,1551.7131,1551.740633,1,46551393,46552218,825,0.832088945691382
18643,1551.743333,1551.814,1,46552299,46554420,2121,0.7921301611869306
18644,1551.816,1551.819467,1,46554480,46554584,104,
18645,1551.8419,1551.848433,1,46555257,46555452,195,0.14877199553667803
18646,1551.8824,1551.888867,1,46556472,46556666,194,
18647,1552.201767,1552.250133,1,46566053,46567503,1450,0.6748090517083848
18648,1552.259867,1552.281733,1,46567796,46568451,655,0.548883232195303
18649,1552.2884,1552.302267,1,46568652,46569068,416,0.455878624752337
18650,1552.3419,1552.373767,1,46570257,46571213,956,0.4991679023799793
18651,1552.388833,1552.4383,1,46571664,46573149,1485,0.5233339238342178
18652,1552.443167,1552.5391,1,46573295,46576173,2878,0.6400481626495303
18653,1552.5488,1552.567067,1,46576464,46577012,548,0.6989575053445798
18654,1552.574667,1552.577833,1,46577240,46577334,94,0.25333839196835106
18655,1552.583933,1552.630767,1,46577517,46578923,1406,0.6915039347832959
18656,1552.6548,1552.679567,1,46579644,46580387,743,0.5635442853001114
18657,1552.711467,1552.715767,1,46581344,46581473,129,0.18340129785169454
18658,1552.719467,1552.765033,1,46581584,46582950,1366,0.052444998385942944
18659,1552.7701,1552.773333,1,46583103,46583199,96,0.463726376275388
18660,1552.783533,1552.896133,1,46583505,46586883,3378,0.8032158865292972
18661,1552.914433,1552.923867,1,46587432,46587716,284,-0.09804012069553253
18662,1552.9277,1552.9469,1,46587831,46588407,576,0.15377204612835374
18663,1552.9517,1553.129767,1,46588551,46593893,5342,0.7968748605761696
18664,1553.158267,1553.2403,1,46594748,46597209,2461,0.7811940043809067
18665,1553.259833,1553.2832,1,46597794,46598496,702,-0.02684734266440604
18666,1553.332667,1553.337433,1,46599980,46600122,142,0.46876916310350036
18667,1553.3495,1553.3585,1,46600485,46600755,270,0.763341872449529
18668,1553.3616,1553.373967,1,46600848,46601219,371,0.3556857237370563
18669,1553.379333,1553.400667,1,46601379,46602020,641,0.7081938526961143
18670,1553.407433,1553.4292,1,46602222,46602876,654,0.6113375298735069
18671,1553.433333,1553.5254,1,46602999,46605762,2763,0.6851421756256894
18672,1553.534933,1553.607533,1,46606047,46608225,2178,0.8109705381078134
18673,1553.638033,1553.6635,1,46609140,46609905,765,0.6594635283337393
18674,1553.6667,1553.745833,1,46610001,46612374,2373,0.7777014500180769
18675,1553.747767,1553.7728,1,46612433,46613184,751,0.2889073784592614
18676,1553.776033,1553.840767,1,46613280,46615223,1943,0.7921778864192671
18677,1553.8424,1553.89,1,46615272,46616700,1428,0.7161795573095282
18678,1553.892767,1553.983133,1,46616783,46619493,2710,0.7613452163338246
18679,1553.9865,1554.0121,1,46619595,46620363,768,0.8035860993821701
18680,1554.015467,1554.108667,1,46620464,46623260,2796,0.8216423148065685
18681,1554.112967,1554.134067,1,46623389,46624022,633,0.8425630341807541
18682,1554.1406,1554.235267,1,46624218,46627058,2840,0.8170003015653422
18683,1554.2423,1554.2651,1,46627269,46627953,684,0.8500069636344316
18684,1554.2677,1554.364567,1,46628031,46630937,2906,0.7910392657488576
18685,1554.367567,1554.5233,1,46631027,46635699,4672,0.7916293707878976
18686,1554.527,1554.623867,1,46635810,46638716,2906,0.8253369307375161
18687,1554.627633,1554.631933,1,46638828,46638957,129,0.34949914440505603
18688,1554.635,1554.654033,1,46639050,46639620,570,0.8101491488125779
18689,1554.657867,1554.754867,1,46639736,46642646,2910,0.8219289545196087
18690,1554.758367,1554.7745,1,46642751,46643235,484,0.7074789635258715
18691,1554.7893,1554.8456,1,46643679,46645368,1689,0.7646207620536701
18692,1554.871033,1554.880933,1,46646130,46646427,297,0.6790314440053457
18693,1554.8865,1554.890533,1,46646595,46646715,120,0.5182915857868075
18694,1554.8957,1554.899467,1,46646871,46646984,113,0.7949813341966331
18695,1554.9161,1554.9705,1,46647483,46649115,1632,0.773293404462414
18696,1554.994033,1555.006567,1,46649820,46650197,377,0.6883872958667395
18697,1555.013733,1555.017333,1,46650411,46650519,108,-0.046965663866608366
18698,1555.042733,1555.0836,1,46651281,46652508,1227,0.8260950126617506
18699,1555.086367,1555.1002,1,46652591,46653006,415,0.6780616238894475
18700,1555.123367,1555.134167,1,46653701,46654025,324,0.7204845113793541
18701,1555.143967,1555.1605,1,46654319,46654815,496,0.886776182371037
18702,1555.1716,1555.211067,1,46655148,46656332,1184,0.7512869365157859
18703,1555.215,1555.227533,1,46656450,46656825,375,0.6410943082461161
18704,1555.257567,1555.261833,1,46657727,46657854,127,0.22684149218387029
18705,1555.268033,1555.278933,1,46658040,46658367,327,0.3451353365099744
18706,1555.283233,1555.2871,1,46658496,46658613,117,0.7943093792856907
18707,1555.290733,1555.297833,1,46658721,46658934,213,0.7765907278997691
18708,1555.3008,1555.352133,1,46659024,46660563,1539,0.5014233206765291
18709,1555.368533,1555.372767,1,46661055,46661183,128,
18710,1555.3743,1555.3913,1,46661229,46661739,510,0.31701904006360987
18711,1555.4046,1555.460667,1,46662138,46663820,1682,0.7585029659938671
18712,1555.507,1555.511,1,46665210,46665330,120,0.36915144033533087
18713,1555.777567,1555.806933,1,46673327,46674207,880,0.5877625756578981
18714,1555.835033,1555.854333,1,46675050,46675629,579,0.6013643567842907
18715,1556.005633,1556.008867,1,46680168,46680266,98,-0.02967769550155311
18716,1556.0159,1556.236967,1,46680477,46687109,6632,0.7861901235507606
18717,1556.243267,1556.264533,1,46687298,46687935,637,0.6890161574348742
18718,1556.266367,1556.295667,1,46687991,46688870,879,0.7275314196746884
18719,1556.297933,1556.327133,1,46688937,46689813,876,0.8042575455089978
18720,1556.3293,1556.337,1,46689879,46690110,231,0.702842795475684
18721,1556.365933,1556.430933,1,46690977,46692927,1950,0.7904959901905112
18722,1556.4421,1556.453,1,46693263,46693590,327,0.5705826078973867
18723,1556.4785,1556.482333,1,46694355,46694469,114,0.06137785373258442
18724,1556.4836,1556.489667,1,46694508,46694690,182,-0.029411710666106903
18725,1556.498133,1556.502767,1,46694943,46695083,140,0.3176880576037157
18726,1556.5038,1556.5084,1,46695114,46695252,138,-0.3136141258271412
18727,1556.5415,1556.601533,1,46696245,46698045,1800,0.744054822859965
18728,1556.603367,1556.6524,1,46698101,46699572,1471,0.8510985097171236
18729,1556.6709,1556.6742,1,46700127,46700226,99,
18730,1556.6755,1556.6863,1,46700265,46700589,324,0.07762376577703411
18731,1556.687833,1556.703733,1,46700634,46701111,477,0.0765900896366839
18732,1556.717767,1556.930067,1,46701533,46707902,6369,0.7663166703886828
18733,1557.036733,1557.089267,1,46711101,46712678,1577,0.7134820299872171
18734,1557.0927,1557.1228,1,46712781,46713684,903,0.7097227016183719
18735,1557.1261,1557.147633,1,46713783,46714428,645,0.5844446552734613
18736,1557.155667,1557.226033,1,46714670,46716780,2110,0.7680653722772405
18737,1557.2272,1557.279267,1,46716816,46718378,1562,0.7698626667008733
18738,1557.284967,1557.3572,1,46718549,46720716,2167,0.6820707344529162
18739,1557.359567,1557.463733,1,46720787,46723911,3124,0.7777138774861325
18740,1557.466533,1557.580733,1,46723995,46727421,3426,0.8116846198914345
18741,1557.583667,1557.670567,1,46727510,46730117,2607,0.845756736982786
18742,1557.674433,1557.6992,1,46730232,46730976,744,0.7292244919974228
18743,1557.7027,1557.816567,1,46731081,46734497,3416,0.8183890133404558
18744,1557.826,1557.9183,1,46734780,46737549,2769,0.7759169776519576
18745,1557.9198,1557.947133,1,46737594,46738413,819,0.7832200660840651
18746,1557.950367,1558.068033,1,46738511,46742040,3529,0.8040274216483243
18747,1558.0694,1558.073333,1,46742082,46742199,117,0.6677098316895763
18748,1558.082233,1558.163333,1,46742466,46744899,2433,0.8235550402899605
18749,1558.167067,1558.1796,1,46745012,46745388,376,0.8649726318788707
18750,1558.182967,1558.204267,1,46745489,46746128,639,0.837317751510307
18751,1558.212167,1558.307833,1,46746365,46749234,2869,0.8311917416613739
18752,1558.310467,1558.440667,1,46749314,46753220,3906,0.800704875188679
18753,1558.444633,1558.572433,1,46753338,46757172,3834,0.7685108016119956
18754,1558.576633,1558.5999,1,46757298,46757997,699,0.8168095862842117
18755,1558.607167,1558.705,1,46758215,46761150,2935,0.8220863791108993
18756,1558.710267,1558.725333,1,46761308,46761759,451,0.8182029890683674
18757,1558.7274,1558.733,1,46761822,46761990,168,0.8971653925636015
18758,1558.7407,1558.7998,1,46762221,46763994,1773,0.7601888483884188
18759,1558.8025,1558.8357,1,46764075,46765071,996,0.7451320771668227
18760,1558.847833,1558.8553,1,46765434,46765659,225,0.7953944916015818
18761,1558.871367,1558.912333,1,46766141,46767369,1228,0.7708675224720442
18762,1558.913533,1558.9664,1,46767405,46768992,1587,0.6988269716397151
18763,1558.974333,1558.978533,1,46769229,46769355,126,-0.2142244551995162
18764,1558.982167,1558.988867,1,46769465,46769666,201,-0.12210699887762415
18765,1559.0027,1559.0987,1,46770081,46772961,2880,0.8069928308206761
18766,1559.104133,1559.1203,1,46773123,46773609,486,0.4290259894173042
18767,1559.134067,1559.171833,1,46774022,46775154,1132,0.7623649815838917
18768,1559.174,1559.1892,1,46775220,46775676,456,0.7844369775187305
18769,1559.217333,1559.229767,1,46776519,46776893,374,0.9114358500457775
18770,1559.2362,1559.2424,1,46777086,46777272,186,0.590842839921543
18771,1559.2444,1559.2478,1,46777332,46777434,102,-0.29002407414410997
18772,1559.267333,1559.305933,1,46778019,46779177,1158,0.8090417143241162
18773,1559.309133,1559.3241,1,46779273,46779723,450,0.7086087366741847
18774,1559.3678,1559.371867,1,46781034,46781156,122,0.41620089175453956
18775,1559.377567,1559.384567,1,46781327,46781537,210,0.27259126424244784
18776,1559.398733,1559.435667,1,46781961,46783070,1109,0.7936077062916725
18777,1559.4402,1559.454433,1,46783206,46783632,426,0.7160284122409215
18778,1559.485433,1559.490033,1,46784562,46784700,138,0.4410644569052459
18779,1559.5032,1559.513133,1,46785096,46785393,297,0.68811518242739
18780,1559.5285,1559.567533,1,46785855,46787025,1170,0.668637424465834
18781,1559.573733,1559.584933,1,46787211,46787547,336,0.6459735452168187
18782,1559.611967,1559.620133,1,46788359,46788603,244,0.7154053035260173
18783,1559.6476,1559.6523,1,46789428,46789569,141,0.7473686202650879
18784,1559.6699,1559.697833,1,46790097,46790934,837,0.8694652132063008
18785,1559.7366,1559.765267,1,46792098,46792958,860,0.625886229582897
18786,1559.766733,1559.796033,1,46793001,46793880,879,0.07154502965628669
18787,1559.7979,1559.890233,1,46793937,46796706,2769,0.779754904174092
18788,1559.919067,1559.923067,1,46797572,46797692,120,
18789,1559.925433,1559.9386,1,46797762,46798158,396,0.41665783821805147
18790,1560.002533,1560.017933,1,46800075,46800537,462,0.8631341674613211
18791,1560.018933,1560.1206,1,46800567,46803618,3051,0.8070493489728597
18792,1560.1352,1560.138533,1,46804056,46804155,99,
18793,1560.141333,1560.1693,1,46804239,46805079,840,0.04094074147369101
18794,1560.1716,1560.190433,1,46805148,46805712,564,0.2739874662050606
18795,1560.201367,1560.4473,1,46806041,46813419,7378,0.8420359724832364
18796,1560.4523,1560.520467,1,46813569,46815614,2045,0.8012804521311181
18797,1560.5254,1560.576067,1,46815762,46817282,1520,0.7495368207019987
18798,1560.578433,1560.6015,1,46817352,46818045,693,0.7075473821083003
18799,1560.603033,1560.649,1,46818090,46819470,1380,0.7575391330383925
18800,1560.6557,1560.7354,1,46819671,46822062,2391,0.8001610065467611
18801,1560.746133,1560.7543,1,46822383,46822629,246,
18802,1560.8019,1560.813567,1,46824057,46824407,350,0.24732911942302102
18803,1560.9295,1561.014967,1,46827885,46830449,2564,0.7620200121853794
18804,1561.016233,1561.064167,1,46830486,46831925,1439,0.6422316954977768
18805,1561.071833,1561.1902,1,46832154,46835706,3552,0.7483614973334661
18806,1561.213833,1561.2169,1,46836414,46836507,93,
18807,1561.285567,1561.337533,1,46838567,46840125,1558,0.7418388155602388
18808,1561.3388,1561.390267,1,46840164,46841708,1544,0.7840377251217353
18809,1561.4009,1561.420867,1,46842027,46842626,599,0.7675795668685071
18810,1561.4224,1561.458967,1,46842672,46843769,1097,0.8381078121404987
18811,1561.4706,1561.522267,1,46844118,46845668,1550,0.8432055369265334
18812,1561.528467,1561.540433,1,46845854,46846212,358,0.5697235500642615
18813,1561.5527,1561.580533,1,46846581,46847415,834,0.740843590591637
18814,1561.582933,1561.605033,1,46847487,46848150,663,0.7942704666810134
18815,1561.607767,1561.714933,1,46848233,46851447,3214,0.7723673592135198
18816,1561.718633,1561.8138,1,46851558,46854414,2856,0.8344111238405071
18817,1561.816,1561.842433,1,46854480,46855272,792,0.8008428086029401
18818,1561.845967,1561.943633,1,46855379,46858308,2929,0.8381362822838763
18819,1561.946667,1561.963733,1,46858400,46858911,511,0.7556701669315007
18820,1561.964867,1561.9745,1,46858946,46859235,289,0.8444190675881141
18821,1561.978,1562.350033,1,46859340,46870500,11160,0.4622623469495924
18822,1562.351833,1562.380567,1,46870554,46871417,863,0.8368099385323885
18823,1562.382667,1562.482667,1,46871480,46874480,3000,0.8226818923809827
18824,1562.487833,1562.512667,1,46874634,46875380,746,0.891810476306471
18825,1562.516133,1562.6078,1,46875483,46878234,2751,0.7926779148130924
18826,1562.6113,1562.638133,1,46878339,46879143,804,0.9049448287941807
18827,1562.639967,1562.732333,1,46879199,46881969,2770,0.7940323040781206
18828,1562.734333,1562.762233,1,46882029,46882866,837,0.9383756780072551
18829,1562.765533,1562.822233,1,46882965,46884666,1701,0.8448563533379668
18830,1562.8233,1562.859367,1,46884699,46885781,1082,0.8236078451123805
18831,1562.862533,1562.866833,1,46885875,46886004,129,0.4960351433179279
18832,1562.867867,1562.8897,1,46886036,46886691,655,0.8450017209058617
18833,1562.8929,1562.9862,1,46886787,46889586,2799,0.8157161765704019
18834,1562.990667,1563.015133,1,46889720,46890453,733,0.8454802326708885
18835,1563.021033,1563.115667,1,46890630,46893470,2840,0.8035445917323378
18836,1563.1208,1563.124867,1,46893624,46893746,122,0.2509285291108513
18837,1563.128,1563.1479,1,46893840,46894437,597,0.8457210825256978
18838,1563.1525,1563.2513,1,46894575,46897539,2964,0.7949378849082923
18839,1563.257067,1563.2743,1,46897712,46898229,517,0.6235293933300142
18840,1563.2876,1563.328833,1,46898628,46899864,1236,0.8090898403102829
18841,1563.3324,1563.347,1,46899972,46900410,438,0.7215711815434322
18842,1563.366167,1563.380767,1,46900985,46901423,438,0.7532262336282786
18843,1563.3868,1563.401467,1,46901604,46902044,440,0.9008550900754612
18844,1563.4171,1563.4566,1,46902513,46903698,1185,0.7238204079410195
18845,1563.461533,1563.474467,1,46903845,46904234,389,0.601959668810226
18846,1563.547467,1563.588267,1,46906424,46907648,1224,0.6344564247232104
18847,1563.5902,1563.603367,1,46907706,46908101,395,0.5931948460820974
18848,1563.629633,1563.6395,1,46908888,46909185,297,0.687627452717892
18849,1563.6451,1563.6481,1,46909353,46909443,90,0.002641876337547504
18850,1563.6555,1563.659533,1,46909665,46909785,120,0.8498628326012618
18851,1563.6696,1563.673267,1,46910088,46910198,110,0.6688479071304693
18852,1563.690467,1563.702567,1,46910714,46911077,363,0.652184030195282
18853,1563.7052,1563.7129,1,46911156,46911387,231,0.6691098714241037
18854,1563.714,1563.726133,1,46911420,46911783,363,0.5732048063393803
18855,1563.7471,1563.7688,1,46912413,46913064,651,0.01618514164647221
18856,1563.775633,1563.785933,1,46913268,46913577,309,0.4782797932661082
18857,1563.787467,1563.795533,1,46913624,46913865,241,0.6572685544560471
18858,1563.843467,1563.9379,1,46915304,46918137,2833,0.7834879661814886
18859,1563.942467,1563.948567,1,46918274,46918457,183,-0.08653092311800148
18860,1563.954567,1563.959167,1,46918637,46918775,138,-0.2533206013616693
18861,1564.062,1564.114,1,46921860,46923420,1560,0.27994715721227814
18862,1564.124833,1564.1346,1,46923744,46924038,294,-0.09544682401093713
18863,1564.145833,1564.149533,1,46924374,46924485,111,-0.15798113944892528
18864,1564.1562,1564.1598,1,46924686,46924794,108,-0.23017713184352145
18865,1564.234633,1564.272067,1,46927038,46928162,1124,0.8065383040064996
18866,1564.279767,1564.2992,1,46928393,46928976,583,0.9064149245848299
18867,1564.3185,1564.375867,1,46929555,46931276,1721,0.7019228464265859
18868,1564.385133,1564.390533,1,46931553,46931715,162,0.6629451883193279
18869,1564.3987,1564.4105,1,46931961,46932315,354,0.744951911447485
18870,1564.411667,1564.425267,1,46932350,46932758,408,0.6726749472244434
18871,1564.440667,1564.483433,1,46933220,46934502,1282,0.08040615097301072
18872,1564.4851,1564.5074,1,46934553,46935222,669,0.14637484145130014
18873,1564.526367,1564.532467,1,46935791,46935974,183,0.1711941141974611
18874,1564.561833,1564.605267,1,46936854,46938158,1304,0.8036721859754438
18875,1564.614833,1564.655967,1,46938444,46939679,1235,0.7462672070404678
18876,1564.6653,1564.670133,1,46939959,46940103,144,0.29074965668244124
18877,1564.672433,1564.7062,1,46940172,46941186,1014,-0.04061820613182735
18878,1564.7082,1564.716567,1,46941246,46941497,251,0.30871705538160593
18879,1564.7237,1564.730233,1,46941711,46941906,195,-0.06950756113932928
18880,1564.758633,1564.7729,1,46942758,46943187,429,0.43191994270400086
18881,1564.774133,1564.7787,1,46943223,46943361,138,
18882,1564.7803,1564.8075,1,46943409,46944225,816,0.2201851825478623
18883,1564.829233,1564.832333,1,46944876,46944969,93,
18884,1564.843933,1564.849333,1,46945317,46945479,162,0.2931943141294669
18885,1564.8618,1564.867933,1,46945854,46946037,183,0.28164334267356106
18886,1564.913767,1564.92,1,46947413,46947600,187,0.4419127441191426
18887,1564.927967,1564.9594,1,46947839,46948782,943,0.437680798005796
18888,1564.973367,1564.9892,1,46949201,46949676,475,-0.06644892802465265
18889,1564.990967,1565.000467,1,46949729,46950014,285,-0.17945124637973728
18890,1565.0021,1565.006267,1,46950063,46950188,125,0.22275145845378772
18891,1565.010767,1565.016667,1,46950323,46950500,177,0.12699103882058674
18892,1565.0185,1565.0216,1,46950555,46950648,93,
18893,1565.0531,1565.058667,1,46951593,46951760,167,0.4853855206984015
18894,1565.067833,1565.0967,1,46952034,46952901,867,0.26437963226799793
18895,1565.105167,1565.1157,1,46953155,46953471,316,-0.060621832664234494
18896,1565.1171,1565.128767,1,46953513,46953863,350,0.01202909083346599
18897,1565.1361,1565.144667,1,46954083,46954340,257,-0.22444495228808123
18898,1565.149767,1565.154233,1,46954493,46954626,133,-0.06258470992542112
18899,1565.187933,1565.193333,1,46955637,46955799,162,0.5914071406598939
18900,1565.194533,1565.2289,1,46955835,46956867,1032,0.13717488189355026
18901,1565.237967,1565.267733,1,46957139,46958031,892,0.03837615206827865
18902,1565.2757,1565.299367,1,46958271,46958981,710,0.2412094450611976
18903,1565.322367,1565.331967,1,46959671,46959959,288,0.23761563315234738
18904,1565.333333,1565.3618,1,46959999,46960854,855,0.2639690294828282
18905,1565.377,1565.3966,1,46961310,46961898,588,-0.08546455251838544
18906,1565.404667,1565.415267,1,46962140,46962458,318,0.036140974163669876
18907,1565.427,1565.433233,1,46962810,46962996,186,-0.07657336644388177
18908,1565.4458,1565.458667,1,46963374,46963760,386,0.40317803017794884
18909,1565.478567,1565.4975,1,46964357,46964925,568,0.3461558085616476
18910,1565.505967,1565.520967,1,46965179,46965629,450,-0.0651185768165118
18911,1565.529567,1565.5396,1,46965887,46966188,301,-0.15419021867830623
18912,1565.5452,1565.552233,1,46966356,46966566,210,0.16354429993115496
18913,1565.567733,1565.5721,1,46967031,46967163,132,
18914,1565.6082,1565.612867,1,46968246,46968386,140,0.2274470342484803
18915,1565.639633,1565.6477,1,46969188,46969431,243,-0.031936329630064805
18916,1565.651333,1565.662367,1,46969539,46969871,332,0.5007453165102072
18917,1565.722167,1565.787333,1,46971665,46973619,1954,0.6606300917985868
18918,1566.246533,1566.256467,1,46987395,46987694,299,0.44571988946510516
18919,1566.258033,1566.275733,1,46987740,46988271,531,0.6609980666353584
18920,1566.310467,1566.320767,1,46989314,46989623,309,0.5655165075634587
18921,1566.347033,1566.3561,1,46990410,46990683,273,0.3034237241330872
18922,1566.377033,1566.385933,1,46991310,46991577,267,0.8049908244954805
18923,1566.5263,1566.5296,1,46995789,46995888,99,-0.034749998778704286
18924,1566.541267,1566.670367,1,46996238,47000111,3873,0.7911128758453777
18925,1566.671967,1566.680833,1,47000159,47000424,265,0.2927675660601701
18926,1566.6885,1566.693467,1,47000655,47000804,149,-0.07943128503666642
18927,1566.695533,1566.7135,1,47000865,47001405,540,0.012338144632398386
18928,1566.720733,1566.730333,1,47001621,47001909,288,0.10238841110918298
18929,1566.7381,1566.743933,1,47002143,47002317,174,0.273894817218417
18930,1566.844333,1566.8518,1,47005329,47005554,225,-0.03295679390004418
18931,1567.0417,1567.082233,1,47011251,47012466,1215,0.6998340092760014
18932,1567.095933,1567.121067,1,47012877,47013632,755,0.6185173196289853
18933,1567.124067,1567.136933,1,47013722,47014107,385,0.32913516422159966
18934,1567.173967,1567.184467,1,47015219,47015534,315,0.4952339240810644
18935,1567.188,1567.210633,1,47015640,47016318,678,0.5567347909356115
18936,1567.2231,1567.228867,1,47016693,47016866,173,0.5419000370911234
18937,1567.276267,1567.292433,1,47018288,47018772,484,0.0686915857651038
18938,1567.293667,1567.298,1,47018810,47018940,130,-0.06392391227801195
18939,1567.300633,1567.3132,1,47019018,47019396,378,0.2698818600524205
18940,1567.323433,1567.328467,1,47019702,47019854,152,0.3352636265075024
18941,1567.3485,1567.461767,1,47020455,47023853,3398,0.8181701892285728
18942,1567.795567,1567.801433,1,47033867,47034042,175,0.6713483880670549
18943,1567.802433,1567.823333,1,47034072,47034699,627,0.7107169976447607
18944,1567.860033,1567.877133,1,47035800,47036313,513,0.6836817876746968
18945,1567.915033,1567.949367,1,47037450,47038481,1031,0.5689473691982428
18946,1567.977133,1567.9971,1,47039313,47039913,600,0.5983701464904
18947,1567.998833,1568.008933,1,47039964,47040267,303,0.5399078913028199
18948,1568.030533,1568.0881,1,47040915,47042643,1728,0.637643773360178
18949,1568.114667,1568.119233,1,47043440,47043576,136,0.5457526407970854
18950,1568.1284,1568.1448,1,47043852,47044344,492,0.5813241833990452
18951,1568.1839,1568.194267,1,47045517,47045828,311,-0.061799270999475325
18952,1568.1991,1568.2107,1,47045973,47046321,348,0.18638652633262498
18953,1568.211733,1568.2257,1,47046351,47046771,420,0.09601420486762244
18954,1568.227933,1568.2335,1,47046837,47047005,168,-0.2153317562445963
18955,1568.252833,1568.308833,1,47047584,47049264,1680,0.8042594974604758
18956,1568.3104,1568.3171,1,47049312,47049513,201,0.4974806838853492
18957,1568.318233,1568.357567,1,47049546,47050727,1181,0.8081195364020172
18958,1568.6907,1568.696933,1,47060721,47060907,186,0.7098695587960066
18959,1568.701467,1568.7185,1,47061044,47061555,511,0.7248018822614484
18960,1568.729233,1568.750067,1,47061876,47062502,626,0.8196039043344179
18961,1568.7686,1568.846233,1,47063058,47065386,2328,0.7955245993214539
18962,1568.933467,1569.017667,1,47068004,47070530,2526,0.7759244712281705
18963,1569.1306,1569.141667,1,47073918,47074250,332,0.00824073335783976
18964,1569.1435,1569.150633,1,47074305,47074518,213,0.2608452884640088
18965,1569.163333,1569.302867,1,47074899,47079086,4187,0.8155300580207554
18966,1569.316733,1569.354,1,47079501,47080620,1119,0.7120017307180859
18967,1569.3651,1569.381,1,47080953,47081430,477,0.0026901892634198406
18968,1569.3874,1569.4216,1,47081622,47082648,1026,0.16542341007855885
18969,1569.4298,1569.544433,1,47082894,47086332,3438,0.8307326678549544
18970,1569.554033,1569.584367,1,47086620,47087531,911,0.7467368111504271
18971,1569.595967,1569.6265,1,47087879,47088795,916,0.7739855692482633
18972,1569.6377,1569.666833,1,47089131,47090004,873,0.7767247961966541
18973,1569.683933,1569.695167,1,47090517,47090855,338,0.8426434767301417
18974,1569.715467,1569.7236,1,47091464,47091708,244,0.5440942695898051
18975,1569.7289,1569.7799,1,47091867,47093397,1530,0.1746874286486173
18976,1569.7924,1569.949633,1,47093772,47098488,4716,0.8511730110968495
18977,1569.958933,1570.006733,1,47098767,47100201,1434,0.7667421415241302
18978,1570.031767,1570.055867,1,47100953,47101676,723,0.7845915902204681
18979,1570.062233,1570.118133,1,47101866,47103543,1677,0.7545564807165094
18980,1570.130367,1570.1457,1,47103911,47104371,460,0.7107779987734801
18981,1570.148167,1570.1643,1,47104445,47104929,484,0.6834892758895151
18982,1570.1949,1570.205733,1,47105847,47106171,324,-0.05350574724720148
18983,1570.2076,1570.227867,1,47106228,47106836,608,0.17999587649132803
18984,1570.2405,1570.284867,1,47107215,47108546,1331,0.8574929603196721
18985,1570.287233,1570.358033,1,47108616,47110740,2124,0.868404482700748
18986,1570.370733,1570.3781,1,47111121,47111343,222,-0.13487285337780971
18987,1570.385867,1570.411933,1,47111576,47112357,781,0.06885817468441757
18988,1570.4131,1570.424167,1,47112393,47112725,332,0.3163315223999704
18989,1570.431933,1570.440067,1,47112957,47113202,245,0.0963347404184527
18990,1570.4723,1570.4812,1,47114169,47114436,267,0.5212679944899483
18991,1570.483933,1570.6041,1,47114517,47118123,3606,0.7684590969145786
18992,1570.6911,1570.873433,1,47120733,47126202,5469,0.8070355036799656
18993,1570.889967,1570.900667,1,47126699,47127020,321,0.017308183877915953
18994,1570.902233,1570.906067,1,47127066,47127182,116,
18995,1570.968233,1570.9718,1,47129046,47129154,108,0.7950380372593084
18996,1570.977033,1571.024267,1,47129310,47130728,1418,0.6399776349863749
18997,1571.039567,1571.157667,1,47131187,47134730,3543,0.7503779816122668
18998,1571.161867,1571.1671,1,47134856,47135013,157,-0.1358138073591461
18999,1571.175733,1571.244,1,47135271,47137320,2049,0.7960341110056766
19000,1571.245467,1571.254967,1,47137364,47137649,285,0.7577080808032544
19001,1571.272567,1571.293567,1,47138177,47138807,630,0.8515122477348234
19002,1571.2971,1571.380767,1,47138913,47141423,2510,0.7440863975115791
19003,1571.396767,1571.399767,1,47141903,47141993,90,
19004,1571.404433,1571.412867,1,47142132,47142386,254,-0.1096774692314921
19005,1571.417367,1571.4265,1,47142521,47142795,274,0.22891744673526987
19006,1571.427867,1571.436867,1,47142836,47143106,270,0.10996050883816715
19007,1571.444967,1571.448667,1,47143349,47143460,111,0.23387939481534323
19008,1571.449667,1571.459667,1,47143490,47143790,300,0.302445548406707
19009,1571.468833,1571.4925,1,47144064,47144775,711,0.8194878051159535
19010,1571.4965,1571.5205,1,47144895,47145615,720,0.8622799882100977
19011,1571.522367,1571.611733,1,47145671,47148351,2680,0.8624641593043789
19012,1571.902367,1571.9187,1,47157071,47157561,490,0.7592488967545044
19013,1571.956533,1571.960933,1,47158695,47158827,132,0.8799569025306294
19014,1571.962367,1571.969633,1,47158871,47159088,217,0.5147857634775866
19015,1571.977533,1572.038767,1,47159325,47161163,1838,0.7998429582905077
19016,1572.044267,1572.130633,1,47161328,47163918,2590,0.7731456837723618
19017,1572.1324,1572.137233,1,47163972,47164116,144,0.8829540916882637
19018,1572.140267,1572.168,1,47164208,47165040,832,0.7567623788242364
19019,1572.197667,1572.2088,1,47165930,47166264,334,-0.059633414359529145
19020,1572.2141,1572.2237,1,47166423,47166711,288,0.36795428031928784
19021,1572.247067,1572.2504,1,47167412,47167512,100,0.15270059057166577
19022,1572.273367,1572.442933,1,47168201,47173287,5086,0.8099934761140822
19023,1572.4683,1572.513433,1,47174049,47175402,1353,0.7904333576222231
19024,1572.528,1572.571067,1,47175840,47177132,1292,0.7653860908528737
19025,1572.588867,1572.6943,1,47177666,47180829,3163,0.7432221543383499
19026,1572.720467,1572.724567,1,47181614,47181737,123,-0.089463493245049
19027,1572.7719,1572.776,1,47183157,47183280,123,0.4315130237449357
19028,1572.7877,1572.801467,1,47183631,47184044,413,0.6622416541790058
19029,1572.802967,1572.891233,1,47184089,47186736,2647,0.8414544953262678
19030,1572.898233,1572.9574,1,47186946,47188722,1776,0.7979757898139808
19031,1572.9697,1573.017767,1,47189091,47190533,1442,0.8458704938909554
19032,1573.022233,1573.0387,1,47190666,47191161,495,0.6092215466595782
19033,1573.045033,1573.092633,1,47191350,47192778,1428,0.6597383303621284
19034,1573.0963,1573.171033,1,47192889,47195130,2241,0.7566192011727323
19035,1573.174633,1573.196733,1,47195238,47195901,663,0.8131796017261433
19036,1573.1998,1573.2632,1,47195994,47197896,1902,0.823807083334202
19037,1573.264533,1573.283433,1,47197935,47198502,567,0.8135977309839404
19038,1573.287167,1573.3116,1,47198615,47199348,733,0.8126745613985945
19039,1573.314667,1573.3934,1,47199440,47201802,2362,0.7934105876698597
19040,1573.3981,1573.409033,1,47201943,47202270,327,0.9224613206482386
19041,1573.412767,1573.438033,1,47202383,47203140,757,0.8928034914268407
19042,1573.441367,1573.564533,1,47203241,47206935,3694,0.8116056185136201
19043,1573.5676,1573.694067,1,47207028,47210822,3794,0.7958483415172528
19044,1573.6975,1573.7931,1,47210925,47213793,2868,0.7983586678499237
19045,1573.795867,1573.822733,1,47213876,47214681,805,0.7844388622483442
19046,1573.826733,1573.923733,1,47214801,47217711,2910,0.8143239982034737
19047,1573.927567,1573.952967,1,47217827,47218589,762,0.7961907401000173
19048,1573.956167,1574.054633,1,47218685,47221638,2953,0.7734140877742367
19049,1574.0577,1574.084633,1,47221731,47222538,807,0.8266055102524371
19050,1574.0883,1574.2176,1,47222649,47226528,3879,0.7939087674297344
19051,1574.221233,1574.341967,1,47226636,47230259,3623,0.7680057607131274
19052,1574.345433,1574.437133,1,47230362,47233113,2751,0.7478603298081646
19053,1574.4454,1574.4669,1,47233362,47234007,645,0.7378106404094571
19054,1574.469467,1574.561667,1,47234084,47236850,2766,0.773045820321278
19055,1574.564,1574.591633,1,47236920,47237748,828,0.77881372843504
19056,1574.5949,1574.6524,1,47237847,47239572,1725,0.7651523509587032
19057,1574.654267,1574.6887,1,47239628,47240661,1033,0.7297915248408481
19058,1574.693433,1574.720467,1,47240802,47241614,812,0.7307225955784665
19059,1574.7235,1574.779967,1,47241705,47243399,1694,0.7404244188490056
19060,1574.8053,1574.817233,1,47244159,47244516,357,0.6700895775097141
19061,1574.8218,1574.847633,1,47244654,47245428,774,0.745346012220515
19062,1574.8518,1574.892367,1,47245554,47246771,1217,0.8036268810951924
19063,1574.895033,1574.907967,1,47246850,47247239,389,0.7321784305900381
19064,1574.937533,1574.944733,1,47248125,47248341,216,0.6651328017218486
19065,1574.951433,1574.969433,1,47248542,47249082,540,0.8839897168295725
19066,1574.982,1575.001667,1,47249460,47250050,590,0.5098249229370633
19067,1575.002867,1575.020433,1,47250086,47250612,526,0.7866841229765349
19068,1575.027433,1575.0386,1,47250822,47251158,336,0.6515098618640892
19069,1575.0678,1575.0732,1,47252034,47252196,162,0.5443356737851731
19070,1575.0815,1575.094633,1,47252445,47252838,393,0.8617262122382423
19071,1575.111167,1575.150067,1,47253335,47254502,1167,0.6943897064158231
19072,1575.158333,1575.1682,1,47254749,47255046,297,0.7139451245614694
19073,1575.214067,1575.222733,1,47256422,47256681,259,0.4624348823339397
19074,1575.232933,1575.2394,1,47256987,47257182,195,0.3187582958298285
19075,1575.2476,1575.2634,1,47257428,47257902,474,0.5810851956257321
19076,1575.2685,1575.277,1,47258055,47258310,255,0.7724341002800047
19077,1575.278267,1575.2884,1,47258348,47258652,304,0.5332326021813718
19078,1575.297033,1575.301867,1,47258910,47259056,146,-0.13360542178395843
19079,1575.311267,1575.3325,1,47259338,47259975,637,-0.004891800090639683
19080,1575.3371,1575.343467,1,47260113,47260304,191,-0.04763909799786579
19081,1575.348267,1575.3555,1,47260448,47260665,217,0.17930811160635993
19082,1575.364067,1575.371167,1,47260922,47261135,213,
19083,1575.3947,1575.4008,1,47261841,47262024,183,
19084,1575.438267,1575.4449,1,47263148,47263347,199,0.14634705942348816
19085,1575.4459,1575.4757,1,47263377,47264271,894,0.7207460882869452
19086,1575.516133,1575.530733,1,47265483,47265921,438,0.8004322354157813
19087,1575.549067,1575.561233,1,47266472,47266836,364,0.3077287910020717
19088,1575.5802,1575.6155,1,47267406,47268465,1059,-0.031784062098889496
19089,1575.6186,1575.6326,1,47268558,47268978,420,0.24743439165150297
19090,1575.6353,1575.641333,1,47269059,47269239,180,0.03701986461372272
19091,1575.6727,1575.680667,1,47270181,47270420,239,0.4147619581861297
19092,1575.681667,1575.686133,1,47270450,47270583,133,
19093,1575.690967,1575.725267,1,47270729,47271758,1029,0.34036717036283975
19094,1575.741333,1575.7483,1,47272239,47272449,210,0.015348241461940288
19095,1575.755967,1575.7651,1,47272679,47272953,274,0.4288511920844411
19096,1575.773767,1575.777467,1,47273213,47273324,111,0.7318955072273535
19097,1575.827,1575.837,1,47274810,47275110,300,0.33430145443297316
19098,1575.838,1575.842633,1,47275140,47275278,138,0.42999936638782277
19099,1575.8438,1575.868167,1,47275314,47276045,731,0.4635079341509489
19100,1575.885233,1575.9107,1,47276556,47277321,765,-0.008025940323655625
19101,1575.9262,1575.930067,1,47277786,47277902,116,0.2957820098435525
19102,1575.969367,1575.978467,1,47279081,47279354,273,0.3701779737554562
19103,1575.982167,1575.987267,1,47279465,47279618,153,0.7218528807892584
19104,1575.988467,1576.0253,1,47279654,47280759,1105,0.4671166769430513
19105,1576.033033,1576.050433,1,47280990,47281512,522,-0.057269149823854414
19106,1576.056433,1576.067967,1,47281692,47282039,347,0.17302402039081488
19107,1576.072967,1576.079667,1,47282189,47282390,201,0.15552231298983127
19108,1576.147167,1576.1524,1,47284415,47284572,157,0.5719156470351385
19109,1576.199933,1576.209567,1,47285997,47286287,290,0.5324120570913028
19110,1576.233767,1576.2372,1,47287013,47287116,103,0.009431375631354318
19111,1576.378633,1576.3873,1,47291358,47291619,261,0.12196254261434165
19112,1576.3925,1576.4192,1,47291775,47292576,801,0.536958809962079
19113,1576.420467,1576.426633,1,47292614,47292798,184,0.5196164933395092
19114,1576.435133,1576.447733,1,47293053,47293431,378,-0.07815421770725481
19115,1576.4491,1576.457833,1,47293473,47293734,261,0.09744938021493339
19116,1576.4657,1576.471767,1,47293971,47294153,182,0.021178584722622157
19117,1576.5394,1576.549333,1,47296182,47296479,297,0.5184022688767369
19118,1576.551133,1576.578333,1,47296533,47297349,816,0.37749124093033004
19119,1576.592867,1576.6271,1,47297786,47298813,1027,-0.03211070002677032
19120,1576.634267,1576.643733,1,47299028,47299311,283,0.04924651931745305
19121,1576.6525,1576.659933,1,47299575,47299797,222,-0.034357060125782775
19122,1576.673367,1576.682367,1,47300201,47300471,270,0.47971776244251657
19123,1576.687133,1576.7191,1,47300613,47301573,960,0.34272316271492165
19124,1576.7248,1576.751667,1,47301744,47302550,806,0.11391330233811835
19125,1576.754967,1576.766433,1,47302649,47302992,343,0.1260116858489108
19126,1576.808467,1576.850833,1,47304254,47305524,1270,0.16701229531965564
19127,1576.855533,1576.890567,1,47305665,47306717,1052,0.1270109279719489
19128,1576.894433,1576.902967,1,47306832,47307089,257,0.27738173860483994
19129,1576.948233,1576.989733,1,47308446,47309691,1245,0.3999339183219525
19130,1576.994867,1577.018433,1,47309846,47310552,706,0.06213703296052301
19131,1577.020367,1577.036667,1,47310611,47311100,489,0.10380156109085988
19132,1577.045833,1577.053167,1,47311374,47311595,221,0.30836472437205004
19133,1577.076433,1577.081867,1,47312292,47312456,164,0.48809055561126263
19134,1577.085967,1577.135133,1,47312579,47314053,1474,0.1319375494563661
19135,1577.140233,1577.1478,1,47314206,47314434,228,0.09195699326981552
19136,1577.152267,1577.160867,1,47314568,47314826,258,0.26115071644415455
19137,1577.218833,1577.2274,1,47316564,47316822,258,0.3654705638959219
19138,1577.242467,1577.256333,1,47317274,47317689,415,0.13951740336309779
19139,1577.268233,1577.288933,1,47318046,47318667,621,0.03839892191748204
19140,1577.294367,1577.3024,1,47318831,47319072,241,
19141,1577.327767,1577.3308,1,47319833,47319924,91,0.08640864497234502
19142,1577.3319,1577.343367,1,47319957,47320301,344,0.007668794943440358
19143,1577.3456,1577.434267,1,47320368,47323028,2660,0.05661628256763327
19144,1577.938133,1577.9625,1,47338143,47338875,732,0.41095533508912774
19145,1578.031933,1578.037033,1,47340957,47341110,153,0.6474898409838298
19146,1578.071767,1578.076,1,47342153,47342280,127,
19147,1578.102667,1578.1076,1,47343080,47343228,148,0.36007259208963716
19148,1578.127933,1578.1378,1,47343837,47344134,297,0.2813341725458518
19149,1578.142333,1578.148533,1,47344269,47344455,186,-0.07999010151985192
19150,1578.183367,1578.1883,1,47345501,47345649,148,0.3526493172164631
19151,1578.200833,1578.260667,1,47346024,47347820,1796,0.8091784310457244
19152,1578.263867,1578.331267,1,47347916,47349938,2022,0.8470618952546002
19153,1578.334733,1578.342067,1,47350041,47350262,221,0.3128987571320661
19154,1578.3435,1578.408167,1,47350305,47352245,1940,0.7353838949025739
19155,1578.412133,1578.470867,1,47352363,47354126,1763,0.6727853944564556
19156,1578.4876,1578.4912,1,47354628,47354736,108,
19157,1578.499967,1578.504767,1,47354999,47355143,144,0.7669699123431627
19158,1578.508267,1578.5183,1,47355248,47355549,301,-0.017123196198614406
19159,1578.519333,1578.543133,1,47355579,47356293,714,0.28555022907099875
19160,1578.544867,1578.5585,1,47356346,47356755,409,0.3629723166856478
19161,1578.623433,1578.745767,1,47358702,47362373,3671,0.8235118349028381
19162,1578.746767,1578.797567,1,47362403,47363927,1524,0.7937296819316608
19163,1578.799,1578.847367,1,47363970,47365421,1451,0.7610407314544531
19164,1578.865533,1578.907167,1,47365965,47367215,1250,0.6676813303864156
19165,1578.926633,1578.942667,1,47367798,47368280,482,0.04763455986327279
19166,1578.945033,1578.976267,1,47368350,47369288,938,0.15154092957208096
19167,1578.991367,1579.269367,1,47369741,47378081,8340,0.7633607575919099
19168,1579.387267,1579.4035,1,47381618,47382105,487,0.7089544241747738
19169,1579.405167,1579.4921,1,47382155,47384763,2608,0.8078414405886043
19170,1579.516367,1579.529133,1,47385491,47385873,382,0.14315360426352886
19171,1579.532333,1579.5387,1,47385969,47386161,192,0.3405976020295989
19172,1579.866367,1579.878167,1,47395991,47396345,354,0.7154256389294158
19173,1579.882667,1579.921933,1,47396480,47397657,1177,0.6950083263901828
19174,1579.9487,1579.9674,1,47398461,47399022,561,0.8246360937099715
19175,1579.9689,1579.9728,1,47399067,47399184,117,0.5783220067385951
19176,1579.9738,1580.001433,1,47399214,47400042,828,0.672862400504551
19177,1580.0027,1580.048567,1,47400081,47401457,1376,0.6021395311343651
19178,1580.0715,1580.089833,1,47402145,47402694,549,0.8312602274147287
19179,1580.109167,1580.122667,1,47403275,47403680,405,0.8367187532796653
19180,1580.1314,1580.146267,1,47403942,47404388,446,0.7800614508110404
19181,1580.1829,1580.186867,1,47405487,47405606,119,
19182,1580.193267,1580.209933,1,47405798,47406297,499,-0.022498648444054636
19183,1580.211467,1580.2222,1,47406344,47406666,322,0.3557998729177799
19184,1580.2267,1580.235133,1,47406801,47407053,252,0.6606632265621716
19185,1580.285067,1580.3515,1,47408552,47410545,1993,0.713410925610291
19186,1580.357033,1580.403333,1,47410710,47412099,1389,0.7153819969613446
19187,1580.427633,1580.4326,1,47412828,47412978,150,0.10044814851166448
19188,1580.445767,1580.4617,1,47413373,47413851,478,-0.06323879039458265
19189,1580.463333,1580.468367,1,47413899,47414051,152,-0.052823645068788276
19190,1580.470467,1580.474167,1,47414114,47414225,111,-0.27749053450312106
19191,1580.481367,1580.487933,1,47414441,47414637,196,-0.19035304833295408
19192,1580.514633,1580.5698,1,47415438,47417094,1656,0.7300112392519524
19193,1580.5774,1580.728933,1,47417322,47421867,4545,0.8109611749487032
19194,1580.730267,1580.7471,1,47421908,47422413,505,0.7718372764172031
19195,1580.749333,1580.769033,1,47422479,47423070,591,0.7214211354226053
19196,1580.799267,1580.8133,1,47423978,47424399,421,-0.011950210471428054
19197,1580.8159,1580.8251,1,47424477,47424753,276,-0.10222400621409196
19198,1580.829233,1580.836833,1,47424876,47425104,228,0.2933309128978122
19199,1580.894467,1580.910433,1,47426834,47427312,478,0.7809574555249019
19200,1580.912567,1580.957167,1,47427377,47428715,1338,0.8517140983571589
19201,1580.958367,1581.0975,1,47428751,47432925,4174,0.8083428623760718
19202,1581.136533,1581.1434,1,47434095,47434302,207,-0.05375693091518767
19203,1581.147267,1581.153467,1,47434418,47434604,186,-0.1704284473724513
19204,1581.4268,1581.434133,1,47442804,47443023,219,0.7423504956616275
19205,1581.437,1581.5413,1,47443110,47446239,3129,0.757644631552258
19206,1581.548167,1581.6382,1,47446445,47449146,2701,0.7553917821876688
19207,1581.643567,1581.719133,1,47449307,47451573,2266,0.8106932874652545
19208,1581.7203,1581.848033,1,47451609,47455440,3831,0.7716671206998678
19209,1581.8618,1581.865867,1,47455854,47455976,122,-0.047542870654846685
19210,1581.8728,1581.876233,1,47456184,47456286,102,0.5888337311398197
19211,1581.948833,1582.061167,1,47458464,47461835,3371,0.798559791956816
19212,1582.0824,1582.107667,1,47462472,47463230,758,0.1559986326027694
19213,1582.1089,1582.115567,1,47463267,47463467,200,-0.10566808037909442
19214,1582.1183,1582.128533,1,47463549,47463855,306,-0.19415529339393728
19215,1582.130033,1582.135667,1,47463900,47464070,170,-0.03184686329720012
19216,1582.1569,1582.3613,1,47464707,47470839,6132,0.7753327994548749
19217,1582.389933,1582.430733,1,47471697,47472921,1224,-0.0535778580323038
19218,1582.4319,1582.437667,1,47472957,47473130,173,-0.07306396108594622
19219,1582.4636,1582.5847,1,47473908,47477541,3633,0.7463907317158031
19220,1582.608,1582.7343,1,47478240,47482029,3789,0.8090950512575121
19221,1582.832567,1582.836067,1,47484977,47485082,105,0.34729727306613606
19222,1582.838,1583.0197,1,47485140,47490591,5451,0.7833023859428686
19223,1583.022933,1583.0272,1,47490687,47490816,129,0.024512167927996924
19224,1583.0377,1583.0686,1,47491131,47492058,927,0.7666784003694481
19225,1583.072467,1583.132333,1,47492174,47493969,1795,0.7251277905204441
19226,1583.138267,1583.1486,1,47494148,47494458,310,0.6794841111497667
19227,1583.162367,1583.198367,1,47494871,47495951,1080,-0.07291729942026591
19228,1583.203167,1583.213,1,47496095,47496390,295,-0.010566903886203731
19229,1583.214467,1583.2197,1,47496434,47496591,157,-0.0435036650578806
19230,1583.2285,1583.234,1,47496855,47497020,165,0.7274828783505343
19231,1583.235033,1583.449333,1,47497050,47503479,6429,0.7869491155785683
19232,1583.452733,1583.500533,1,47503581,47505015,1434,0.7713524324378074
19233,1583.511733,1583.5381,1,47505351,47506143,792,0.04625777143135851
19234,1583.5396,1583.547733,1,47506188,47506431,243,0.2156105978767781
19235,1583.549033,1583.5616,1,47506470,47506848,378,0.20913639593609357
19236,1583.563467,1583.567467,1,47506904,47507024,120,0.503551758152698
19237,1583.5888,1583.7868,1,47507664,47513604,5940,0.8334191881015968
19238,1583.798767,1583.874333,1,47513963,47516229,2266,0.814821744065789
19239,1583.884867,1583.927633,1,47516546,47517828,1282,-0.047657376714589327
19240,1583.933067,1583.9366,1,47517992,47518098,106,-0.4156782015911061
19241,1583.957467,1584.074267,1,47518724,47522228,3504,0.767107750051062
19242,1584.083367,1584.109667,1,47522501,47523290,789,0.06445420526303501
19243,1584.138133,1584.252633,1,47524143,47527578,3435,0.8497467157714609
19244,1584.5713,1584.580067,1,47537139,47537402,263,0.7063379378571376
19245,1584.581733,1584.610833,1,47537451,47538324,873,0.5482442605099923
19246,1584.624467,1584.6491,1,47538734,47539473,739,0.5049296570926679
19247,1584.652133,1584.763767,1,47539563,47542913,3350,0.7900667697870762
19248,1584.878633,1584.9885,1,47546358,47549655,3297,0.7312512897074782
19249,1584.989733,1585.106767,1,47549691,47553203,3512,0.7774315492346301
19250,1585.116633,1585.158167,1,47553498,47554745,1247,0.060944183463805486
19251,1585.1633,1585.1722,1,47554899,47555166,267,0.04025996269674534
19252,1585.1946,1585.316233,1,47555838,47559486,3648,0.7772876269925383
19253,1585.328167,1585.414667,1,47559845,47562440,2595,0.793636147509022
19254,1585.428933,1585.457967,1,47562867,47563739,872,-0.015250868208054656
19255,1585.459367,1585.483533,1,47563781,47564505,724,-0.012498154733308436
19256,1585.4985,1585.529467,1,47564955,47565884,929,0.7452072668377909
19257,1585.534467,1585.725233,1,47566034,47571756,5722,0.7769393712510685
19258,1585.7499,1585.756733,1,47572497,47572701,204,-0.04818273287876968
19259,1585.757767,1585.761333,1,47572733,47572839,106,
19260,1586.073533,1586.093167,1,47582205,47582795,590,0.7710875233705741
19261,1586.0979,1586.258267,1,47582937,47587748,4811,0.7709393415607291
19262,1586.264233,1586.3488,1,47587926,47590464,2538,0.8111442702779417
19263,1586.368467,1586.382933,1,47591054,47591487,433,-0.09243348644453017
19264,1586.3925,1586.403833,1,47591775,47592114,339,0.2056790084763807
19265,1586.406767,1586.4143,1,47592203,47592429,226,-0.115288594639385
19266,1586.4381,1586.4418,1,47593143,47593254,111,0.0697935659954045
19267,1586.4504,1586.574667,1,47593512,47597240,3728,0.8233894399862968
19268,1586.596667,1586.684833,1,47597900,47600544,2644,0.7836944256124994
19269,1586.698367,1586.7042,1,47600951,47601126,175,-0.01815257025824065
19270,1586.712433,1586.7163,1,47601372,47601489,117,0.6259072282327577
19271,1586.7882,1586.9797,1,47603646,47609391,5745,0.8302760075791699
19272,1587.008667,1587.016767,1,47610260,47610503,243,0.3120848278014418
19273,1587.0184,1587.040467,1,47610552,47611214,662,0.07216164747274272
19274,1587.0428,1587.045867,1,47611284,47611376,92,-0.2674117279580776
19275,1587.0537,1587.0631,1,47611611,47611893,282,0.08592951635886478
19276,1587.066567,1587.181767,1,47611997,47615453,3456,0.7517949905044186
19277,1587.1833,1587.1881,1,47615499,47615643,144,0.10759694349759308
19278,1587.1977,1587.206133,1,47615931,47616183,252,0.44295942170340546
19279,1587.2117,1587.222333,1,47616351,47616669,318,-0.051839757884654517
19280,1587.2359,1587.245433,1,47617077,47617362,285,0.15150405311548515
19281,1587.255933,1587.464833,1,47617677,47623944,6267,0.41088479971838415
19282,1587.466233,1587.472233,1,47623986,47624166,180,0.07650162602263666
19283,1587.484533,1587.492867,1,47624535,47624786,251,0.16702038500414032
19284,1587.4968,1587.507,1,47624904,47625210,306,-0.0923967032320251
19285,1587.508467,1587.516567,1,47625254,47625497,243,-0.13325226162367956
19286,1587.538833,1587.689767,1,47626164,47630693,4529,0.791297260488273
19287,1587.710867,1587.750567,1,47631326,47632517,1191,-0.10551213516056009
19288,1587.756333,1587.7655,1,47632689,47632965,276,0.06862961167806463
19289,1587.780867,1588.029367,1,47633426,47640881,7455,0.7669767781823111
19290,1588.0462,1588.056567,1,47641386,47641697,311,-0.018029421361642664
19291,1588.0835,1588.087067,1,47642505,47642612,107,
19292,1588.1503,1588.283433,1,47644509,47648502,3993,0.7690097138144955
19293,1588.306533,1588.311833,1,47649195,47649354,159,0.18128990463407046
19294,1588.326633,1588.358133,1,47649798,47650743,945,0.02179787442385665
19295,1588.3609,1588.374333,1,47650827,47651229,402,0.2040154398352391
19296,1588.451733,1588.686433,1,47653551,47660592,7041,0.7893932861607077
19297,1588.779733,1588.790167,1,47663391,47663705,314,0.6171428641798822
19298,1588.792,1588.948467,1,47663760,47668454,4694,0.8118185673114616
19299,1588.950267,1588.956167,1,47668508,47668685,177,0.6164579545715556
19300,1588.959867,1589.0086,1,47668796,47670258,1462,0.7763837252657235
19301,1589.023567,1589.032567,1,47670707,47670977,270,0.47700593643881684
19302,1589.034267,1589.0613,1,47671028,47671839,811,0.506112726335874
19303,1589.095533,1589.1157,1,47672865,47673471,606,0.050157603075774035
19304,1589.1172,1589.137867,1,47673516,47674136,620,0.2371693641544368
19305,1589.1433,1589.147733,1,47674299,47674431,132,0.5518122618012409
19306,1589.1608,1589.378333,1,47674824,47681349,6525,0.8333717333040128
19307,1589.400533,1589.441667,1,47682015,47683250,1235,0.05659336289702326
19308,1589.4431,1589.450867,1,47683293,47683526,233,0.20341591315272095
19309,1589.471633,1589.5836,1,47684148,47687508,3360,0.7711414028812339
19310,1589.594267,1589.635767,1,47687828,47689073,1245,0.04118532964057689
19311,1589.6517,1589.8216,1,47689551,47694648,5097,0.836202951948053
19312,1589.8392,1589.870867,1,47695176,47696126,950,-0.0741777124470979
19313,1589.913767,1590.070567,1,47697413,47702117,4704,0.7270193691993952
19314,1590.201567,1590.2059,1,47706047,47706177,130,0.39312163936041566
19315,1590.4288,1590.4358,1,47712864,47713074,210,0.8190291497322233
19316,1590.44,1590.4546,1,47713200,47713638,438,0.7056647526530888
19317,1590.4588,1590.4867,1,47713764,47714601,837,0.7380425578334591
19318,1590.5047,1590.5906,1,47715141,47717718,2577,0.7852966050024063
19319,1590.591933,1590.596333,1,47717757,47717889,132,-0.18585477384980437
19320,1590.645433,1590.652533,1,47719362,47719575,213,0.1942950206395761
19321,1590.655367,1590.754,1,47719661,47722620,2959,0.761959675731029
19322,1590.7726,1590.7804,1,47723178,47723412,234,-0.12877545885937264
19323,1590.873933,1590.949067,1,47726217,47728472,2255,0.8057819026890561
19324,1590.951433,1590.979067,1,47728542,47729372,830,0.8393546884195046
19325,1591.0129,1591.043167,1,47730387,47731295,908,0.7763984033775859
19326,1591.0594,1591.0647,1,47731782,47731941,159,0.632079891357549
19327,1591.067167,1591.113633,1,47732015,47733408,1393,0.5267074424911384
19328,1591.139467,1591.1685,1,47734184,47735055,871,0.6442498148851243
19329,1591.1922,1591.230433,1,47735766,47736912,1146,0.0715373415128619
19330,1591.2319,1591.240733,1,47736957,47737221,264,0.1467200655676697
19331,1591.265533,1591.269567,1,47737965,47738087,122,
19332,1591.2837,1591.435967,1,47738511,47743079,4568,0.8029689113798913
19333,1591.4647,1591.5295,1,47743941,47745885,1944,0.649767483262524
19334,1592.752,1592.7569,1,47782560,47782707,147,0.13865266220937078
19335,1592.783367,1592.786567,1,47783501,47783597,96,-0.40576483451211703
19336,1592.824067,1592.837433,1,47784722,47785122,400,0.8606583845889084
19337,1592.848467,1592.851933,1,47785454,47785557,103,0.932787100773411
19338,1592.865267,1592.885333,1,47785958,47786559,601,0.6979512745334253
19339,1592.8921,1592.896,1,47786763,47786880,117,0.361375620997968
19340,1592.9136,1592.931833,1,47787408,47787954,546,0.7172647466607533
19341,1592.9419,1592.955333,1,47788257,47788659,402,0.670258419162574
19342,1592.959433,1592.963567,1,47788782,47788907,125,0.47934198364311525
19343,1592.967333,1592.9761,1,47789019,47789283,264,0.6601161113112783
19344,1592.987633,1593.032333,1,47789628,47790969,1341,0.7397660039452406
19345,1593.0357,1593.0536,1,47791071,47791608,537,0.7075191460572028
19346,1593.0558,1593.070033,1,47791674,47792100,426,0.5812177408981811
19347,1593.116567,1593.131733,1,47793497,47793951,454,-0.01588154898095893
19348,1593.134033,1593.141733,1,47794020,47794251,231,0.28088374440340436
19349,1593.200233,1593.2689,1,47796006,47798067,2061,0.8118376406652459
19350,1593.272033,1593.302,1,47798160,47799060,900,0.8830161424303831
19351,1593.5695,1593.638633,1,47807085,47809158,2073,0.7378215570601684
19352,1593.649767,1593.730467,1,47809493,47811914,2421,0.7968297451559759
19353,1593.747667,1593.803867,1,47812430,47814116,1686,0.7993522836608391
19354,1593.8119,1593.8153,1,47814357,47814459,102,0.0761469919702055
19355,1594.102033,1594.255633,1,47823060,47827668,4608,0.7376304904435681
19356,1594.277833,1594.281567,1,47828334,47828447,113,0.6606364852401125
19357,1594.289833,1594.294567,1,47828694,47828837,143,-0.05341197114635272
19358,1594.296267,1594.407833,1,47828888,47832234,3346,0.7942118538918239
19359,1594.986867,1594.995167,1,47849606,47849855,249,0.6625601601313214
19360,1595.015433,1595.022267,1,47850462,47850668,206,0.5838568079675506
19361,1595.0505,1595.0738,1,47851515,47852214,699,0.6765390249164701
19362,1595.102667,1595.1104,1,47853080,47853312,232,0.582416206079792
19363,1595.116,1595.131767,1,47853480,47853953,473,0.615011458515134
19364,1595.181233,1595.1896,1,47855436,47855688,252,0.5341555576132441
19365,1595.1913,1595.2035,1,47855739,47856105,366,0.698256337767287
19366,1595.2319,1595.2378,1,47856957,47857134,177,0.6182979631495993
19367,1595.243433,1595.253067,1,47857302,47857592,290,0.6315742181933467
19368,1595.526333,1595.659767,1,47865789,47869793,4004,0.8083844204735905
19369,1595.6728,1595.7517,1,47870184,47872551,2367,0.8224912644934307
19370,1595.753433,1595.763167,1,47872602,47872895,293,0.7259750294996982
19371,1595.790467,1595.846667,1,47873714,47875400,1686,0.8406080409073998
19372,1595.859433,1595.877,1,47875782,47876310,528,0.7113102416697453
19373,1595.882433,1595.961367,1,47876472,47878841,2369,0.7489755011209557
19374,1596.269833,1596.274833,1,47888094,47888244,150,0.5816716978881007
19375,1596.293733,1596.463933,1,47888811,47893917,5106,0.7864941091112848
19376,1596.4907,1596.501767,1,47894721,47895053,332,0.5029025035415102
19377,1596.515467,1596.526433,1,47895464,47895792,328,-0.051240577936019605
19378,1596.5282,1596.545933,1,47895846,47896377,531,0.05678330557662731
19379,1596.5747,1596.5926,1,47897241,47897778,537,0.623554609458419
19380,1596.6091,1596.692433,1,47898273,47900772,2499,0.7896612318293503
19381,1596.964533,1596.968667,1,47908935,47909060,125,
19382,1596.976133,1597.0994,1,47909283,47912982,3699,0.8732108723549681
19383,1597.1216,1597.308167,1,47913648,47919245,5597,0.7826416850726092
19384,1597.327133,1597.332767,1,47919813,47919983,170,0.07389889162243787
19385,1597.702333,1597.708433,1,47931069,47931252,183,0.4500163905223076
19386,1597.726167,1597.7613,1,47931785,47932839,1054,0.7654412411537762
19387,1597.767633,1597.799467,1,47933028,47933984,956,0.8895889073818819
19388,1597.8009,1597.866233,1,47934027,47935986,1959,0.7666454456812223
19389,1597.8709,1597.963067,1,47936127,47938892,2765,0.7550760511621594
19390,1597.965533,1597.9927,1,47938965,47939781,816,0.754028989470536
19391,1598.007967,1598.0211,1,47940239,47940633,394,0.0836547223900423
19392,1598.032833,1598.0435,1,47940984,47941305,321,-0.009249145378033617
19393,1598.046033,1598.051367,1,47941380,47941541,161,0.18121759040949081
19394,1598.2934,1598.307433,1,47948802,47949222,420,0.7352162875344441
19395,1598.315267,1598.357,1,47949458,47950710,1252,0.891621134325477
19396,1598.3591,1598.444233,1,47950773,47953326,2553,0.8095960300520536
19397,1598.457333,1598.498233,1,47953719,47954946,1227,0.8021135926775608
19398,1598.501967,1598.586133,1,47955059,47957583,2524,0.8094264357056693
19399,1598.589233,1598.6512,1,47957676,47959536,1860,0.7979723606038941
19400,1598.6555,1598.673133,1,47959665,47960193,528,0.7416040701057663
19401,1598.675633,1598.739233,1,47960268,47962176,1908,0.7456776399465505
19402,1599.1302,1599.163667,1,47973906,47974910,1004,0.6696775152880949
19403,1599.199833,1599.2076,1,47975994,47976228,234,0.6488713666126866
19404,1599.2148,1599.235333,1,47976444,47977059,615,0.7114625491606769
19405,1599.5879,1599.614067,1,47987637,47988422,785,0.6588602509533835
19406,1599.647667,1599.736167,1,47989430,47992085,2655,0.7622785359748228
19407,1600.1693,1600.279867,1,48005079,48008396,3317,0.785723264294909
19408,1600.645367,1600.651267,1,48019361,48019538,177,0.36013825855509196
19409,1600.660167,1600.882867,1,48019805,48026486,6681,0.7856254884957936
19410,1600.901533,1600.906033,1,48027045,48027180,135,-0.10551764114643745
19411,1600.974167,1600.981833,1,48029225,48029454,229,-0.046896564417942266
19412,1600.986167,1601.080633,1,48029585,48032418,2833,0.7985480651532172
19413,1601.0832,1601.086933,1,48032496,48032607,111,-0.4169357674291237
19414,1601.416367,1601.440233,1,48042491,48043206,715,0.6543697373937031
19415,1601.443767,1601.456967,1,48043313,48043709,396,0.7184402670320207
19416,1601.514,1601.523967,1,48045420,48045719,299,0.7199443783345986
19417,1601.557567,1601.578667,1,48046727,48047360,633,0.7117331220052097
19418,1601.579767,1601.583733,1,48047393,48047511,118,-0.03527405674390335
19419,1601.585,1601.599267,1,48047550,48047978,428,0.6912343062807619
19420,1601.629933,1601.648,1,48048897,48049440,543,0.7024767716566863
19421,1601.667267,1601.680667,1,48050018,48050420,402,0.6472957180474682
19422,1601.6822,1601.696667,1,48050466,48050900,434,0.7276968576845689
19423,1601.7315,1601.749167,1,48051945,48052475,530,-0.16222243003276077
19424,1601.7502,1601.765167,1,48052506,48052955,449,-0.12264448610451341
19425,1601.8049,1601.8836,1,48054147,48056508,2361,0.5525736656871496
19426,1601.9106,1601.997633,1,48057318,48059928,2610,0.5931148383733199
19427,1602.015767,1602.020667,1,48060473,48060620,147,0.4597461905608597
19428,1602.0219,1602.0667,1,48060657,48062001,1344,0.6918526530664492
19429,1602.082833,1602.0988,1,48062484,48062964,480,0.6050683786733551
19430,1602.101233,1602.114433,1,48063036,48063432,396,0.5969575804579533
19431,1602.140333,1602.148467,1,48064209,48064454,245,0.05782282738053548
19432,1602.150667,1602.206067,1,48064520,48066182,1662,0.3435303837254867
19433,1602.207667,1602.213333,1,48066230,48066399,169,0.012714739860081934
19434,1602.221867,1602.232567,1,48066656,48066977,321,0.45044582420057133
19435,1602.2404,1602.313033,1,48067212,48069390,2178,0.42517875758013124
19436,1602.387733,1602.393067,1,48071631,48071792,161,0.6595079561053437
19437,1602.394467,1602.553233,1,48071834,48076596,4762,0.8367695366020003
19438,1602.555367,1602.577433,1,48076661,48077322,661,0.771596327682183
19439,1602.580467,1602.620833,1,48077414,48078624,1210,0.4474152664923743
19440,1602.634967,1602.810833,1,48079049,48084324,5275,0.7743866796378268
19441,1602.819933,1602.824533,1,48084597,48084735,138,0.1862804353178654
19442,1602.849933,1602.854233,1,48085497,48085626,129,-0.023915128357591933
19443,1602.865167,1602.8685,1,48085955,48086055,100,0.43355917713703646
19444,1603.1943,1603.198733,1,48095829,48095961,132,0.6759060305782607
19445,1603.220767,1603.249567,1,48096623,48097487,864,0.6721205463251667
19446,1603.2574,1603.294367,1,48097722,48098831,1109,0.8105571160865458
19447,1603.295467,1603.322767,1,48098864,48099683,819,0.6747331721307106
19448,1603.324,1603.342067,1,48099720,48100262,542,0.729935092896871
19449,1603.356133,1603.404433,1,48100683,48102132,1449,0.5946824203201642
19450,1603.426867,1603.461833,1,48102806,48103854,1048,0.7286156400523354
19451,1603.47,1603.523067,1,48104100,48105692,1592,0.5143514522894567
19452,1603.543433,1603.5834,1,48106302,48107502,1200,0.7322607392949783
19453,1603.598733,1603.619867,1,48107961,48108596,635,0.7970044275104883
19454,1603.625267,1603.675433,1,48108758,48110262,1504,0.06008027005981524
19455,1603.712767,1603.728933,1,48111383,48111867,484,0.6353779301215422
19456,1603.730233,1603.764767,1,48111906,48112943,1037,0.8287894677487032
19457,1603.775067,1603.816233,1,48113252,48114486,1234,0.8262766646746893
19458,1603.827433,1603.8387,1,48114822,48115161,339,-0.07951909731222345
19459,1603.840433,1603.848667,1,48115212,48115460,248,-0.008927382738503997
19460,1603.850133,1603.858833,1,48115503,48115764,261,0.4592221756599035
19461,1603.8719,1603.991633,1,48116157,48119748,3591,0.8518611598625274
19462,1604.012467,1604.102667,1,48120374,48123080,2706,0.803270801338372
19463,1604.5688,1604.6415,1,48137064,48139245,2181,0.7799554085511942
19464,1604.642767,1604.7031,1,48139283,48141093,1810,0.3557733614294969
19465,1604.7098,1604.7984,1,48141294,48143952,2658,0.8314382150253985
19466,1604.801,1604.8063,1,48144030,48144189,159,0.5927753828181962
19467,1604.811167,1604.837,1,48144335,48145110,775,0.8477373260713773
19468,1604.875667,1604.880467,1,48146270,48146414,144,0.20453183070353892
19469,1604.890067,1605.022033,1,48146702,48150660,3958,0.7784801948525467
19470,1605.043367,1605.046633,1,48151301,48151398,97,
19471,1605.716867,1605.729267,1,48171506,48171878,372,0.5944188721635285
19472,1605.731167,1605.75,1,48171935,48172500,565,0.6987114524936332
19473,1605.751233,1605.7572,1,48172536,48172716,180,0.3802737594680764
19474,1605.790733,1605.7993,1,48173721,48173979,258,0.4635706966814594
19475,1605.857533,1605.8609,1,48175725,48175827,102,0.1523087823084707
19476,1606.020533,1606.1025,1,48180615,48183075,2460,0.7930344647772392
19477,1606.106033,1606.245333,1,48183180,48187359,4179,0.8041244034205423
19478,1606.671767,1606.6826,1,48200153,48200478,325,0.5863955163275759
19479,1606.689133,1606.7091,1,48200673,48201273,600,0.4352095987312518
19480,1606.730633,1606.7355,1,48201918,48202065,147,0.6248059095737383
19481,1606.736933,1606.746833,1,48202107,48202404,297,0.4502644906255701
19482,1606.8035,1606.812,1,48204105,48204360,255,0.744342222516976
19483,1606.845867,1606.958267,1,48205376,48208748,3372,0.737760180690859
19484,1607.356367,1607.359433,1,48220691,48220782,91,0.46276781815281076
19485,1607.431633,1607.4461,1,48222948,48223383,435,0.7164347764092284
19486,1607.486067,1607.515833,1,48224582,48225474,892,0.8314862621696213
19487,1607.549467,1607.565667,1,48226484,48226970,486,0.7067905172416756
19488,1607.582933,1607.6266,1,48227487,48228798,1311,0.6369179866289918
19489,1607.648367,1607.666433,1,48229451,48229992,541,0.5810427518462267
19490,1607.792533,1607.913433,1,48233775,48237402,3627,0.8114801080185811
19491,1608.166667,1608.173467,1,48245000,48245204,204,0.7072356997595333
19492,1608.177667,1608.1928,1,48245330,48245784,454,0.6792568105215607
19493,1608.194767,1608.328467,1,48245843,48249854,4011,0.7971049542040863
19494,1608.361133,1608.364267,1,48250833,48250928,95,-0.08919631117779143
19495,1608.3988,1608.403567,1,48251964,48252107,143,-0.025328656242645086
19496,1608.521967,1608.535133,1,48255659,48256053,394,0.6621763129105086
19497,1608.5789,1608.586533,1,48257367,48257595,228,0.5657530807086111
19498,1608.610133,1608.614533,1,48258303,48258435,132,0.23307489532200465
19499,1608.616333,1608.621333,1,48258489,48258639,150,-0.24272355081476232
19500,1608.842233,1608.855567,1,48265266,48265667,401,0.742052326238808
19501,1608.8584,1608.898467,1,48265752,48266954,1202,0.8360458467225065
19502,1608.906167,1608.944133,1,48267185,48268323,1138,0.8338513808766491
19503,1608.959733,1608.966567,1,48268791,48268997,206,0.5377124349373648
19504,1608.969867,1608.982967,1,48269096,48269489,393,0.15573496343082163
19505,1608.9877,1608.991967,1,48269631,48269759,128,
19506,1609.318133,1609.341467,1,48279543,48280244,701,0.5190049486858994
19507,1609.342933,1609.3531,1,48280287,48280593,306,0.22237843853582173
19508,1609.370933,1609.445667,1,48281127,48283370,2243,0.7632051392047423
19509,1609.453033,1609.456467,1,48283590,48283694,104,-0.0468477617017664
19510,1609.462833,1609.473933,1,48283884,48284217,333,0.5946044138040316
19511,1609.8961,1609.9064,1,48296883,48297192,309,0.6915980965347441
19512,1609.958533,1609.970567,1,48298755,48299117,362,0.5289610318897041
19513,1610.0043,1610.020367,1,48300129,48300611,482,0.688606355090234
19514,1610.024033,1610.0414,1,48300720,48301242,522,0.7532093286705784
19515,1610.050567,1610.058267,1,48301517,48301748,231,0.1338304251168813
19516,1610.0762,1610.1029,1,48302286,48303087,801,0.6200966325137172
19517,1610.1394,1610.144,1,48304182,48304320,138,0.5534170865815423
19518,1610.1543,1610.1683,1,48304629,48305049,420,0.4247076359292435
19519,1610.185667,1610.198567,1,48305570,48305957,387,0.4994097833094788
19520,1610.216767,1610.2222,1,48306503,48306666,163,0.8104133668700546
19521,1610.254433,1610.275233,1,48307632,48308256,624,0.6422620541631684
19522,1610.298633,1610.3038,1,48308958,48309114,156,0.5083340489453682
19523,1610.311,1610.3323,1,48309330,48309969,639,0.7037025581396776
19524,1610.5135,1610.6496,1,48315405,48319488,4083,0.7687927717854114
19525,1610.651833,1610.747733,1,48319554,48322431,2877,0.8228100921134615
19526,1610.766633,1610.7712,1,48322998,48323136,138,-0.325310288104366
19527,1610.837367,1610.9581,1,48325121,48328743,3622,0.8180385017658218
19528,1610.981133,1610.991567,1,48329433,48329747,314,-0.0541344633992961
19529,1610.9927,1610.9959,1,48329781,48329877,96,
19530,1610.997067,1611.004233,1,48329912,48330126,214,0.14124722793557987
19531,1611.005567,1611.0132,1,48330167,48330396,229,-0.051879618037330925
19532,1611.0254,1611.250633,1,48330762,48337518,6756,0.8238999097114496
19533,1611.251767,1611.256333,1,48337553,48337689,136,0.3838961673585888
19534,1611.257633,1611.314233,1,48337728,48339426,1698,0.75982495037953
19535,1611.3199,1611.357567,1,48339597,48340727,1130,0.7017327352030873
19536,1611.3686,1611.375233,1,48341058,48341256,198,-0.15571626147780337
19537,1611.377733,1611.3819,1,48341331,48341457,126,-0.0665183281136814
19538,1611.388933,1611.3974,1,48341667,48341922,255,-0.061491751096042775
19539,1611.416133,1611.530333,1,48342483,48345909,3426,0.831641545567304
19540,1611.553733,1611.566033,1,48346611,48346980,369,-0.005644256897099195
19541,1611.568033,1611.580767,1,48347040,48347423,383,0.137752206534912
19542,1611.5819,1611.589967,1,48347457,48347699,242,0.24801335878406866
19543,1611.5968,1611.601133,1,48347904,48348033,129,0.7522712563208925
19544,1611.633467,1611.6475,1,48349004,48349425,421,0.3868407438218972
19545,1611.648933,1611.741133,1,48349467,48352233,2766,0.6013968133751382
19546,1611.752333,1611.773633,1,48352569,48353208,639,0.11392645105624256
19547,1611.799967,1611.882433,1,48353999,48356472,2473,0.79861085166026
19548,1611.891333,1611.982633,1,48356739,48359478,2739,0.8292641393046735
19549,1611.993033,1611.996567,1,48359790,48359897,107,-0.098191288967207
19550,1612.402167,1612.4286,1,48372065,48372858,793,0.6248188110972217
19551,1612.4437,1612.502033,1,48373311,48375060,1749,0.8216294228437411
19552,1612.506867,1612.5154,1,48375206,48375462,256,0.5307937674319039
19553,1612.516567,1612.5867,1,48375497,48377601,2104,0.6649277204334709
19554,1612.5927,1612.665,1,48377781,48379950,2169,0.6600035368681773
19555,1612.675433,1612.721667,1,48380262,48381650,1388,0.6969422895327788
19556,1612.7439,1612.754333,1,48382317,48382629,312,0.10720589807503858
19557,1612.755533,1612.7632,1,48382665,48382896,231,0.00817289185194399
19558,1612.765067,1612.783467,1,48382952,48383504,552,0.12116031227450991
19559,1612.793667,1612.7983,1,48383810,48383949,139,0.24975138621605172
19560,1612.799833,1612.9986,1,48383994,48389958,5964,0.7573724964182633
19561,1613.020467,1613.0257,1,48390614,48390771,157,0.014050875822967563
19562,1613.0541,1613.057467,1,48391623,48391724,101,
19563,1613.122767,1613.138833,1,48393683,48394164,481,0.7758851224632783
19564,1613.140267,1613.249967,1,48394208,48397499,3291,0.6009376421600016
19565,1613.267333,1613.2783,1,48398019,48398349,330,-0.017735441922129357
19566,1613.284433,1613.301867,1,48398532,48399056,524,-0.02519465797545545
19567,1613.303467,1613.313567,1,48399104,48399407,303,-0.12939884465467205
19568,1613.320567,1613.326233,1,48399617,48399786,169,0.29852419917442585
19569,1613.436967,1613.614,1,48403109,48408420,5311,0.8276642436852283
19570,1613.628567,1613.752767,1,48408857,48412583,3726,0.788263591126472
19571,1613.795167,1613.7982,1,48413855,48413946,91,
19572,1614.101533,1614.105933,1,48423045,48423177,132,0.5281272277409437
19573,1614.1086,1614.268133,1,48423258,48428043,4785,0.7433452272257915
19574,1614.271933,1614.322,1,48428157,48429660,1503,0.7123712765762309
19575,1614.338533,1614.3779,1,48430155,48431337,1182,0.7321806764169434
19576,1614.380333,1614.387633,1,48431409,48431628,219,-0.2833437503450329
19577,1614.3899,1614.395333,1,48431697,48431859,162,0.6063328779496455
19578,1614.409667,1614.416233,1,48432290,48432486,196,-0.26154406854058065
19579,1614.423767,1614.442633,1,48432713,48433278,565,-0.015078874692421276
19580,1614.4457,1614.467433,1,48433371,48434022,651,0.16187377467150624
19581,1614.4708,1614.475133,1,48434124,48434253,129,0.4226888563747992
19582,1614.488133,1614.491733,1,48434643,48434751,108,0.28037887998019095
19583,1614.499467,1614.650167,1,48434984,48439505,4521,0.8176961012064544
19584,1614.651567,1614.770267,1,48439547,48443108,3561,0.7847940482726052
19585,1614.801233,1614.815867,1,48444036,48444476,440,-0.04343370057172873
19586,1614.817433,1614.821067,1,48444522,48444632,110,-0.3446449005485837
19587,1614.869267,1615.008767,1,48446078,48450263,4185,0.7873727401962194
19588,1615.0182,1615.023833,1,48450546,48450714,168,0.2535071007414382
19589,1615.025733,1615.093067,1,48450771,48452792,2021,0.7537027688120589
19590,1615.0991,1615.1777,1,48452973,48455331,2358,0.8105222586021849
19591,1615.1841,1615.219333,1,48455523,48456579,1056,0.6688102177370424
19592,1615.234567,1615.256233,1,48457037,48457686,649,-0.008241642666908635
19593,1615.258267,1615.276367,1,48457748,48458291,543,0.012377832739477724
19594,1615.277867,1615.2852,1,48458336,48458556,220,0.06716582335440459
19595,1615.299633,1615.570933,1,48458988,48467127,8139,0.8199854607342015
19596,1615.573667,1615.674133,1,48467210,48470223,3013,0.7844266670221913
19597,1615.676867,1615.7628,1,48470306,48472884,2578,0.8158383389172369
19598,1615.764667,1615.7886,1,48472940,48473658,718,0.5441347726144562
19599,1615.791367,1615.882367,1,48473741,48476471,2730,0.8202383052217621
19600,1615.884567,1615.9076,1,48476537,48477228,691,0.8122154842745964
19601,1615.9145,1616.0318,1,48477435,48480954,3519,0.8278940629070896
19602,1616.040333,1616.135933,1,48481209,48484077,2868,0.8467830953631345
19603,1616.138,1616.1652,1,48484140,48484956,816,0.8702353021514373
19604,1616.168,1616.291967,1,48485040,48488759,3719,0.7840694298355879
19605,1616.294767,1616.3916,1,48488843,48491748,2905,0.79603228212527
19606,1616.393333,1616.416067,1,48491799,48492482,683,0.8560796550463415
19607,1616.423933,1616.521767,1,48492717,48495653,2936,0.8224999067131596
19608,1616.5235,1616.545633,1,48495705,48496368,663,0.8389655468800075
19609,1616.555667,1616.6577,1,48496670,48499731,3061,0.8219369779392297
19610,1616.6606,1616.6875,1,48499818,48500625,807,0.8072365077415724
19611,1616.690833,1616.788167,1,48500724,48503645,2921,0.7381467846795884
19612,1616.794133,1616.820333,1,48503823,48504609,786,0.8981843783958254
19613,1616.822167,1616.88,1,48504665,48506400,1735,0.8231923330341057
19614,1616.884,1616.9038,1,48506520,48507114,594,0.8911090029179675
19615,1616.922133,1616.9303,1,48507663,48507909,246,-0.038058403393954804
19616,1616.9322,1616.937067,1,48507966,48508112,146,-0.19190020508415997
19617,1616.939467,1616.949833,1,48508184,48508494,310,0.170851938648276
19618,1616.9593,1617.035633,1,48508779,48511068,2289,0.7790082061042158
19619,1617.0584,1617.065133,1,48511752,48511953,201,-0.12393223110430641
19620,1617.066667,1617.0753,1,48512000,48512259,259,-0.14015487432310716
19621,1617.079,1617.086267,1,48512370,48512588,218,0.1735625433610214
19622,1617.1303,1617.1334,1,48513909,48514002,93,0.6051837918031979
19623,1617.139067,1617.305933,1,48514172,48519177,5005,0.8237295908390654
19624,1617.329767,1617.3365,1,48519893,48520095,202,0.8344631201565342
19625,1617.343267,1617.359567,1,48520298,48520787,489,0.8385882774508576
19626,1617.364933,1617.4466,1,48520947,48523398,2451,0.7978460156490954
19627,1617.448767,1617.528433,1,48523463,48525852,2389,0.7410864813219924
19628,1617.5315,1617.544767,1,48525945,48526343,398,0.6639365134324487
19629,1617.551967,1617.6435,1,48526559,48529305,2746,0.7573202506590686
19630,1617.645933,1617.668967,1,48529377,48530069,692,0.8148164126103888
19631,1617.671033,1617.680033,1,48530130,48530400,270,0.045399754976797664
19632,1617.6872,1617.693333,1,48530616,48530799,183,0.0484051230182073
19633,1617.698033,1617.713333,1,48530940,48531399,459,0.05551992006346511
19634,1617.716433,1617.729333,1,48531492,48531879,387,0.20629657283091468
19635,1617.734267,1617.741333,1,48532028,48532239,211,0.5020275133134136
19636,1617.7562,1617.957733,1,48532686,48538731,6045,0.8429373058946908
19637,1617.988733,1617.995767,1,48539661,48539873,212,-0.08289712264790715
19638,1618.452267,1618.4777,1,48553568,48554331,763,0.5017876714686522
19639,1618.480867,1618.489533,1,48554426,48554685,259,0.36872216922898604
19640,1618.537067,1618.542367,1,48556112,48556271,159,0.5779327004339475
19641,1618.594567,1618.601367,1,48557837,48558041,204,0.4975908149458084
19642,1618.664433,1618.672667,1,48559932,48560180,248,0.5621894409811239
19643,1618.709033,1618.719933,1,48561270,48561597,327,0.6372437882883981
19644,1618.762433,1618.769067,1,48562872,48563072,200,
19645,1618.776267,1618.809,1,48563288,48564270,982,-0.018795367856038893
19646,1618.823767,1618.8314,1,48564713,48564942,229,-0.1581050875717418
19647,1618.834233,1618.9783,1,48565026,48569349,4323,0.7773414982897455
19648,1618.991767,1619.092833,1,48569753,48572784,3031,0.780478451471113
19649,1619.112867,1619.1185,1,48573386,48573555,169,-0.041031732233733215
19650,1619.134833,1619.138667,1,48574044,48574160,116,0.01001291705791939
19651,1619.1938,1619.210067,1,48575814,48576302,488,0.826832557688197
19652,1619.211133,1619.255,1,48576333,48577650,1317,0.7632719868895236
19653,1619.256633,1619.297833,1,48577698,48578934,1236,0.7515293403990508
19654,1619.3073,1619.357767,1,48579219,48580733,1514,0.036060127972396064
19655,1619.368633,1619.3953,1,48581058,48581859,801,0.7367759187788145
19656,1619.397167,1619.585267,1,48581915,48587558,5643,0.8338377426475102
19657,1619.601067,1619.606167,1,48588032,48588185,153,0.8386466526792906
19658,1619.617667,1619.643333,1,48588530,48589299,769,-0.07439273781925779
19659,1619.646333,1619.656433,1,48589389,48589692,303,0.1820215493096039
19660,1619.676233,1619.698167,1,48590286,48590945,659,0.8070185373778933
19661,1619.6997,1619.794333,1,48590991,48593829,2838,0.7983583376796177
19662,1619.8235,1619.849033,1,48594705,48595470,765,0.19590084760435567
19663,1619.850233,1619.8702,1,48595506,48596106,600,0.16378269193005104
19664,1619.885767,1619.9698,1,48596573,48599094,2521,0.46173015181427257
19665,1619.971233,1620.0233,1,48599136,48600699,1563,0.7632585670455992
19666,1620.031067,1620.0664,1,48600932,48601992,1060,0.026149024519786946
19667,1620.0683,1620.091,1,48602049,48602730,681,0.12874623110658326
19668,1620.1213,1620.1804,1,48603639,48605412,1773,0.7189757757099058
19669,1620.181833,1620.228633,1,48605454,48606858,1404,0.7969536963181086
19670,1620.2386,1620.2648,1,48607158,48607944,786,0.034264316466049785
19671,1620.297867,1620.3049,1,48608936,48609147,211,0.036984350250247794
19672,1620.309233,1620.314567,1,48609276,48609437,161,0.10594859965828568
19673,1620.336167,1620.341467,1,48610085,48610244,159,-0.13247324377777972
19674,1620.3425,1620.345767,1,48610275,48610373,98,0.79357269428491
19675,1620.351333,1620.3816,1,48610539,48611448,909,0.7053923616257801
19676,1620.383367,1620.4725,1,48611501,48614175,2674,0.6938415513111549
19677,1620.485467,1620.618067,1,48614564,48618542,3978,0.7816841122434698
19678,1620.625967,1620.6293,1,48618779,48618879,100,-0.012198631850851994
19679,1620.630967,1620.6565,1,48618929,48619695,766,-0.005556194240915356
19680,1620.660267,1620.678933,1,48619808,48620367,559,0.05352524784076772
19681,1620.693367,1620.7129,1,48620801,48621387,586,0.5721308900871283
19682,1620.7295,1620.814867,1,48621885,48624446,2561,0.7761314537900604
19683,1620.8654,1620.869,1,48625962,48626070,108,-0.2688641798916225
19684,1620.914233,1620.917233,1,48627426,48627516,90,-0.20584103528888026
19685,1620.923033,1621.0537,1,48627690,48631611,3921,0.7675337203827649
19686,1621.2183,1621.509033,1,48636549,48645270,8721,0.7909041989322908
19687,1621.5212,1621.5379,1,48645636,48646137,501,-0.09655487064143906
19688,1621.5406,1621.557667,1,48646218,48646730,512,0.04541146398081451
19689,1621.565367,1621.5698,1,48646961,48647094,133,-0.12442703653518564
19690,1621.660267,1621.723467,1,48649808,48651704,1896,0.8340902197547196
19691,1621.724767,1621.7911,1,48651743,48653733,1990,0.781676105184227
19692,1621.7955,1621.960033,1,48653865,48658800,4935,0.71945986586105
19693,1621.969867,1621.9849,1,48659096,48659547,451,0.1694481335106896
19694,1622.603533,1622.613533,1,48678105,48678405,300,0.6600657758378032
19695,1622.632333,1622.645467,1,48678969,48679364,395,0.4684972464638263
19696,1622.648,1622.6597,1,48679440,48679791,351,0.5411315492668362
19697,1622.665667,1622.668967,1,48679970,48680069,99,0.06645297045821712
19698,1622.673033,1622.697667,1,48680190,48680930,740,0.633462402347252
19699,1622.720267,1622.750133,1,48681608,48682503,895,0.6201621212824469
19700,1622.7642,1622.871167,1,48682926,48686135,3209,0.784711505623453
19701,1622.8742,1622.8775,1,48686226,48686325,99,-0.16649907509748094
19702,1622.8902,1622.8934,1,48686706,48686802,96,-0.09909861908981264
19703,1622.9112,1622.919367,1,48687336,48687581,245,0.695080484911658
19704,1622.9537,1622.961667,1,48688611,48688850,239,0.42750648222530435
19705,1622.9691,1623.058233,1,48689073,48691746,2673,0.8252850976407035
19706,1623.067267,1623.126367,1,48692018,48693791,1773,0.795927913686459
19707,1623.134567,1623.244467,1,48694037,48697334,3297,0.16476469996926366
19708,1623.2571,1623.353933,1,48697713,48700617,2904,0.8349687227025795
19709,1623.355267,1623.4612,1,48700658,48703836,3178,0.770704878879412
19710,1623.468967,1623.480467,1,48704069,48704414,345,0.4483401737065364
19711,1623.485933,1623.527867,1,48704577,48705836,1259,0.13124933521752247
19712,1623.531033,1623.5483,1,48705930,48706449,519,-0.010131738436623402
19713,1623.558333,1623.561933,1,48706749,48706857,108,0.27027313519521784
19714,1623.564267,1623.573133,1,48706928,48707193,265,-0.09364158862221818
19715,1623.577133,1623.5802,1,48707313,48707406,93,
19716,1623.593367,1623.708367,1,48707801,48711251,3450,0.6806779106741624
19717,1623.709833,1623.718067,1,48711294,48711542,248,0.4493056913919542
19718,1623.722967,1623.726633,1,48711689,48711798,109,
19719,1623.727967,1623.765833,1,48711839,48712974,1135,0.195436797193838
19720,1623.7671,1623.792733,1,48713013,48713781,768,0.11436097120266363
19721,1623.825533,1623.935867,1,48714765,48718076,3311,0.7561009684147937
19722,1623.940733,1623.9468,1,48718221,48718404,183,0.017366521322451176
19723,1623.962,1623.9751,1,48718860,48719253,393,0.3955718543594228
19724,1623.984967,1624.011767,1,48719549,48720353,804,0.12694178534872702
19725,1624.016367,1624.026867,1,48720491,48720806,315,0.29680859544668337
19726,1624.034533,1624.046633,1,48721035,48721398,363,-0.11819874491599308
19727,1624.098267,1624.107433,1,48722948,48723222,274,0.258963557147504
19728,1624.116767,1624.123633,1,48723503,48723708,205,0.38194669841716034
19729,1624.144233,1624.147633,1,48724326,48724428,102,-0.13880895928562412
19730,1624.149933,1624.232733,1,48724497,48726981,2484,0.7778240316293932
19731,1624.237333,1624.264833,1,48727119,48727944,825,0.7610434250523465
19732,1624.266,1624.276533,1,48727980,48728295,315,0.6239676406242723
19733,1624.277533,1624.3069,1,48728325,48729207,882,0.730931382126005
19734,1624.310567,1624.344433,1,48729317,48730332,1015,0.7694679564298166
19735,1624.366133,1624.4007,1,48730983,48732021,1038,0.6466267527488679
19736,1624.409267,1624.485233,1,48732278,48734556,2278,0.7855255722606911
19737,1624.501333,1624.509333,1,48735039,48735279,240,-0.018223270764477793
19738,1624.5707,1624.676633,1,48737121,48740298,3177,0.7635053602533002
19739,1624.6975,1624.7011,1,48740925,48741033,108,
19740,1624.7438,1624.751467,1,48742314,48742544,230,0.19880529089683802
19741,1624.755333,1624.789133,1,48742659,48743673,1014,0.7341173804763246
19742,1624.791833,1624.806033,1,48743754,48744180,426,0.45108275222530364
19743,1624.8133,1624.935333,1,48744399,48748059,3660,0.5254668700227666
19744,1624.937967,1625.043733,1,48748139,48751311,3172,0.7307303233153368
19745,1625.047,1625.0525,1,48751410,48751575,165,0.5579206220185643
19746,1625.0547,1625.1102,1,48751641,48753306,1665,0.14728876297923302
19747,1625.1261,1625.240567,1,48753783,48757217,3434,0.7655040746002075
19748,1625.242,1625.245933,1,48757260,48757377,117,0.18818033876507684
19749,1625.2562,1625.2655,1,48757686,48757965,279,0.4948430964257566
19750,1625.268867,1625.334933,1,48758066,48760047,1981,0.18683183088300065
19751,1625.339,1625.456933,1,48760170,48763707,3537,0.7155205265397577
19752,1625.469967,1625.5433,1,48764099,48766299,2200,0.776410137517417
19753,1625.5445,1625.5872,1,48766335,48767616,1281,0.66689551489281
19754,1625.607633,1625.6903,1,48768228,48770709,2481,0.7913810667438359
19755,1625.7057,1625.736767,1,48771171,48772103,932,0.031827480169411414
19756,1625.738367,1625.758433,1,48772151,48772752,601,-0.05986559082374545
19757,1625.767267,1625.7717,1,48773018,48773151,133,-0.01403883284211115
19758,1625.779633,1626.033267,1,48773388,48780998,7610,0.7526404215490925
19759,1626.0375,1626.0428,1,48781125,48781284,159,-0.036223167775949756
19760,1626.050333,1626.056,1,48781509,48781680,171,0.5334764963742894
19761,1626.261133,1626.305533,1,48787833,48789165,1332,0.6665324686154643
19762,1626.315233,1626.352367,1,48789456,48790571,1115,0.5391564441750359
19763,1626.362233,1626.368467,1,48790866,48791054,188,0.5649231942704321
19764,1626.379033,1626.382633,1,48791370,48791478,108,-0.23624447156295691
19765,1626.441,1626.517467,1,48793230,48795524,2294,0.7559718982197363
19766,1626.531933,1626.556267,1,48795957,48796688,731,0.6574503328385625
19767,1626.581667,1626.6113,1,48797450,48798339,889,0.8052926834749492
19768,1626.6271,1626.6884,1,48798813,48800652,1839,0.7959264895991708
19769,1626.705867,1626.743533,1,48801176,48802305,1129,0.34835754609805225
19770,1626.750167,1626.760233,1,48802505,48802806,301,0.3003538211394573
19771,1626.763367,1626.778633,1,48802901,48803358,457,0.13035823042275355
19772,1626.799333,1626.959267,1,48803979,48808778,4799,0.8182567885876665
19773,1626.968267,1627.0197,1,48809048,48810591,1543,0.7984389327001152
19774,1627.038833,1627.0536,1,48811164,48811608,444,0.7981538241888542
19775,1627.055067,1627.063,1,48811652,48811890,238,0.8505209406355055
19776,1627.066567,1627.121367,1,48811997,48813641,1644,0.79001292869406
19777,1627.134467,1627.169367,1,48814034,48815081,1047,0.7205639607727488
19778,1627.195833,1627.2,1,48815874,48816000,126,-0.06719840712889556
19779,1627.204367,1627.208433,1,48816131,48816252,121,
19780,1627.2102,1627.213367,1,48816306,48816401,95,-0.09852149528384224
19781,1627.214967,1627.220567,1,48816449,48816617,168,
19782,1627.392767,1627.3981,1,48821783,48821943,160,0.4790018851437593
19783,1627.4001,1627.630733,1,48822003,48828921,6918,0.8201962411869811
19784,1627.6341,1627.661733,1,48829023,48829851,828,0.739006142255567
19785,1627.664233,1627.675233,1,48829926,48830256,330,0.5384044432931572
19786,1627.6821,1627.714967,1,48830463,48831449,986,-0.14419424265840525
19787,1627.716467,1627.726833,1,48831494,48831804,310,-0.08126783769991984
19788,1627.7328,1627.737767,1,48831984,48832133,149,-0.5126252490344031
19789,1627.7716,1627.775667,1,48833148,48833270,122,0.5320386138033997
19790,1627.7768,1627.783833,1,48833304,48833514,210,-0.09546912340125972
19791,1627.7849,1627.811167,1,48833547,48834335,788,0.5505821883067467
19792,1627.824133,1627.894667,1,48834723,48836840,2117,0.8205859805666836
19793,1627.908767,1627.9997,1,48837263,48839991,2728,0.8415398843357683
19794,1628.008333,1628.012233,1,48840249,48840366,117,0.4386716574485341
19795,1628.016,1628.0192,1,48840480,48840576,96,
19796,1628.022433,1628.026567,1,48840672,48840797,125,-0.004496357910680029
19797,1628.049533,1628.057733,1,48841485,48841731,246,0.5341763373359799
19798,1628.0852,1628.207733,1,48842556,48846231,3675,0.815732728394667
19799,1628.211867,1628.305767,1,48846356,48849173,2817,0.804079922809926
19800,1628.318367,1628.3778,1,48849551,48851334,1783,0.785423448527895
19801,1628.379433,1628.385167,1,48851382,48851555,173,0.6058337002940002
19802,1628.399,1628.4281,1,48851970,48852843,873,0.5592388438904755
19803,1628.437933,1628.501733,1,48853137,48855051,1914,0.293782787792148
19804,1628.521767,1628.739767,1,48855653,48862193,6540,0.8219420131052475
19805,1628.756967,1628.7897,1,48862709,48863691,982,-0.08823351545622134
19806,1628.7911,1628.809167,1,48863733,48864275,542,-0.4263618559624562
19807,1628.831833,1628.849233,1,48864954,48865476,522,0.35192076656705557
19808,1628.8507,1628.944733,1,48865521,48868341,2820,0.6634769659498878
19809,1628.9552,1628.9847,1,48868656,48869541,885,-0.014163196485772545
19810,1629.005033,1629.1231,1,48870150,48873693,3543,0.8485443682546685
19811,1629.150967,1629.2481,1,48874529,48877443,2914,0.7996375733076583
19812,1629.267733,1629.276133,1,48878031,48878283,252,0.059895396685390415
19813,1629.3392,1629.523767,1,48880176,48885713,5537,0.8270616308304749
19814,1629.527733,1629.543733,1,48885831,48886311,480,0.7325749287930924
19815,1629.547733,1629.6275,1,48886431,48888825,2394,0.6821806940583672
19816,1629.6286,1629.657433,1,48888858,48889722,864,0.7145996606628108
19817,1629.6586,1629.711933,1,48889758,48891357,1599,0.7353160022267561
19818,1629.715633,1629.7441,1,48891468,48892323,855,0.7760838437292489
19819,1629.745233,1629.8479,1,48892356,48895437,3081,0.8127130918109166
19820,1629.858567,1629.868433,1,48895757,48896052,295,0.10142778022278552
19821,1629.8843,1629.8948,1,48896529,48896844,315,0.20222176369396885
19822,1629.9011,1629.9053,1,48897033,48897159,126,0.24917201014450452
19823,1629.906967,1629.9497,1,48897209,48898491,1282,0.6360688459813156
19824,1629.969333,1630.255733,1,48899079,48907671,8592,0.7410044634803021
19825,1630.274767,1630.279267,1,48908243,48908378,135,-0.0925848753893615
19826,1630.347733,1630.3644,1,48910431,48910932,501,0.43459756578271663
19827,1630.3657,1630.471867,1,48910971,48914156,3185,0.6890841362630113
19828,1630.493,1630.621,1,48914790,48918630,3840,0.7303410479980316
19829,1630.624833,1630.706333,1,48918744,48921189,2445,0.7947904125041064
19830,1630.712367,1630.751567,1,48921371,48922547,1176,0.7190337100780474
19831,1630.752633,1630.817767,1,48922578,48924533,1955,0.704784084181407
19832,1630.850167,1630.9041,1,48925505,48927123,1618,0.798026038237128
19833,1630.9053,1630.937533,1,48927159,48928125,966,0.8010327384084276
19834,1630.9415,1630.947433,1,48928245,48928422,177,0.7089256696593936
19835,1630.951933,1630.955733,1,48928557,48928671,114,
19836,1630.9714,1631.0077,1,48929142,48930231,1089,0.7957251966759508
19837,1631.009367,1631.062333,1,48930281,48931869,1588,0.8229366104021908
19838,1631.0663,1631.080767,1,48931989,48932423,434,0.7454431321194069
19839,1631.097167,1631.192233,1,48932915,48935766,2851,0.8121039300732186
19840,1631.1942,1631.221233,1,48935826,48936636,810,0.821084317309609
19841,1631.224533,1631.3186,1,48936735,48939558,2823,0.8227747136446729
19842,1631.3213,1631.3436,1,48939639,48940308,669,0.8136803275434095
19843,1631.3507,1631.444633,1,48940521,48943338,2817,0.4180172413337881
19844,1631.4483,1631.4693,1,48943449,48944079,630,0.5336723405608115
19845,1631.478033,1631.518567,1,48944340,48945557,1217,0.7342690508268281
19846,1631.5197,1631.573733,1,48945591,48947211,1620,0.8067944709872278
19847,1631.577133,1631.6042,1,48947313,48948126,813,0.4543384987326252
19848,1631.6091,1631.648,1,48948273,48949440,1167,0.8026337182730576
19849,1631.6492,1631.703033,1,48949476,48951090,1614,0.8094535066837971
19850,1631.708967,1631.728067,1,48951269,48951842,573,0.7718867207182679
19851,1631.7382,1631.8359,1,48952146,48955077,2931,0.7927425059682806
19852,1631.8379,1631.861933,1,48955137,48955857,720,0.7346543589557973
19853,1631.8696,1631.9683,1,48956088,48959049,2961,0.8301132055126611
19854,1631.971267,1631.999133,1,48959138,48959973,835,0.7729814725676192
19855,1632.003333,1632.0412,1,48960099,48961236,1137,0.808891965607609
19856,1632.042667,1632.1038,1,48961280,48963114,1834,0.858155184028356
19857,1632.107967,1632.1281,1,48963239,48963843,604,0.8121798932050144
19858,1632.136233,1632.2299,1,48964086,48966897,2811,0.7783727329637476
19859,1632.238733,1632.246267,1,48967161,48967388,227,-0.054101523652829206
19860,1632.250133,1632.2626,1,48967503,48967878,375,-0.05856221540738941
19861,1632.2719,1632.276333,1,48968157,48968289,132,
19862,1632.284933,1632.287933,1,48968547,48968637,90,0.7550468876691794
19863,1632.297033,1632.310233,1,48968910,48969306,396,0.10909568775226808
19864,1632.317133,1632.3772,1,48969513,48971316,1803,0.7942831510714006
19865,1632.4048,1632.412933,1,48972144,48972387,243,-0.1018096670026968
19866,1632.745233,1632.7697,1,48982356,48983091,735,0.6200738590479652
19867,1632.800633,1632.8212,1,48984018,48984636,618,0.48005225102765237
19868,1633.4251,1633.456567,1,49002753,49003697,944,0.5575873286624702
19869,1633.479667,1633.501167,1,49004390,49005035,645,0.5164478297364271
19870,1633.552633,1633.568333,1,49006578,49007049,471,0.6479516291046806
19871,1633.7497,1633.7637,1,49012491,49012911,420,0.5469474129536717
19872,1633.768933,1633.7751,1,49013067,49013253,186,0.5572596118266046
19873,1633.8159,1633.823233,1,49014477,49014696,219,0.6953383742710393
19874,1633.827733,1633.8308,1,49014831,49014924,93,0.3546227279351791
19875,1633.9223,1633.9284,1,49017669,49017852,183,0.22024310486876975
19876,1634.065533,1634.2399,1,49021965,49027197,5232,0.7764112216114207
19877,1634.247267,1634.251133,1,49027418,49027533,115,0.29851053013860396
19878,1634.253833,1634.258033,1,49027614,49027740,126,0.19098392259818117
19879,1634.290667,1634.294867,1,49028720,49028846,126,
19880,1634.561433,1634.589533,1,49036842,49037685,843,0.7098922244036847
19881,1634.599,1634.649567,1,49037970,49039487,1517,0.6754338170367772
19882,1634.6621,1634.700467,1,49039863,49041014,1151,0.6424533570289626
19883,1634.717,1634.758333,1,49041510,49042749,1239,0.6397360977832173
19884,1634.7716,1634.781333,1,49043148,49043439,291,0.603367465131995
19885,1634.810533,1634.830533,1,49044315,49044915,600,0.06568052933252067
19886,1634.8332,1634.847567,1,49044996,49045427,431,0.3045250535588145
19887,1634.859933,1634.869233,1,49045797,49046076,279,0.16058550815798833
19888,1634.874833,1634.926033,1,49046244,49047780,1536,0.7897249755647368
19889,1634.9334,1634.9792,1,49048002,49049376,1374,0.7263813933956005
19890,1634.989967,1635.0136,1,49049699,49050408,709,0.04821083912736288
19891,1635.0165,1635.026633,1,49050495,49050798,303,-0.24648521732800918
19892,1635.036333,1635.041033,1,49051089,49051230,141,-0.19960759020177082
19893,1635.0423,1635.153033,1,49051269,49054590,3321,0.8225119621170455
19894,1635.1797,1635.258833,1,49055391,49057764,2373,0.8114700793301204
19895,1635.292567,1635.2979,1,49058777,49058937,160,-0.010484943730593305
19896,1635.3458,1635.351667,1,49060374,49060550,176,0.6117430137993084
19897,1635.3555,1635.371467,1,49060665,49061144,479,0.7939515562758716
19898,1635.372633,1635.549467,1,49061178,49066484,5306,0.8088332391457072
19899,1635.5805,1635.5882,1,49067415,49067646,231,0.12145598975460319
19900,1635.5999,1635.614933,1,49067997,49068447,450,0.02726171419902901
19901,1635.6455,1635.765567,1,49069365,49072967,3602,0.7662158059818406
19902,1635.769,1635.774067,1,49073070,49073222,152,
19903,1635.780633,1635.787567,1,49073418,49073627,209,-0.02896435328086059
19904,1635.794033,1635.8023,1,49073820,49074069,249,0.4576191309754046
19905,1635.815733,1635.820233,1,49074471,49074606,135,0.41505348521482827
19906,1635.842833,1635.8618,1,49075284,49075854,570,0.12786313532901591
19907,1635.8645,1635.884633,1,49075935,49076538,603,-0.040365442489329974
19908,1635.895767,1636.038233,1,49076873,49081146,4273,0.724861970935806
19909,1636.044633,1636.102333,1,49081338,49083069,1731,0.7267591670189997
19910,1636.106967,1636.197633,1,49083209,49085928,2719,0.7748250961415186
19911,1636.229267,1636.2363,1,49086878,49087089,211,-0.0675292412056534
19912,1636.241967,1636.245633,1,49087259,49087368,109,0.10389035908081203
19913,1636.774267,1636.815067,1,49103228,49104452,1224,0.5370449800980732
19914,1636.826067,1636.875533,1,49104782,49106265,1483,0.6141722227094629
19915,1637.3683,1637.3972,1,49121049,49121916,867,0.7045512767668727
19916,1637.408433,1637.4587,1,49122252,49123761,1509,0.6160708273894326
19917,1637.478333,1637.506567,1,49124349,49125197,848,0.5904911238588129
19918,1637.513367,1637.518267,1,49125401,49125548,147,
19919,1637.528067,1637.545267,1,49125842,49126358,516,0.5354407367363714
19920,1637.546533,1637.5692,1,49126395,49127076,681,0.5497305723991619
19921,1637.579767,1637.5856,1,49127393,49127568,175,0.2530467522093547
19922,1637.611067,1637.6248,1,49128332,49128744,412,0.5123649892032882
19923,1637.630133,1637.6752,1,49128903,49130256,1353,0.09720436944522914
19924,1637.696533,1637.7121,1,49130895,49131363,468,0.7500696840204932
19925,1637.7146,1637.7592,1,49131438,49132776,1338,0.8422411952058058
19926,1637.7628,1637.799367,1,49132884,49133981,1097,0.7807612141340536
19927,1637.815833,1637.850733,1,49134474,49135521,1047,-0.04069240512755142
19928,1637.852533,1637.862033,1,49135575,49135860,285,0.11717348135209135
19929,1637.863033,1637.877067,1,49135890,49136312,422,0.17023025346856746
19930,1637.898433,1637.994233,1,49136952,49139826,2874,0.5839358791880077
19931,1637.9961,1638.064833,1,49139883,49141944,2061,0.792322450579628
19932,1638.070433,1638.126333,1,49142112,49143789,1677,0.7895969291728183
19933,1638.137433,1638.157067,1,49144122,49144712,590,0.6810669421639374
19934,1638.1625,1638.2567,1,49144875,49147701,2826,0.8014447331110608
19935,1638.307467,1638.3121,1,49149224,49149363,139,0.3676503360931117
19936,1638.314167,1638.317933,1,49149425,49149537,112,0.6541951796375172
19937,1638.3526,1638.358533,1,49150578,49150755,177,0.5642109281626386
19938,1638.3683,1638.566033,1,49151049,49156980,5931,0.8113036576930656
19939,1638.5769,1638.580067,1,49157307,49157402,95,0.5856551815084825
19940,1638.5988,1638.6065,1,49157964,49158195,231,-0.1074520811559375
19941,1638.6166,1638.619867,1,49158498,49158596,98,
19942,1638.625767,1638.629767,1,49158773,49158893,120,0.18021294080759345
19943,1638.650333,1638.817533,1,49159509,49164525,5016,0.24812478027077858
19944,1638.822867,1638.994567,1,49164686,49169837,5151,0.7783882735783197
19945,1639.032133,1639.036667,1,49170963,49171100,137,
19946,1639.043167,1639.0498,1,49171295,49171494,199,0.697693716180554
19947,1639.078667,1639.207833,1,49172360,49176234,3874,0.7772940369381627
19948,1639.216833,1639.2608,1,49176504,49177824,1320,0.7058227760475546
19949,1639.2632,1639.316733,1,49177896,49179501,1605,0.7491471729886008
19950,1639.317967,1639.352533,1,49179539,49180575,1036,0.828788732278164
19951,1639.354633,1639.569233,1,49180638,49187076,6438,0.816105553503265
19952,1639.574367,1639.597267,1,49187231,49187918,687,0.5730853418444163
19953,1639.600067,1639.690833,1,49188002,49190724,2722,0.7912750399173599
19954,1639.6945,1639.7209,1,49190835,49191627,792,0.8316933680857036
19955,1639.722867,1639.812467,1,49191686,49194374,2688,0.8168795238906604
19956,1639.814367,1639.839433,1,49194431,49195182,751,0.7882530617467803
19957,1639.842433,1639.966167,1,49195272,49198985,3713,0.825892847580672
19958,1639.9677,1640.091667,1,49199031,49202750,3719,0.8080876449793144
19959,1640.100667,1640.197833,1,49203020,49205934,2914,0.810053019411213
19960,1640.200367,1640.227067,1,49206011,49206812,801,0.796663303625145
19961,1640.229133,1640.310633,1,49206873,49209318,2445,0.8189905106776062
19962,1640.311767,1640.3259,1,49209353,49209777,424,0.7844835695978993
19963,1640.328967,1640.3333,1,49209869,49209999,130,0.8014015151113747
19964,1640.334733,1640.3569,1,49210041,49210707,666,0.6846425473065186
19965,1640.360067,1640.459067,1,49210802,49213772,2970,0.7810221841059739
19966,1640.462167,1640.485767,1,49213865,49214573,708,0.7815870370555527
19967,1640.491933,1640.576267,1,49214757,49217288,2531,0.8042218099766303
19968,1640.5775,1640.610933,1,49217325,49218327,1002,0.8253292749334966
19969,1640.612267,1640.724433,1,49218368,49221732,3364,0.7960891368498397
19970,1640.726967,1640.859733,1,49221809,49225791,3982,0.7652475931696039
19971,1640.8642,1640.886633,1,49225926,49226598,672,0.8177095147030595
19972,1640.893367,1640.951533,1,49226801,49228545,1744,0.742183410340382
19973,1640.976667,1640.986433,1,49229300,49229592,292,0.7453780844760344
19974,1641.022133,1641.060933,1,49230663,49231827,1164,0.7176545187805048
19975,1641.0676,1641.078133,1,49232028,49232343,315,0.6726557352839667
19976,1641.1007,1641.111967,1,49233021,49233359,338,0.730084161607253
19977,1641.117567,1641.123067,1,49233527,49233692,165,0.5931746011617022
19978,1641.129,1641.1612,1,49233870,49234836,966,0.4907944759199812
19979,1641.163133,1641.203333,1,49234893,49236099,1206,0.7318799790997407
19980,1641.214033,1641.217833,1,49236420,49236534,114,
19981,1641.2197,1641.229067,1,49236591,49236872,281,0.10880347947661878
19982,1641.2439,1641.2529,1,49237317,49237587,270,-0.05962301713528615
19983,1641.261567,1641.270367,1,49237847,49238111,264,0.13157656274455762
19984,1641.319033,1641.342,1,49239570,49240260,690,0.7370219667816543
19985,1641.347767,1641.4503,1,49240433,49243509,3076,0.7713174761654348
19986,1641.4611,1641.467167,1,49243833,49244015,182,-0.0014763818006339135
19987,1641.500167,1641.514467,1,49245005,49245434,429,0.01839190966512883
19988,1641.582967,1641.592467,1,49247489,49247774,285,0.7339804362932827
19989,1641.593667,1641.6247,1,49247810,49248741,931,0.4003812942867143
19990,1641.647133,1641.658367,1,49249413,49249751,338,0.21851943148223582
19991,1641.673533,1641.732733,1,49250205,49251981,1776,0.6732437142465698
19992,1641.745833,1641.7663,1,49252374,49252989,615,0.8452344852550177
19993,1641.7708,1641.774833,1,49253124,49253244,120,0.04243704630477327
19994,1641.789133,1641.809967,1,49253673,49254299,626,-0.04817189663068192
19995,1641.8128,1641.831967,1,49254384,49254959,575,0.19219872491438958
19996,1641.8802,1641.9229,1,49256406,49257687,1281,0.47032534411139704
19997,1641.9239,1641.931167,1,49257717,49257935,218,0.7425025221232886
19998,1641.934067,1641.9573,1,49258022,49258719,697,0.004488357025017355
19999,1641.961367,1641.969767,1,49258841,49259093,252,0.0064977342644263626
20000,1641.976167,1641.985933,1,49259285,49259577,292,-0.056635802884688724
20001,1642.042067,1642.087867,1,49261262,49262636,1374,0.3281897009756197
20002,1642.0954,1642.100967,1,49262862,49263029,167,-0.03873264813930607
20003,1642.102367,1642.1157,1,49263071,49263471,400,-0.1441507195239014
20004,1642.117733,1642.125767,1,49263531,49263773,242,0.06809987405148854
20005,1642.133867,1642.138467,1,49264016,49264154,138,0.4754326031422316
20006,1642.182433,1642.186167,1,49265472,49265585,113,
20007,1642.201067,1642.2275,1,49266032,49266825,793,0.12374953919307922
20008,1642.229467,1642.264667,1,49266884,49267940,1056,0.09231294422467536
20009,1642.266867,1642.273,1,49268006,49268190,184,0.20201794584522564
20010,1642.2807,1642.287933,1,49268421,49268637,216,0.21301725522139844
20011,1642.3269,1642.364767,1,49269807,49270943,1136,0.2928372010513171
20012,1642.365767,1642.370367,1,49270973,49271111,138,0.4101857867920439
20013,1642.373533,1642.3873,1,49271205,49271619,414,-0.04297391372633435
20014,1642.392367,1642.3979,1,49271771,49271937,166,
20015,1642.410767,1642.4176,1,49272323,49272528,205,0.1359060884056698
20016,1642.435433,1642.442433,1,49273062,49273272,210,0.17455140067423516
20017,1642.5026,1642.5116,1,49275078,49275348,270,0.28320291921318164
20018,1642.517933,1642.523367,1,49275537,49275701,164,-0.1305271176413311
20019,1642.5335,1642.5365,1,49276005,49276095,90,
20020,1642.5399,1642.604433,1,49276197,49278132,1935,0.20566421216228314
20021,1642.972733,1642.992,1,49289181,49289760,579,0.5362458524197747
20022,1643.027433,1643.044633,1,49290822,49291338,516,0.524391266879568
20023,1643.256933,1643.260233,1,49297707,49297806,99,0.37236108285931724
20024,1643.275033,1643.293833,1,49298250,49298814,564,0.13614320745238814
20025,1643.306567,1643.3197,1,49299197,49299591,394,0.21620577891299442
20026,1643.330567,1643.334067,1,49299917,49300022,105,0.12693213324396854
20027,1643.340267,1643.447433,1,49300208,49303422,3214,0.7724079990102157
20028,1643.459633,1643.4966,1,49303788,49304898,1110,0.047222160706533386
20029,1643.508633,1643.5117,1,49305258,49305351,93,
20030,1644.030633,1644.1194,1,49320918,49323582,2664,0.43243079451960903
20031,1644.1385,1644.173133,1,49324155,49325193,1038,0.5035620555649888
20032,1644.193033,1644.209333,1,49325790,49326279,489,0.6403071101000157
20033,1644.212867,1644.234833,1,49326386,49327044,658,0.5601308478992278
20034,1644.247733,1644.2556,1,49327431,49327668,237,0.446459240216349
20035,1644.302967,1644.355033,1,49329089,49330650,1561,0.07488469108733219
20036,1644.366933,1644.374233,1,49331007,49331226,219,-0.006821756852952541
20037,1644.379533,1644.511433,1,49331385,49335342,3957,0.7778128278554167
20038,1644.526333,1644.6171,1,49335789,49338513,2724,0.7732193554713493
20039,1644.634867,1644.641233,1,49339046,49339236,190,0.03500999598670852
20040,1645.032533,1645.0401,1,49350975,49351203,228,0.7212407063645108
20041,1645.043067,1645.0615,1,49351292,49351845,553,0.7594721713041078
20042,1645.075567,1645.1775,1,49352267,49355325,3058,0.7979688367889941
20043,1645.199933,1645.230767,1,49355997,49356923,926,0.7578925361345941
20044,1645.231933,1645.237167,1,49356957,49357115,158,0.4250353706376812
20045,1645.245467,1645.294067,1,49357364,49358822,1458,0.6717293956256479
20046,1645.297867,1645.344433,1,49358936,49360332,1396,0.7371572687910877
20047,1645.348133,1645.434433,1,49360443,49363032,2589,0.7795810598216343
20048,1645.447333,1645.452333,1,49363419,49363569,150,0.00724553633888621
20049,1645.5339,1645.648567,1,49366017,49369457,3440,0.8224289961310436
20050,1645.657533,1645.671467,1,49369725,49370144,419,0.24731996836456577
20051,1645.678933,1645.731033,1,49370367,49371930,1563,0.12509111804227152
20052,1645.739433,1645.900533,1,49372182,49377015,4833,0.79854803797139
20053,1645.902133,1645.951967,1,49377063,49378559,1496,0.7704701870881392
20054,1645.977933,1646.0111,1,49379337,49380333,996,0.8112253514434952
20055,1646.0248,1646.050333,1,49380744,49381509,765,0.005645948402909307
20056,1646.053367,1646.072033,1,49381601,49382160,559,0.15257939046581703
20057,1646.101633,1646.227467,1,49383048,49386824,3776,0.6560291113413573
20058,1646.246133,1646.372133,1,49387383,49391163,3780,0.7772658736428254
20059,1646.385033,1646.391333,1,49391550,49391739,189,0.049630189007294795
20060,1646.4169,1646.4209,1,49392507,49392627,120,-0.12446735301913064
20061,1646.459,1646.465733,1,49393770,49393971,201,0.019840431764339115
20062,1646.4671,1646.689033,1,49394013,49400670,6657,0.8313824060843309
20063,1646.698167,1646.701767,1,49400945,49401053,108,0.03747540776149267
20064,1646.721267,1646.733433,1,49401638,49402002,364,0.26617615840566955
20065,1646.7485,1646.754767,1,49402455,49402643,188,0.14671194299712265
20066,1647.2204,1647.231333,1,49416612,49416939,327,0.7615429105984697
20067,1647.2404,1647.258267,1,49417212,49417748,536,0.7054626796299137
20068,1647.2852,1647.3214,1,49418556,49419642,1086,0.6840796311174856
20069,1647.328067,1647.3366,1,49419842,49420098,256,0.5447666951206103
20070,1647.349933,1647.395433,1,49420497,49421862,1365,0.5420440852916079
20071,1647.4056,1647.468467,1,49422168,49424054,1886,0.5371605612721446
20072,1647.471733,1647.5196,1,49424151,49425588,1437,0.0427603180922388
20073,1647.534333,1647.574,1,49426029,49427220,1191,0.7502418018019397
20074,1647.590033,1647.618767,1,49427700,49428563,863,0.7893233651895403
20075,1647.633633,1647.682467,1,49429008,49430474,1466,0.052458773799251415
20076,1647.709967,1647.714633,1,49431299,49431438,139,0.10618635262328394
20077,1647.7201,1647.957267,1,49431603,49438718,7115,0.7849352419466427
20078,1648.047367,1648.0566,1,49441421,49441698,277,-0.03879550520258738
20079,1648.062233,1648.1472,1,49441866,49444416,2550,0.8013896886249405
20080,1648.458733,1648.463667,1,49453761,49453910,149,0.6977256621919503
20081,1648.465167,1648.482667,1,49453955,49454480,525,0.8032412291943627
20082,1648.495367,1648.523233,1,49454861,49455696,835,0.7919660067591314
20083,1648.528867,1648.588233,1,49455866,49457646,1780,0.8127388819055149
20084,1648.594,1648.679633,1,49457820,49460388,2568,0.8103225519641081
20085,1648.684067,1648.689333,1,49460522,49460679,157,0.4758726653266155
20086,1648.691533,1648.717033,1,49460745,49461510,765,0.7935112774703681
20087,1648.7244,1648.7279,1,49461732,49461837,105,
20088,1648.740833,1648.7641,1,49462224,49462923,699,0.01254679471013306
20089,1648.765133,1648.786367,1,49462953,49463591,638,0.21711946592812403
20090,1648.787567,1648.7952,1,49463627,49463856,229,0.6094797249913414
20091,1648.818167,1648.980467,1,49464545,49469414,4869,0.8361757880028438
20092,1648.981733,1649.0314,1,49469451,49470942,1491,0.7615216605360271
20093,1649.035133,1649.113267,1,49471053,49473398,2345,0.8028204070906791
20094,1649.166833,1649.172367,1,49475004,49475171,167,0.10645196275158597
20095,1649.206467,1649.213233,1,49476194,49476396,202,0.24167882187246653
20096,1649.227767,1649.3864,1,49476833,49481592,4759,0.7693122646593672
20097,1649.405633,1649.435967,1,49482168,49483079,911,0.7927043039539927
20098,1649.439667,1649.520833,1,49483190,49485624,2434,0.8333090598033621
20099,1649.552567,1649.560767,1,49486577,49486823,246,-0.03626993472833297
20100,1649.8783,1649.882633,1,49496349,49496478,129,0.6225900790432906
20101,1649.8845,1649.8886,1,49496535,49496658,123,0.2820311737028293
20102,1649.902367,1649.910567,1,49497071,49497317,246,0.7277062706764338
20103,1649.914933,1649.924833,1,49497447,49497744,297,0.6954058898158153
20104,1649.9506,1649.9564,1,49498518,49498692,174,0.1441343310900443
20105,1649.984467,1649.999667,1,49499534,49499990,456,0.5798776650325455
20106,1650.004267,1650.008,1,49500128,49500240,112,0.7263526146657024
20107,1650.010733,1650.017267,1,49500321,49500518,197,0.6594609953656709
20108,1650.0293,1650.036167,1,49500879,49501085,206,0.7510811346294927
20109,1650.084467,1650.1134,1,49502534,49503402,868,0.66290273200032
20110,1650.1627,1650.165833,1,49504881,49504974,93,0.8251282964374238
20111,1650.1676,1650.170967,1,49505028,49505129,101,0.13663211154305482
20112,1650.179133,1650.220367,1,49505373,49506611,1238,0.6363402733313315
20113,1650.247633,1650.262367,1,49507428,49507871,443,0.710284259806865
20114,1650.2775,1650.2813,1,49508325,49508439,114,0.6504828275247823
20115,1650.295133,1650.298533,1,49508853,49508955,102,-0.03747533345265114
20116,1650.300467,1650.3094,1,49509014,49509282,268,0.21321296066680662
20117,1650.315933,1650.3211,1,49509477,49509633,156,0.3536940654009604
20118,1650.327833,1650.3318,1,49509834,49509954,120,0.7393791520050079
20119,1650.760733,1650.775667,1,49522821,49523270,449,0.5907657976741496
20120,1650.796967,1650.8264,1,49523909,49524792,883,0.7681488165052172
20121,1650.8359,1650.839967,1,49525077,49525199,122,0.04328209831419834
20122,1650.862633,1650.887167,1,49525878,49526615,737,0.578757571148315
20123,1650.916733,1650.926133,1,49527501,49527783,282,0.5475139652603184
20124,1650.931367,1650.948433,1,49527941,49528452,511,0.5800290291052638
20125,1650.9686,1650.984467,1,49529058,49529534,476,0.5166455207654218
20126,1651.033667,1651.05,1,49531010,49531500,490,0.5605409599187118
20127,1651.0751,1651.084033,1,49532253,49532520,267,0.6227422925488286
20128,1651.091833,1651.097833,1,49532754,49532934,180,0.5298916967748876
20129,1651.115733,1651.120133,1,49533471,49533603,132,0.4169217591773379
20130,1651.136267,1651.1405,1,49534088,49534215,127,0.692614625281679
20131,1651.157033,1651.169733,1,49534710,49535091,381,0.016578230017514347
20132,1651.1748,1651.180533,1,49535244,49535415,171,0.45949207196280695
20133,1651.324267,1651.472933,1,49539728,49544187,4459,0.7458045871679801
20134,1651.480333,1651.553233,1,49544409,49546596,2187,0.7269676295725704
20135,1651.592567,1651.6942,1,49547777,49550826,3049,0.7859779503451205
20136,1651.767767,1651.772033,1,49553033,49553160,127,-0.1106043449750397
20137,1651.778333,1651.793933,1,49553349,49553817,468,0.6244713400470135
20138,1651.795233,1651.829067,1,49553856,49554872,1016,0.8184761812096156
20139,1651.838633,1651.882733,1,49555158,49556481,1323,0.8339206895376106
20140,1651.893333,1651.910433,1,49556799,49557312,513,-0.04636733436599588
20141,1651.912,1651.921867,1,49557360,49557656,296,0.24863387723982436
20142,1651.923367,1651.930733,1,49557701,49557921,220,0.175512451108994
20143,1651.948433,1651.951833,1,49558452,49558554,102,
20144,1651.952867,1652.062767,1,49558586,49561883,3297,0.8440148746020809
20145,1652.354,1652.3879,1,49570620,49571637,1017,0.6903553634817193
20146,1652.410733,1652.427167,1,49572321,49572815,494,0.7097567686619467
20147,1652.451233,1652.460767,1,49573536,49573823,287,0.8604365554696022
20148,1652.469867,1652.490733,1,49574096,49574721,625,0.7225603038546875
20149,1652.506867,1652.513567,1,49575206,49575407,201,0.212312219621565
20150,1652.541733,1652.5753,1,49576251,49577259,1008,0.0135688930029401
20151,1652.576667,1652.5831,1,49577300,49577493,193,0.7253818320087413
20152,1652.6209,1652.6286,1,49578627,49578858,231,0.8011460533837718
20153,1652.6314,1652.828933,1,49578942,49584867,5925,0.7834436618259869
20154,1652.834633,1652.908667,1,49585038,49587260,2222,0.7422783692714247
20155,1652.918967,1652.9268,1,49587569,49587804,235,0.6363014417236468
20156,1652.9333,1652.946233,1,49587999,49588386,387,0.6739049549111604
20157,1652.9476,1652.957667,1,49588428,49588730,302,0.6435288586098289
20158,1652.988033,1653.034233,1,49589640,49591026,1386,0.08054027145063672
20159,1653.046267,1653.0532,1,49591388,49591596,208,0.3741193855077077
20160,1653.057567,1653.206567,1,49591727,49596197,4470,0.7867416672063037
20161,1653.208733,1653.212,1,49596261,49596360,99,0.41997741940081845
20162,1653.213867,1653.412867,1,49596416,49602386,5970,0.7375506406520744
20163,1653.422367,1653.427533,1,49602671,49602825,154,0.2315738696244959
20164,1653.429533,1653.433433,1,49602885,49603002,117,0.014747779866279268
20165,1653.462267,1653.4653,1,49603868,49603959,91,-0.13890620954025584
20166,1653.506433,1653.513833,1,49605192,49605414,222,-0.20163627514602836
20167,1653.521267,1653.537233,1,49605638,49606116,478,0.7868680897043192
20168,1653.538367,1653.574067,1,49606151,49607222,1071,0.7173518885998177
20169,1653.5754,1653.629933,1,49607262,49608897,1635,0.6721536224133203
20170,1653.636067,1653.6425,1,49609082,49609275,193,-0.08490406313768464
20171,1653.643733,1653.6792,1,49609311,49610376,1065,0.06584934782999433
20172,1653.683067,1653.688467,1,49610492,49610654,162,0.3356865796775224
20173,1653.7071,1653.829267,1,49611213,49614878,3665,0.8086177799418823
20174,1653.8483,1653.913233,1,49615449,49617396,1947,0.7984799978267099
20175,1653.933133,1653.965467,1,49617993,49618964,971,0.8145693340473114
20176,1653.9765,1653.9925,1,49619295,49619775,480,-0.11393364318133842
20177,1653.9976,1654.0056,1,49619928,49620168,240,0.20384570149167103
20178,1654.008167,1654.0189,1,49620245,49620567,322,0.16287905325658278
20179,1654.023967,1654.030167,1,49620719,49620905,186,0.6134176333088236
20180,1654.043367,1654.2625,1,49621301,49627875,6574,0.8298197594864071
20181,1654.284467,1654.289667,1,49628534,49628690,156,-0.09581150215837743
20182,1654.291,1654.294,1,49628730,49628820,90,
20183,1654.295467,1654.301,1,49628864,49629030,166,-0.035599713070597526
20184,1654.927967,1654.932567,1,49647839,49647977,138,0.6959662958732838
20185,1654.935533,1654.955067,1,49648065,49648652,587,0.6801781136291708
20186,1655.011133,1655.0348,1,49650333,49651044,711,0.6314723507555153
20187,1655.035933,1655.050467,1,49651077,49651514,437,0.5067566229382728
20188,1655.061533,1655.068867,1,49651845,49652066,221,0.28758445112573483
20189,1655.0785,1655.094533,1,49652355,49652835,480,0.4105011788268084
20190,1655.098167,1655.131167,1,49652945,49653935,990,0.6720292557096922
20191,1655.1543,1655.202,1,49654629,49656060,1431,0.6428466562141242
20192,1655.208233,1655.223,1,49656246,49656690,444,0.28218859278264685
20193,1655.2306,1655.235733,1,49656918,49657071,153,0.41390009636426095
20194,1655.245467,1655.268333,1,49657364,49658049,685,0.5865038543870109
20195,1655.269467,1655.284167,1,49658084,49658525,441,0.4239709822171686
20196,1655.2964,1655.3127,1,49658892,49659381,489,0.7346814899984065
20197,1655.3182,1655.3306,1,49659546,49659918,372,0.6348745897805884
20198,1655.558367,1655.5726,1,49666751,49667178,427,0.3306444909819209
20199,1655.577,1655.6003,1,49667310,49668009,699,0.4068246748912657
20200,1655.610767,1655.616867,1,49668323,49668506,183,
20201,1655.618,1655.6387,1,49668540,49669161,621,0.3414810845975787
20202,1655.695967,1655.817933,1,49670879,49674537,3658,0.8039392402544192
20203,1655.835667,1655.9201,1,49675070,49677603,2533,0.23983167321304277
20204,1655.9217,1655.932233,1,49677651,49677966,315,0.0913888160625423
20205,1655.970033,1655.973967,1,49679100,49679219,119,0.20546392283208134
20206,1655.996367,1656.0081,1,49679891,49680243,352,0.5441457982981192
20207,1656.051033,1656.056567,1,49681530,49681697,167,
20208,1656.205433,1656.233267,1,49686162,49686998,836,0.6013695885894949
20209,1656.2382,1656.242367,1,49687146,49687271,125,0.8742791767512688
20210,1656.300367,1656.3154,1,49689011,49689462,451,0.5262931570476913
20211,1656.324167,1656.345967,1,49689725,49690379,654,0.5736104818479164
20212,1656.352267,1656.358233,1,49690568,49690746,178,-0.40757024410503817
20213,1656.3811,1656.4007,1,49691433,49692021,588,0.668041762414772
20214,1656.4121,1656.4296,1,49692363,49692888,525,0.5363020362970443
20215,1656.431767,1656.4365,1,49692953,49693095,142,0.44823919028266535
20216,1656.438567,1656.446967,1,49693157,49693409,252,0.47038512534082416
20217,1656.457833,1656.499867,1,49693734,49694996,1262,0.6161678553528561
20218,1656.506667,1656.543833,1,49695200,49696314,1114,0.482485259568221
20219,1656.558,1656.565767,1,49696740,49696973,233,-0.07394978287499984
20220,1656.5673,1656.636133,1,49697019,49699083,2064,0.48307864927432875
20221,1656.686933,1656.7668,1,49700607,49703004,2397,0.7455940505098904
20222,1656.767833,1656.790433,1,49703034,49703712,678,0.7220575872992807
20223,1657.490933,1657.520167,1,49724727,49725605,878,0.6985020710460367
20224,1657.543967,1657.587067,1,49726319,49727612,1293,0.8511536743652832
20225,1657.596033,1657.600733,1,49727880,49728021,141,0.3143649452227567
20226,1657.6052,1657.667467,1,49728156,49730024,1868,0.5946299070153098
20227,1657.6704,1657.748033,1,49730112,49732440,2328,0.6660198397582158
20228,1657.756033,1657.781,1,49732680,49733430,750,0.617573670512425
20229,1657.782733,1657.8009,1,49733481,49734027,546,0.5206298056373269
20230,1657.826467,1657.8307,1,49734794,49734921,127,
20231,1657.838033,1657.8478,1,49735140,49735434,294,0.1646477663657346
20232,1657.859667,1657.864833,1,49735790,49735944,154,0.03253073469070105
20233,1658.0037,1658.0086,1,49740111,49740258,147,0.4943010016803797
20234,1658.021967,1658.1278,1,49740659,49743834,3175,0.8335113435770769
20235,1658.1511,1658.173433,1,49744533,49745202,669,0.035566428951282876
20236,1658.175533,1658.2085,1,49745265,49746255,990,0.11160230393790321
20237,1658.293533,1658.311867,1,49748805,49749356,551,0.20899374545406996
20238,1658.324333,1658.340767,1,49749729,49750223,494,-0.01156201202607386
20239,1658.3519,1658.476167,1,49750557,49754285,3728,0.7901912515321019
20240,1658.620267,1658.624733,1,49758608,49758741,133,0.3676783090538907
20241,1658.636433,1658.6883,1,49759092,49760649,1557,0.07785876132221956
20242,1658.695067,1658.832967,1,49760852,49764989,4137,0.8126428527027939
20243,1658.8649,1658.872633,1,49765947,49766178,231,0.40756291836804814
20244,1658.880233,1658.897533,1,49766406,49766925,519,-0.1773225970053204
20245,1658.903733,1658.908433,1,49767111,49767252,141,-0.10918313584171657
20246,1658.909567,1658.913633,1,49767287,49767408,121,-0.254965437922312
20247,1659.0908,1659.116967,1,49772724,49773509,785,0.6774970613283909
20248,1659.118233,1659.157533,1,49773546,49774725,1179,0.814189326328972
20249,1659.1621,1659.330767,1,49774863,49779923,5060,0.8145776618085412
20250,1659.335767,1659.356833,1,49780073,49780704,631,0.7792478494478309
20251,1659.3758,1659.383867,1,49781274,49781516,242,0.03656640018037915
20252,1659.385367,1659.468467,1,49781561,49784054,2493,0.7497908492681624
20253,1659.4923,1659.497,1,49784769,49784910,141,-0.01598010998408035
20254,1660.0467,1660.0589,1,49801401,49801767,366,0.7519051699203706
20255,1660.068333,1660.102267,1,49802049,49803068,1019,0.8035945174108723
20256,1660.128,1660.133867,1,49803840,49804016,176,0.4270300109374993
20257,1660.1364,1660.1463,1,49804092,49804389,297,0.6448041759938997
20258,1660.161867,1660.1834,1,49804856,49805502,646,0.18388606166243052
20259,1660.185167,1660.234733,1,49805555,49807041,1486,0.21635776359060976
20260,1660.253833,1660.270033,1,49807614,49808100,486,0.7799380104641728
20261,1660.290367,1660.325833,1,49808711,49809774,1063,0.7730271122424819
20262,1660.332167,1660.335767,1,49809965,49810073,108,0.5730868358705355
20263,1660.345967,1660.3603,1,49810379,49810809,430,-0.027739583840935816
20264,1660.362167,1660.388133,1,49810865,49811643,778,0.12420683889718813
20265,1660.391067,1660.398233,1,49811732,49811946,214,0.29206273337735544
20266,1660.423733,1660.428833,1,49812711,49812864,153,0.5891367906621189
20267,1660.429833,1660.441633,1,49812894,49813248,354,0.6670814901822937
20268,1660.443367,1660.47,1,49813301,49814100,799,0.7459009241262452
20269,1660.471467,1660.4756,1,49814144,49814268,124,0.7475331465286971
20270,1660.4815,1660.5343,1,49814445,49816029,1584,0.7466404030354304
20271,1660.5492,1660.555367,1,49816476,49816661,185,0.13762352842937184
20272,1660.564333,1660.585667,1,49816929,49817570,641,0.0067200702424228985
20273,1660.6372,1660.802467,1,49819116,49824074,4958,0.8009505632397801
20274,1660.809067,1660.812733,1,49824272,49824381,109,0.2889906160046377
20275,1660.8208,1660.824167,1,49824624,49824725,101,
20276,1660.832967,1660.8444,1,49824989,49825332,343,0.3287774316056553
20277,1661.279267,1661.307,1,49838378,49839210,832,0.43952529587060546
20278,1661.312367,1661.3195,1,49839371,49839585,214,0.14715769265551304
20279,1661.337,1661.355167,1,49840110,49840655,545,0.6533145008714089
20280,1661.4152,1661.424767,1,49842456,49842743,287,0.7705986528557847
20281,1661.643467,1661.6596,1,49849304,49849788,484,0.7278127267485832
20282,1661.660933,1661.756933,1,49849827,49852707,2880,0.6999592382410843
20283,1662.017767,1662.225367,1,49860533,49866761,6228,0.6773079997898463
20284,1662.243833,1662.247167,1,49867314,49867415,101,-0.05839591267537063
20285,1662.248233,1662.254,1,49867446,49867620,174,0.15901653343792763
20286,1662.5326,1662.539533,1,49875978,49876185,207,-0.039893604305615976
20287,1662.542567,1662.7013,1,49876277,49881039,4762,0.7694179339871885
20288,1662.702867,1662.709233,1,49881086,49881276,190,-0.1334879746476835
20289,1662.719533,1662.783833,1,49881585,49883514,1929,0.8047872700748361
20290,1662.799133,1662.8351,1,49883973,49885053,1080,0.7255111147406139
20291,1662.844833,1662.8491,1,49885344,49885473,129,-0.41929181469916516
20292,1662.8532,1662.858767,1,49885596,49885763,167,-0.08585244789670829
20293,1662.873267,1662.8801,1,49886198,49886403,205,0.06178954167196206
20294,1662.884733,1662.891767,1,49886541,49886753,212,-0.058440034428220565
20295,1663.1645,1663.169467,1,49894935,49895084,149,0.6788287600064843
20296,1663.173533,1663.2275,1,49895205,49896825,1620,0.787425750616764
20297,1663.2286,1663.233933,1,49896858,49897017,159,0.635930535517691
20298,1663.2368,1663.277233,1,49897104,49898316,1212,0.791340120544425
20299,1663.305133,1663.308433,1,49899153,49899252,99,0.1530125017624927
20300,1663.5027,1663.510767,1,49905081,49905323,242,0.5516282252531305
20301,1663.516567,1663.5451,1,49905497,49906353,856,0.5169801058750232
20302,1663.8054,1663.958833,1,49914162,49918764,4602,0.7578933544976034
20303,1663.974,1663.978733,1,49919220,49919361,141,-0.007588408221327422
20304,1663.9826,1663.9864,1,49919478,49919592,114,
20305,1664.972333,1664.978333,1,49949169,49949349,180,0.5667031760769163
20306,1664.998367,1665.0024,1,49949951,49950072,121,
20307,1665.003533,1665.008067,1,49950105,49950242,137,0.6075412492705393
20308,1665.036333,1665.056,1,49951089,49951680,591,0.6130324645439457
20309,1665.101667,1665.123367,1,49953050,49953701,651,0.5779487189229655
20310,1665.128333,1665.132167,1,49953849,49953965,116,0.8965594712612794
20311,1665.172733,1665.182267,1,49955181,49955468,287,0.5979639279650744
20312,1665.2213,1665.225733,1,49956639,49956771,132,0.11442838549761905
20313,1665.3673,1665.485333,1,49961019,49964559,3540,0.8206428358161442
20314,1665.776433,1665.850267,1,49973292,49975508,2216,0.8069942936026521
20315,1665.863267,1665.9476,1,49975898,49978428,2530,0.8069485948596534
20316,1665.968467,1666.067367,1,49979054,49982021,2967,0.7783915910655619
20317,1666.071367,1666.0949,1,49982141,49982847,706,0.7094907195141338
20318,1666.097633,1666.121233,1,49982928,49983636,708,0.6136264841164955
20319,1666.122733,1666.145967,1,49983681,49984379,698,0.7767485516708185
20320,1666.150833,1666.209667,1,49984524,49986290,1766,0.8204036899147045
20321,1666.213033,1666.310033,1,49986390,49989300,2910,0.7469525657182049
20322,1666.589467,1666.6002,1,49997684,49998006,322,0.3084825682677474
20323,1666.601767,1666.643767,1,49998053,49999313,1260,0.8110228644216306
20324,1666.6454,1666.689033,1,49999362,50000670,1308,0.8169573293640912
20325,1666.860367,1666.863933,1,50005811,50005917,106,0.25661184305128953
20326,1667.093067,1667.1401,1,50012792,50014203,1411,0.7431361178681335
20327,1667.1577,1667.1788,1,50014731,50015364,633,0.7632090556936261
20328,1667.188867,1667.195233,1,50015666,50015856,190,0.6954989199338113
20329,1667.196833,1667.316567,1,50015904,50019497,3593,0.7937975061938343
20330,1667.982333,1668.041733,1,50039469,50041251,1782,0.7263604735843495
20331,1668.049233,1668.092533,1,50041476,50042775,1299,0.8490609368636655
20332,1668.8072,1668.8193,1,50064216,50064579,363,0.628422361200794
20333,1668.823233,1668.845267,1,50064696,50065358,662,0.5237349556807295
20334,1668.863833,1668.881567,1,50065914,50066447,533,0.5224773414810161
20335,1668.894,1668.8995,1,50066820,50066985,165,0.5958449954855973
20336,1668.9017,1668.9108,1,50067051,50067324,273,0.5834025151002855
20337,1668.9399,1668.947233,1,50068197,50068416,219,0.508069373475898
20338,1668.948567,1668.9521,1,50068457,50068563,106,0.5779234754466798
20339,1668.9537,1668.969533,1,50068611,50069085,474,0.6375772770812996
20340,1669.0228,1669.0264,1,50070684,50070792,108,0.49676290328061024
20341,1669.029033,1669.035433,1,50070870,50071062,192,0.6210611727072977
20342,1669.185267,1669.235167,1,50075558,50077055,1497,0.7269010633222863
20343,1669.2363,1669.262767,1,50077089,50077883,794,0.6916577445644826
20344,1669.2728,1669.293467,1,50078184,50078804,620,0.7279000232278209
20345,1669.730467,1669.829433,1,50091914,50094882,2968,0.7559988475857871
20346,1670.150267,1670.176667,1,50104508,50105300,792,0.7061678031653343
20347,1670.178,1670.280133,1,50105340,50108403,3063,0.8440113168591632
20348,1670.298133,1670.323233,1,50108943,50109696,753,0.8515590798084154
20349,1670.329933,1670.415967,1,50109897,50112479,2582,0.7210912259488823
20350,1670.669367,1670.8303,1,50120081,50124909,4828,0.8297490656120562
20351,1670.831533,1670.898367,1,50124945,50126951,2006,0.7807633868891412
20352,1670.9028,1670.987267,1,50127084,50129618,2534,0.7792874348721831
20353,1671.016,1671.028433,1,50130480,50130852,372,0.1249880186749713
20354,1671.0644,1671.081133,1,50131932,50132433,501,0.6540327603447313
20355,1671.085567,1671.1011,1,50132567,50133033,466,0.7616822999857725
20356,1671.1027,1671.137467,1,50133081,50134124,1043,0.7583871689876519
20357,1671.388633,1671.509867,1,50141658,50145296,3638,0.7988661421817247
20358,1671.6082,1671.7327,1,50148246,50151981,3735,0.8066296820491792
20359,1671.7415,1671.7453,1,50152245,50152359,114,-0.08917751160206312
20360,1671.749133,1671.761567,1,50152473,50152847,374,-0.19867844567542908
20361,1672.119033,1672.157733,1,50163570,50164731,1161,0.6094149962702105
20362,1672.16,1672.1703,1,50164800,50165109,309,0.6636234824921111
20363,1672.1826,1672.251833,1,50165478,50167554,2076,0.7805751519148632
20364,1672.709133,1672.714467,1,50181273,50181434,161,0.7605224266590882
20365,1672.715633,1672.726567,1,50181468,50181797,329,0.5860185341258367
20366,1672.7458,1672.8236,1,50182374,50184708,2334,0.7706695960222637
20367,1672.838033,1672.8411,1,50185140,50185233,93,-0.14218987541886094
20368,1672.842233,1672.8479,1,50185266,50185437,171,0.2544946012787664
20369,1673.118433,1673.2438,1,50193552,50197314,3762,0.7885415056890688
20370,1673.252067,1673.255567,1,50197562,50197667,105,0.1743769196205506
20371,1673.262933,1673.273233,1,50197887,50198196,309,0.0292119183054188
20372,1673.557967,1673.561767,1,50206739,50206853,114,0.7637723307904427
20373,1673.5821,1673.605433,1,50207463,50208162,699,0.7730216686964302
20374,1673.623533,1673.712667,1,50208705,50211380,2675,0.4131349759088375
20375,1673.720633,1673.773233,1,50211618,50213196,1578,0.6881464425815034
20376,1673.7905,1673.830333,1,50213715,50214909,1194,0.7821759825712293
20377,1673.8407,1673.847767,1,50215221,50215433,212,0.7496376835742674
20378,1673.882633,1673.903767,1,50216478,50217113,635,-0.032728672546812734
20379,1673.904833,1673.9125,1,50217144,50217375,231,0.2908114525146141
20380,1673.913733,1673.918667,1,50217411,50217560,149,
20381,1673.943,1674.040467,1,50218290,50221214,2924,0.6989746957860353
20382,1674.049567,1674.1604,1,50221487,50224812,3325,0.845131007160603
20383,1674.355,1674.374967,1,50230650,50231249,599,0.6130183182147275
20384,1674.378867,1674.382333,1,50231366,50231469,103,0.09068588858427047
20385,1674.384033,1674.3897,1,50231520,50231691,171,-0.1810669437713162
20386,1674.6144,1674.6666,1,50238432,50239998,1566,0.7878418291450604
20387,1674.669267,1674.715967,1,50240078,50241479,1401,0.5690802083522187
20388,1674.7393,1674.742767,1,50242179,50242283,104,0.42491427513227154
20389,1674.750067,1674.755767,1,50242502,50242673,171,-0.12425202399226984
20390,1674.758167,1674.7694,1,50242745,50243082,337,0.23044312841619036
20391,1674.770467,1674.775967,1,50243114,50243279,165,-0.05596199877821689
20392,1674.79,1674.878133,1,50243700,50246343,2643,0.8021474994938108
20393,1674.888133,1674.9876,1,50246643,50249628,2985,0.8097795526879384
20394,1674.989867,1674.998767,1,50249696,50249963,267,-0.0017041060571589617
20395,1675.509033,1675.514967,1,50265270,50265449,179,0.5157098787438879
20396,1675.519033,1675.523133,1,50265570,50265693,123,0.7727403383296882
20397,1675.5371,1675.5495,1,50266113,50266485,372,0.42488852336920546
20398,1675.5577,1675.564733,1,50266731,50266941,210,0.5198994366208444
20399,1675.5702,1675.608033,1,50267106,50268240,1134,0.6999199185347716
20400,1675.6105,1675.6146,1,50268315,50268438,123,0.10213196912202653
20401,1675.6227,1675.652433,1,50268681,50269572,891,0.6378399819566969
20402,1675.687733,1675.693967,1,50270631,50270819,188,0.49899690793120494
20403,1675.701,1675.7154,1,50271030,50271462,432,0.4704090743955762
20404,1675.716767,1675.722767,1,50271503,50271683,180,0.16113756521864062
20405,1675.734433,1675.7679,1,50272032,50273037,1005,0.4246096639077137
20406,1675.798967,1675.815967,1,50273969,50274479,510,0.5514674360935724
20407,1675.835467,1675.850633,1,50275064,50275518,454,0.669903576186602
20408,1675.8588,1675.8721,1,50275764,50276163,399,0.6485372755391445
20409,1676.0316,1676.157333,1,50280948,50284719,3771,0.836590831275956
20410,1676.397533,1676.477867,1,50291925,50294336,2411,0.8168148817616337
20411,1676.487467,1676.622267,1,50294624,50298668,4044,0.7492326794562126
20412,1676.643933,1676.648,1,50299317,50299440,123,0.17483181447122415
20413,1676.649233,1676.652867,1,50299476,50299586,110,0.17322204317581316
20414,1676.966433,1676.991033,1,50308992,50309730,738,0.8135028178052689
20415,1676.9939,1677.183533,1,50309817,50315505,5688,0.8483416003505562
20416,1677.192,1677.2288,1,50315760,50316864,1104,0.8067632632766522
20417,1677.230567,1677.3626,1,50316917,50320878,3961,0.814487315584279
20418,1677.683667,1677.688367,1,50330510,50330651,141,0.5482553738471382
20419,1677.6964,1677.7073,1,50330892,50331219,327,0.656652621330128
20420,1677.7084,1677.800667,1,50331252,50334020,2768,0.799762879547903
20421,1677.805233,1677.8308,1,50334156,50334924,768,0.7242028509535448
20422,1677.8396,1677.948433,1,50335188,50338452,3264,0.7234217574815787
20423,1677.954233,1677.976067,1,50338626,50339282,656,0.11115809091421607
20424,1678.0269,1678.030433,1,50340807,50340912,105,
20425,1678.033767,1678.051967,1,50341013,50341559,546,0.7107945925213001
20426,1678.0564,1678.117733,1,50341692,50343531,1839,0.8036370365103365
20427,1678.685533,1678.6888,1,50360565,50360664,99,0.444014389840738
20428,1678.709,1678.756467,1,50361270,50362694,1424,0.8362678745116188
20429,1678.7646,1678.807633,1,50362938,50364228,1290,0.8370287096256136
20430,1678.815733,1678.8212,1,50364471,50364636,165,0.238631143110987
20431,1678.828567,1678.832267,1,50364857,50364968,111,-0.04661342758742815
20432,1678.839567,1678.847733,1,50365187,50365431,244,0.10552756610625293
20433,1678.849633,1678.8537,1,50365488,50365611,123,-0.13633830493732416
20434,1679.187933,1679.192167,1,50375637,50375765,128,0.5531027937496021
20435,1679.1979,1679.235267,1,50375937,50377058,1121,0.5654322185370646
20436,1679.251433,1679.266167,1,50377542,50377985,443,0.4883433791011887
20437,1679.2766,1679.298167,1,50378298,50378945,647,0.6163944808702073
20438,1679.328667,1679.385333,1,50379860,50381559,1699,0.588774757925481
20439,1679.4096,1679.420667,1,50382288,50382620,332,0.4357597593694143
20440,1679.4238,1679.444967,1,50382714,50383349,635,0.5310989625396516
20441,1679.459633,1679.4683,1,50383788,50384049,261,0.5662083896172605
20442,1679.4967,1679.520433,1,50384901,50385612,711,0.1042345016122197
20443,1679.521433,1679.551433,1,50385642,50386542,900,0.14207164019344726
20444,1679.556233,1679.566467,1,50386686,50386994,308,0.6319980391510294
20445,1679.568,1679.7613,1,50387040,50392839,5799,0.8054598244122897
20446,1679.7779,1679.8662,1,50393337,50395986,2649,0.7848067708774832
20447,1680.120067,1680.134333,1,50403602,50404029,427,0.7886521959317675
20448,1680.135467,1680.2229,1,50404064,50406687,2623,0.8254825997946741
20449,1680.2605,1680.266933,1,50407815,50408007,192,-0.06457118389871135
20450,1680.269967,1680.278567,1,50408099,50408357,258,0.44129096872151063
20451,1680.488633,1680.511633,1,50414658,50415348,690,0.6919819578178708
20452,1680.6671,1680.684933,1,50420013,50420547,534,0.3207326502486627
20453,1680.696333,1680.723367,1,50420889,50421701,812,0.14193913373219125
20454,1680.7249,1680.7285,1,50421747,50421855,108,
20455,1680.7321,1680.7478,1,50421963,50422434,471,-0.12513268420004306
20456,1680.748833,1680.7564,1,50422464,50422692,228,0.1244555711143659
20457,1680.7574,1680.770233,1,50422722,50423106,384,0.22424225464696862
20458,1680.771467,1680.774967,1,50423144,50423249,105,
20459,1680.805667,1681.012833,1,50424170,50430384,6214,0.8365125388264832
20460,1681.027067,1681.040233,1,50430812,50431206,394,0.8193441994853163
20461,1681.5004,1681.530033,1,50445012,50445900,888,0.6712156660868537
20462,1681.580967,1681.590167,1,50447429,50447705,276,0.4341402347712216
20463,1681.880267,1681.906167,1,50456408,50457185,777,0.5297931929235504
20464,1681.918667,1681.928167,1,50457560,50457845,285,0.012700410394563513
20465,1681.9314,1681.936267,1,50457942,50458088,146,
20466,1682.034767,1682.136767,1,50461043,50464103,3060,0.7710724447410587
20467,1682.147467,1682.1544,1,50464424,50464632,208,0.4226192315146777
20468,1682.167267,1682.190467,1,50465018,50465714,696,-0.017727991729160293
20469,1682.191933,1682.202233,1,50465757,50466066,309,0.17319231092952878
20470,1682.204067,1682.214333,1,50466122,50466429,307,0.030992262608894844
20471,1682.305667,1682.308767,1,50469170,50469263,93,-0.22540863432605493
20472,1682.328567,1682.346933,1,50469857,50470407,550,0.5265004862144848
20473,1682.351633,1682.3862,1,50470548,50471586,1038,0.05034118991615255
20474,1682.387733,1682.413767,1,50471631,50472413,782,0.07699440623266422
20475,1682.436567,1682.6132,1,50473097,50478396,5299,0.7094525107883329
20476,1682.6143,1682.641567,1,50478429,50479247,818,0.5891448827523141
20477,1682.958433,1683.0325,1,50488752,50490975,2223,0.6901171290715251
20478,1683.042133,1683.061,1,50491263,50491830,567,0.7749175869735749
20479,1683.457367,1683.486233,1,50503721,50504586,865,0.7393334083523267
20480,1683.5121,1683.551833,1,50505363,50506554,1191,0.5654513863572134
20481,1683.554133,1683.557233,1,50506623,50506716,93,0.09383574094907551
20482,1683.568033,1683.597533,1,50507040,50507925,885,0.6117181652469258
20483,1683.619633,1683.631533,1,50508588,50508945,357,0.5621496004246038
20484,1683.635833,1683.653633,1,50509074,50509608,534,0.6330210086578134
20485,1683.669533,1683.673667,1,50510085,50510210,125,0.4676679237131534
20486,1683.695667,1683.7036,1,50510870,50511108,238,-0.09455073448808009
20487,1683.705033,1683.763033,1,50511150,50512890,1740,0.39074034048037515
20488,1683.775833,1683.791733,1,50513274,50513751,477,0.7935668613397054
20489,1683.794667,1683.894333,1,50513840,50516829,2989,0.6931216828830523
20490,1683.919533,1683.9278,1,50517585,50517834,249,0.5146116634615291
20491,1683.940333,1683.9472,1,50518209,50518416,207,-0.09520074056618245
20492,1684.162833,1684.1923,1,50524884,50525769,885,0.04068011291091539
20493,1684.3246,1684.329767,1,50529738,50529893,155,0.7397375031371086
20494,1684.3324,1684.3472,1,50529972,50530416,444,0.5132213484716606
20495,1684.360567,1684.3941,1,50530817,50531823,1006,0.788577052441067
20496,1684.3987,1684.457233,1,50531961,50533716,1755,0.7558915189182281
20497,1684.464833,1684.549567,1,50533944,50536487,2543,0.7641731248873327
20498,1684.561167,1684.632433,1,50536835,50538972,2137,0.7929771306751918
20499,1684.6466,1684.6817,1,50539398,50540451,1053,0.7525396057927797
20500,1684.985833,1684.999767,1,50549574,50549993,419,0.4988494765340952
20501,1685.016133,1685.0218,1,50550483,50550654,171,0.39275063259634163
20502,1685.229267,1685.237733,1,50556878,50557131,253,-0.05084642323952319
20503,1685.239033,1685.245333,1,50557170,50557359,189,-0.1652161545719416
20504,1685.2464,1685.2562,1,50557392,50557686,294,-0.0019348834724540207
20505,1685.2593,1685.273233,1,50557779,50558196,417,0.11298085074203217
20506,1685.292933,1685.472667,1,50558787,50564180,5393,0.7273969978083175
20507,1685.476533,1685.5896,1,50564295,50567688,3393,0.7045931055266552
20508,1685.895467,1685.900033,1,50576864,50577000,136,0.6858830616995067
20509,1685.921067,1685.924467,1,50577632,50577734,102,0.5257161318892597
20510,1686.348933,1686.358933,1,50590467,50590767,300,0.14793471988617712
20511,1686.3763,1686.3812,1,50591289,50591436,147,0.16115683963505048
20512,1686.385833,1686.3932,1,50591574,50591796,222,-0.1433574900541141
20513,1686.4288,1686.434467,1,50592864,50593034,170,0.6044916069210369
20514,1686.456633,1686.4744,1,50593698,50594232,534,0.3793112656024545
20515,1686.500533,1686.511233,1,50595015,50595336,321,0.03046333667365623
20516,1686.512467,1686.535167,1,50595374,50596055,681,0.8592947823970503
20517,1686.538133,1686.5819,1,50596143,50597457,1314,0.7728817210811186
20518,1686.589,1686.600333,1,50597670,50598009,339,0.7333707177336679
20519,1686.601467,1686.6307,1,50598044,50598921,877,0.7928109576580892
20520,1686.656833,1686.676867,1,50599704,50600306,602,0.5733698477043621
20521,1686.6834,1686.705,1,50600502,50601150,648,0.6731840622205715
20522,1686.707167,1686.7428,1,50601215,50602284,1069,0.6684037569665943
20523,1686.743967,1686.756533,1,50602319,50602695,376,0.23160568259541495
20524,1686.770267,1686.777567,1,50603108,50603327,219,0.4274628883374489
20525,1686.782067,1686.794867,1,50603462,50603846,384,0.564988075372811
20526,1686.798,1686.816867,1,50603940,50604506,566,0.6395837266119738
20527,1687.147833,1687.1667,1,50614434,50615001,567,0.21930980844629133
20528,1687.167933,1687.178567,1,50615037,50615357,320,0.19802428266749583
20529,1687.2171,1687.2248,1,50616513,50616744,231,0.5231828181551087
20530,1687.2394,1687.282167,1,50617182,50618465,1283,0.8296547610921716
20531,1687.283833,1687.401467,1,50618514,50622044,3530,0.8120326709168204
20532,1687.405633,1687.425967,1,50622168,50622779,611,0.7359290239867894
20533,1687.752667,1687.7593,1,50632580,50632779,199,0.3819459061774479
20534,1687.846967,1687.852367,1,50635409,50635571,162,0.003962288071377334
20535,1688.677633,1688.6862,1,50660328,50660586,258,0.5140875572842917
20536,1688.785333,1688.794967,1,50663559,50663849,290,0.5510270424256297
20537,1688.808767,1688.8287,1,50664263,50664861,598,0.2501366776571181
20538,1688.831867,1688.837533,1,50664956,50665125,169,0.30065586670600364
20539,1689.094733,1689.105133,1,50672841,50673153,312,0.7609445810133024
20540,1689.1064,1689.122567,1,50673192,50673677,485,0.5608634517645864
20541,1689.1888,1689.199433,1,50675664,50675982,318,0.6269074568337931
20542,1689.3506,1689.366167,1,50680518,50680985,467,0.5684153633876464
20543,1689.4208,1689.428167,1,50682624,50682845,221,0.44534691010571315
20544,1689.430567,1689.433867,1,50682917,50683016,99,0.5248147456860562
20545,1689.738633,1689.7781,1,50692158,50693343,1185,0.5225061066210945
20546,1689.787533,1689.8344,1,50693625,50695032,1407,0.4654503449479633
20547,1689.835967,1689.839067,1,50695079,50695172,93,0.17533227858550207
20548,1689.9766,1690.000533,1,50699298,50700015,717,0.6201994867519484
20549,1690.027367,1690.049367,1,50700821,50701481,660,0.5209673712322527
20550,1690.050933,1690.06,1,50701527,50701800,273,-0.042382084959421404
20551,1690.065833,1690.0767,1,50701974,50702301,327,0.1203823487321388
20552,1690.0778,1690.0884,1,50702334,50702652,318,0.1863125719675819
20553,1690.152033,1690.2789,1,50704560,50708367,3807,0.660670482384698
20554,1690.281433,1690.285833,1,50708442,50708574,132,0.22795514184335344
20555,1690.287333,1690.2933,1,50708619,50708799,180,0.2699124781510096
20556,1690.303267,1690.334,1,50709098,50710020,922,0.07289800633832307
20557,1690.3358,1690.3657,1,50710074,50710971,897,0.3023059875982467
20558,1690.3669,1690.379133,1,50711007,50711373,366,0.08870483092306926
20559,1690.382267,1690.387,1,50711468,50711610,142,0.4319334074287936
20560,1690.394833,1690.4029,1,50711844,50712087,243,0.5641395706312231
20561,1690.407967,1690.440267,1,50712239,50713208,969,0.4577008598850875
20562,1690.454833,1690.4668,1,50713644,50714004,360,-0.059344296555671985
20563,1690.4699,1690.4761,1,50714097,50714283,186,0.17398313531548512
20564,1690.479267,1690.488267,1,50714378,50714648,270,0.784060796814798
20565,1690.723733,1690.754233,1,50721711,50722626,915,0.5579863812904564
20566,1690.7657,1690.816867,1,50722971,50724506,1535,0.7260973788831016
20567,1690.818367,1690.859367,1,50724551,50725781,1230,0.5921727278509539
20568,1690.877433,1690.924433,1,50726322,50727732,1410,0.5489246000464417
20569,1690.9295,1690.992567,1,50727885,50729777,1892,0.6833426591319774
20570,1690.993767,1691.007433,1,50729813,50730222,409,0.5390279446812384
20571,1691.0173,1691.025167,1,50730519,50730755,236,0.5289456851274716
20572,1691.029767,1691.044433,1,50730893,50731332,439,0.559253527659882
20573,1691.045533,1691.057133,1,50731365,50731713,348,0.5263605470377067
20574,1691.0861,1691.104967,1,50732583,50733149,566,0.02452545109781084
20575,1691.106033,1691.1163,1,50733180,50733489,309,0.10063818400757278
20576,1691.1209,1691.132967,1,50733627,50733989,362,0.13547901109973867
20577,1691.1342,1691.146867,1,50734026,50734406,380,0.21145854773276088
20578,1691.179967,1691.186967,1,50735399,50735609,210,0.12471514771833876
20579,1691.188133,1691.213133,1,50735643,50736393,750,0.3638351346686172
20580,1691.214233,1691.218267,1,50736426,50736548,122,0.6715920131844962
20581,1691.221067,1691.226633,1,50736632,50736798,166,0.7921519849861463
20582,1691.240767,1691.255767,1,50737223,50737673,450,-0.08812339928554888
20583,1691.264867,1691.277767,1,50737946,50738333,387,0.18341874250559423
20584,1691.279467,1691.286633,1,50738384,50738598,214,-0.1216107904796874
20585,1691.309467,1691.435667,1,50739284,50743070,3786,0.8166749129169149
20586,1691.453333,1691.5459,1,50743599,50746377,2778,0.780097812406571
20587,1691.549133,1691.555333,1,50746473,50746659,186,0.24230703397957987
20588,1691.561367,1691.5654,1,50746841,50746962,121,-0.07813785222207527
20589,1691.581767,1691.590367,1,50747453,50747711,258,0.13790143407925884
20590,1691.5983,1691.6064,1,50747949,50748192,243,-0.1828716239960339
20591,1691.608833,1691.623233,1,50748264,50748696,432,0.19450440293590154
20592,1691.6288,1691.633333,1,50748864,50748999,135,0.041840885207740326
20593,1691.685,1691.690233,1,50750550,50750706,156,0.1590809237093317
20594,1691.6982,1691.721033,1,50750946,50751630,684,0.43962296929353945
20595,1691.723433,1691.730533,1,50751702,50751915,213,0.7636512785725527
20596,1691.755967,1691.763567,1,50752679,50752907,228,-0.10752451441147123
20597,1691.774967,1691.7788,1,50753249,50753364,115,-0.027320588408552976
20598,1691.790133,1691.795233,1,50753703,50753856,153,0.14841416594575751
20599,1691.856333,1691.863367,1,50755689,50755901,212,0.518042831908758
20600,1691.8663,1691.882067,1,50755989,50756462,473,0.7738690616479283
20601,1691.902467,1691.922667,1,50757074,50757680,606,0.7036674712982718
20602,1691.9286,1692.014167,1,50757858,50760425,2567,0.7147777534493727
20603,1692.0153,1692.024333,1,50760459,50760729,270,0.5977037110868366
20604,1692.0273,1692.072867,1,50760819,50762186,1367,0.7086550619839754
20605,1692.082333,1692.0935,1,50762469,50762805,336,0.4675018420622722
20606,1692.122733,1692.1311,1,50763681,50763933,252,-0.1297229125645921
20607,1692.140167,1692.1474,1,50764205,50764422,217,0.10301273275120994
20608,1692.1624,1692.171367,1,50764872,50765141,269,-0.06585763242296336
20609,1692.176233,1692.192133,1,50765286,50765763,477,0.05547607431805576
20610,1692.392533,1692.431733,1,50771775,50772951,1176,0.646624308052132
20611,1692.490467,1692.499833,1,50774714,50774994,280,0.486197378214747
20612,1692.520667,1692.5241,1,50775620,50775723,103,0.593930990867703
20613,1692.5266,1692.5311,1,50775798,50775933,135,0.5457691059049837
20614,1692.533233,1692.549833,1,50775996,50776494,498,0.698219126398648
20615,1692.557133,1692.575833,1,50776713,50777274,561,0.8820486177730987
20616,1692.603633,1692.6187,1,50778108,50778561,453,0.7315311262136098
20617,1692.639533,1692.655433,1,50779185,50779662,477,0.743418868144589
20618,1692.6572,1692.669667,1,50779716,50780090,374,0.6433661437232518
20619,1692.6804,1692.683567,1,50780412,50780507,95,-0.21753154275044956
20620,1692.689833,1692.745633,1,50780694,50782368,1674,0.06373812855500222
20621,1692.778033,1692.827967,1,50783340,50784839,1499,0.732741704950577
20622,1692.8295,1692.871267,1,50784885,50786138,1253,0.7367980321282743
20623,1692.872933,1692.883733,1,50786187,50786511,324,0.12388122953182364
20624,1692.900067,1692.9395,1,50787002,50788185,1183,0.027433938688061855
20625,1692.9485,1692.954733,1,50788455,50788641,186,0.24249110118550865
20626,1692.961933,1693.071167,1,50788857,50792135,3278,0.8255484261673468
20627,1693.112433,1693.1227,1,50793372,50793681,309,-0.11364373976844126
20628,1693.296967,1693.316867,1,50798909,50799506,597,0.6995804878190511
20629,1693.3208,1693.3243,1,50799624,50799729,105,
20630,1693.5951,1693.717367,1,50807853,50811521,3668,0.7701463187996626
20631,1693.7422,1693.844633,1,50812266,50815338,3072,0.7560019911443251
20632,1693.845733,1693.866233,1,50815371,50815986,615,0.7832383089394752
20633,1693.870867,1693.927833,1,50816126,50817834,1708,0.7502134131326933
20634,1693.934833,1693.950467,1,50818044,50818514,470,0.6859242293570023
20635,1693.959533,1694.047233,1,50818785,50821416,2631,0.7954028349122355
20636,1694.172067,1694.1753,1,50825162,50825259,97,-0.2549538252141295
20637,1694.1841,1694.1974,1,50825523,50825922,399,0.24587492534413607
20638,1694.215367,1694.233433,1,50826461,50827002,541,-0.08236149435014388
20639,1694.236433,1694.246667,1,50827092,50827400,308,-0.12374836709497025
20640,1694.2481,1694.26,1,50827443,50827800,357,0.23620603435292012
20641,1694.2646,1694.269033,1,50827938,50828070,132,-0.2407294804030954
20642,1694.290633,1694.518,1,50828718,50835540,6822,0.8030990812711053
20643,1694.537733,1694.6168,1,50836131,50838504,2373,0.7781142456429302
20644,1694.664233,1694.6689,1,50839926,50840067,141,-0.04554856836371051
20645,1694.981533,1694.987133,1,50849445,50849613,168,0.6152647179639323
20646,1694.989033,1695.008867,1,50849670,50850266,596,0.6289230657057305
20647,1695.024733,1695.028,1,50850741,50850840,99,0.6572733076514417
20648,1695.046833,1695.060933,1,50851404,50851827,423,0.5854327081409917
20649,1695.090133,1695.128733,1,50852703,50853861,1158,0.7276513442790138
20650,1695.161133,1695.200033,1,50854833,50856000,1167,0.7663909992458269
20651,1695.2228,1695.226333,1,50856684,50856789,105,0.37582160904163886
20652,1695.247767,1695.267533,1,50857433,50858025,592,0.7809658694951971
20653,1695.283233,1695.2917,1,50858496,50858751,255,0.7759300809525254
20654,1695.2961,1695.301333,1,50858883,50859039,156,0.5547093288931922
20655,1695.3265,1695.333067,1,50859795,50859992,197,0.40864615240008606
20656,1695.334333,1695.351033,1,50860029,50860530,501,0.6707011287397234
20657,1695.410967,1695.424333,1,50862329,50862729,400,0.7677153808901209
20658,1695.450467,1695.4576,1,50863514,50863728,214,0.5420426843567544
20659,1695.462867,1695.482,1,50863886,50864460,574,0.6512655634700446
20660,1695.610767,1695.6201,1,50868323,50868603,280,0.46172225710507475
20661,1695.626167,1695.6354,1,50868785,50869062,277,0.8068003687756525
20662,1695.636733,1695.804,1,50869101,50874120,5019,0.809325797226625
20663,1695.832333,1695.835833,1,50874969,50875074,105,
20664,1695.853133,1695.875633,1,50875593,50876268,675,0.3102417454746784
20665,1695.879533,1695.886,1,50876385,50876580,195,0.7777918523447643
20666,1696.063667,1696.09,1,50881910,50882700,790,0.7704286837153479
20667,1696.3492,1696.418733,1,50890476,50892561,2085,0.7708434300145804
20668,1696.429733,1696.4713,1,50892891,50894139,1248,0.7439414152695685
20669,1696.4868,1696.5124,1,50894604,50895372,768,0.7373842391392735
20670,1696.5211,1696.545833,1,50895633,50896374,741,0.780560394287938
20671,1696.546833,1696.558167,1,50896404,50896745,341,0.6330830487210088
20672,1696.585133,1696.700467,1,50897553,50901014,3461,0.7116413947822823
20673,1696.701567,1696.755,1,50901047,50902650,1603,0.6036771827642224
20674,1696.759533,1696.818933,1,50902785,50904567,1782,0.7896062019397989
20675,1696.824567,1696.840167,1,50904737,50905205,468,0.7331765274036246
20676,1696.845167,1696.853867,1,50905355,50905616,261,0.1231639243415462
20677,1696.875367,1696.8873,1,50906261,50906619,358,-0.08571750960774352
20678,1696.9002,1696.904467,1,50907006,50907134,128,0.2838758484799673
20679,1696.963533,1697.017067,1,50908905,50910512,1607,0.6452061067629669
20680,1697.2321,1697.406233,1,50916963,50922186,5223,0.7970448585171737
20681,1697.419667,1697.4802,1,50922590,50924406,1816,0.6788913102475582
20682,1697.502333,1697.705667,1,50925069,50931170,6101,0.7804460394086651
20683,1697.734567,1697.7441,1,50932037,50932323,286,-0.08619577027770693
20684,1697.7503,1697.753533,1,50932509,50932605,96,0.2643868033029361
20685,1697.754533,1697.761733,1,50932635,50932851,216,-0.029741937496791732
20686,1697.798233,1697.802467,1,50933946,50934074,128,0.2176015825289265
20687,1697.836833,1697.872767,1,50935104,50936183,1079,0.4211964839524367
20688,1698.141067,1698.328733,1,50944232,50949861,5629,0.806814724807496
20689,1698.331367,1698.338267,1,50949941,50950148,207,0.6682773222030124
20690,1698.359933,1698.3788,1,50950797,50951364,567,0.7443746126593246
20691,1698.379967,1698.430233,1,50951399,50952906,1507,0.7510581007148625
20692,1698.4334,1698.462167,1,50953002,50953865,863,0.7993648306481431
20693,1698.4657,1698.510533,1,50953971,50955315,1344,0.7658805747117569
20694,1698.5162,1698.5358,1,50955486,50956074,588,0.750894528434955
20695,1698.538367,1698.611633,1,50956151,50958348,2197,0.7882870319040233
20696,1698.6474,1698.655,1,50959422,50959650,228,0.20149131406877796
20697,1699.0126,1699.018233,1,50970378,50970546,168,0.4187530034216048
20698,1699.075633,1699.107033,1,50972268,50973210,942,0.8699439216182097
20699,1699.122067,1699.125567,1,50973662,50973767,105,0.49138078562584736
20700,1699.215467,1699.226167,1,50976464,50976785,321,0.3704909251638771
20701,1699.250833,1699.294067,1,50977524,50978822,1298,0.447615287262819
20702,1699.301233,1699.305933,1,50979036,50979177,141,0.30153477882646423
20703,1699.317367,1699.3325,1,50979521,50979975,454,0.6737909329796209
20704,1699.380133,1699.409267,1,50981403,50982278,875,0.19257414153610353
20705,1699.456267,1699.605067,1,50983688,50988152,4464,0.7947951428274855
20706,1699.6175,1699.822167,1,50988525,50994665,6140,0.7725758319203297
20707,1699.868367,1699.875333,1,50996051,50996259,208,-0.092400086753646
20708,1699.899533,1699.9046,1,50996985,50997138,153,-0.26263519815484715
20709,1699.9457,1699.991467,1,50998371,50999744,1373,0.5257621396443516
20710,1700.236967,1700.273167,1,51007109,51008195,1086,0.7991828369716475
20711,1700.2742,1700.318867,1,51008226,51009566,1340,0.7023325934173223
20712,1700.335433,1700.356733,1,51010062,51010701,639,0.8482756190955758
20713,1700.375433,1700.4078,1,51011262,51012234,972,0.7641335452499272
20714,1700.4165,1700.420967,1,51012495,51012629,134,0.3448702108161266
20715,1700.4235,1700.471467,1,51012705,51014144,1439,0.5694837725536027
20716,1700.488133,1700.491967,1,51014643,51014759,116,0.20469295644567803
20717,1700.500667,1700.509833,1,51015020,51015294,274,0.6409169384036992
20718,1700.5142,1700.525233,1,51015426,51015756,330,0.5921707510827686
20719,1700.544867,1700.5548,1,51016346,51016644,298,0.3604742263558189
20720,1700.560867,1700.591867,1,51016826,51017756,930,0.13387031595601828
20721,1700.592967,1700.601467,1,51017789,51018044,255,-0.0740453135280383
20722,1700.605333,1700.6121,1,51018159,51018363,204,0.39878001238387756
20723,1700.620567,1700.6815,1,51018617,51020445,1828,0.7762103700361876
20724,1700.682933,1700.7287,1,51020487,51021861,1374,0.7787810373633227
20725,1700.744833,1700.7549,1,51022344,51022647,303,-0.018650896621559953
20726,1700.756567,1700.769967,1,51022697,51023099,402,0.024171440980512052
20727,1700.777467,1700.7875,1,51023324,51023625,301,0.015021914027572254
20728,1700.809867,1700.884567,1,51024296,51026537,2241,0.8072357729365727
20729,1700.8884,1700.930367,1,51026652,51027911,1259,0.8330365572704118
20730,1700.950833,1701.013467,1,51028524,51030404,1880,0.7844943150133278
20731,1701.028467,1701.0711,1,51030854,51032133,1279,0.7756308679732092
20732,1701.087833,1701.0911,1,51032634,51032733,99,
20733,1701.092133,1701.101,1,51032763,51033030,267,-0.12556443155087463
20734,1701.1032,1701.1365,1,51033096,51034095,999,0.11518645423030305
20735,1701.158867,1701.360167,1,51034766,51040805,6039,0.8359402371683056
20736,1701.361667,1701.3733,1,51040850,51041199,349,0.7724807199243009
20737,1701.398233,1701.413367,1,51041946,51042401,455,-0.05756097237054846
20738,1701.7438,1701.7475,1,51052314,51052425,111,0.5883977290432811
20739,1701.7505,1701.7627,1,51052515,51052881,366,0.7221891295168699
20740,1701.784667,1701.8424,1,51053540,51055272,1732,0.8303951466163217
20741,1701.844233,1701.8732,1,51055326,51056196,870,0.7190015071505542
20742,1701.8763,1701.9,1,51056289,51057000,711,0.658615383715072
20743,1701.907067,1702.036867,1,51057212,51061106,3894,0.7314092326903939
20744,1702.045633,1702.136767,1,51061368,51064103,2735,0.7394153398916218
20745,1702.290833,1702.304,1,51068724,51069120,396,0.846245207521938
20746,1702.3073,1702.398533,1,51069219,51071955,2736,0.8018570127039837
20747,1702.399533,1702.4631,1,51071985,51073893,1908,0.7813120432761828
20748,1702.475033,1702.5246,1,51074250,51075738,1488,0.7982577226365943
20749,1702.5274,1702.540633,1,51075822,51076218,396,0.5761946074443304
20750,1702.542233,1702.5726,1,51076266,51077178,912,0.5531995380934519
20751,1702.576367,1702.595533,1,51077291,51077865,574,0.5244591512302118
20752,1702.5979,1702.607533,1,51077937,51078225,288,0.6575416877596303
20753,1702.608633,1702.638433,1,51078258,51079152,894,0.7836872446577192
20754,1702.641933,1702.649167,1,51079257,51079475,218,0.6446967444572547
20755,1702.6538,1702.671733,1,51079614,51080151,537,0.8438502557882628
20756,1702.675367,1702.6786,1,51080261,51080358,97,0.5968359361770427
20757,1702.680033,1702.697567,1,51080400,51080927,527,0.5609202188975431
20758,1702.699233,1702.785567,1,51080976,51083567,2591,0.7527901989007062
20759,1702.7918,1702.8124,1,51083754,51084372,618,0.47344346005177507
20760,1702.814767,1702.821433,1,51084443,51084642,199,0.6116919296214799
20761,1702.823333,1702.900233,1,51084699,51087006,2307,0.7998895980788463
20762,1702.9016,1702.926433,1,51087048,51087792,744,0.7617164374348101
20763,1702.927467,1702.9375,1,51087824,51088125,301,0.5338684501995156
20764,1702.938733,1702.984033,1,51088161,51089520,1359,0.7928241429790444
20765,1702.990767,1703.0112,1,51089723,51090336,613,0.7881192251075868
20766,1703.051067,1703.059367,1,51091532,51091781,249,0.31883050465844887
20767,1703.278033,1703.282233,1,51098340,51098466,126,0.7533905335599644
20768,1703.2834,1703.300167,1,51098502,51099005,503,0.7097234522314908
20769,1703.3412,1703.3595,1,51100236,51100785,549,0.6809912045080344
20770,1703.659033,1703.724833,1,51109770,51111744,1974,0.6568340970720421
20771,1703.726967,1703.8037,1,51111809,51114111,2302,0.7374825446627863
20772,1703.822233,1703.913533,1,51114666,51117405,2739,0.6755474119996429
20773,1703.917133,1703.929133,1,51117513,51117873,360,0.7020396086522922
20774,1703.952433,1703.9815,1,51118572,51119445,873,0.7908179131640847
20775,1703.982933,1703.9923,1,51119487,51119769,282,0.6360690630535056
20776,1704.011533,1704.0146,1,51120345,51120438,93,0.3669912054537504
20777,1704.0238,1704.043,1,51120714,51121290,576,0.6147740334271257
20778,1704.068833,1704.075267,1,51122064,51122258,194,0.13516686869011554
20779,1704.085033,1704.0951,1,51122550,51122853,303,-0.08129405286058182
20780,1704.0966,1704.0998,1,51122898,51122994,96,-0.0659153176478453
20781,1704.100833,1704.108667,1,51123024,51123260,236,-0.09619716148681004
20782,1704.110567,1704.1195,1,51123317,51123585,268,0.06797979317627996
20783,1704.640333,1704.6739,1,51139209,51140217,1008,0.5935925500544611
20784,1704.730033,1704.749933,1,51141900,51142497,597,0.7957721263121611
20785,1704.776867,1704.782733,1,51143306,51143481,175,0.49266357137495137
20786,1704.785067,1704.831367,1,51143552,51144941,1389,0.6711391845643271
20787,1704.8491,1704.8658,1,51145473,51145974,501,0.7856890368651277
20788,1704.8811,1704.902767,1,51146433,51147083,650,0.8261663360100099
20789,1704.908267,1704.930267,1,51147248,51147908,660,0.7435129810988159
20790,1704.9562,1704.971133,1,51148686,51149133,447,-0.06525465117115765
20791,1704.9723,1704.9859,1,51149169,51149577,408,-0.05182836054371594
20792,1704.986967,1705.0024,1,51149609,51150072,463,0.17098857688132996
20793,1705.0048,1705.026067,1,51150144,51150782,638,0.1351616865244139
20794,1705.031633,1705.034633,1,51150948,51151038,90,
20795,1705.038833,1705.046067,1,51151164,51151382,218,0.1602660622296542
20796,1705.049,1705.209967,1,51151470,51156299,4829,0.12290020683285548
20797,1705.222767,1705.2272,1,51156683,51156816,133,0.5667729670416262
20798,1705.2414,1705.2715,1,51157242,51158145,903,0.05932060203675064
20799,1705.287033,1705.339667,1,51158610,51160190,1580,0.3395584314858856
20800,1705.345067,1705.355467,1,51160352,51160664,312,0.37689854436260267
20801,1705.402833,1705.442467,1,51162084,51163274,1190,0.3545892742551807
20802,1705.444,1705.476933,1,51163320,51164307,987,0.6822288739806727
20803,1705.4822,1705.4882,1,51164466,51164646,180,0.14534024200840445
20804,1705.501267,1705.5267,1,51165038,51165801,763,0.8654249294130936
20805,1705.534267,1705.5484,1,51166028,51166452,424,0.4241653776452687
20806,1705.5593,1705.596467,1,51166779,51167894,1115,0.5776265472791924
20807,1705.602567,1705.620833,1,51168077,51168624,547,0.6251466154695251
20808,1705.623433,1705.627833,1,51168702,51168834,132,0.6518313784071841
20809,1705.63,1705.638267,1,51168900,51169148,248,0.39583076247311133
20810,1705.648433,1705.690767,1,51169452,51170723,1271,0.7021194202182885
20811,1705.6948,1705.7293,1,51170844,51171879,1035,0.5559950814910463
20812,1706.1218,1706.1266,1,51183654,51183798,144,0.34130450959132397
20813,1706.1482,1706.206867,1,51184446,51186206,1760,0.7310901079653322
20814,1706.210433,1706.256233,1,51186312,51187686,1374,0.852767119630973
20815,1706.6206,1706.6239,1,51198618,51198717,99,0.32085601578934375
20816,1706.6256,1706.629833,1,51198768,51198894,126,0.3112255177962552
20817,1706.642433,1706.6653,1,51199272,51199959,687,0.7468594311492067
20818,1706.6956,1706.719733,1,51200868,51201591,723,0.9275775742482892
20819,1706.737167,1706.745067,1,51202115,51202352,237,0.747319030176724
20820,1706.7615,1706.783433,1,51202845,51203502,657,0.6889417679872372
20821,1706.784867,1706.8082,1,51203546,51204246,700,0.8744661910374136
20822,1706.825733,1706.898467,1,51204771,51206954,2183,0.7960780802292744
20823,1706.913333,1706.92,1,51207399,51207600,201,0.5237131979434794
20824,1706.921233,1706.9326,1,51207636,51207978,342,0.7084467870304588
20825,1706.943967,1706.958833,1,51208319,51208764,445,0.6739332389851286
20826,1706.996633,1707.080633,1,51209898,51212418,2520,0.05746974089998017
20827,1707.123033,1707.2389,1,51213690,51217167,3477,0.7782159951966265
20828,1707.278633,1707.297933,1,51218358,51218937,579,0.4449387679643239
20829,1707.302467,1707.367367,1,51219074,51221021,1947,0.0383944886274827
20830,1707.4183,1707.4296,1,51222549,51222888,339,0.5042924990198798
20831,1707.4329,1707.438767,1,51222987,51223163,176,0.6341400433712512
20832,1707.445733,1707.551667,1,51223371,51226550,3179,0.8488805049278252
20833,1707.5539,1707.592167,1,51226617,51227765,1148,0.6868839741727285
20834,1707.593267,1707.596833,1,51227798,51227904,106,0.42531774835673364
20835,1707.598133,1707.604067,1,51227943,51228122,179,0.72838835807677
20836,1707.6134,1707.6276,1,51228402,51228828,426,0.8681504882732877
20837,1707.630667,1707.7461,1,51228920,51232383,3463,0.7638923857355866
20838,1707.747367,1707.764433,1,51232421,51232932,511,0.7901997242672641
20839,1707.775167,1707.790733,1,51233255,51233721,466,0.6644305172056414
20840,1707.796067,1707.807867,1,51233882,51234236,354,0.5996087033040237
20841,1707.815967,1707.8224,1,51234479,51234672,193,0.45533797425712386
20842,1707.8321,1707.882967,1,51234963,51236489,1526,0.06415882832312725
20843,1707.951733,1707.98,1,51238551,51239400,849,0.6345701152735109
20844,1707.985767,1708.123767,1,51239573,51243713,4140,0.8322107453885763
20845,1708.138333,1708.142433,1,51244149,51244272,123,0.9231756316924354
20846,1708.143767,1708.166967,1,51244313,51245009,696,0.6277709359863421
20847,1708.178933,1708.199233,1,51245367,51245976,609,0.0040626667162901395
20848,1708.202833,1708.238767,1,51246084,51247163,1079,0.1809768347040894
20849,1708.2636,1708.267667,1,51247908,51248030,122,-0.12164570599455898
20850,1708.277133,1708.477067,1,51248313,51254312,5999,0.81526306984736
20851,1708.703067,1708.713067,1,51261092,51261392,300,0.39442292966503206
20852,1708.721467,1708.743,1,51261644,51262290,646,0.7003879336800215
20853,1708.753433,1708.793,1,51262602,51263790,1188,0.7587217638076065
20854,1708.800067,1708.8351,1,51264002,51265053,1051,0.7864057212565504
20855,1708.836633,1709.0298,1,51265098,51270894,5796,0.7329969392100373
20856,1709.036967,1709.055033,1,51271109,51271650,541,0.7997812107279172
20857,1709.057867,1709.0813,1,51271736,51272439,703,0.5418545936556397
20858,1709.082667,1709.086067,1,51272480,51272582,102,0.33793463357353204
20859,1709.0915,1709.1489,1,51272745,51274467,1722,0.24635783191395072
20860,1709.152167,1709.1565,1,51274565,51274695,130,-0.33901033095461125
20861,1709.179267,1709.291333,1,51275378,51278739,3361,0.8128209629088917
20862,1709.2928,1709.333667,1,51278784,51280010,1226,0.8417669823908727
20863,1709.337833,1709.415033,1,51280134,51282450,2316,0.8241179572206657
20864,1709.426667,1709.499133,1,51282800,51284973,2173,0.5106348673050363
20865,1709.512167,1709.527133,1,51285365,51285813,448,0.8396307819851123
20866,1709.529233,1709.631233,1,51285876,51288936,3060,0.8466941554779133
20867,1709.643233,1709.6464,1,51289296,51289392,96,
20868,1709.651533,1709.7175,1,51289545,51291525,1980,0.16599685353881918
20869,1709.729533,1709.7341,1,51291885,51292023,138,0.6946625490824965
20870,1709.735267,1709.965833,1,51292058,51298974,6916,0.7010026475820047
20871,1709.969367,1709.983067,1,51299081,51299492,411,-0.17957701882536384
20872,1709.984567,1709.989267,1,51299537,51299678,141,-0.24040253870794803
20873,1710.0633,1710.067033,1,51301899,51302010,111,0.6373166507604783
20874,1710.083333,1710.0939,1,51302499,51302817,318,0.47958593306444003
20875,1710.1025,1710.1755,1,51303075,51305265,2190,0.7922634860745679
20876,1710.180233,1710.206467,1,51305406,51306194,788,0.7313914881835818
20877,1710.2121,1710.3285,1,51306363,51309855,3492,0.735007739730469
20878,1710.330767,1710.382267,1,51309923,51311468,1545,0.802747317003102
20879,1710.389167,1710.453233,1,51311675,51313596,1921,0.7877714557243477
20880,1710.458367,1710.4937,1,51313751,51314811,1060,0.6649876514076999
20881,1710.507533,1710.565533,1,51315225,51316965,1740,0.04027718214709415
20882,1710.5922,1710.598767,1,51317766,51317963,197,0.16953268080429562
20883,1710.6049,1710.676133,1,51318147,51320283,2136,0.8415290613291442
20884,1710.6774,1710.8077,1,51320322,51324231,3909,0.7339629427543601
20885,1710.809233,1710.8156,1,51324276,51324468,192,-0.21956587942449193
20886,1710.8288,1711.038567,1,51324864,51331157,6293,0.780751897826447
20887,1711.052033,1711.098433,1,51331560,51332952,1392,0.7993521776291006
20888,1711.0999,1711.143967,1,51332997,51334319,1322,0.6967623041375576
20889,1711.159967,1711.188267,1,51334799,51335648,849,-0.03065969989440628
20890,1711.189333,1711.207,1,51335679,51336210,531,0.025819964688493378
20891,1711.234733,1711.287633,1,51337041,51338628,1587,0.776150627829283
20892,1711.296333,1711.347133,1,51338889,51340413,1524,0.7848318918275288
20893,1711.361167,1711.3866,1,51340835,51341598,763,-0.009839055007735957
20894,1711.388267,1711.409767,1,51341648,51342293,645,0.23573996647067125
20895,1711.427533,1711.6269,1,51342825,51348807,5982,0.7420697469907094
20896,1711.649167,1711.652833,1,51349475,51349584,109,-0.10990888797115086
20897,1711.683033,1711.686233,1,51350490,51350586,96,
20898,1711.732867,1711.8146,1,51351986,51354438,2452,0.7077493392086263
20899,1711.8347,1711.945567,1,51355041,51358367,3326,0.7889560514311884
20900,1711.954033,1712.028867,1,51358620,51360866,2246,0.7911223257645746
20901,1712.059533,1712.111933,1,51361785,51363357,1572,0.772122708384018
20902,1712.117267,1712.1442,1,51363518,51364326,808,0.8350345662565768
20903,1712.1498,1712.156933,1,51364494,51364707,213,0.7412404551328869
20904,1712.159867,1712.168733,1,51364796,51365061,265,0.7919220670152471
20905,1712.171033,1712.2284,1,51365130,51366852,1722,0.6746083278228511
20906,1712.238267,1712.244567,1,51367148,51367337,189,0.6155822503189208
20907,1712.250567,1712.263667,1,51367517,51367910,393,0.7772603973344216
20908,1712.264667,1712.2801,1,51367940,51368403,463,0.6293147892617407
20909,1712.2877,1712.291233,1,51368631,51368736,105,0.2246203714889187
20910,1712.295833,1712.360333,1,51368874,51370809,1935,0.0790899293198145
20911,1712.388867,1712.5012,1,51371666,51375036,3370,0.8055340857867418
20912,1712.503067,1712.542467,1,51375092,51376274,1182,0.8462055841818448
20913,1712.5548,1712.628467,1,51376644,51378854,2210,0.748078030478373
20914,1712.647,1712.731667,1,51379410,51381950,2540,0.8145383484744813
20915,1712.747633,1712.758167,1,51382428,51382745,317,-0.09489743499395681
20916,1712.764367,1712.794433,1,51382931,51383832,901,0.13797945016325036
20917,1712.820033,1712.9038,1,51384600,51387114,2514,0.8005056057561071
20918,1712.908833,1712.933833,1,51387264,51388014,750,0.920255584852088
20919,1712.953167,1712.970067,1,51388595,51389102,507,0.041129686550408245
20920,1712.975367,1712.982633,1,51389261,51389478,217,0.224285545391823
20921,1712.986667,1712.9904,1,51389600,51389712,112,
20922,1712.9971,1713.200267,1,51389913,51396008,6095,0.8489503569082067
20923,1713.2289,1713.238833,1,51396867,51397164,297,-0.021105806299092544
20924,1713.239867,1713.253867,1,51397196,51397616,420,0.25456241041372035
20925,1713.257867,1713.276333,1,51397736,51398289,553,0.1487219782957378
20926,1713.3047,1713.326233,1,51399141,51399786,645,0.8395568669315367
20927,1713.327633,1713.447633,1,51399828,51403428,3600,0.8216789247508115
20928,1713.464433,1713.4856,1,51403932,51404568,636,0.7347038799358429
20929,1713.486667,1713.590633,1,51404600,51407718,3118,0.8454900480434108
20930,1713.596867,1713.612233,1,51407906,51408366,460,0.6451161384333488
20931,1713.618333,1713.769067,1,51408549,51413072,4523,0.7828323456658204
20932,1713.7754,1713.818567,1,51413262,51414557,1295,0.7417354270308333
20933,1713.826333,1713.833633,1,51414789,51415008,219,0.6024067222414456
20934,1713.8355,1713.9167,1,51415065,51417501,2436,0.7545036024403639
20935,1714.0206,1714.023667,1,51420618,51420710,92,
20936,1714.032133,1714.046433,1,51420963,51421392,429,0.584419136116012
20937,1714.0477,1714.085133,1,51421431,51422553,1122,0.7416093724184105
20938,1714.093533,1714.131533,1,51422805,51423945,1140,0.8484546655049565
20939,1714.154733,1714.1726,1,51424641,51425178,537,0.08884212723121421
20940,1714.180033,1714.1846,1,51425400,51425538,138,0.3329987182484001
20941,1714.204567,1714.211633,1,51426137,51426348,211,0.7621674023116822
20942,1714.236233,1714.239933,1,51427086,51427197,111,0.6939878749624637
20943,1714.247933,1714.366633,1,51427437,51430998,3561,0.8008478521477539
20944,1714.3814,1714.461633,1,51431442,51433848,2406,0.7634791817192422
20945,1714.4713,1714.496533,1,51434139,51434895,756,0.722897074500145
20946,1714.506567,1714.5413,1,51435197,51436239,1042,0.03193473517276961
20947,1714.545133,1714.554067,1,51436353,51436622,269,0.605094713161292
20948,1714.6033,1714.6301,1,51438099,51438903,804,0.631641042357656
20949,1714.631367,1714.837333,1,51438941,51445119,6178,0.8218822204104432
20950,1714.8467,1714.899033,1,51445401,51446970,1569,0.7900464545073397
20951,1714.903667,1714.909567,1,51447110,51447287,177,-0.23466796525762937
20952,1714.932633,1714.935733,1,51447978,51448071,93,-0.1738890550541452
20953,1714.937,1714.941767,1,51448110,51448253,143,0.06977731955601275
20954,1714.943267,1714.954633,1,51448298,51448638,340,0.18779829399298553
20955,1714.956833,1714.983133,1,51448704,51449493,789,0.13786375081323543
20956,1715.017467,1715.157967,1,51450524,51454739,4215,0.833264888633495
20957,1715.1627,1715.166067,1,51454881,51454982,101,-0.1384609343203302
20958,1715.173567,1715.2594,1,51455207,51457782,2575,0.8280422895342245
20959,1715.265667,1715.3585,1,51457970,51460755,2785,0.7751856619299966
20960,1715.359733,1715.366533,1,51460791,51460995,204,0.07773684607487116
20961,1715.3753,1715.3806,1,51461259,51461418,159,-0.09819052492065353
20962,1715.441267,1715.4608,1,51463238,51463824,586,0.6518844440924957
20963,1715.4702,1715.479967,1,51464106,51464399,293,0.8410438384760334
20964,1715.49,1715.523433,1,51464700,51465702,1002,0.8009532302627156
20965,1715.555733,1715.565567,1,51466671,51466967,296,0.5003871018259658
20966,1715.5723,1715.615933,1,51467169,51468477,1308,0.0035078105975565876
20967,1715.622667,1715.626333,1,51468680,51468789,109,0.40218480746066065
20968,1715.6338,1715.783133,1,51469014,51473493,4479,0.8192979355572126
20969,1715.7945,1715.8931,1,51473835,51476793,2958,0.8299784443214152
20970,1715.896333,1715.916433,1,51476889,51477492,603,0.6271740864134842
20971,1715.922533,1715.943633,1,51477675,51478308,633,0.7349332098813741
20972,1715.946867,1716.036733,1,51478406,51481101,2695,0.8083338391391723
20973,1716.038367,1716.041567,1,51481151,51481247,96,
20974,1716.053267,1716.106133,1,51481598,51483183,1585,0.029621282016798138
20975,1716.1394,1716.143,1,51484182,51484290,108,0.6456102536480738
20976,1716.151733,1716.180267,1,51484551,51485408,857,0.8300797667947231
20977,1716.183033,1716.207633,1,51485490,51486228,738,0.7233360179346289
20978,1716.2201,1716.240567,1,51486603,51487217,614,0.8897076091166046
20979,1716.242367,1716.2455,1,51487271,51487365,94,0.750487369775068
20980,1716.252433,1716.257367,1,51487572,51487721,149,0.8795786256587733
20981,1716.280867,1716.325367,1,51488426,51489761,1335,0.7341789551137213
20982,1716.327233,1716.331167,1,51489816,51489935,119,0.8791889289240891
20983,1716.332567,1716.3624,1,51489977,51490872,895,0.7882438569076214
20984,1716.3643,1716.403467,1,51490929,51492104,1175,0.8211590394992103
20985,1716.421833,1716.503033,1,51492654,51495090,2436,0.7416061031080218
20986,1716.5253,1716.532567,1,51495759,51495977,218,0.6998527922324188
20987,1716.5359,1716.599867,1,51496077,51497996,1919,0.7882765190159519
20988,1716.605533,1716.624033,1,51498165,51498720,555,0.6988489574976482
20989,1716.629867,1716.640667,1,51498896,51499220,324,0.520993891471307
20990,1716.644667,1716.653167,1,51499340,51499595,255,0.7635007785507109
20991,1716.663767,1716.682633,1,51499913,51500478,565,0.03333477487074106
20992,1716.6838,1716.693633,1,51500514,51500808,294,0.291634188569018
20993,1716.6949,1716.7085,1,51500847,51501255,408,0.22053244793989582
20994,1716.7098,1716.716167,1,51501294,51501485,191,0.016470350477422388
20995,1716.759467,1716.769033,1,51502784,51503070,286,0.5751874046953407
20996,1716.787567,1716.8026,1,51503627,51504078,451,-0.008872484961114865
20997,1716.819233,1716.8271,1,51504576,51504813,237,-0.08178605627415084
20998,1716.8465,1716.851933,1,51505395,51505557,162,0.4608665296889907
20999,1716.8612,1716.9153,1,51505836,51507459,1623,0.6994243955235374
21000,1716.919633,1716.963,1,51507588,51508890,1302,0.7282461996785246
21001,1716.9677,1716.9977,1,51509031,51509931,900,0.6074508573672229
21002,1717.001,1717.072633,1,51510030,51512178,2148,0.7144515455261329
21003,1717.101833,1717.2949,1,51513054,51518847,5793,0.7701405278293428
21004,1717.297933,1717.4121,1,51518937,51522363,3426,0.8233538848635783
21005,1717.4144,1717.536633,1,51522432,51526098,3666,0.8133820078147066
21006,1717.544267,1717.612133,1,51526328,51528363,2035,0.8102754320699358
21007,1717.613633,1717.636,1,51528408,51529080,672,0.8237461107718069
21008,1717.658967,1717.666133,1,51529769,51529983,214,-0.04283519021324269
21009,1717.6682,1717.687467,1,51530046,51530624,578,-0.016916897797758675
21010,1717.714133,1717.719967,1,51531423,51531599,176,0.4672812776561833
21011,1717.776033,1717.798867,1,51533280,51533966,686,0.5610250889116397
21012,1717.8021,1717.991167,1,51534063,51539735,5672,0.825539223746119
21013,1717.993433,1718.0474,1,51539802,51541422,1620,0.6460409641887958
21014,1718.0498,1718.1361,1,51541494,51544083,2589,0.8163448547130101
21015,1718.1449,1718.1665,1,51544347,51544995,648,-0.09327922558219752
21016,1718.1679,1718.191533,1,51545037,51545745,708,0.15414909472488283
21017,1718.1983,1718.205733,1,51545949,51546171,222,0.19165063280393632
21018,1718.233133,1718.458233,1,51546993,51553746,6753,0.812361216696077
21019,1718.469967,1718.550633,1,51554099,51556518,2419,0.8166670679673942
21020,1718.552667,1718.558167,1,51556580,51556745,165,0.6399231993196225
21021,1718.559967,1718.619733,1,51556799,51558591,1792,0.8241797211852808
21022,1718.620833,1718.679933,1,51558624,51560397,1773,0.8392309572174382
21023,1718.6983,1718.7078,1,51560949,51561234,285,-0.10096627412542768
21024,1718.722633,1718.730667,1,51561678,51561920,242,-0.008602340796387208
21025,1718.734967,1718.739967,1,51562049,51562199,150,0.20960051881166605
21026,1718.7499,1718.757733,1,51562497,51562731,234,-0.0042832402269184396
21027,1718.814833,1718.829167,1,51564444,51564875,431,0.8194919829247008
21028,1718.830267,1718.942067,1,51564908,51568262,3354,0.8421592752344584
21029,1718.946067,1718.949367,1,51568382,51568481,99,
21030,1718.950633,1719.015267,1,51568518,51570458,1940,0.06762837319669021
21031,1719.0286,1719.032067,1,51570858,51570962,104,
21032,1719.04,1719.1549,1,51571200,51574647,3447,0.8035802752053205
21033,1719.162533,1719.182567,1,51574875,51575477,602,0.7758181862229875
21034,1719.2047,1719.2639,1,51576141,51577917,1776,0.8031417152951165
21035,1719.269833,1719.304733,1,51578094,51579141,1047,0.7558043183504153
21036,1719.328533,1719.355867,1,51579855,51580676,821,0.06515044307328988
21037,1719.357967,1719.368767,1,51580739,51581063,324,0.07673815568862008
21038,1719.3759,1719.384467,1,51581277,51581534,257,-0.09384245784637273
21039,1719.4062,1719.6305,1,51582186,51588915,6729,0.8318682408057816
21040,1719.642967,1719.742167,1,51589289,51592265,2976,0.8150253706995931
21041,1719.747,1719.776733,1,51592410,51593301,891,0.7191218575738013
21042,1719.7881,1719.7994,1,51593643,51593982,339,-0.06413555900169154
21043,1719.803667,1719.806733,1,51594110,51594201,91,
21044,1719.808067,1719.8116,1,51594242,51594348,106,-0.14257471509326652
21045,1719.813633,1719.816767,1,51594408,51594503,95,
21046,1719.817767,1719.8212,1,51594533,51594636,103,
21047,1719.824133,1719.8353,1,51594723,51595059,336,0.15525696550235207
21048,1719.8478,1719.8511,1,51595434,51595533,99,0.48506800863379335
21049,1719.8988,1720.072633,1,51596964,51602178,5214,0.8589299558257596
21050,1720.089,1720.1746,1,51602670,51605238,2568,0.8337587239434652
21051,1720.181567,1720.185967,1,51605447,51605579,132,-0.06861932581232631
21052,1720.1901,1720.217967,1,51605703,51606539,836,0.16035348322745369
21053,1720.2206,1720.2486,1,51606618,51607458,840,0.0639937162073092
21054,1720.286667,1720.292833,1,51608600,51608784,184,0.2967889316958378
21055,1720.2966,1720.4191,1,51608898,51612573,3675,0.8466660929330632
21056,1720.4344,1720.4642,1,51613032,51613926,894,-0.030964649627980956
21057,1720.468033,1720.4931,1,51614040,51614793,753,0.10013469847080281
21058,1720.510067,1720.515167,1,51615302,51615455,153,0.6025653493886428
21059,1720.516433,1720.691533,1,51615492,51620745,5253,0.8515615021605457
21060,1720.735333,1720.747267,1,51622059,51622418,359,0.7560070613682542
21061,1720.7517,1720.880867,1,51622551,51626426,3875,0.8447834917449276
21062,1720.8986,1720.905367,1,51626958,51627161,203,0.7222058716041804
21063,1720.930367,1720.9364,1,51627911,51628092,181,-0.0530993400738993
21064,1720.937867,1720.949367,1,51628136,51628481,345,0.19908978382747938
21065,1721.0127,1721.179367,1,51630381,51635381,5000,0.8690774800115185
21066,1721.2026,1721.2178,1,51636078,51636534,456,-0.01610573331643996
21067,1721.219967,1721.226833,1,51636599,51636804,205,0.07670451300954725
21068,1721.2311,1721.2407,1,51636933,51637221,288,0.031633080553572404
21069,1721.250133,1721.257433,1,51637503,51637722,219,-0.20745013475229712
21070,1721.302933,1721.429167,1,51639087,51642875,3788,0.8501123674825275
21071,1721.430933,1721.438233,1,51642927,51643146,219,0.4285591046201492
21072,1721.4486,1721.4762,1,51643458,51644286,828,0.031112428631985767
21073,1721.478667,1721.4897,1,51644360,51644691,331,0.21313671581119484
21074,1721.493267,1721.501533,1,51644798,51645045,247,0.04870950745206297
21075,1721.5516,1721.6996,1,51646548,51650988,4440,0.8754818226535417
21076,1721.7221,1721.7288,1,51651663,51651864,201,0.5883987777683286
21077,1721.752967,1721.756,1,51652589,51652680,91,
21078,1721.7589,1721.7642,1,51652767,51652926,159,0.05159904479235422
21079,1721.8846,1722.0578,1,51656538,51661734,5196,0.844720585276309
21080,1722.072033,1722.1374,1,51662160,51664122,1962,0.8367774481468543
21081,1722.138667,1722.1724,1,51664160,51665172,1012,0.8024973650031451
21082,1722.181767,1722.1911,1,51665453,51665733,280,0.7320303308329908
21083,1722.198933,1722.217133,1,51665967,51666513,546,-0.06693653417275684
21084,1722.2182,1722.225367,1,51666546,51666761,215,0.017809090312781845
21085,1722.226467,1722.237533,1,51666794,51667125,331,0.07583935912943994
21086,1722.244033,1722.2513,1,51667320,51667539,219,-0.18884522390192335
21087,1722.305967,1722.310633,1,51669179,51669318,139,0.3145939328788869
21088,1722.316933,1722.528633,1,51669507,51675858,6351,0.840641852369067
21089,1722.532233,1722.611967,1,51675966,51678359,2393,0.7558337524163502
21090,1722.635633,1722.639167,1,51679068,51679175,107,0.5702224375312989
21091,1722.652267,1722.6705,1,51679568,51680115,547,-0.03463085114442884
21092,1722.676133,1722.684033,1,51680283,51680520,237,0.15070171569934304
21093,1722.685067,1722.6983,1,51680552,51680949,397,0.21104510093574674
21094,1722.699433,1722.707,1,51680982,51681210,228,0.395375637985415
21095,1722.720267,1722.7261,1,51681608,51681783,175,-0.09431443409406498
21096,1722.740167,1722.946333,1,51682205,51688389,6184,0.8286379959520228
21097,1722.989467,1723.003233,1,51689684,51690096,412,-0.01947329473098084
21098,1723.008867,1723.0168,1,51690266,51690504,238,0.09790525805220437
21099,1723.0224,1723.032467,1,51690672,51690974,302,0.028099012068128742
21100,1723.039467,1723.049267,1,51691184,51691478,294,0.15841202965701442
21101,1723.098167,1723.318667,1,51692945,51699560,6615,0.8487481133492399
21102,1723.321067,1723.3448,1,51699632,51700344,712,0.9196709448267935
21103,1723.362367,1723.3892,1,51700871,51701676,805,-0.08306990284776784
21104,1723.393367,1723.403067,1,51701801,51702092,291,-0.09301108187297101
21105,1723.4109,1723.4171,1,51702327,51702513,186,0.01812681913282567
21106,1723.471767,1723.685233,1,51704153,51710556,6403,0.8143175466812158
21107,1723.687667,1723.7841,1,51710630,51713523,2893,0.8041712742720821
21108,1723.809033,1723.826933,1,51714270,51714807,537,0.0061999937638386295
21109,1723.834867,1723.841733,1,51715046,51715251,205,-0.12324614483633455
21110,1723.8431,1723.853733,1,51715293,51715611,318,0.0706374340310554
21111,1723.862367,1723.866667,1,51715871,51716000,129,0.35175965664117803
21112,1723.904067,1724.139367,1,51717122,51724181,7059,0.7718986953193987
21113,1724.2294,1724.238833,1,51726882,51727164,282,0.5345412302860556
21114,1724.2473,1724.3015,1,51727419,51729045,1626,0.6662671517297095
21115,1724.3074,1724.378333,1,51729222,51731349,2127,0.755856011085047
21116,1724.3814,1724.4283,1,51731442,51732849,1407,0.7571976558340157
21117,1724.4328,1724.442167,1,51732984,51733265,281,0.6945179103077679
21118,1724.4479,1724.539467,1,51733437,51736184,2747,0.7716393651543992
21119,1724.545767,1724.562967,1,51736373,51736889,516,0.7305158912561107
21120,1724.567167,1724.595133,1,51737015,51737853,838,0.796769012863713
21121,1724.599167,1724.678667,1,51737975,51740360,2385,0.8246890094684537
21122,1724.679867,1724.700733,1,51740396,51741021,625,0.8471289022045081
21123,1724.703967,1724.8434,1,51741119,51745302,4183,0.8018456093702208
21124,1724.846167,1724.932167,1,51745385,51747965,2580,0.8160081300407317
21125,1724.936067,1724.9619,1,51748082,51748857,775,0.4453660402122163
21126,1724.964333,1725.0846,1,51748929,51752538,3609,0.8101669284185877
21127,1725.088267,1725.1795,1,51752648,51755385,2737,0.8632118224248807
21128,1725.182,1725.2941,1,51755460,51758823,3363,0.7783454903316454
21129,1725.318533,1725.33,1,51759555,51759900,345,-0.09272233840397198
21130,1725.331567,1725.340233,1,51759947,51760206,259,0.13807546631350576
21131,1725.9083,1725.9133,1,51777249,51777399,150,-0.13138685329801583
21132,1725.9774,1725.981367,1,51779322,51779441,119,-0.04365448159606323
21133,1725.985067,1725.996133,1,51779552,51779883,331,0.2638854660817232
21134,1726.006933,1726.019033,1,51780207,51780570,363,0.5191109970119284
21135,1726.0425,1726.047833,1,51781275,51781434,159,0.4300562687507744
21136,1726.051467,1726.0599,1,51781544,51781797,253,0.14681986175955528
21137,1726.148467,1726.1773,1,51784454,51785319,865,0.7894984743924648
21138,1726.185667,1726.207067,1,51785570,51786212,642,0.6109687510923377
21139,1726.2093,1726.225733,1,51786279,51786771,492,0.8024668207058092
21140,1726.242667,1726.3181,1,51787280,51789543,2263,0.704096381529254
21141,1726.319933,1726.4054,1,51789597,51792162,2565,0.7758441752898153
21142,1726.4064,1726.4105,1,51792192,51792315,123,-0.15675122594000362
21143,1726.414267,1726.440367,1,51792428,51793211,783,0.7787262214878174
21144,1726.441667,1726.4624,1,51793250,51793872,622,0.7478026928896
21145,1726.497567,1726.508633,1,51794927,51795258,331,-0.0812232967346452
21146,1726.510667,1726.5197,1,51795320,51795591,271,0.2578005253091642
21147,1726.5209,1726.531533,1,51795627,51795945,318,0.1110125064077414
21148,1726.5328,1726.5407,1,51795984,51796221,237,0.2531100258076414
21149,1730.935533,1730.9407,1,51928065,51928221,156,0.7137609940145446
21150,1731.005867,1731.0184,1,51930176,51930552,376,0.7706000497415068
21151,1731.0504,1731.057267,1,51931512,51931718,206,0.5313838206673834
21152,1731.061167,1731.0786,1,51931835,51932358,523,0.5861199735509325
21153,1731.126033,1731.130467,1,51933780,51933914,134,0.6796297140353045
21154,1731.1327,1731.147267,1,51933981,51934418,437,0.6264464366890231
21155,1731.170867,1731.1795,1,51935126,51935385,259,0.7415225920709606
21156,1731.186633,1731.196667,1,51935598,51935900,302,0.593274720939961
21157,1731.385367,1731.484333,1,51941561,51944529,2968,0.67828006858344
21158,1731.535933,1731.605833,1,51946077,51948174,2097,0.23847037834611082
21159,1731.6091,1731.623367,1,51948273,51948701,428,0.009911504458834807
21160,1731.653967,1731.658233,1,51949619,51949746,127,0.46921974571452557
21161,1731.660733,1731.6638,1,51949821,51949914,93,-0.07515653193096826
21162,1731.665233,1731.864867,1,51949956,51955946,5990,0.1640189339713407
21163,1731.8764,1731.887933,1,51956292,51956637,345,0.04136154865490557
21164,1731.9051,1731.911767,1,51957153,51957353,200,0.01231777178472268
21165,1731.9128,1731.916067,1,51957384,51957482,98,
21166,1731.917467,1731.9242,1,51957524,51957726,202,0.16713265190636076
21167,1731.928533,1731.935867,1,51957855,51958076,221,-0.18006726127410133
21168,1732.2196,1732.252967,1,51966588,51967589,1001,0.7276533372656525
21169,1732.281133,1732.2952,1,51968433,51968856,423,0.6841700549856061
21170,1732.2962,1732.301433,1,51968886,51969042,156,0.39295676599701734
21171,1732.311433,1732.322267,1,51969342,51969668,326,0.5583301110762049
21172,1732.347467,1732.386933,1,51970424,51971607,1183,0.6683649442316419
21173,1732.4178,1732.435167,1,51972534,51973055,521,0.6060083757043412
21174,1732.4394,1732.4458,1,51973182,51973374,192,0.32402493252323245
21175,1732.4468,1732.509367,1,51973404,51975281,1877,0.5373865010249353
21176,1732.5223,1732.544133,1,51975669,51976323,654,0.466119924697675
21177,1732.562133,1732.6055,1,51976863,51978165,1302,0.6296517408289888
21178,1732.6147,1732.6215,1,51978441,51978645,204,0.2730603940264617
21179,1732.6231,1732.638667,1,51978693,51979160,467,0.6188513794876778
21180,1732.641233,1732.650233,1,51979236,51979506,270,0.4342077424029441
21181,1732.684367,1732.7384,1,51980531,51982152,1621,0.08515214285033913
21182,1732.757467,1732.774233,1,51982724,51983226,502,0.7203641350101464
21183,1732.7768,1732.868433,1,51983304,51986052,2748,0.7977761312201126
21184,1732.884767,1732.8882,1,51986543,51986646,103,-0.2989567504988257
21185,1732.9012,1732.914933,1,51987036,51987447,411,-0.091641053596752
21186,1732.9164,1732.9197,1,51987492,51987591,99,
21187,1732.920733,1732.929233,1,51987621,51987876,255,0.1635341070694452
21188,1732.9316,1732.936833,1,51987948,51988104,156,0.18484257007772328
21189,1733.0003,1733.006967,1,51990009,51990209,200,0.6654120738988504
21190,1733.015833,1733.1783,1,51990474,51995349,4875,0.8607686283039797
21191,1733.624967,1733.648433,1,52008749,52009452,703,0.6179161734567512
21192,1733.662067,1733.678133,1,52009862,52010343,481,0.8458865909780725
21193,1733.6909,1733.728367,1,52010727,52011851,1124,0.7360671639536635
21194,1733.732133,1733.773333,1,52011963,52013199,1236,0.5009532766967665
21195,1733.794033,1733.810267,1,52013820,52014308,488,0.7322320808147613
21196,1733.837467,1733.842267,1,52015124,52015268,144,0.641203240471563
21197,1733.843633,1733.8884,1,52015308,52016652,1344,0.7620511280567214
21198,1733.9197,1733.937733,1,52017591,52018131,540,0.7393654135145068
21199,1733.958067,1733.987967,1,52018742,52019639,897,0.6999989731399962
21200,1734.016433,1734.032,1,52020492,52020960,468,0.17177667901795693
21201,1734.033167,1734.067733,1,52020995,52022031,1036,0.11965122755063552
21202,1734.094933,1734.271233,1,52022847,52028136,5289,0.7488579611038862
21203,1734.292967,1734.315633,1,52028789,52029468,679,0.636895405583122
21204,1734.323833,1734.404,1,52029714,52032120,2406,0.7224100906610822
21205,1734.475733,1734.481567,1,52034271,52034447,176,-0.5390709951641004
21206,1734.737167,1734.758567,1,52042115,52042757,642,0.7029009336270317
21207,1734.763167,1734.7762,1,52042895,52043286,391,0.6526769501014547
21208,1734.8314,1734.843933,1,52044942,52045317,375,0.6847815045471843
21209,1734.873867,1734.878167,1,52046216,52046345,129,0.6995419593853025
21210,1734.879733,1734.921,1,52046391,52047630,1239,0.7513416396328364
21211,1734.9556,1734.967567,1,52048668,52049027,359,0.7926818344933882
21212,1734.995667,1735.006867,1,52049870,52050206,336,0.6999636251795301
21213,1735.008867,1735.012167,1,52050266,52050365,99,0.732516617793386
21214,1735.013733,1735.020067,1,52050411,52050602,191,0.5506411041216451
21215,1735.032567,1735.0432,1,52050977,52051296,319,0.5334792590036453
21216,1735.0446,1735.0492,1,52051338,52051476,138,0.5290958289287568
21217,1735.050767,1735.055067,1,52051523,52051652,129,0.8557846577030459
21218,1735.059633,1735.075633,1,52051788,52052268,480,-0.09489323488856792
21219,1735.077933,1735.085933,1,52052337,52052577,240,0.14182202984572503
21220,1735.089733,1735.108933,1,52052691,52053267,576,0.16537800696002355
21221,1735.139967,1735.147067,1,52054199,52054412,213,
21222,1735.152267,1735.2505,1,52054568,52057515,2947,0.8187823058561179
21223,1735.4854,1735.6494,1,52064562,52069482,4920,0.8057018293473762
21224,1735.670233,1735.688633,1,52070106,52070658,552,0.7624500181925162
21225,1735.689667,1735.753433,1,52070690,52072602,1912,0.8140666881378301
21226,1736.057067,1736.100767,1,52081712,52083023,1311,0.7316219862507364
21227,1736.1122,1736.1358,1,52083366,52084074,708,0.7316369003420281
21228,1736.159633,1736.168667,1,52084788,52085060,272,0.8109137314635246
21229,1736.185867,1736.199933,1,52085576,52085997,421,0.6212226005349397
21230,1736.2352,1736.2443,1,52087056,52087329,273,0.4446004024027387
21231,1736.259333,1736.287867,1,52087779,52088636,857,0.025138293416764403
21232,1736.319033,1736.394033,1,52089570,52091820,2250,0.6671760065714023
21233,1736.429567,1736.537633,1,52092887,52096128,3241,0.7768239123702966
21234,1736.555767,1736.559167,1,52096673,52096775,102,0.13221731474896722
21235,1736.561167,1736.635,1,52096835,52099050,2215,0.7916437725814984
21236,1736.985233,1736.988633,1,52109556,52109658,102,0.9287599138622123
21237,1737.000433,1737.0043,1,52110012,52110129,117,0.7457672363379889
21238,1737.0092,1737.043667,1,52110276,52111310,1034,0.8375703022017849
21239,1737.046567,1737.0818,1,52111397,52112454,1057,0.6071493471462869
21240,1737.094667,1737.189533,1,52112840,52115685,2845,0.7624820983881657
21241,1737.1911,1737.227867,1,52115733,52116836,1103,0.6996345664491879
21242,1737.234633,1737.3026,1,52117038,52119078,2040,0.6740061364819364
21243,1737.3168,1737.3227,1,52119504,52119681,177,0.6949082061035571
21244,1737.3325,1737.3435,1,52119975,52120305,330,0.7410204907596258
21245,1737.344967,1737.3586,1,52120349,52120758,409,0.7445362780334239
21246,1737.3882,1737.4067,1,52121646,52122201,555,-0.024874532605192023
21247,1737.4116,1737.419267,1,52122348,52122578,230,-0.03303494688684336
21248,1737.424233,1737.432167,1,52122726,52122965,239,0.01613410977315899
21249,1737.664067,1737.7675,1,52129922,52133025,3103,0.8354940084103757
21250,1737.769833,1737.812267,1,52133094,52134368,1274,0.8650504546693161
21251,1738.156333,1738.163833,1,52144689,52144914,225,0.662915051739195
21252,1738.174133,1738.183,1,52145223,52145490,267,0.7816085562130385
21253,1738.195233,1738.2517,1,52145856,52147551,1695,0.7483028394797632
21254,1738.270667,1738.282367,1,52148120,52148471,351,0.7524248079081062
21255,1738.2886,1738.2994,1,52148658,52148982,324,0.4322363945461122
21256,1738.318567,1738.324467,1,52149557,52149734,177,0.4376742866854043
21257,1738.327967,1738.335667,1,52149839,52150070,231,0.4434568226383697
21258,1738.342033,1738.358867,1,52150260,52150766,506,0.6405492634036317
21259,1738.378667,1738.3978,1,52151360,52151934,574,0.4783856844064704
21260,1738.400433,1738.414433,1,52152012,52152432,420,0.3600595562480469
21261,1738.445667,1738.461533,1,52153370,52153845,475,0.610075422874788
21262,1738.486367,1738.4966,1,52154591,52154898,307,0.62493025131199
21263,1738.539967,1738.5438,1,52156199,52156314,115,0.656904779202412
21264,1738.563267,1738.5902,1,52156898,52157706,808,-0.06489319968212905
21265,1738.592433,1738.6005,1,52157772,52158015,243,0.14033128557596095
21266,1738.6241,1738.746967,1,52158723,52162409,3686,0.8027488212004329
21267,1738.9279,1739.0917,1,52167837,52172751,4914,0.7513735571500045
21268,1739.0962,1739.099833,1,52172886,52172994,108,0.7229533564058528
21269,1739.100967,1739.152267,1,52173029,52174568,1539,0.8477248538877019
21270,1739.163733,1739.181933,1,52174911,52175457,546,0.7010897319619485
21271,1739.183933,1739.194367,1,52175517,52175831,314,0.43928967114093975
21272,1739.208333,1739.212533,1,52176249,52176375,126,-0.04540073155443696
21273,1739.219867,1739.237733,1,52176596,52177131,535,-0.08708839549182863
21274,1739.238767,1739.251667,1,52177163,52177550,387,0.1606083272332401
21275,1739.255567,1739.2657,1,52177667,52177971,304,-0.05728675025932687
21276,1739.4612,1739.465167,1,52183836,52183955,119,0.6316512794478223
21277,1739.4778,1739.631767,1,52184334,52188953,4619,0.8156716370092105
21278,1739.651633,1739.679733,1,52189548,52190391,843,0.7769680223466708
21279,1739.6819,1739.7615,1,52190457,52192845,2388,0.840396092825649
21280,1739.785533,1739.865133,1,52193565,52195953,2388,0.7754116337475763
21281,1739.8814,1739.885933,1,52196442,52196577,135,0.05088308231695999
21282,1740.1529,1740.1576,1,52204587,52204728,141,0.39040890114931504
21283,1740.164,1740.172433,1,52204920,52205172,252,0.7211873089077375
21284,1740.191967,1740.205333,1,52205759,52206159,400,0.7968897011954228
21285,1740.224433,1740.2343,1,52206732,52207029,297,0.7093680712644959
21286,1740.2813,1740.311767,1,52208439,52209353,914,0.8173514618946653
21287,1740.319467,1740.3811,1,52209584,52211433,1849,0.7890225169566061
21288,1740.4085,1740.431567,1,52212255,52212947,692,0.6480981448469993
21289,1740.4537,1740.456933,1,52213611,52213707,96,
21290,1740.461367,1740.490267,1,52213841,52214708,867,0.16283806445499338
21291,1740.497133,1740.505767,1,52214913,52215173,260,-0.043288252374417684
21292,1740.545467,1740.648467,1,52216364,52219454,3090,0.7473086813398321
21293,1740.827067,1740.884267,1,52224812,52226528,1716,0.7705600257379387
21294,1740.887633,1741.013067,1,52226628,52230392,3764,0.7879870778915201
21295,1741.031567,1741.042867,1,52230947,52231286,339,0.10773329504577164
21296,1741.279867,1741.285467,1,52238396,52238564,168,0.6448928110004967
21297,1741.286967,1741.366333,1,52238609,52240989,2380,0.8270920444263733
21298,1741.370367,1741.464167,1,52241111,52243925,2814,0.8129857617864196
21299,1741.4945,1741.516733,1,52244835,52245501,666,0.29269700853504516
21300,1741.543,1741.5499,1,52246290,52246497,207,0.14001347466569974
21301,1741.848,1741.8789,1,52255440,52256367,927,0.5378074580301262
21302,1741.903267,1741.918233,1,52257098,52257546,448,0.34269342209681203
21303,1742.036367,1742.160367,1,52261091,52264811,3720,0.7730940651660863
21304,1742.267233,1742.270867,1,52268016,52268126,110,-0.39372844256662887
21305,1742.288033,1742.386767,1,52268640,52271603,2963,0.7854344602787897
21306,1742.420967,1742.439033,1,52272629,52273170,541,-0.06309883155577414
21307,1742.441633,1742.451733,1,52273248,52273551,303,-0.013746572208306643
21308,1742.4576,1742.463233,1,52273728,52273896,168,-0.11283142089684033
21309,1742.739733,1742.836,1,52282191,52285080,2889,0.7063496804353236
21310,1742.851267,1742.882433,1,52285538,52286472,934,0.6901882351555123
21311,1742.899067,1742.9415,1,52286972,52288245,1273,0.616655002893779
21312,1742.9538,1742.9612,1,52288614,52288836,222,0.5650138366176372
21313,1742.996933,1743.007667,1,52289907,52290230,323,0.5955278750868322
21314,1743.014867,1743.0496,1,52290446,52291488,1042,0.044244166112956125
21315,1743.0744,1743.129167,1,52292232,52293875,1643,0.8105924822191354
21316,1743.141733,1743.184867,1,52294251,52295546,1295,0.8121560895096791
21317,1743.205067,1743.2099,1,52296152,52296297,145,-0.1672198468456997
21318,1743.211,1743.221067,1,52296330,52296632,302,0.08579140805867252
21319,1743.222967,1743.234967,1,52296689,52297049,360,-0.01999065900686148
21320,1743.241067,1743.2458,1,52297232,52297374,142,-4.4444236118368086e-05
21321,1743.2683,1743.387333,1,52298049,52301619,3570,0.838050226842059
21322,1743.7031,1743.735833,1,52311093,52312074,981,0.7531563517634954
21323,1743.742933,1743.7525,1,52312287,52312575,288,-0.14892074678299852
21324,1743.7572,1743.783233,1,52312716,52313496,780,0.5375730349213448
21325,1743.786167,1743.799367,1,52313585,52313981,396,0.460245792868603
21326,1743.841367,1743.8475,1,52315241,52315425,184,0.44786253071528476
21327,1743.851833,1743.871233,1,52315554,52316136,582,0.40974998464497103
21328,1743.885,1743.937233,1,52316550,52318116,1566,0.4443926794567569
21329,1743.944633,1743.964367,1,52318338,52318931,593,0.6557614047344937
21330,1743.967367,1744.0338,1,52319021,52321014,1993,0.6713533147085075
21331,1744.047767,1744.070533,1,52321433,52322115,682,0.6776327994554313
21332,1744.0834,1744.131167,1,52322502,52323935,1433,0.6016693130031843
21333,1744.150367,1744.171933,1,52324511,52325157,646,0.500994157465782
21334,1744.203867,1744.207433,1,52326116,52326222,106,-0.1879676512355759
21335,1744.219,1744.2276,1,52326570,52326828,258,-0.015689371304863538
21336,1744.229667,1744.238733,1,52326890,52327161,271,0.16936956243336737
21337,1744.239967,1744.252233,1,52327199,52327566,367,0.23220688817712723
21338,1744.259967,1744.266767,1,52327799,52328003,204,-0.20279051319548377
21339,1744.290767,1744.304033,1,52328723,52329120,397,0.6870244926839312
21340,1744.3058,1744.407533,1,52329174,52332225,3051,0.7611835013850838
21341,1744.6273,1744.635433,1,52338819,52339062,243,0.6814195965426598
21342,1744.636733,1744.640333,1,52339101,52339209,108,0.7955699911788334
21343,1744.642533,1744.779667,1,52339275,52343390,4115,0.8244875705410639
21344,1744.8005,1744.864133,1,52344015,52345923,1908,0.8191224981756332
21345,1744.872767,1744.8839,1,52346183,52346517,334,0.6886693021923258
21346,1744.886033,1744.916567,1,52346580,52347497,917,0.7545909319435367
21347,1745.248133,1745.253267,1,52357443,52357598,155,0.6646661546834755
21348,1745.256733,1745.3084,1,52357701,52359252,1551,0.7638856209936595
21349,1745.323233,1745.350133,1,52359696,52360503,807,0.9355609466834944
21350,1745.3518,1745.406833,1,52360554,52362204,1650,0.7331001521980874
21351,1745.413867,1745.4919,1,52362416,52364757,2341,0.7877762856557528
21352,1745.493833,1745.5732,1,52364814,52367196,2382,0.7710351604707243
21353,1745.577167,1745.605333,1,52367315,52368159,844,0.618799337670505
21354,1745.610167,1745.6854,1,52368305,52370562,2257,0.7911290080394264
21355,1745.689067,1745.706667,1,52370672,52371200,528,0.8314082127608224
21356,1745.737233,1745.742233,1,52372116,52372266,150,0.5668397210854714
21357,1745.750667,1745.8645,1,52372520,52375935,3415,0.7859714757748838
21358,1745.8827,1745.884033,1,52376481,52376520,39,
21359,1746.293767,1746.297833,1,52388813,52388934,121,0.7368776393401028
21360,1746.306,1746.323067,1,52389180,52389692,512,0.3742589834292739
21361,1746.325833,1746.3297,1,52389774,52389891,117,0.6687273553306201
21362,1746.366533,1746.3757,1,52390995,52391271,276,0.6040476489263553
21363,1746.3818,1746.404,1,52391454,52392120,666,0.7158263400099202
21364,1746.535733,1746.541267,1,52396071,52396238,167,0.5317253692906023
21365,1746.5435,1746.5601,1,52396305,52396803,498,0.6957948957854332
21366,1746.5616,1746.602833,1,52396848,52398084,1236,0.7866629121500216
21367,1746.6079,1746.753767,1,52398237,52402613,4376,0.7816481742463183
21368,1747.062567,1747.101833,1,52411877,52413054,1177,0.6758402363812119
21369,1747.349933,1747.378767,1,52420497,52421363,866,0.6806312617306759
21370,1747.401433,1747.477167,1,52422042,52424315,2273,0.793402333495223
21371,1747.771067,1747.794533,1,52433132,52433835,703,0.5711812656313802
21372,1747.826,1747.908467,1,52434780,52437254,2474,0.7477493666673664
21373,1747.914267,1747.923067,1,52437428,52437692,264,0.13085843616817025
21374,1747.929667,1747.932667,1,52437890,52437980,90,0.5359492028387026
21375,1747.998467,1748.0039,1,52439954,52440117,163,0.7147296514142459
21376,1748.008867,1748.153967,1,52440266,52444619,4353,0.7965430497179853
21377,1748.1582,1748.242533,1,52444746,52447275,2529,0.7747420679102672
21378,1748.246633,1748.254867,1,52447398,52447646,248,0.37016282518363763
21379,1748.266567,1748.2723,1,52447997,52448169,172,0.15810980616786927
21380,1748.609,1748.614167,1,52458270,52458425,155,0.6935307315925027
21381,1748.6153,1748.6195,1,52458459,52458585,126,0.0783859713651265
21382,1748.630067,1748.665667,1,52458902,52459970,1068,0.7929312163794494
21383,1748.696767,1748.713967,1,52460903,52461419,516,0.7206221039297813
21384,1748.718233,1748.740233,1,52461546,52462206,660,0.7324200431892371
21385,1748.756933,1748.779967,1,52462707,52463399,692,0.5509149823219287
21386,1748.782267,1748.803667,1,52463468,52464110,642,0.559487172313741
21387,1748.829467,1748.847333,1,52464884,52465419,535,0.748674407534254
21388,1748.867033,1748.884633,1,52466010,52466538,528,0.8153489294145277
21389,1748.887933,1748.907467,1,52466637,52467224,587,0.7549531299485065
21390,1748.9154,1748.9267,1,52467462,52467801,339,0.4244597707173443
21391,1748.953633,1748.9844,1,52468608,52469532,924,0.17392416731394386
21392,1749.0204,1749.169367,1,52470612,52475081,4469,0.7078807776060926
21393,1749.213633,1749.223633,1,52476408,52476708,300,0.6559090636609597
21394,1749.2262,1749.2299,1,52476786,52476897,111,-0.21905550940103863
21395,1749.231,1749.287867,1,52476930,52478636,1706,0.20019561024513333
21396,1749.3126,1749.4186,1,52479378,52482558,3180,0.746351108353721
21397,1749.4202,1749.432133,1,52482606,52482963,357,0.3742339999123052
21398,1749.442333,1749.449633,1,52483269,52483488,219,-0.04813460068975254
21399,1749.465333,1749.468367,1,52483959,52484051,92,-0.04803295107909011
21400,1749.480733,1749.487367,1,52484421,52484621,200,0.4037930204773084
21401,1749.490067,1749.493567,1,52484702,52484807,105,
21402,1749.556033,1749.591567,1,52486680,52487747,1067,0.8477978491638092
21403,1749.592967,1749.7131,1,52487789,52491393,3604,0.8292302457570354
21404,1749.714167,1749.7237,1,52491425,52491711,286,0.8828172497227142
21405,1750.0114,1750.018833,1,52500342,52500564,222,0.20420366652965066
21406,1750.022933,1750.0556,1,52500687,52501668,981,0.6908993405186254
21407,1750.077667,1750.0863,1,52502330,52502589,259,0.750534428789689
21408,1750.090767,1750.1299,1,52502723,52503897,1174,0.6506661036604561
21409,1750.143433,1750.180933,1,52504302,52505427,1125,0.7472062624611978
21410,1750.1953,1750.199067,1,52505859,52505972,113,0.8676418655298066
21411,1750.206,1750.213767,1,52506180,52506413,233,0.45351628081216677
21412,1750.214967,1750.2414,1,52506449,52507242,793,0.6940017261383142
21413,1750.244167,1750.3288,1,52507325,52509864,2539,0.7897266994886206
21414,1750.343533,1750.349667,1,52510305,52510490,185,0.05468172259638449
21415,1750.358367,1750.3614,1,52510751,52510842,91,-0.22498239113490898
21416,1750.430867,1750.539533,1,52512926,52516185,3259,0.8296902577572371
21417,1750.551367,1750.567333,1,52516541,52517019,478,0.41575311366977963
21418,1750.575133,1750.597367,1,52517253,52517921,668,0.04021296512350722
21419,1750.599033,1750.6056,1,52517970,52518168,198,0.019381672451768982
21420,1750.607033,1750.623233,1,52518210,52518696,486,0.29612672221984315
21421,1750.632667,1750.831933,1,52518980,52524957,5977,0.7994460296971359
21422,1750.8349,1750.838267,1,52525047,52525148,101,0.538311300629363
21423,1750.839833,1750.981767,1,52525194,52529453,4259,0.7916732884801658
21424,1750.9893,1751.022633,1,52529679,52530678,999,0.6867750397674862
21425,1751.0351,1751.044133,1,52531053,52531323,270,-0.10633580295164877
21426,1751.046267,1751.050933,1,52531388,52531527,139,
21427,1751.052467,1751.073767,1,52531574,52532213,639,-0.029928301132914645
21428,1751.077667,1751.086833,1,52532330,52532604,274,-0.01784114159321143
21429,1751.1156,1751.229067,1,52533468,52536872,3404,0.778600546274229
21430,1751.237967,1751.2443,1,52537139,52537329,190,0.5279337827402855
21431,1751.264467,1751.2736,1,52537934,52538208,274,0.14224052547332872
21432,1751.307433,1751.315833,1,52539222,52539474,252,0.6424705361212205
21433,1751.3174,1751.4968,1,52539522,52544904,5382,0.8103115793301043
21434,1751.7696,1751.776567,1,52553088,52553297,209,0.7421500286197897
21435,1751.791633,1751.846633,1,52553748,52555398,1650,0.8318826816837739
21436,1751.847633,1751.877967,1,52555428,52556339,911,0.710795178306218
21437,1751.8808,1751.886867,1,52556424,52556606,182,0.09257844473719684
21438,1751.8957,1751.937633,1,52556871,52558128,1257,0.80641630960644
21439,1751.939267,1751.982833,1,52558178,52559484,1306,0.7503318560426158
21440,1751.987867,1752.0028,1,52559636,52560084,448,0.6555480415320876
21441,1752.0042,1752.010467,1,52560126,52560314,188,0.4295328536084029
21442,1752.011833,1752.033467,1,52560354,52561004,650,0.5842447687538587
21443,1752.037567,1752.0611,1,52561127,52561833,706,0.810689855978145
21444,1752.064833,1752.120667,1,52561944,52563620,1676,0.8492231209408686
21445,1752.1338,1752.164367,1,52564014,52564931,917,0.6008905864470242
21446,1752.188133,1752.212333,1,52565643,52566369,726,0.054945814728241
21447,1752.213467,1752.228633,1,52566404,52566858,454,0.1852298376031607
21448,1752.2297,1752.2364,1,52566891,52567092,201,0.6931445959287221
21449,1752.2832,1752.477933,1,52568496,52574337,5841,0.8003596026542599
21450,1752.489433,1752.509233,1,52574682,52575276,594,0.8830751087639793
21451,1753.018467,1753.0452,1,52590554,52591356,802,0.5584502969752811
21452,1753.1101,1753.115633,1,52593303,52593468,165,0.5191514447237519
21453,1753.232333,1753.2444,1,52596969,52597332,363,0.6367394196738166
21454,1753.295367,1753.313033,1,52598861,52599390,529,0.5783199085576272
21455,1753.434667,1753.574567,1,52603040,52607237,4197,0.7868374527334763
21456,1753.5965,1753.680867,1,52607895,52610426,2531,0.7970385649878813
21457,1753.683,1753.7046,1,52610490,52611138,648,0.545825473074091
21458,1753.709033,1753.7283,1,52611270,52611849,579,0.5656328733392945
21459,1753.731867,1753.738,1,52611956,52612140,184,0.5221336227586081
21460,1753.7401,1753.7876,1,52612203,52613628,1425,0.7478676530868553
21461,1753.801,1753.805733,1,52614030,52614171,141,0.5662759725427765
21462,1753.8147,1753.8363,1,52614441,52615089,648,0.7017258798452164
21463,1753.882633,1753.904667,1,52616478,52617140,662,0.48404992250755513
21464,1753.925,1754.037467,1,52617750,52621124,3374,0.6100793264377649
21465,1754.044433,1754.106833,1,52621332,52623204,1872,0.7220013214868706
21466,1754.1121,1754.1288,1,52623363,52623864,501,0.6776022613997588
21467,1754.133467,1754.147733,1,52624004,52624431,427,0.7035237149551722
21468,1754.1564,1754.1695,1,52624692,52625085,393,0.03177547784240242
21469,1754.202933,1754.2096,1,52626087,52626288,201,0.2883234625735692
21470,1754.210667,1754.221567,1,52626320,52626647,327,0.3267694790232589
21471,1755.2832,1755.4001,1,52658496,52662003,3507,0.8105387542743481
21472,1757.635667,1757.641333,1,52729070,52729239,169,0.508291733031684
21473,1757.857333,1757.8606,1,52735719,52735818,99,0.8283466975831096
21474,1757.8858,1757.889533,1,52736574,52736685,111,0.24073330460233608
21475,1757.890633,1757.8945,1,52736718,52736835,117,-0.057782391138006206
21476,1757.929633,1757.935233,1,52737888,52738056,168,0.5695138861258072
21477,1757.986367,1757.996167,1,52739591,52739885,294,0.6336572833015767
21478,1758.058433,1758.071067,1,52741752,52742132,380,0.6663095052543038
21479,1758.095533,1758.100767,1,52742865,52743023,158,0.4797860860991185
21480,1758.1111,1758.1151,1,52743333,52743453,120,0.45076368811983086
21481,1758.542333,1758.547533,1,52756269,52756425,156,0.48137798811890814
21482,1758.590533,1758.620733,1,52757715,52758621,906,0.7081594532445878
21483,1758.623767,1758.632867,1,52758713,52758986,273,0.30895930125622745
21484,1758.6558,1758.6814,1,52759674,52760442,768,0.7303309242298642
21485,1758.7102,1758.717233,1,52761306,52761516,210,0.715107221465306
21486,1758.734267,1758.7704,1,52762028,52763112,1084,0.6836379415072051
21487,1758.7979,1758.824667,1,52763937,52764740,803,0.6258321973851991
21488,1758.841667,1758.888767,1,52765250,52766663,1413,0.4963721758285005
21489,1758.918567,1758.934767,1,52767557,52768043,486,0.6726532043668731
21490,1758.954833,1758.968933,1,52768644,52769067,423,0.6586874334608378
21491,1758.978133,1759.001567,1,52769343,52770047,704,0.6157431870041679
21492,1759.324833,1759.465567,1,52779744,52783967,4223,0.7786060800176372
21493,1759.4882,1759.5149,1,52784646,52785447,801,0.7345974108815065
21494,1759.5192,1759.580533,1,52785576,52787415,1839,0.801561749273982
21495,1759.582233,1759.590967,1,52787466,52787729,263,0.8520197438018171
21496,1759.948933,1760.081233,1,52798467,52802436,3969,0.8036356052619377
21497,1760.089067,1760.158033,1,52802672,52804740,2068,0.8292179956245694
21498,1760.159733,1760.171567,1,52804791,52805147,356,0.4325326193677877
21499,1760.1778,1760.224933,1,52805334,52806747,1413,0.7166071091475575
21500,1760.2299,1760.308333,1,52806897,52809249,2352,0.7354010969591935
21501,1760.311333,1760.368267,1,52809339,52811048,1709,0.6147199197627916
21502,1760.3937,1760.400367,1,52811811,52812011,200,0.633603300477129
21503,1760.4014,1760.4247,1,52812042,52812741,699,0.6352752574421471
21504,1760.440033,1760.4666,1,52813200,52813998,798,0.7796669680875102
21505,1760.4698,1760.473433,1,52814094,52814202,108,-0.32102539100790495
21506,1760.4918,1760.499633,1,52814754,52814988,234,0.1880051901529756
21507,1760.501333,1760.5169,1,52815039,52815507,468,0.39340637586777094
21508,1760.5195,1760.5251,1,52815585,52815753,168,0.6108799468399493
21509,1760.818967,1760.823733,1,52824569,52824711,142,0.37525785045945176
21510,1760.8361,1760.994433,1,52825083,52829832,4749,0.8175723663864155
21511,1761.0001,1761.004467,1,52830003,52830134,131,-0.08012543919512997
21512,1761.005567,1761.023367,1,52830167,52830701,534,0.4312840847280266
21513,1761.0253,1761.0422,1,52830759,52831266,507,0.8587090653100089
21514,1761.045767,1761.2008,1,52831373,52836024,4651,0.6984312894123325
21515,1761.204433,1761.3477,1,52836132,52840431,4299,0.7782970587670357
21516,1761.395533,1761.3989,1,52841865,52841967,102,0.038066051074422874
21517,1761.9029,1761.9067,1,52857087,52857201,114,0.6330694904594039
21518,1761.939633,1761.9667,1,52858188,52859001,813,0.6102001120894583
21519,1761.980533,1761.9917,1,52859415,52859751,336,0.7333239254255662
21520,1762.008533,1762.049233,1,52860255,52861476,1221,0.8061138904741879
21521,1762.074567,1762.077767,1,52862237,52862333,96,0.6321142644019115
21522,1762.0796,1762.110533,1,52862388,52863315,927,0.7513990786032644
21523,1762.113033,1762.185833,1,52863390,52865574,2184,0.6918106404328445
21524,1762.192967,1762.209267,1,52865789,52866278,489,0.7990534222314064
21525,1762.210933,1762.271067,1,52866327,52868132,1805,0.8021299175536539
21526,1762.2776,1762.294067,1,52868328,52868822,494,0.8699445726048954
21527,1762.298433,1762.323133,1,52868952,52869693,741,0.8032503068234548
21528,1762.9648,1762.967967,1,52888944,52889039,95,0.5880742073508688
21529,1763.143033,1763.154733,1,52894290,52894641,351,0.619904497629541
21530,1763.156967,1763.177467,1,52894709,52895324,615,0.4813828904310233
21531,1763.2071,1763.219633,1,52896213,52896588,375,0.5730589561722058
21532,1763.2792,1763.2858,1,52898376,52898574,198,0.4466098108829687
21533,1763.401067,1763.4053,1,52902032,52902159,127,0.6438418459259362
21534,1763.406633,1763.543267,1,52902198,52906298,4100,0.8233199602183066
21535,1763.994367,1763.9982,1,52919831,52919946,115,0.6156721444147742
21536,1764.0147,1764.0467,1,52920441,52921401,960,0.7484354197909829
21537,1764.069433,1764.078633,1,52922082,52922358,276,0.7001023708671389
21538,1764.096633,1764.152633,1,52922898,52924578,1680,0.7259113684368056
21539,1764.163767,1764.293767,1,52924913,52928813,3900,0.7288026377890714
21540,1764.3004,1764.382533,1,52929012,52931475,2463,0.5240636924578722
21541,1764.3865,1764.434267,1,52931595,52933028,1433,0.43080457912238396
21542,1765.435567,1765.467567,1,52963067,52964027,960,0.7402044448075781
21543,1765.4799,1765.501533,1,52964397,52965045,648,0.8962595775078176
21544,1765.586467,1765.595867,1,52967594,52967876,282,0.7901157377478774
21545,1765.631533,1765.682533,1,52968945,52970475,1530,0.7077908011340727
21546,1765.7174,1765.7303,1,52971522,52971909,387,0.7710922007507168
21547,1765.7543,1765.765567,1,52972629,52972967,338,0.7342494390420088
21548,1765.767167,1765.7788,1,52973015,52973364,349,0.5458747631883071
21549,1766.103567,1766.1778,1,52983107,52985334,2227,0.857679930362218
21550,1766.182167,1766.2384,1,52985465,52987152,1687,0.8104674944802496
21551,1766.245233,1766.305067,1,52987356,52989152,1796,0.6648530971947301
21552,1766.306333,1766.310933,1,52989189,52989327,138,0.4262714094992287
21553,1766.333333,1766.391667,1,52989999,52991750,1751,0.720406749162057
21554,1766.4037,1766.4537,1,52992111,52993611,1500,0.7115665255947887
21555,1766.455,1766.472433,1,52993650,52994172,522,0.5606488590562223
21556,1766.4778,1766.4958,1,52994334,52994874,540,0.7852907856856538
21557,1766.500867,1766.5217,1,52995026,52995651,625,0.7199417442042754
21558,1766.527767,1766.609867,1,52995833,52998296,2463,0.7762303336270355
21559,1766.9851,1766.988267,1,53009553,53009648,95,0.5818579262588968
21560,1766.9945,1767.159467,1,53009835,53014784,4949,0.8345994458813087
21561,1767.166667,1767.365467,1,53015000,53020964,5964,0.7777317049358436
21562,1767.4099,1767.419133,1,53022297,53022573,276,0.19781142154308973
21563,1767.421967,1767.4251,1,53022659,53022753,94,
21564,1767.852733,1767.8579,1,53035581,53035737,156,0.8134467381301994
21565,1767.859867,1767.8632,1,53035796,53035896,100,
21566,1767.975333,1767.983633,1,53039259,53039508,249,0.5269101726981044
21567,1768.033567,1768.037367,1,53041007,53041121,114,0.8440592796097001
21568,1768.038533,1768.050533,1,53041155,53041515,360,0.6381075096980235
21569,1768.075667,1768.079767,1,53042270,53042393,123,0.6723763377863621
21570,1768.0819,1768.0952,1,53042457,53042856,399,0.6494650898944724
21571,1768.2222,1768.337633,1,53046666,53050128,3462,0.7458600901325504
21572,1768.340867,1768.3772,1,53050226,53051316,1090,0.800900367830148
21573,1768.4188,1768.431633,1,53052564,53052948,384,0.7510892741099752
21574,1768.434433,1768.5225,1,53053032,53055675,2643,0.7435728500525708
21575,1768.9191,1768.928467,1,53067573,53067854,281,0.4407986102903925
21576,1768.944167,1769.031767,1,53068325,53070953,2628,0.8335086602325256
21577,1769.074033,1769.116533,1,53072220,53073495,1275,0.7243504254165654
21578,1769.118533,1769.122067,1,53073555,53073662,107,0.44147097296489757
21579,1769.125533,1769.210067,1,53073765,53076302,2537,0.76155135767488
21580,1769.213733,1769.220167,1,53076411,53076605,194,-0.15953201681928686
21581,1769.768933,1769.774833,1,53093067,53093244,177,0.7335675171508237
21582,1769.8021,1769.8359,1,53094063,53095077,1014,0.7131037642087777
21583,1769.8553,1769.8617,1,53095659,53095851,192,0.8494854199632997
21584,1769.8716,1769.885933,1,53096148,53096577,429,0.7028476698332614
21585,1769.889033,1769.8929,1,53096670,53096787,117,-0.14695641651118982
21586,1769.907833,1769.951867,1,53097234,53098556,1322,0.5053473245826313
21587,1769.974033,1769.9935,1,53099220,53099805,585,0.544193129520716
21588,1770.0289,1770.033367,1,53100867,53101001,134,0.4001806855713874
21589,1770.051133,1770.058233,1,53101533,53101746,213,-0.07126780678426389
21590,1770.061933,1770.0871,1,53101857,53102613,756,0.16451770105770785
21591,1770.0961,1770.100467,1,53102883,53103014,131,0.6921268132365662
21592,1770.1072,1770.221767,1,53103216,53106653,3437,0.7630574582642765
21593,1770.224267,1770.295333,1,53106728,53108859,2131,0.7801761111086067
21594,1770.301667,1770.371067,1,53109050,53111132,2082,0.8455954444423502
21595,1770.647267,1770.6575,1,53119418,53119725,307,0.3456608551593433
21596,1770.661733,1770.6961,1,53119851,53120883,1032,0.7986684983769741
21597,1770.697167,1770.703067,1,53120915,53121092,177,0.6333213626134688
21598,1770.705567,1770.7457,1,53121167,53122371,1204,0.7627354416200501
21599,1770.748167,1770.752133,1,53122445,53122563,118,0.24084985382892138
21600,1770.7725,1770.7755,1,53123175,53123265,90,
21601,1770.7907,1770.794933,1,53123721,53123847,126,-0.2507700322808365
21602,1771.0383,1771.093167,1,53131149,53132795,1646,0.7056888838357822
21603,1771.0948,1771.1766,1,53132844,53135298,2454,0.8367159252011772
21604,1771.1778,1771.182667,1,53135334,53135480,146,0.31050900730013964
21605,1771.1859,1771.198933,1,53135577,53135967,390,-0.015818907359285834
21606,1771.256,1771.270367,1,53137680,53138111,431,0.7545749474400023
21607,1771.278333,1771.340767,1,53138349,53140223,1874,0.8336991542259696
21608,1771.675433,1771.819267,1,53150262,53154578,4316,0.7506119402214967
21609,1771.833967,1771.834433,1,53155019,53155032,13,
21610,1771.839467,1771.964467,1,53155184,53158934,3750,0.8039157355235915
21611,1771.9671,1771.972433,1,53159013,53159172,159,0.4012877008160756
21612,1771.980833,1771.9853,1,53159424,53159559,135,0.022137179415241973
21613,1771.990167,1771.994633,1,53159705,53159838,133,0.3087860391124417
21614,1772.295,1772.3223,1,53168850,53169669,819,0.7826090525707675
21615,1772.349833,1772.3864,1,53170494,53171592,1098,0.8144576211308785
21616,1772.400067,1772.423733,1,53172002,53172711,709,0.7363817670077307
21617,1772.433,1772.457967,1,53172990,53173739,749,0.7062710605808922
21618,1772.4596,1772.483567,1,53173788,53174507,719,0.5290435219102666
21619,1772.489467,1772.563967,1,53174684,53176919,2235,0.7910532833013065
21620,1772.573133,1772.578067,1,53177193,53177342,149,0.8741704105444994
21621,1772.579067,1772.587067,1,53177372,53177612,240,0.566662499946228
21622,1772.590633,1772.616967,1,53177718,53178509,791,0.7581056989853628
21623,1772.634033,1772.645133,1,53179020,53179353,333,-0.06393579085595233
21624,1772.655467,1772.6646,1,53179664,53179938,274,-0.15805925025299897
21625,1772.830133,1772.8939,1,53184903,53186817,1914,0.7990889234334335
21626,1772.894933,1772.94,1,53186847,53188200,1353,0.8077492735607475
21627,1772.9607,1772.965233,1,53188821,53188956,135,0.2556162997189074
21628,1772.9991,1773.111967,1,53189973,53193359,3386,0.8013099814757626
21629,1773.115267,1773.120533,1,53193458,53193615,157,-0.02560289734625167
21630,1773.126067,1773.130567,1,53193782,53193917,135,0.3379795940406974
21631,1773.542767,1773.5657,1,53206283,53206971,688,0.7291940342695497
21632,1773.6051,1773.6389,1,53208153,53209167,1014,0.7285806878800545
21633,1773.662467,1773.6771,1,53209874,53210313,439,0.5293316776855574
21634,1773.678167,1773.687033,1,53210345,53210610,265,0.4959866285652616
21635,1773.721533,1773.729433,1,53211645,53211882,237,0.5109919277408552
21636,1773.7377,1773.752633,1,53212131,53212578,447,0.565190110632172
21637,1773.7707,1773.7856,1,53213121,53213568,447,0.5282478226376803
21638,1773.8345,1773.851,1,53215035,53215530,495,0.5997572561095256
21639,1773.8771,1773.8882,1,53216313,53216646,333,0.5636208780827491
21640,1773.896767,1773.904,1,53216903,53217120,217,0.36381743342136125
21641,1773.966833,1773.970867,1,53219004,53219126,122,-0.2736479694046186
21642,1774.028733,1774.140767,1,53220861,53224223,3362,0.7635810217555858
21643,1774.3374,1774.537133,1,53230122,53236113,5991,0.7166345780033987
21644,1774.559367,1774.5669,1,53236781,53237007,226,0.08713134487127935
21645,1774.851733,1774.8604,1,53245551,53245812,261,0.5570047726793559
21646,1774.862633,1774.9892,1,53245878,53249676,3798,0.7884935039793571
21647,1774.991933,1775.075167,1,53249757,53252255,2498,0.8357028740190298
21648,1775.0764,1775.110967,1,53252292,53253329,1037,0.6270608629293701
21649,1775.115233,1775.1784,1,53253456,53255352,1896,0.8197154332124594
21650,1775.1925,1775.231333,1,53255775,53256939,1164,0.772293045746543
21651,1775.236067,1775.2421,1,53257082,53257263,181,0.40203690656315016
21652,1775.2606,1775.2673,1,53257818,53258019,201,0.14845710250528318
21653,1775.2725,1775.352,1,53258175,53260560,2385,0.7857767833701161
21654,1775.3607,1775.3637,1,53260821,53260911,90,0.06731309367865601
21655,1775.375033,1775.3781,1,53261250,53261343,93,
21656,1775.380533,1775.385333,1,53261415,53261559,144,
21657,1775.493733,1775.5029,1,53264811,53265087,276,0.13855222152615088
21658,1775.5058,1775.6743,1,53265174,53270229,5055,0.8221236076711033
21659,1775.689467,1775.7507,1,53270684,53272521,1837,0.732186847501365
21660,1775.7648,1775.780933,1,53272944,53273427,483,0.82143759428626
21661,1775.782433,1775.792967,1,53273472,53273789,317,0.2805140373086331
21662,1775.796233,1775.8754,1,53273886,53276262,2376,0.7649495022584002
21663,1775.876433,1775.881633,1,53276292,53276448,156,0.5386351352200731
21664,1775.9087,1775.914,1,53277261,53277420,159,-0.04905426952354975
21665,1776.240167,1776.281633,1,53287205,53288448,1243,0.5045254541923634
21666,1776.286,1776.339233,1,53288580,53290176,1596,0.6359027006139675
21667,1776.356267,1776.377933,1,53290688,53291337,649,0.697138246241695
21668,1776.408167,1776.507367,1,53292245,53295221,2976,0.778719448908683
21669,1776.6189,1776.670333,1,53298567,53300109,1542,0.749792127600269
21670,1776.679767,1776.718367,1,53300393,53301551,1158,0.6324899795715091
21671,1776.7268,1776.730333,1,53301804,53301909,105,-0.4913934995699575
21672,1776.7507,1776.761633,1,53302521,53302848,327,-0.08906367869540953
21673,1776.7794,1776.894,1,53303382,53306820,3438,0.8591420386809001
21674,1777.213,1777.218867,1,53316390,53316566,176,0.6634748732508612
21675,1777.2335,1777.267933,1,53317005,53318037,1032,0.8085074928831125
21676,1777.275567,1777.3061,1,53318267,53319183,916,0.7827685585099879
21677,1777.326333,1777.525767,1,53319789,53325773,5984,0.765146220966972
21678,1777.527433,1777.5611,1,53325822,53326833,1011,0.7812416144400828
21679,1777.5887,1777.597833,1,53327661,53327934,273,0.16615045858322308
21680,1777.598933,1777.603567,1,53327967,53328107,140,-0.09017047458804128
21681,1777.6664,1777.6812,1,53329992,53330436,444,0.39505631267870406
21682,1777.6827,1777.689267,1,53330481,53330678,197,0.5372371342530029
21683,1777.696333,1777.789133,1,53330889,53333673,2784,0.7944352801977586
21684,1777.8012,1777.805267,1,53334036,53334158,122,0.09019323718984318
21685,1777.8236,1777.901667,1,53334708,53337050,2342,0.7997392805882507
21686,1778.184333,1778.188667,1,53345529,53345660,131,0.7114686126541141
21687,1778.197267,1778.2506,1,53345918,53347518,1600,0.7920735414359585
21688,1778.251633,1778.2707,1,53347548,53348121,573,0.784577293651528
21689,1778.2761,1778.306133,1,53348283,53349183,900,0.7349101020533397
21690,1778.320833,1778.3403,1,53349624,53350209,585,0.8055307577930761
21691,1778.3419,1778.398767,1,53350257,53351963,1706,0.8182767407782875
21692,1778.4067,1778.4365,1,53352201,53353095,894,0.7909304385057736
21693,1778.454933,1778.464133,1,53353647,53353923,276,-0.10036745158272281
21694,1778.4685,1778.495767,1,53354055,53354873,818,0.25205835434540785
21695,1778.521733,1778.5256,1,53355651,53355768,117,0.44180784709956394
21696,1778.530767,1778.694,1,53355923,53360820,4897,0.8199663605641161
21697,1778.702633,1778.7258,1,53361078,53361774,696,0.7557941045699709
21698,1778.727433,1778.768233,1,53361822,53363046,1224,0.7287748791300219
21699,1778.778467,1778.7836,1,53363354,53363508,154,0.776623059243712
21700,1778.7868,1778.912333,1,53363604,53367369,3765,0.7845296344995996
21701,1778.929,1778.951167,1,53367870,53368535,665,0.016405709816904222
21702,1778.956233,1778.978833,1,53368686,53369364,678,-0.2501934937627798
21703,1779.000733,1779.0039,1,53370021,53370117,96,0.4032125487596258
21704,1779.011233,1779.134667,1,53370336,53374040,3704,0.8104397134435181
21705,1779.409233,1779.433267,1,53382276,53382998,722,0.7006209482027613
21706,1779.445233,1779.452533,1,53383356,53383575,219,-0.03697475989277162
21707,1779.588533,1779.7625,1,53387655,53392875,5220,0.7939494806926379
21708,1779.783167,1779.880467,1,53393495,53396414,2919,0.8144936921825173
21709,1780.460467,1780.472333,1,53413814,53414169,355,0.6719641175445789
21710,1780.487867,1780.519567,1,53414636,53415587,951,0.7377553925212945
21711,1780.523067,1780.575733,1,53415692,53417271,1579,0.7872771773655318
21712,1780.580033,1780.607167,1,53417400,53418215,815,0.7485231246024966
21713,1780.6096,1780.646333,1,53418288,53419389,1101,0.8125777168402013
21714,1780.6489,1780.705667,1,53419467,53421170,1703,0.7415627071492519
21715,1780.707067,1780.721333,1,53421212,53421639,427,0.6011793261032956
21716,1780.722933,1780.862433,1,53421687,53425872,4185,0.7107743783137465
21717,1780.867133,1780.8706,1,53426013,53426118,105,-0.024705853858783954
21718,1780.871633,1780.8775,1,53426148,53426325,177,-0.0054616886436761975
21719,1781.161167,1781.170667,1,53434835,53435120,285,0.17711746251207766
21720,1781.172133,1781.326233,1,53435163,53439786,4623,0.7154153870544239
21721,1781.3437,1781.349567,1,53440311,53440487,176,0.39744282389993985
21722,1781.3876,1781.399967,1,53441628,53441999,371,-0.029725740018793335
21723,1781.4026,1781.408,1,53442078,53442240,162,
21724,1781.433533,1781.456367,1,53443005,53443691,686,0.6368293748132657
21725,1781.472033,1781.5555,1,53444160,53446665,2505,0.8055974885655272
21726,1781.579467,1781.583167,1,53447384,53447495,111,
21727,1781.821767,1781.824767,1,53454653,53454743,90,
21728,1781.825767,1781.939967,1,53454773,53458199,3426,0.8608016104064664
21729,1781.963667,1782.102033,1,53458910,53463060,4150,0.7812575503474712
21730,1782.120533,1782.125433,1,53463615,53463762,147,0.13302949439736036
21731,1782.6766,1782.714833,1,53480298,53481444,1146,0.6662734393486281
21732,1782.736133,1782.754367,1,53482083,53482631,548,0.7002177091647255
21733,1782.7599,1782.762967,1,53482797,53482889,92,0.3403896949960894
21734,1782.784367,1782.792067,1,53483531,53483762,231,0.8369603651747192
21735,1782.808367,1782.824467,1,53484251,53484734,483,0.6195684079992938
21736,1782.872933,1782.882267,1,53486187,53486468,281,-0.11389862620839697
21737,1782.885133,1782.894767,1,53486553,53486843,290,0.29314164385790115
21738,1782.897133,1782.9044,1,53486913,53487132,219,0.08096766263698937
21739,1782.962033,1783.045733,1,53488860,53491371,2511,0.8236550832952768
21740,1783.0495,1783.062967,1,53491485,53491889,404,0.7521235742603745
21741,1783.065967,1783.185867,1,53491979,53495576,3597,0.8480187633134588
21742,1783.2006,1783.205867,1,53496018,53496176,158,0.0707245854112148
21743,1783.220867,1783.225,1,53496626,53496750,124,0.41945220738186517
21744,1783.230567,1783.235333,1,53496917,53497059,142,0.3237452365106077
21745,1783.428533,1783.443833,1,53502855,53503314,459,0.2287729978811684
21746,1783.447433,1783.4816,1,53503422,53504448,1026,0.8854643889447763
21747,1783.4906,1783.531833,1,53504718,53505954,1236,0.8715247735655358
21748,1783.789,1783.819267,1,53513670,53514578,908,0.7610507612713435
21749,1784.0741,1784.140667,1,53522223,53524220,1997,0.7604538595844194
21750,1784.143867,1784.256433,1,53524316,53527692,3376,0.800215182977571
21751,1784.259367,1784.377267,1,53527781,53531318,3537,0.766957834622601
21752,1784.393833,1784.398867,1,53531814,53531966,152,0.32540264138981206
21753,1784.4125,1784.4181,1,53532375,53532543,168,-0.10135456089048485
21754,1784.420467,1784.435267,1,53532614,53533058,444,0.020317681126783643
21755,1784.452733,1784.584167,1,53533581,53537525,3944,0.7964806818054255
21756,1784.5873,1784.595233,1,53537619,53537856,237,0.2888020688715168
21757,1784.596567,1784.687167,1,53537897,53540615,2718,0.8020849015413634
21758,1784.703067,1784.7249,1,53541092,53541747,655,-0.05850357152154155
21759,1784.726767,1784.7312,1,53541803,53541936,133,-0.015711628080119475
21760,1784.7323,1784.760233,1,53541969,53542806,837,0.16052637170693634
21761,1784.7823,1784.7877,1,53543469,53543631,162,0.5279783668979132
21762,1784.7909,1784.864333,1,53543727,53545929,2202,0.8350063689815966
21763,1784.867933,1784.9885,1,53546037,53549655,3618,0.8594371039944287
21764,1785.009867,1785.0161,1,53550296,53550483,187,0.6156726888732195
21765,1785.035833,1785.045667,1,53551074,53551370,296,-0.06532565188519159
21766,1785.2788,1785.368267,1,53558364,53561048,2684,0.7341277141547793
21767,1785.374667,1785.414867,1,53561240,53562446,1206,0.8265581136928412
21768,1785.427733,1785.438467,1,53562831,53563154,323,-0.08757041943692795
21769,1785.4405,1785.446433,1,53563215,53563392,177,0.07422459241117953
21770,1785.4529,1785.462933,1,53563587,53563887,300,0.14400926776744913
21771,1785.467633,1785.471033,1,53564028,53564130,102,
21772,1785.7858,1785.791967,1,53573574,53573759,185,0.6403281726430572
21773,1785.8207,1785.845933,1,53574621,53575377,756,0.659753231983114
21774,1785.847433,1785.862967,1,53575422,53575889,467,0.6466051116087886
21775,1785.897633,1785.903033,1,53576928,53577090,162,0.47728764156384285
21776,1785.907533,1785.926967,1,53577225,53577809,584,0.6898273698252361
21777,1785.944467,1785.966967,1,53578334,53579009,675,0.6205414916441312
21778,1786.013367,1786.031,1,53580401,53580930,529,0.5803659944219589
21779,1786.032533,1786.0516,1,53580975,53581548,573,0.6469104782027365
21780,1786.0663,1786.071067,1,53581989,53582132,143,0.46768221650051284
21781,1786.102533,1786.111667,1,53583075,53583350,275,0.4070966844908046
21782,1786.124167,1786.132733,1,53583725,53583981,256,0.23641499245304234
21783,1786.1351,1786.165033,1,53584053,53584950,897,0.24129692633027258
21784,1786.187433,1786.203733,1,53585622,53586111,489,0.7267649231296771
21785,1786.205267,1786.2734,1,53586158,53588202,2044,0.849108087275535
21786,1786.274533,1786.305133,1,53588235,53589153,918,0.8447485669456708
21787,1786.565767,1786.7333,1,53596973,53601999,5026,0.8107954766344289
21788,1786.772867,1786.868767,1,53603186,53606063,2877,0.8003301670439331
21789,1786.889933,1786.893667,1,53606697,53606810,113,
21790,1787.3517,1787.357633,1,53620551,53620728,177,0.6211053022181098
21791,1787.373733,1787.3775,1,53621211,53621325,114,0.3043683855670587
21792,1787.382567,1787.3925,1,53621477,53621775,298,0.8420313514672481
21793,1787.4245,1787.449567,1,53622735,53623487,752,0.8448711418080004
21794,1787.463133,1787.527733,1,53623893,53625831,1938,0.5044511016901928
21795,1787.5533,1787.5736,1,53626599,53627208,609,0.687549280462781
21796,1787.575267,1787.583733,1,53627258,53627511,253,0.4097169985079328
21797,1787.588,1787.6325,1,53627640,53628975,1335,0.6831014596403522
21798,1787.641867,1787.6471,1,53629256,53629413,157,0.5312005542781775
21799,1787.6568,1787.668933,1,53629704,53630067,363,0.675185566411828
21800,1787.669933,1787.6774,1,53630097,53630322,225,0.6421595516951734
21801,1787.695533,1787.700967,1,53630865,53631029,164,0.20300571438848283
21802,1787.728133,1787.7388,1,53631843,53632164,321,-0.002470865883711399
21803,1787.742133,1787.7455,1,53632263,53632365,102,0.16207054668759596
21804,1787.798567,1787.8037,1,53633957,53634111,154,0.13076945588396532
21805,1787.805067,1787.942533,1,53634152,53638275,4123,0.8472875386045792
21806,1788.218667,1788.333167,1,53646560,53649995,3435,0.7813569925515818
21807,1788.3587,1788.3947,1,53650761,53651841,1080,0.7301564471376335
21808,1788.4003,1788.5389,1,53652009,53656167,4158,0.767459288349099
21809,1788.543233,1788.561333,1,53656296,53656839,543,0.7681431056142056
21810,1788.563133,1788.580067,1,53656893,53657402,509,0.7016405431461986
21811,1788.622,1788.6319,1,53658660,53658957,297,0.09764724122779378
21812,1788.6333,1788.642033,1,53658999,53659260,261,0.5508114242257823
21813,1788.808367,1788.9063,1,53664251,53667189,2938,0.6293402435914306
21814,1788.911367,1788.927133,1,53667341,53667813,472,0.2185476833144864
21815,1788.950233,1788.969267,1,53668506,53669078,572,0.6047323651683992
21816,1788.993167,1789.002133,1,53669795,53670063,268,0.6425442027229952
21817,1789.011833,1789.0165,1,53670354,53670495,141,0.5060516097907307
21818,1789.049133,1789.060367,1,53671473,53671811,338,0.5735441659768005
21819,1789.061733,1789.0713,1,53671851,53672139,288,-0.10677171075910963
21820,1789.074567,1789.097733,1,53672237,53672931,694,0.05121842999273245
21821,1789.116933,1789.171567,1,53673507,53675147,1640,0.7651511938279956
21822,1789.1726,1789.176067,1,53675178,53675282,104,0.6609933426565914
21823,1789.179467,1789.2209,1,53675384,53676627,1243,0.8183308480173151
21824,1789.241767,1789.248367,1,53677253,53677451,198,-0.15380852371992312
21825,1789.250267,1789.254067,1,53677508,53677622,114,-0.0033329211108052053
21826,1789.255367,1789.2597,1,53677661,53677791,130,
21827,1789.2623,1789.265567,1,53677869,53677967,98,0.20036425152130283
21828,1789.267367,1789.284833,1,53678021,53678544,523,0.08689712747648282
21829,1789.313067,1789.430967,1,53679392,53682929,3537,0.8569146668304757
21830,1789.766133,1789.9927,1,53692983,53699781,6798,0.7345750291821838
21831,1790.0128,1790.219567,1,53700384,53706587,6203,0.7902650039283775
21832,1790.252133,1790.3324,1,53707563,53709972,2409,0.7369898956764789
21833,1791.052733,1791.060867,1,53731581,53731826,245,0.5975380863088517
21834,1791.065633,1791.074633,1,53731968,53732238,270,0.5719860756875643
21835,1791.1468,1791.155333,1,53734404,53734659,255,0.5442480371330868
21836,1791.178633,1791.184367,1,53735358,53735531,173,0.751182029359244
21837,1791.2816,1791.285433,1,53738448,53738562,114,0.5387039457947501
21838,1791.338233,1791.355667,1,53740146,53740670,524,0.6736134127806576
21839,1791.488867,1791.593233,1,53744666,53747796,3130,0.7926149736734432
21840,1791.602,1791.707233,1,53748060,53751216,3156,0.806357079984271
21841,1791.7325,1791.766633,1,53751975,53752998,1023,0.7455629269446729
21842,1791.769033,1791.7798,1,53753070,53753394,324,0.35802525059972984
21843,1791.795833,1791.7995,1,53753874,53753985,111,0.009872125884437193
21844,1792.020467,1792.023533,1,53760614,53760705,91,0.216644004221185
21845,1792.034267,1792.042367,1,53761028,53761271,243,0.8668812075861315
21846,1792.0466,1792.139033,1,53761398,53764170,2772,0.792274541662444
21847,1792.1766,1792.307867,1,53765298,53769236,3938,0.721071142529413
21848,1792.3192,1792.3249,1,53769576,53769747,171,-0.09547695131012748
21849,1792.506167,1792.5575,1,53775185,53776725,1540,0.7543200534511433
21850,1792.568,1792.579267,1,53777040,53777378,338,0.744208587385393
21851,1792.592333,1792.610467,1,53777769,53778314,545,0.8678304319563587
21852,1792.6133,1792.617,1,53778399,53778510,111,0.6814478416698093
21853,1792.6362,1792.6436,1,53779086,53779308,222,-0.2565735226778987
21854,1792.866267,1793.071633,1,53785988,53792148,6160,0.6610086637651718
21855,1797.343233,1797.348267,1,53920296,53920448,152,-0.07631068476861624
21856,1805.6586,1805.6629,1,54169758,54169887,129,-0.11154444053329249
21857,1805.663933,1805.669233,1,54169917,54170076,159,0.42456104688504104
21858,1805.673233,1805.6913,1,54170196,54170739,543,0.6023075517162855
21859,1805.709167,1805.715867,1,54171275,54171476,201,0.4149028697488865
21860,1805.717633,1805.7683,1,54171528,54173049,1521,0.30321162298316673
21861,1805.7729,1805.820867,1,54173187,54174626,1439,0.4738667141743823
21862,1805.827933,1805.8814,1,54174837,54176442,1605,0.45712653196826575
21863,1806.032633,1806.037833,1,54180978,54181134,156,0.5248303385798183
21864,1806.350867,1806.3551,1,54190526,54190653,127,0.04171896952130034
21865,1806.359267,1806.3626,1,54190778,54190878,100,0.1253017521051551
21866,1837.987733,1838.0013,1,55139631,55140039,408,0.16987696800106064
21867,1838.003267,1838.007167,1,55140098,55140215,117,0.035390934342359806
21868,1838.0144,1838.023433,1,55140432,55140702,270,0.03530725236338378
21869,1838.024533,1838.031067,1,55140735,55140932,197,0.33332099814478466
21870,1838.033033,1838.063433,1,55140990,55141902,912,0.27360097858550536
21871,1838.094633,1838.109033,1,55142838,55143270,432,0.3227527979572987
21872,1838.113567,1838.1246,1,55143407,55143738,331,0.04028876393924543
21873,1838.131133,1838.1478,1,55143933,55144434,501,0.17232297084938508
21874,1838.153267,1838.1672,1,55144598,55145016,418,0.26142031215316286
21875,1838.197467,1838.207633,1,55145924,55146228,304,0.282260058231522
21876,1838.222867,1838.2291,1,55146686,55146873,187,0.5409997264501981
21877,1838.2508,1838.261,1,55147524,55147830,306,0.29999164911148024
21878,1838.683333,1838.7128,1,55160499,55161384,885,0.19774092103741214
21879,1838.844767,1838.859033,1,55165343,55165770,427,0.0668173148415663
21880,1838.865667,1838.873067,1,55165970,55166192,222,0.29711897275854127
21881,1838.874133,1838.8773,1,55166223,55166319,96,
21882,1838.883833,1838.903067,1,55166514,55167092,578,0.1944874183731525
21883,1838.905967,1838.921467,1,55167179,55167644,465,0.2551411455560671
21884,1838.926833,1838.959267,1,55167804,55168778,974,0.020858785796955704
21885,1838.9712,1838.980833,1,55169136,55169424,288,-0.12005651498104476
21886,1838.981833,1838.985233,1,55169454,55169556,102,0.5931375451072609
21887,1838.9922,1839.031833,1,55169766,55170954,1188,0.1140692942134155
21888,1839.043067,1839.058933,1,55171292,55171767,475,0.014182922672227352
21889,1839.062167,1839.078,1,55171865,55172340,475,0.06817165153627938
21890,1839.135833,1839.1671,1,55174074,55175013,939,0.20247891080264663
21891,1839.168267,1839.182867,1,55175048,55175486,438,0.23701400155145025
21892,1839.1897,1839.210667,1,55175691,55176320,629,0.01808847894516226
21893,1839.220367,1839.223433,1,55176611,55176702,91,
21894,1841.2233,1841.2372,1,55236699,55237116,417,0.37585620313992235
21895,1841.238833,1841.2657,1,55237164,55237971,807,0.2705987720189743
21896,1841.267167,1841.276067,1,55238015,55238282,267,0.20651689681184873
21897,1841.292933,1841.300967,1,55238787,55239029,242,-0.03211077820880493
21898,1841.3053,1841.309067,1,55239159,55239272,113,-0.11712247803252
21899,1841.3218,1841.358967,1,55239654,55240769,1115,0.05680583671441824
21900,1841.451133,1841.482433,1,55243533,55244472,939,0.02809599099505856
21901,1841.488267,1841.491733,1,55244648,55244751,103,-0.08905925939470528
21902,1841.493733,1841.4995,1,55244811,55244985,174,0.24137344217611958
21903,1841.513967,1841.5224,1,55245419,55245672,253,0.2598246697707893
21904,1841.5238,1841.527133,1,55245714,55245813,99,0.0425330148744464
21905,1841.5578,1841.6099,1,55246734,55248297,1563,0.5769026485171007
21906,1841.664367,1841.671333,1,55249931,55250139,208,0.5987177321517855
21907,1841.774333,1841.784967,1,55253229,55253549,320,0.17347768953778903
21908,1841.792567,1841.8191,1,55253777,55254573,796,0.22456868975595592
21909,1841.830633,1841.866967,1,55254918,55256009,1091,0.22421433015899137
21910,1843.911,1843.915633,1,55317330,55317468,138,0.05546993687266491
21911,1845.543733,1845.5556,1,55366311,55366668,357,0.11960383563381413
21912,1845.5881,1845.6024,1,55367643,55368072,429,0.3334137050728529
21913,1845.6997,1845.745933,1,55370991,55372377,1386,0.1437072983216241
21914,1845.747067,1845.760433,1,55372412,55372812,400,0.0012377722326459904
21915,1845.765667,1845.7809,1,55372970,55373427,457,-0.11873096180958755
21916,1845.828833,1845.834067,1,55374864,55375022,158,0.23379908202326807
21917,1845.843467,1845.9086,1,55375304,55377258,1954,0.04314088958639192
21918,1845.921733,1845.928133,1,55377651,55377843,192,-0.08897683087619332
21919,1845.937467,1845.9521,1,55378124,55378563,439,-0.07542121043895623
21920,1845.958533,1845.972,1,55378755,55379160,405,-0.08881371652498803
21921,1845.9843,1845.990933,1,55379529,55379727,198,-0.15994721961541533
21922,1845.992867,1846.020733,1,55379786,55380621,835,-0.08933976685206906
21923,1846.045933,1846.064167,1,55381377,55381925,548,-0.07818716089695514
21924,1846.071567,1846.083633,1,55382147,55382508,361,-0.07142263341216616
21925,1846.093633,1846.109267,1,55382808,55383278,470,-0.08383497113461892
21926,1846.119067,1846.135233,1,55383572,55384056,484,-0.08646615799686495
21927,1846.1376,1846.145467,1,55384128,55384364,236,-0.09669838596200951
21928,1846.164567,1846.180867,1,55384937,55385426,489,0.01897584249904033
21929,1846.184867,1846.197567,1,55385546,55385927,381,-0.09319391796343
21930,1846.205167,1846.2623,1,55386155,55387869,1714,-0.028414264268444935
21931,1846.2668,1846.2698,1,55388004,55388094,90,
21932,1846.288267,1846.2943,1,55388648,55388829,181,-0.17557298461427848
21933,1846.316067,1846.319067,1,55389482,55389572,90,0.27644125700319033
21934,1846.320367,1846.335433,1,55389611,55390062,451,0.1529215703703055
21935,1846.349367,1846.353067,1,55390481,55390592,111,
21936,1846.354267,1846.397867,1,55390628,55391936,1308,0.055588494059553066
21937,1846.404833,1846.413033,1,55392144,55392390,246,-0.04784351693775034
21938,1846.422933,1846.4343,1,55392687,55393029,342,0.0341125322630774
21939,1846.439467,1846.447167,1,55393184,55393415,231,
21940,1846.470533,1846.4806,1,55394115,55394418,303,0.2876119206315468
21941,1846.916833,1846.923233,1,55407504,55407696,192,
21942,1846.950733,1846.9698,1,55408521,55409094,573,0.17162717943935857
21943,1846.971033,1846.9947,1,55409130,55409841,711,0.35772542949902447
21944,1847.012767,1847.021633,1,55410383,55410648,265,-0.07272599756103604
21945,1847.027533,1847.033933,1,55410825,55411017,192,-0.06788187173408522
21946,1847.0436,1847.078767,1,55411308,55412363,1055,0.06272222609182719
21947,1855.9264,1855.936033,1,55677792,55678080,288,0.6550310120657103
21948,1855.943833,1855.948667,1,55678314,55678460,146,0.14754472556657866
21949,1855.986133,1856.007867,1,55679583,55680236,653,0.42628226118969853
21950,1856.085133,1856.1088,1,55682553,55683264,711,0.1537873996920782
21951,1856.110033,1856.2146,1,55683300,55686438,3138,0.02726539469250868
21952,1856.2217,1856.239167,1,55686651,55687175,524,-0.025633564723469376
21953,1856.2432,1856.259567,1,55687296,55687787,491,-0.07510330318346864
21954,1856.271367,1856.289867,1,55688141,55688696,555,-0.05494570908864215
21955,1856.2937,1856.3185,1,55688811,55689555,744,-0.06733297591480097
21956,1856.3273,1856.3534,1,55689819,55690602,783,0.08696854969843909
21957,1856.355167,1856.367533,1,55690655,55691025,370,-0.06052055598629488
21958,1856.3767,1856.394367,1,55691301,55691831,530,0.09714026995418015
21959,1856.3955,1856.4175,1,55691865,55692525,660,-0.05991922881622734
21960,1856.427967,1856.470467,1,55692839,55694114,1275,0.0371744626294839
21961,1856.4819,1856.504233,1,55694457,55695126,669,-0.012695985616628058
21962,1856.5053,1856.521433,1,55695159,55695642,483,-0.06774418216296299
21963,1856.538933,1856.577433,1,55696167,55697322,1155,0.024295710234541162
21964,1856.587533,1856.605067,1,55697625,55698152,527,-0.06602942437176895
21965,1856.607133,1856.624767,1,55698213,55698743,530,-0.029023380901110268
21966,1856.643167,1856.664333,1,55699295,55699929,634,-0.006598519191435423
21967,1856.677867,1856.693533,1,55700336,55700805,469,-0.03151427758791415
21968,1856.711767,1856.724667,1,55701353,55701740,387,-0.09499756050581863
21969,1856.729167,1856.7419,1,55701875,55702257,382,0.29961086087871763
21970,1856.7463,1856.762767,1,55702389,55702883,494,0.23893449265439318
21971,1856.7755,1856.788767,1,55703265,55703663,398,-0.0038051654556064307
21972,1856.796633,1856.8523,1,55703898,55705569,1671,0.09807046016204626
21973,1856.8559,1856.878,1,55705677,55706340,663,0.06053953924025882
21974,1856.9036,1856.908933,1,55707108,55707267,159,-0.0033951189644874434
21975,1856.927667,1856.931067,1,55707830,55707932,102,0.093828984378398
21976,1856.972,1856.9978,1,55709160,55709934,774,0.27647715902247716
21977,1857.033133,1857.042867,1,55710993,55711286,293,-0.20388647821113162
21978,1857.061,1857.073033,1,55711830,55712190,360,-0.21853101573511266
21979,1857.322033,1857.3384,1,55719660,55720152,492,0.24113577652354326
21980,1857.409467,1857.415133,1,55722284,55722453,169,-0.037161173171147754
21981,1857.419667,1857.4241,1,55722590,55722723,133,
21982,1857.4284,1857.457567,1,55722852,55723727,875,0.2831139352002399
21983,1857.507333,1857.517567,1,55725219,55725527,308,0.17534191505716382
21984,1857.552967,1857.561533,1,55726589,55726845,256,0.09275822149074459
21985,1857.562633,1857.565933,1,55726878,55726977,99,-0.19201659552683792
21986,1857.667067,1857.682333,1,55730012,55730469,457,0.45566722021387335
21987,1857.683667,1857.692767,1,55730510,55730783,273,0.5159626345403312
21988,1857.7254,1857.748,1,55731762,55732440,678,0.10778397225266416
21989,1857.7602,1857.763933,1,55732806,55732917,111,
21990,1857.7654,1857.774133,1,55732962,55733223,261,0.5284533210781549
21991,1857.7822,1857.796,1,55733466,55733880,414,0.35061889803320473
21992,1857.8042,1857.814867,1,55734126,55734446,320,0.12450191109531956
21993,1858.757033,1858.760867,1,55762710,55762826,116,0.35841219783746386
21994,1892.5473,1892.551667,1,56776419,56776550,131,0.39969818580873456
21995,1892.768433,1892.775933,1,56783052,56783277,225,0.41105026465226163
21996,1892.777067,1892.794667,1,56783312,56783840,528,0.6395358285650363
21997,1892.796033,1892.8015,1,56783880,56784045,165,0.39183062685567527
21998,1892.8407,1892.846167,1,56785221,56785385,164,0.5384434304918948
21999,1892.851733,1892.874867,1,56785551,56786246,695,0.7452256403097246
22000,1892.896167,1892.9073,1,56786885,56787219,334,0.7092748627504752
22001,1893.0868,1893.0914,1,56792604,56792742,138,0.39678172797114636
22002,1893.352467,1893.3582,1,56800574,56800746,172,0.389056027430379
22003,1893.568867,1893.581333,1,56807066,56807439,373,0.5638583996519904
22004,1893.611467,1893.625733,1,56808344,56808771,427,0.3234866560570124
22005,1893.626767,1893.6344,1,56808803,56809032,229,0.13008545447895525
22006,1893.635567,1893.641667,1,56809067,56809250,183,
22007,1893.661067,1893.664067,1,56809832,56809922,90,-0.08629257828305444
22008,1893.667467,1893.671,1,56810024,56810130,106,
22009,1893.672967,1893.705233,1,56810189,56811156,967,0.21643502129642953
22010,1893.8365,1893.841967,1,56815095,56815259,164,0.038409838572503865
22011,1894.7148,1894.720433,1,56841444,56841612,168,0.11573535097266129
22012,1894.7246,1894.7346,1,56841738,56842038,300,0.4787010324356224
22013,1894.7357,1894.742533,1,56842071,56842275,204,-0.1080015631479887
22014,1894.758833,1894.762733,1,56842764,56842881,117,
22015,1894.770333,1894.7841,1,56843109,56843523,414,0.055494811438559465
22016,1894.881267,1894.8855,1,56846438,56846565,127,0.6196128428636848
22017,1905.270533,1905.287333,1,57158115,57158619,504,-0.0647793680950795
22018,1905.289067,1905.3211,1,57158672,57159633,961,0.24136661036076554
22019,1905.386733,1905.4014,1,57161601,57162042,441,0.044405824488950765
22020,1905.404233,1905.415367,1,57162126,57162461,335,-0.08171866635346056
22021,1905.419967,1905.4435,1,57162599,57163305,706,-0.0753953659948354
22022,1905.445167,1905.4504,1,57163355,57163512,157,-0.2567981981882436
22023,1905.460233,1905.468033,1,57163806,57164040,234,0.13167165992656993
22024,1905.469333,1905.499333,1,57164079,57164979,900,0.06967278167105002
22025,1905.505067,1905.5237,1,57165152,57165711,559,0.009484754529447852
22026,1905.524833,1905.560033,1,57165744,57166800,1056,0.12062050831869736
22027,1905.568467,1905.5813,1,57167054,57167439,385,-0.07872251876958691
22028,1905.588067,1905.6734,1,57167642,57170202,2560,0.18230850992069736
22029,1905.680367,1905.6921,1,57170411,57170763,352,0.2424689421933114
22030,1905.702367,1905.705633,1,57171071,57171168,97,
22031,1905.7925,1905.7961,1,57173775,57173883,108,
22032,1907.635833,1907.663733,1,57229074,57229911,837,0.19558733578773863
22033,1907.6716,1907.6751,1,57230148,57230253,105,0.30396097969446445
22034,1907.697733,1907.706967,1,57230931,57231209,278,-0.1107159355724548
22035,1907.745867,1907.7789,1,57232376,57233367,991,0.6801684022104714
22036,1917.578933,1917.587533,1,57527367,57527625,258,0.5013372916444233
22037,1917.966433,1917.995167,1,57538992,57539855,863,0.12297985351685228
22038,1918.002433,1918.0069,1,57540072,57540207,135,
22039,1918.008767,1918.016033,1,57540263,57540480,217,0.09465227163886503
22040,1918.0298,1918.046333,1,57540894,57541389,495,0.04286404633162687
22041,1918.0746,1918.0781,1,57542238,57542343,105,
22042,1918.098367,1918.1456,1,57542951,57544368,1417,0.1259156552794842
22043,1918.153333,1918.187767,1,57544599,57545633,1034,0.14337721374855764
22044,1918.1898,1918.2043,1,57545694,57546129,435,0.2694491086598896
22045,1918.2479,1918.2581,1,57547437,57547743,306,0.05055990205281135
22046,1918.276767,1918.282467,1,57548303,57548474,171,-0.4328848567440361
22047,1918.284733,1918.295633,1,57548541,57548868,327,0.16937491906035274
22048,1918.931733,1918.935867,1,57567951,57568076,125,-0.42028670833668447
22049,1918.938067,1918.9431,1,57568142,57568293,151,-0.16417219544020523
22050,1920.384933,1920.393433,1,57611547,57611802,255,-0.0005590889838782505
22051,1920.3951,1920.403867,1,57611853,57612116,263,0.4045762573436157
22052,1920.4107,1920.452933,1,57612321,57613587,1266,0.008609146418902178
22053,1920.454667,1920.4584,1,57613640,57613752,112,-0.1878769576745752
22054,1920.4699,1920.5346,1,57614097,57616038,1941,0.07797817678858555
22055,1920.5394,1920.547833,1,57616182,57616434,252,0.07588282689237118
22056,1920.938333,1920.941833,1,57628149,57628254,105,0.2245333670978497
22057,1921.072067,1921.0753,1,57632162,57632259,97,
22058,1921.0903,1921.097433,1,57632709,57632922,213,0.0015387285201325207
22059,1921.196567,1921.2409,1,57635897,57637227,1330,0.41027279893703045
22060,1921.246667,1921.253567,1,57637400,57637607,207,0.02001524682757529
22061,1921.2589,1921.292233,1,57637767,57638766,999,-0.05398581951482661
22062,1921.295767,1921.313733,1,57638873,57639411,538,0.11686623380333722
22063,1921.319133,1921.364933,1,57639573,57640947,1374,-0.011086945832789954
22064,1921.388933,1921.394333,1,57641667,57641829,162,0.029312026404943632
22065,1921.397033,1921.432967,1,57641910,57642989,1079,0.09973367303578727
22066,1921.4374,1921.460867,1,57643122,57643826,704,0.37288240130476713
22067,1921.4659,1921.496,1,57643977,57644880,903,0.043948367632925214
22068,1921.5009,1921.5609,1,57645027,57646827,1800,0.14631676116698855
22069,1921.567767,1921.610167,1,57647033,57648305,1272,0.0780498034580536
22070,1921.616333,1921.619733,1,57648489,57648591,102,-0.17885911223776751
22071,1921.648867,1921.6673,1,57649466,57650019,553,0.05101727457772026
22072,1921.676067,1921.7014,1,57650282,57651042,760,-0.08700959069482354
22073,1921.704733,1921.7082,1,57651141,57651246,105,-0.16285947071452483
22074,1921.733967,1921.7413,1,57652019,57652239,220,0.18990565465003106
22075,1921.811533,1921.821833,1,57654345,57654654,309,0.15318159970976805
22076,1921.831067,1921.840233,1,57654932,57655206,274,-0.14368826664668927
22077,1921.851933,1921.856567,1,57655557,57655697,140,0.01721777270753508
22078,1921.991667,1921.9997,1,57659750,57659991,241,-0.0032528611906817253
22079,1922.0023,1922.024,1,57660069,57660720,651,0.2936157061684378
22080,1922.0281,1922.0518,1,57660843,57661554,711,0.0977465532737763
22081,1922.156067,1922.179267,1,57664682,57665378,696,-0.015554453982396682
22082,1922.3089,1922.340933,1,57669267,57670227,960,-0.00782797734760446
22083,1922.347533,1922.3792,1,57670425,57671376,951,-0.06114054533201702
22084,1922.389433,1922.431033,1,57671682,57672930,1248,-0.0873952582423114
22085,1922.475333,1922.5082,1,57674259,57675246,987,-0.013936339247201855
22086,1922.522133,1922.546233,1,57675663,57676386,723,-0.029475105531800043
22087,1922.5601,1922.5876,1,57676803,57677628,825,-0.03611923766265588
22088,1922.627067,1922.636633,1,57678812,57679098,286,-0.04816026931301757
22089,1922.641267,1922.6757,1,57679238,57680271,1033,-0.016441636008275133
22090,1922.689333,1922.713867,1,57680679,57681416,737,0.011825549881207091
22091,1922.730767,1922.757533,1,57681923,57682725,802,-0.01645220264782739
22092,1922.773367,1922.800467,1,57683201,57684014,813,0.029974640328341372
22093,1922.839467,1922.848867,1,57685184,57685466,282,0.38605814112129916
22094,1922.863367,1922.887,1,57685901,57686610,709,-0.05177523168141273
22095,1922.902667,1922.9318,1,57687080,57687954,874,0.03864888221430844
22096,1922.995267,1923.0288,1,57689858,57690864,1006,-0.09483563609232898
22097,1923.045,1923.068933,1,57691350,57692067,717,0.06815411447155965
22098,1923.090333,1923.113733,1,57692709,57693411,702,0.035627862685109674
22099,1923.165467,1923.1696,1,57694964,57695088,124,0.4188844593728891
22100,1923.2693,1923.296833,1,57698079,57698904,825,-0.018456567094454347
22101,1923.3206,1923.347667,1,57699618,57700430,812,0.29293941149243474
22102,1923.3644,1923.394967,1,57700932,57701849,917,0.04681993135194167
22103,1923.4138,1923.445833,1,57702414,57703374,960,0.007471262875888519
22104,1923.456067,1923.5445,1,57703682,57706335,2653,0.13986038199254755
22105,1923.5522,1923.588967,1,57706566,57707669,1103,0.0516984343026166
22106,1923.590367,1923.5945,1,57707711,57707835,124,
22107,1923.605767,1923.69,1,57708173,57710700,2527,0.1952180173837472
22108,1923.6933,1923.696867,1,57710799,57710906,107,0.29285700759411754
22109,1923.702367,1923.74,1,57711071,57712200,1129,-0.09522924770248696
22110,1923.761133,1923.7821,1,57712833,57713463,630,-0.029501047096724093
22111,1924.244933,1924.271067,1,57727347,57728132,785,0.100957562057379
22112,1924.272067,1924.281767,1,57728162,57728453,291,0.5458232595888218
22113,1924.298833,1924.303833,1,57728964,57729114,150,
22114,1924.305067,1924.316667,1,57729152,57729500,348,0.041162818760705815
22115,1924.320533,1924.326867,1,57729615,57729806,191,0.014485941802312345
22116,1924.345433,1924.353267,1,57730362,57730598,236,0.21533729157136275
22117,1924.3643,1924.3683,1,57730929,57731049,120,-0.0449619754371747
22118,1924.3923,1924.396767,1,57731769,57731903,134,0.02242531049964883
22119,1924.406133,1924.410133,1,57732183,57732303,120,0.2576481630351174
22120,1925.065333,1925.070667,1,57751959,57752120,161,-0.25908213302957367
22121,1925.0885,1925.0976,1,57752655,57752928,273,-0.024967845312785095
22122,1925.215,1925.2208,1,57756450,57756624,174,0.1245434686927104
22123,1925.3123,1925.3362,1,57759369,57760086,717,0.05652754727111607
22124,1925.339833,1925.467,1,57760194,57764010,3816,0.17244625487396262
22125,1925.6391,1925.643,1,57769173,57769290,117,-0.23198982840178156
22126,1925.961867,1926.0112,1,57778856,57780336,1480,0.3797029331665997
22127,1926.016433,1926.0228,1,57780492,57780684,192,0.21655083482449375
22128,1926.631067,1926.634467,1,57798932,57799034,102,0.2013692688271892
22129,1926.6398,1926.658367,1,57799194,57799751,557,0.825706092258288
22130,1926.6597,1926.752533,1,57799791,57802575,2784,0.8344174351292128
22131,1927.941367,1927.986333,1,57838241,57839589,1348,0.09900178139680653
22132,1927.987533,1927.9922,1,57839625,57839766,141,-0.10590127078884062
22133,1927.999133,1928.044967,1,57839973,57841349,1376,0.24296800226265197
22134,1928.112967,1928.1419,1,57843389,57844257,868,-0.07481832986660161
22135,1928.142933,1928.159333,1,57844287,57844779,492,0.08765090753826062
22136,1928.165267,1928.181533,1,57844958,57845445,487,0.07665788529327142
22137,1928.184467,1928.2319,1,57845534,57846957,1423,0.5760900260290052
22138,1928.240733,1928.290833,1,57847221,57848724,1503,0.06525588904106912
22139,1928.4566,1928.467167,1,57853698,57854015,317,-0.11698502835965707
22140,1928.468467,1928.481433,1,57854054,57854442,388,0.06919053468437815
22141,1928.482733,1928.4919,1,57854481,57854757,276,0.180823057990702
22142,1928.542867,1928.546067,1,57856286,57856382,96,-0.16699229565944748
22143,1928.559633,1928.569033,1,57856788,57857070,282,-0.0838295594524744
22144,1928.5902,1928.5975,1,57857706,57857925,219,0.19028593770625252
22145,1928.608867,1928.629867,1,57858266,57858896,630,0.051378799094067694
22146,1928.6654,1928.674067,1,57859962,57860222,260,0.31950067201775484
22147,1928.9831,1929.090833,1,57869493,57872724,3231,0.7611772109564157
22148,1929.678367,1929.795567,1,57890351,57893867,3516,0.8781528116892489
22149,1930.228533,1930.2342,1,57906855,57907026,171,0.6033985024472094
22150,1930.248167,1930.261567,1,57907445,57907847,402,0.6300569869767151
22151,1930.262567,1930.279067,1,57907877,57908372,495,0.4966268113904914
22152,1930.291833,1930.309433,1,57908754,57909282,528,0.7565753256045319
22153,1930.323367,1930.3272,1,57909701,57909816,115,0.7922386451460341
22154,1930.3302,1930.341267,1,57909906,57910238,332,0.5070168968719182
22155,1930.347067,1930.37,1,57910412,57911100,688,0.726380266870854
22156,1930.3893,1930.409567,1,57911679,57912287,608,0.6095238470245542
22157,1930.410767,1930.435733,1,57912323,57913071,748,0.6087052564126619
22158,1930.441167,1930.502633,1,57913235,57915078,1843,0.6859210222693407
22159,1930.508433,1930.5181,1,57915252,57915543,291,0.7718596527320108
22160,1930.530067,1930.536333,1,57915902,57916089,187,0.4813489257693702
22161,1930.542267,1930.552967,1,57916268,57916589,321,0.619336535554528
22162,1930.557467,1930.5688,1,57916724,57917064,340,0.5093428812113021
22163,1930.6209,1930.6269,1,57918627,57918807,180,0.12757610537531303
22164,1930.6326,1930.639967,1,57918978,57919199,221,0.2642716272522125
22165,1930.865233,1930.868233,1,57925956,57926046,90,
22166,1930.987333,1930.991633,1,57929619,57929748,129,0.496093874631235
22167,1931.001767,1931.1531,1,57930053,57934593,4540,0.8238024865542308
22168,1931.159233,1931.25,1,57934776,57937500,2724,0.851464124037484
22169,1931.279133,1931.357267,1,57938373,57940718,2345,0.7955363422510497
22170,1931.892067,1931.9006,1,57956762,57957018,256,0.6108386497611569
22171,1931.9616,1931.972033,1,57958848,57959160,312,0.7622638851744544
22172,1932.012033,1932.0376,1,57960360,57961128,768,0.8616753693571414
22173,1932.051833,1932.1134,1,57961554,57963402,1848,0.8316565219784127
22174,1932.140833,1932.165167,1,57964224,57964955,731,0.772180459136789
22175,1932.606233,1932.610733,1,57978186,57978321,135,0.7769621482789685
22176,1932.6152,1932.622067,1,57978456,57978662,206,0.5715217496963568
22177,1932.650933,1932.6897,1,57979527,57980691,1164,0.5776775978564929
22178,1932.722167,1932.739233,1,57981665,57982176,511,0.6258769673844679
22179,1932.7409,1932.7494,1,57982227,57982482,255,0.36945923514162016
22180,1932.754267,1932.7958,1,57982628,57983874,1246,0.7143191490794646
22181,1932.8033,1932.8076,1,57984099,57984228,129,0.4586907925970103
22182,1932.815867,1932.836533,1,57984476,57985095,619,0.6685274465029565
22183,1932.9622,1933.096,1,57988866,57992880,4014,0.8316148244611549
22184,1933.531333,1933.537067,1,58005939,58006112,173,0.5127043264972456
22185,1933.5569,1933.586467,1,58006707,58007594,887,0.8684831885639447
22186,1933.589567,1933.642633,1,58007687,58009278,1591,0.7854680210158097
22187,1933.6506,1933.705033,1,58009518,58011150,1632,0.8392053479335194
22188,1933.707033,1933.7173,1,58011210,58011519,309,0.5332041697007123
22189,1933.7442,1933.831367,1,58012326,58014941,2615,0.8163251085319235
22190,1933.8381,1933.866833,1,58015143,58016004,861,0.6719974774812782
22191,1933.889467,1933.998867,1,58016684,58019966,3282,0.827175773745692
22192,1934.457533,1934.646133,1,58033725,58039383,5658,0.8344185222581882
22193,1934.6689,1934.6843,1,58040067,58040529,462,0.8475550969155227
22194,1934.698867,1934.785333,1,58040966,58043559,2593,0.762961729680345
22195,1935.2463,1935.303667,1,58057389,58059110,1721,0.780662922462286
22196,1935.320767,1935.3461,1,58059623,58060383,760,0.8399137328603817
22197,1935.347467,1935.415467,1,58060424,58062464,2040,0.6359973766007384
22198,1935.424733,1935.444667,1,58062741,58063340,599,0.619735292956888
22199,1935.446067,1935.467133,1,58063382,58064013,631,0.5114043570270157
22200,1935.497533,1935.504033,1,58064925,58065120,195,0.5650025703689449
22201,1935.506133,1935.528433,1,58065183,58065852,669,0.595498335821977
22202,1935.544767,1935.561067,1,58066343,58066832,489,0.4943233134576901
22203,1935.605967,1935.624933,1,58068179,58068747,568,0.6120180546199792
22204,1935.640567,1935.648233,1,58069217,58069446,229,0.6610846181240968
22205,1935.655667,1935.6815,1,58069670,58070445,775,0.7045559713232384
22206,1935.7056,1935.7113,1,58071168,58071339,171,-0.0243862570092021
22207,1936.0707,1936.078,1,58082121,58082340,219,0.5151584075717267
22208,1936.080567,1936.238167,1,58082417,58087145,4728,0.8258291738830243
22209,1936.246867,1936.272067,1,58087406,58088162,756,0.6357642101986283
22210,1936.273667,1936.2916,1,58088210,58088748,538,0.7291817395882425
22211,1936.2947,1936.4365,1,58088841,58093095,4254,0.7479538045033899
22212,1936.831933,1936.835067,1,58104957,58105052,95,0.7867605779408531
22213,1936.836767,1936.856133,1,58105103,58105683,580,0.6649164077664392
22214,1936.8651,1936.8726,1,58105953,58106178,225,0.6536145292345032
22215,1936.8746,1936.884067,1,58106238,58106522,284,0.5956675789227192
22216,1936.8887,1936.9602,1,58106661,58108806,2145,0.8006557232711536
22217,1936.965333,1936.968433,1,58108959,58109052,93,-0.04423029206744741
22218,1937.3936,1937.497367,1,58121808,58124921,3113,0.8358698386472475
22219,1937.883833,1937.8908,1,58136514,58136724,210,0.660834083156647
22220,1937.894067,1937.915267,1,58136822,58137458,636,0.5489819158964758
22221,1937.926633,1938.027067,1,58137798,58140812,3014,0.8484488427255461
22222,1939.168333,1939.175933,1,58175049,58175277,228,0.6509752948547167
22223,1939.1784,1939.1831,1,58175352,58175493,141,0.43420330599309764
22224,1939.186567,1939.198233,1,58175597,58175946,349,0.509867375120242
22225,1939.200567,1939.205267,1,58176017,58176158,141,0.5910542003986518
22226,1939.250567,1939.268333,1,58177517,58178049,532,0.7837208457359571
22227,1939.299067,1939.304033,1,58178972,58179120,148,0.5563229599023035
22228,1939.308733,1939.3525,1,58179261,58180575,1314,0.6412674147857932
22229,1939.370367,1939.376833,1,58181111,58181304,193,0.7863190619398066
22230,1939.3801,1939.3898,1,58181403,58181694,291,0.6539079470900053
22231,1939.3953,1939.4159,1,58181859,58182477,618,0.6424098554372031
22232,1939.427967,1939.4313,1,58182839,58182939,100,0.12590796772536203
22233,1939.4328,1939.478467,1,58182984,58184354,1370,0.6415775316414657
22234,1939.498667,1939.516233,1,58184960,58185486,526,0.7119871561432677
22235,1939.534433,1939.548067,1,58186032,58186442,410,0.8018615569036706
22236,1939.556533,1939.572433,1,58186695,58187172,477,0.6727856876096253
22237,1940.024733,1940.029433,1,58200741,58200882,141,0.3640805730458112
22238,1940.0323,1940.174733,1,58200969,58205241,4272,0.7804231510839837
22239,1940.1829,1940.367267,1,58205487,58211018,5531,0.8170961493241621
22240,1940.371067,1940.391233,1,58211132,58211736,604,0.7202135390207782
22241,1940.394733,1940.4475,1,58211841,58213425,1584,0.7747917853116482
22242,1940.4676,1940.4718,1,58214028,58214154,126,0.13812652794704353
22243,1940.880467,1940.884033,1,58226414,58226520,106,0.43579506699753395
22244,1940.905567,1940.9308,1,58227167,58227924,757,0.7327575582627784
22245,1940.942833,1940.9803,1,58228284,58229409,1125,0.877837531160385
22246,1940.9839,1941.037967,1,58229517,58231139,1622,0.6955884327726314
22247,1941.041,1941.117267,1,58231230,58233518,2288,0.7937359465949934
22248,1941.120467,1941.1952,1,58233614,58235856,2242,0.7424765184621613
22249,1941.197767,1941.303133,1,58235933,58239093,3160,0.806241746431456
22250,1941.304133,1941.3258,1,58239123,58239774,651,0.5232143376261289
22251,1941.347967,1941.359433,1,58240439,58240782,343,0.16892680796294496
22252,1941.7262,1941.8766,1,58251786,58256298,4512,0.8126500646015616
22253,1941.889467,1941.9398,1,58256684,58258194,1510,0.8033706972536999
22254,1941.960333,1941.9859,1,58258809,58259577,768,0.7308201287114569
22255,1941.989833,1942.0486,1,58259694,58261458,1764,0.7916351045202927
22256,1942.052633,1942.069433,1,58261578,58262082,504,0.728386048222577
22257,1942.074233,1942.158467,1,58262226,58264754,2528,0.7944514391264472
22258,1942.1761,1942.1796,1,58265283,58265388,105,0.156336135818865
22259,1942.540867,1942.545833,1,58276226,58276374,148,0.07619948111152451
22260,1942.5481,1942.5582,1,58276443,58276746,303,0.649606111948857
22261,1942.559267,1942.6121,1,58276778,58278363,1585,0.7954703098045801
22262,1942.622467,1942.6408,1,58278674,58279224,550,-0.014640757160975253
22263,1942.991967,1943.040867,1,58289759,58291226,1467,0.6016368966998278
22264,1943.042367,1943.116567,1,58291271,58293497,2226,0.8123302402750944
22265,1943.547367,1943.553067,1,58306421,58306592,171,0.7268558275484792
22266,1943.5582,1943.704233,1,58306746,58311126,4380,0.8224608200381556
22267,1943.7062,1943.715933,1,58311186,58311477,291,0.13356889129693342
22268,1943.7836,1943.8754,1,58313508,58316262,2754,0.8239861037555769
22269,1943.900567,1943.9053,1,58317017,58317159,142,0.5952869979373941
22270,1944.181367,1944.277533,1,58325441,58328325,2884,0.7717550018020739
22271,1944.288233,1944.362433,1,58328646,58330872,2226,0.5338725340743286
22272,1944.3644,1944.445233,1,58330932,58333356,2424,0.7297724109958704
22273,1944.452,1944.5084,1,58333560,58335252,1692,0.6929078160409217
22274,1944.525333,1944.541267,1,58335759,58336238,479,0.08717346673112542
22275,1944.5556,1944.562133,1,58336668,58336863,195,-0.1428535528040303
22276,1944.873967,1944.8823,1,58346219,58346469,250,0.5885983933330861
22277,1944.883767,1944.902033,1,58346513,58347060,547,0.8290516100880806
22278,1944.9042,1945.0932,1,58347126,58352796,5670,0.824761802604878
22279,1945.111533,1945.243067,1,58353345,58357292,3947,0.7480629647355043
22280,1945.283167,1945.286667,1,58358495,58358600,105,-0.04638818178152855
22281,1945.293367,1945.299067,1,58358801,58358972,171,0.46814522040460455
22282,1945.698867,1945.7361,1,58370966,58372083,1117,0.6288309355141843
22283,1945.754967,1945.7736,1,58372649,58373208,559,0.6297340419679666
22284,1945.7972,1945.807167,1,58373916,58374215,299,0.8383441884113296
22285,1945.8239,1945.842933,1,58374717,58375287,570,0.7916180363922731
22286,1945.871133,1945.874367,1,58376133,58376231,98,
22287,1945.884533,1945.8918,1,58376535,58376754,219,-0.13518417704584454
22288,1945.894433,1945.916633,1,58376832,58377498,666,0.07623028126813741
22289,1945.9232,1945.931433,1,58377696,58377942,246,-0.034227622047266044
22290,1945.938167,1945.941767,1,58378145,58378253,108,0.6426645509077974
22291,1945.952867,1946.003233,1,58378586,58380096,1510,0.7233458719701327
22292,1946.004267,1946.032533,1,58380128,58380975,847,0.6898700766923125
22293,1946.034767,1946.0381,1,58381043,58381143,100,0.3565565056732629
22294,1946.063533,1946.085533,1,58381905,58382565,660,0.6859111304085096
22295,1946.101,1946.1988,1,58383030,58385964,2934,0.6661766194481448
22296,1946.203167,1946.2124,1,58386095,58386372,277,0.4353720211918657
22297,1946.2248,1946.2298,1,58386744,58386894,150,0.6502435158144789
22298,1946.230933,1946.277233,1,58386927,58388316,1389,0.7250622498107021
22299,1946.290533,1946.325267,1,58388715,58389758,1043,0.5756956708969182
22300,1946.3519,1946.355367,1,58390557,58390661,104,-0.1246587296006978
22301,1946.36,1946.365,1,58390800,58390950,150,0.6262391266781113
22302,1946.368733,1946.375367,1,58391061,58391261,200,0.11581099589744656
22303,1946.376667,1946.3841,1,58391300,58391523,223,0.056301173165979115
22304,1946.385767,1946.460067,1,58391573,58393802,2229,0.6666541073268467
22305,1946.476833,1946.5867,1,58394304,58397601,3297,0.8376406677653521
22306,1946.889733,1947.063667,1,58406691,58411910,5219,0.8004834867442833
22307,1947.069533,1947.100267,1,58412085,58413008,923,0.853964035519034
22308,1947.122633,1947.3164,1,58413678,58419492,5814,0.7435383567580164
22309,1947.335233,1947.338333,1,58420056,58420149,93,-0.10606386124518216
22310,1947.361633,1947.374133,1,58420848,58421223,375,
22311,1947.7637,1947.7922,1,58432911,58433766,855,0.784078580070645
22312,1947.796933,1947.848033,1,58433907,58435440,1533,0.7323237057219364
22313,1947.879767,1947.947867,1,58436393,58438436,2043,0.7368047999999774
22314,1947.9578,1948.0037,1,58438734,58440111,1377,0.6467570832175265
22315,1948.020133,1948.059133,1,58440603,58441773,1170,0.7823212479902961
22316,1948.064833,1948.068633,1,58441944,58442058,114,-0.26161649831851447
22317,1948.074533,1948.0847,1,58442235,58442541,306,0.6345954343668
22318,1948.115833,1948.124267,1,58443474,58443728,254,-0.046660576172536855
22319,1948.1283,1948.140933,1,58443849,58444227,378,-0.07302431056386456
22320,1948.145067,1948.1715,1,58444352,58445145,793,0.2697744284301985
22321,1948.1973,1948.315133,1,58445919,58449453,3534,0.7395700658552854
22322,1948.320733,1948.326867,1,58449621,58449806,185,-0.17002813005490958
22323,1948.336067,1948.3453,1,58450082,58450359,277,0.5420293799800673
22324,1948.3526,1948.367467,1,58450578,58451024,446,0.018648105433675097
22325,1948.369067,1948.433533,1,58451072,58453005,1933,0.396501859840348
22326,1948.480867,1948.486467,1,58454426,58454594,168,0.10049124734063183
22327,1948.5069,1948.5434,1,58455207,58456302,1095,0.8041460689723107
22328,1948.5444,1948.565833,1,58456332,58456974,642,0.8496347846687428
22329,1948.567833,1948.618033,1,58457034,58458540,1506,0.7850200454394931
22330,1948.619767,1948.7191,1,58458593,58461573,2980,0.8037433731680343
22331,1948.733033,1948.765,1,58461990,58462950,960,0.6687983772857504
22332,1948.7785,1948.787867,1,58463355,58463636,281,0.5195407138749107
22333,1948.799667,1948.8134,1,58463990,58464402,412,-0.04315069501660271
22334,1948.8146,1948.840933,1,58464438,58465227,789,0.19931516991278037
22335,1948.842067,1948.8475,1,58465262,58465425,163,-0.1229086450489163
22336,1948.9298,1948.9329,1,58467894,58467987,93,-0.13857388324973993
22337,1948.941867,1948.951567,1,58468256,58468547,291,0.4231509178219742
22338,1948.9581,1948.999,1,58468743,58469970,1227,0.1318670840017472
22339,1949.0001,1949.0307,1,58470003,58470921,918,0.24089360913864433
22340,1949.048667,1949.051667,1,58471460,58471550,90,0.5171432181960128
22341,1949.0637,1949.075333,1,58471911,58472259,348,0.7655577939667256
22342,1949.0766,1949.165667,1,58472298,58474970,2672,0.8238741938079363
22343,1949.166733,1949.288833,1,58475001,58478664,3663,0.7956193984665687
22344,1949.319267,1949.342,1,58479578,58480260,682,0.6669542238816786
22345,1949.343033,1949.347333,1,58480290,58480419,129,0.42227555424442653
22346,1949.3605,1949.379767,1,58480815,58481393,578,0.6249875540750273
22347,1949.380933,1949.441533,1,58481427,58483245,1818,0.8053205003835936
22348,1949.590067,1949.654833,1,58487702,58489644,1942,0.15764846296000734
22349,1949.663867,1949.6766,1,58489916,58490298,382,0.3578303211648014
22350,1949.677933,1949.736733,1,58490337,58492101,1764,0.8272653218383811
22351,1949.7378,1949.780133,1,58492134,58493403,1269,0.8393733864091315
22352,1949.8024,1949.808,1,58494072,58494240,168,-0.1452895466324723
22353,1949.811333,1949.816067,1,58494339,58494482,143,0.22220326876656715
22354,1950.052367,1950.129433,1,58501571,58503882,2311,0.7204148870433803
22355,1950.141033,1950.221567,1,58504230,58506647,2417,0.8209959315935759
22356,1950.2226,1950.2458,1,58506678,58507374,696,0.8048682210386242
22357,1950.2511,1950.389267,1,58507533,58511678,4145,0.6882211887009323
22358,1950.4148,1950.417867,1,58512444,58512536,92,
22359,1950.630567,1950.6401,1,58518917,58519203,286,0.4427307761756409
22360,1950.641167,1950.841333,1,58519235,58525239,6004,0.7878647795999708
22361,1951.154233,1951.170833,1,58534626,58535124,498,0.682080120405825
22362,1951.177467,1951.192133,1,58535324,58535763,439,0.7162779584844169
22363,1951.214933,1951.247333,1,58536447,58537419,972,0.6922663313610741
22364,1951.2555,1951.266467,1,58537665,58537994,329,0.8058007588875614
22365,1951.276233,1951.319033,1,58538286,58539570,1284,0.771980688792213
22366,1951.335167,1951.370967,1,58540055,58541129,1074,0.8624923212125358
22367,1951.3917,1951.438433,1,58541751,58543152,1401,0.62769136305172
22368,1951.4548,1951.460967,1,58543644,58543829,185,0.8196583867360774
22369,1951.4631,1951.471867,1,58543893,58544156,263,0.5698676899404367
22370,1951.5069,1951.519033,1,58545207,58545570,363,0.6978153145254163
22371,1951.531133,1951.551133,1,58545933,58546533,600,0.8761937170302353
22372,1951.5748,1951.592433,1,58547244,58547772,528,0.835478876235854
22373,1951.613833,1951.6262,1,58548414,58548786,372,0.7416953240823582
22374,1951.629,1951.643833,1,58548870,58549314,444,0.7145431756353009
22375,1951.654967,1951.705233,1,58549649,58551156,1507,0.02521582354695866
22376,1951.706533,1951.726767,1,58551195,58551803,608,0.23158626323963932
22377,1951.7539,1951.869733,1,58552617,58556091,3474,0.7164036776841137
22378,1952.332833,1952.337333,1,58569984,58570119,135,0.12195362898722938
22379,1952.3404,1952.4137,1,58570212,58572411,2199,0.7795087041890757
22380,1952.424,1952.431433,1,58572720,58572942,222,0.37821343431334953
22381,1952.435167,1952.459933,1,58573055,58573797,742,0.777262405905161
22382,1952.491467,1952.509667,1,58574744,58575290,546,0.7630737743577201
22383,1952.513933,1952.537967,1,58575417,58576139,722,0.7766585858198537
22384,1952.539667,1952.593467,1,58576190,58577804,1614,0.7684029661100916
22385,1952.6033,1952.625,1,58578099,58578750,651,0.8147569426172713
22386,1952.6367,1952.653133,1,58579101,58579593,492,0.7964884537183985
22387,1952.862333,1952.980733,1,58585869,58589421,3552,0.8809089110494405
22388,1953.3027,1953.372233,1,58599081,58601166,2085,0.8429775635327257
22389,1953.374433,1953.3911,1,58601232,58601733,501,0.9011783102406273
22390,1953.393333,1953.493467,1,58601799,58604804,3005,0.8463191483516848
22391,1953.507733,1953.546967,1,58605231,58606409,1178,0.8272815723284598
22392,1953.563533,1953.585533,1,58606905,58607565,660,0.7174746414962454
22393,1953.9004,1953.904533,1,58617012,58617135,123,0.04387077129107463
22394,1953.918033,1953.9532,1,58617540,58618596,1056,0.7618004477947404
22395,1953.9806,1953.987733,1,58619418,58619631,213,0.625126196576794
22396,1953.991667,1954.0169,1,58619750,58620507,757,0.6833506018918759
22397,1954.020933,1954.074133,1,58620627,58622223,1596,0.65034975292364
22398,1954.079733,1954.158533,1,58622391,58624755,2364,0.765240066702424
22399,1954.1682,1954.240267,1,58625046,58627208,2162,0.7933998732447841
22400,1954.2548,1954.259433,1,58627644,58627782,138,0.9429132120690479
22401,1954.260633,1954.281967,1,58627818,58628459,641,0.6713941043053354
22402,1954.315267,1954.331167,1,58629458,58629935,477,-0.0434880145240548
22403,1954.335367,1954.340133,1,58630061,58630203,142,0.46489365836527335
22404,1954.341333,1954.353967,1,58630239,58630619,380,0.36108852210761555
22405,1954.569067,1954.818933,1,58637072,58644567,7495,0.8202033186120753
22406,1954.884,1954.888133,1,58646520,58646643,123,0.5924024330410503
22407,1954.891167,1954.895333,1,58646735,58646859,124,-0.06286964823776707
22408,1955.289133,1955.297967,1,58658673,58658939,266,0.538821289744672
22409,1955.299767,1955.315133,1,58658993,58659453,460,0.5288613745598051
22410,1955.3403,1955.3643,1,58660209,58660929,720,0.6204956762873538
22411,1955.397467,1955.4044,1,58661924,58662132,208,0.4810973004999713
22412,1955.4057,1955.4296,1,58662171,58662888,717,0.619325403179712
22413,1955.448467,1955.463767,1,58663454,58663913,459,0.5046411029141904
22414,1955.4742,1955.481433,1,58664226,58664442,216,0.93385862733446
22415,1955.506933,1955.5228,1,58665207,58665684,477,0.5766875614477003
22416,1955.547933,1955.559167,1,58666437,58666775,338,0.5866736890779702
22417,1955.566767,1955.5731,1,58667003,58667193,190,0.5293229344922179
22418,1955.615933,1955.6259,1,58668477,58668777,300,-0.054115325484697295
22419,1955.628067,1955.6632,1,58668842,58669896,1054,0.20966404269611436
22420,1955.6923,1955.750167,1,58670769,58672505,1736,0.854226019443761
22421,1955.7517,1955.809133,1,58672551,58674273,1722,0.7705650539362827
22422,1955.830567,1956.0046,1,58674917,58680138,5221,0.7644798204321973
22423,1956.009367,1956.047667,1,58680281,58681430,1149,0.7271682201996835
22424,1956.075433,1956.079,1,58682262,58682370,108,0.20282367218849381
22425,1956.080733,1956.094167,1,58682421,58682825,404,0.30061350597768205
22426,1956.406167,1956.462133,1,58692185,58693863,1678,0.6704645016896771
22427,1956.463133,1956.5406,1,58693893,58696218,2325,0.6472729957957539
22428,1956.546867,1956.564667,1,58696406,58696940,534,0.6582229118061597
22429,1956.567467,1956.6354,1,58697024,58699062,2038,0.5895384240854903
22430,1956.647467,1956.668067,1,58699424,58700042,618,0.5757507363220357
22431,1956.671733,1956.687233,1,58700151,58700616,465,0.5424310547437048
22432,1956.720733,1956.7527,1,58701621,58702581,960,0.5940948247720124
22433,1956.768067,1956.7893,1,58703042,58703679,637,0.709944754663153
22434,1956.795533,1956.8,1,58703865,58704000,135,-0.24519874888571247
22435,1956.812033,1956.8201,1,58704360,58704603,243,-0.11723506614628211
22436,1956.822967,1956.871767,1,58704689,58706153,1464,0.20898565912557793
22437,1956.8734,1956.8785,1,58706202,58706355,153,
22438,1956.904033,1956.907567,1,58707120,58707227,107,0.6240015824544404
22439,1956.917367,1956.932733,1,58707521,58707981,460,0.8157308802260753
22440,1956.9339,1957.033333,1,58708017,58710999,2982,0.8398400889095232
22441,1957.0804,1957.087267,1,58712412,58712618,206,0.35670200020697834
22442,1957.224133,1957.379167,1,58716723,58721375,4652,0.8377870473154165
22443,1957.394267,1957.5127,1,58721828,58725381,3553,0.8463074231056518
22444,1957.839533,1957.8483,1,58735185,58735449,264,0.5404420044678163
22445,1957.8493,1957.8539,1,58735479,58735617,138,0.49051337921111926
22446,1957.873267,1957.878167,1,58736198,58736345,147,0.10225649110155134
22447,1957.888133,1957.965933,1,58736643,58738977,2334,0.8127574503584687
22448,1957.975167,1958.046767,1,58739255,58741403,2148,0.7502097908124602
22449,1958.048967,1958.089767,1,58741469,58742693,1224,0.6765185624040303
22450,1958.122633,1958.132567,1,58743678,58743977,299,0.8993644811566626
22451,1958.134033,1958.172,1,58744020,58745160,1140,0.8364611311101711
22452,1958.1811,1958.199867,1,58745433,58745996,563,0.7569000626332706
22453,1958.209033,1958.293633,1,58746270,58748808,2538,0.7787114449610195
22454,1958.400367,1958.405933,1,58752011,58752177,166,0.4376992813003029
22455,1958.409233,1958.4208,1,58752276,58752624,348,0.49533955656446943
22456,1958.422367,1958.463333,1,58752671,58753899,1228,0.7889167540411628
22457,1958.466567,1958.478367,1,58753997,58754351,354,0.8660621351702852
22458,1958.479633,1958.509567,1,58754388,58755287,899,0.8962844432881136
22459,1958.529133,1958.5456,1,58755873,58756368,495,0.31727843707637166
22460,1958.546833,1958.562933,1,58756404,58756887,483,0.10123657041359242
22461,1958.588633,1958.698367,1,58757658,58760951,3293,0.8701899274616138
22462,1958.943167,1958.962333,1,58768295,58768869,574,0.7563891421959797
22463,1958.9636,1958.987233,1,58768908,58769616,708,0.7470511381049749
22464,1958.995533,1959.2013,1,58769865,58776039,6174,0.7387182530447102
22465,1959.204967,1959.211967,1,58776149,58776359,210,0.808692170809515
22466,1959.224267,1959.2361,1,58776728,58777083,355,0.8334568313601972
22467,1959.240067,1959.245433,1,58777202,58777362,160,0.38023470607484666
22468,1959.246867,1959.251267,1,58777406,58777538,132,0.8695050010436245
22469,1959.2561,1959.340667,1,58777683,58780220,2537,0.8211949774731426
22470,1959.358633,1959.374233,1,58780758,58781226,468,-0.014222764663010501
22471,1959.376333,1959.406233,1,58781289,58782186,897,0.2792861722796313
22472,1959.431533,1959.538833,1,58782945,58786164,3219,0.6932039875735491
22473,1959.5474,1959.5604,1,58786422,58786812,390,0.7234311448827996
22474,1959.564967,1959.574033,1,58786949,58787220,271,0.7128743841104354
22475,1959.582233,1959.804733,1,58787466,58794141,6675,0.7565513154797916
22476,1959.822067,1959.851367,1,58794662,58795541,879,0.11665177730054978
22477,1959.8537,1959.876567,1,58795611,58796297,686,0.08954933431580189
22478,1959.899,1960.0818,1,58796970,58802454,5484,0.8237906842506885
22479,1960.1003,1960.120967,1,58803009,58803629,620,0.7876871107839355
22480,1960.1221,1960.127033,1,58803663,58803810,147,0.5429443032370259
22481,1960.131933,1960.192333,1,58803957,58805769,1812,0.8490182513961366
22482,1960.194967,1960.204133,1,58805849,58806123,274,-0.2989148707201555
22483,1960.2318,1960.2373,1,58806954,58807119,165,0.17950745012624197
22484,1960.597867,1960.640167,1,58817936,58819205,1269,0.8003283891121381
22485,1960.6535,1960.676,1,58819605,58820280,675,0.6667800621710595
22486,1960.678933,1960.695433,1,58820367,58820862,495,0.5672869364637544
22487,1960.730933,1960.739,1,58821927,58822170,243,0.47972215750687563
22488,1960.740033,1960.760867,1,58822200,58822826,626,0.6485901718196094
22489,1960.774567,1960.8227,1,58823237,58824681,1444,0.6037309487026196
22490,1960.846067,1960.8512,1,58825382,58825536,154,0.5946451979560738
22491,1960.853533,1960.862733,1,58825605,58825881,276,0.5630150646961554
22492,1960.8821,1960.893,1,58826463,58826790,327,0.7164540812365655
22493,1960.900933,1960.9226,1,58827027,58827678,651,0.7876975497312213
22494,1960.992067,1960.995367,1,58829762,58829861,99,-0.24177659683274377
22495,1961.041433,1961.124833,1,58831242,58833744,2502,0.8407757835317912
22496,1961.126067,1961.163233,1,58833782,58834896,1114,0.799663464409532
22497,1961.3679,1961.587567,1,58841037,58847627,6590,0.6972636294129408
22498,1961.606,1961.610833,1,58848180,58848324,144,-0.06196499494311028
22499,1961.690533,1961.706167,1,58850715,58851185,470,0.7584356066139668
22500,1961.7072,1961.8458,1,58851216,58855374,4158,0.8047154580909668
22501,1961.8609,1961.8916,1,58855827,58856748,921,0.7111497020958365
22502,1961.9053,1961.961333,1,58857159,58858839,1680,0.0600876673989518
22503,1961.9724,1961.975767,1,58859172,58859273,101,0.12431523003987607
22504,1961.985233,1962.155233,1,58859556,58864656,5100,0.8089758563063939
22505,1962.160767,1962.164067,1,58864823,58864922,99,0.6715834101215072
22506,1962.165667,1962.230567,1,58864970,58866917,1947,0.8283445134990657
22507,1962.233033,1962.2629,1,58866990,58867887,897,0.7375817055803858
22508,1962.282767,1962.335667,1,58868483,58870070,1587,0.14898467731384335
22509,1962.3536,1962.516467,1,58870608,58875494,4886,0.8449171892325122
22510,1962.518567,1962.565967,1,58875557,58876979,1422,0.8349009896843597
22511,1962.570967,1962.578433,1,58877129,58877352,223,0.5551502144289794
22512,1962.592633,1962.661567,1,58877778,58879847,2069,0.7721496522370482
22513,1962.725267,1962.743867,1,58881758,58882316,558,0.0801194562068579
22514,1962.747267,1962.751633,1,58882418,58882548,130,0.7350160123889429
22515,1962.756033,1962.7599,1,58882680,58882797,117,
22516,1962.764433,1962.811467,1,58882932,58884344,1412,0.8222147134611645
22517,1962.8177,1962.8656,1,58884531,58885968,1437,0.779291008777781
22518,1962.882133,1962.940267,1,58886463,58888208,1745,0.07828340416087684
22519,1962.956633,1962.9611,1,58888698,58888833,135,0.756125367316757
22520,1962.967433,1962.971633,1,58889022,58889148,126,0.6939273504232454
22521,1962.973533,1963.116,1,58889205,58893480,4275,0.7916977852978823
22522,1963.119133,1963.1286,1,58893573,58893858,285,0.6561586143604861
22523,1963.130733,1963.1817,1,58893921,58895451,1530,0.7766551605937747
22524,1963.190333,1963.2017,1,58895709,58896051,342,0.02432946444180566
22525,1963.203033,1963.21,1,58896090,58896300,210,0.003415259795348838
22526,1963.243333,1963.2465,1,58897299,58897395,96,-0.3740679593246695
22527,1963.251033,1963.3071,1,58897530,58899213,1683,0.09972004243940917
22528,1963.308733,1963.312867,1,58899261,58899386,125,0.27171803635528763
22529,1963.318233,1963.335533,1,58899546,58900065,519,0.7181223931210758
22530,1963.338,1963.4266,1,58900140,58902798,2658,0.7824583559764684
22531,1963.4508,1963.462233,1,58903524,58903866,342,-0.11484183806319702
22532,1963.4691,1963.482633,1,58904073,58904478,405,0.09259949022669392
22533,1963.494467,1963.6134,1,58904834,58908402,3568,0.8415492946109896
22534,1963.628567,1963.643933,1,58908857,58909317,460,-0.11506955559698641
22535,1963.645433,1963.6554,1,58909362,58909662,300,0.2635981463767394
22536,1963.656667,1963.6801,1,58909700,58910403,703,0.016426048648828472
22537,1963.7055,1963.809633,1,58911165,58914288,3123,0.7899957041221346
22538,1963.8154,1963.9423,1,58914462,58918269,3807,0.7902075844704212
22539,1963.9543,1963.958333,1,58918629,58918749,120,0.14429093044599714
22540,1963.9671,1963.9702,1,58919013,58919106,93,-0.003046934892805906
22541,1964.032033,1964.0359,1,58920960,58921077,117,0.7113988974817073
22542,1964.0434,1964.063467,1,58921302,58921904,602,0.5358741954763123
22543,1964.064733,1964.145433,1,58921941,58924362,2421,0.7692847897349798
22544,1964.1524,1964.251167,1,58924572,58927535,2963,0.8063120627597572
22545,1964.252233,1964.271,1,58927566,58928130,564,0.6867274335875978
22546,1964.280367,1964.329667,1,58928411,58929890,1479,0.7437699212991238
22547,1964.3438,1964.3795,1,58930314,58931385,1071,0.5846635395255992
22548,1964.394567,1964.443567,1,58931837,58933307,1470,0.11545385314893103
22549,1964.463167,1964.667767,1,58933895,58940033,6138,0.8066039935705285
22550,1964.681867,1964.855767,1,58940456,58945673,5217,0.7924370599200513
22551,1964.8576,1964.8826,1,58945728,58946478,750,0.7414034655618793
22552,1964.9,1964.989867,1,58947000,58949696,2696,0.8121455077605533
22553,1964.997433,1965.0098,1,58949922,58950294,372,-0.03475094870139714
22554,1965.0181,1965.045333,1,58950543,58951359,816,0.2895061849636747
22555,1965.051667,1965.057833,1,58951550,58951734,184,0.1909500768507613
22556,1965.0869,1965.1014,1,58952607,58953042,435,0.34830800130822687
22557,1965.1037,1965.1486,1,58953111,58954458,1347,0.7549275081298403
22558,1965.1497,1965.1926,1,58954491,58955778,1287,0.8223497598890219
22559,1965.204233,1965.2349,1,58956126,58957047,921,-0.07724102931722077
22560,1965.236567,1965.2519,1,58957097,58957557,460,0.16634443750030056
22561,1965.2738,1965.3076,1,58958214,58959228,1014,0.8169913544767036
22562,1965.309833,1965.439933,1,58959294,58963197,3903,0.8308831589128237
22563,1965.456167,1965.495633,1,58963685,58964868,1183,0.05416863684216165
22564,1965.501233,1965.506133,1,58965036,58965183,147,0.34939931274687375
22565,1965.534367,1965.658,1,58966031,58969740,3709,0.7986254671088916
22566,1965.684367,1965.940233,1,58970531,58978206,7675,0.5157926013192355
22567,1965.953167,1965.976867,1,58978595,58979306,711,0.02509335076101371
22568,1965.978667,1966.01,1,58979360,58980300,940,0.13328188618371808
22569,1966.043633,1966.063933,1,58981308,58981917,609,0.8016992889555917
22570,1966.067667,1966.0733,1,58982030,58982199,169,0.11283608752201578
22571,1966.081333,1966.0976,1,58982439,58982928,489,0.6354053970351157
22572,1966.0987,1966.109633,1,58982961,58983288,327,0.8590545364508031
22573,1966.113233,1966.147267,1,58983396,58984418,1022,0.6990065245030964
22574,1966.164033,1966.197067,1,58984920,58985912,992,0.8115209717527784
22575,1966.200567,1966.2144,1,58986017,58986432,415,0.7605793222613285
22576,1966.218267,1966.2836,1,58986548,58988508,1960,0.7031504611801163
22577,1966.294333,1966.3903,1,58988829,58991709,2880,0.7243042331874727
22578,1966.393333,1966.4957,1,58991799,58994871,3072,0.7247222089358963
22579,1966.505733,1966.547167,1,58995171,58996415,1244,0.024555642671493707
22580,1966.550733,1966.5612,1,58996521,58996836,315,0.4861685600774155
22581,1966.5892,1966.607033,1,58997676,58998210,534,0.7630165724854954
22582,1966.608533,1966.7025,1,58998255,59001075,2820,0.8320600406193623
22583,1966.7035,1966.8329,1,59001105,59004987,3882,0.8058359010321695
22584,1966.926867,1966.933267,1,59007806,59007998,192,0.6393746392369405
22585,1966.9373,1967.102167,1,59008119,59013065,4946,0.7696820761553739
22586,1967.1089,1967.174033,1,59013267,59015220,1953,0.828266059051364
22587,1967.1797,1967.198033,1,59015391,59015940,549,0.7951682253950336
22588,1967.205733,1967.216333,1,59016171,59016489,318,0.6832759600994176
22589,1967.232833,1967.250467,1,59016984,59017514,530,-0.021016971649375157
22590,1967.256033,1967.2638,1,59017680,59017914,234,0.1722011413958536
22591,1967.278,1967.409567,1,59018340,59022287,3947,0.8585326356238141
22592,1967.428433,1967.446967,1,59022852,59023409,557,0.0041226690890916315
22593,1967.4483,1967.481333,1,59023449,59024439,990,0.2240179691665154
22594,1967.527033,1967.569467,1,59025810,59027084,1274,0.7851053895982918
22595,1967.579667,1967.632667,1,59027390,59028980,1590,0.8290040771217688
22596,1967.6338,1967.6386,1,59029014,59029158,144,0.4265473738283648
22597,1967.643633,1967.6649,1,59029308,59029947,639,-0.030233385464334465
22598,1967.666467,1967.687533,1,59029994,59030625,631,0.2962287892773315
22599,1967.689667,1967.699233,1,59030690,59030976,286,0.337882583679721
22600,1967.7317,1967.7504,1,59031951,59032512,561,0.7694720949414141
22601,1967.751967,1967.756567,1,59032559,59032697,138,0.12605113797215922
22602,1967.757633,1967.8524,1,59032728,59035572,2844,0.8315571932067274
22603,1967.863267,1967.873967,1,59035898,59036219,321,-0.04093549799933531
22604,1967.8754,1967.8866,1,59036262,59036598,336,0.1675525284182814
22605,1967.888467,1967.895733,1,59036654,59036871,217,0.14123175479547095
22606,1967.8968,1967.931267,1,59036904,59037938,1034,0.28385884187164867
22607,1967.936133,1967.943667,1,59038083,59038310,227,0.6324331837186711
22608,1968.0003,1968.033167,1,59040009,59040995,986,0.6947980523399712
22609,1968.036167,1968.046467,1,59041085,59041394,309,0.7468848873419824
22610,1968.047833,1968.0871,1,59041434,59042613,1179,0.8809948489205212
22611,1968.091467,1968.144667,1,59042744,59044340,1596,0.8822131417185377
22612,1968.157667,1968.182567,1,59044730,59045477,747,-0.04323703346359056
22613,1968.183967,1968.2164,1,59045519,59046492,973,0.1001101074691405
22614,1968.251667,1968.329233,1,59047550,59049876,2326,0.7893377956683841
22615,1968.3336,1968.357267,1,59050008,59050718,710,0.9023660812623419
22616,1968.371367,1968.4056,1,59051141,59052168,1027,-0.021316764839071974
22617,1968.4093,1968.422833,1,59052279,59052684,405,0.38324173199653155
22618,1968.430367,1968.434533,1,59052911,59053035,124,0.24616230027084504
22619,1968.437667,1968.574567,1,59053130,59057237,4107,0.85943746118899
22620,1969.0535,1969.118033,1,59071605,59073540,1935,0.7327934534501571
22621,1969.122967,1969.158767,1,59073689,59074763,1074,0.8573955341134698
22622,1969.166167,1969.1704,1,59074985,59075112,127,0.6984859171310355
22623,1969.1725,1969.2376,1,59075175,59077128,1953,0.6669551663280057
22624,1969.242633,1969.320167,1,59077278,59079605,2327,0.7420595087055247
22625,1969.331533,1969.376867,1,59079945,59081306,1361,0.6862324441452351
22626,1969.385933,1969.3892,1,59081577,59081676,99,
22627,1969.395667,1969.4005,1,59081870,59082015,145,-0.13554040656461855
22628,1969.402133,1969.453333,1,59082063,59083599,1536,0.06257134835456325
22629,1969.483033,1969.4883,1,59084490,59084649,159,0.1643449544385129
22630,1969.498567,1969.551433,1,59084957,59086542,1585,0.8359665013640862
22631,1969.5544,1969.682633,1,59086632,59090478,3846,0.8228099330810754
22632,1969.700867,1969.840533,1,59091026,59095215,4189,0.7224951193478893
22633,1969.857133,1969.8679,1,59095713,59096037,324,0.1726744651997308
22634,1969.8809,1969.8882,1,59096427,59096646,219,-0.12245146475411996
22635,1969.9359,1970.015,1,59098077,59100450,2373,0.7280183405805957
22636,1970.0469,1970.0544,1,59101407,59101632,225,0.318484521666951
22637,1970.070067,1970.097133,1,59102102,59102913,811,-0.05170760090119794
22638,1970.100633,1970.111867,1,59103018,59103356,338,0.24057651229465246
22639,1970.114967,1970.1226,1,59103449,59103678,229,0.04437632441391655
22640,1970.130733,1970.134833,1,59103921,59104044,123,0.8283649119641189
22641,1970.1372,1970.224933,1,59104116,59106747,2631,0.8348385288026853
22642,1970.229033,1970.2927,1,59106870,59108781,1911,0.7805039071821611
22643,1970.294133,1970.308067,1,59108823,59109242,419,0.6253868657785898
22644,1970.311,1970.316267,1,59109330,59109488,158,0.41392828026550893
22645,1970.334133,1970.4275,1,59110023,59112825,2802,0.8066261790756699
22646,1970.4313,1970.453233,1,59112939,59113596,657,0.6368229652728573
22647,1970.4552,1970.477167,1,59113656,59114315,659,0.5394089768706011
22648,1970.479267,1970.510667,1,59114378,59115320,942,0.8373239374038047
22649,1970.516167,1970.5931,1,59115485,59117793,2308,0.8164591401373031
22650,1970.599533,1970.615567,1,59117985,59118467,482,0.775011819381796
22651,1970.619867,1970.6362,1,59118596,59119086,490,0.5559066996049985
22652,1970.692267,1970.695933,1,59120768,59120877,109,
22653,1971.057867,1971.060967,1,59131736,59131829,93,
22654,1971.062033,1971.0709,1,59131860,59132127,267,0.2796842066039454
22655,1971.343467,1971.373167,1,59140304,59141195,891,0.5818028131811277
22656,1971.4254,1971.445833,1,59142762,59143374,612,0.7647857589689319
22657,1971.470533,1971.521733,1,59144115,59145651,1536,0.6721394544078113
22658,1971.538833,1971.545,1,59146164,59146350,186,0.8089881042169303
22659,1971.546667,1971.585467,1,59146400,59147564,1164,0.7185420999677887
22660,1971.594467,1971.6069,1,59147834,59148207,373,0.6621105561424367
22661,1971.617333,1971.627567,1,59148519,59148827,308,0.358487075778389
22662,1971.660967,1971.6819,1,59149829,59150457,628,0.1006830239195601
22663,1971.757,1971.820367,1,59152710,59154611,1901,0.7651212931831167
22664,1971.8214,1971.846667,1,59154642,59155400,758,0.7665871967175876
22665,1971.853367,1971.8786,1,59155601,59156358,757,0.7301041542219399
22666,1971.915433,1971.918433,1,59157462,59157552,90,-0.23796046634653434
22667,1971.9477,1971.953267,1,59158431,59158598,167,0.24653435774551005
22668,1972.151867,1972.161533,1,59164556,59164845,289,0.3413243147685172
22669,1972.1656,1972.187967,1,59164968,59165639,671,0.7349517183421002
22670,1972.198133,1972.2223,1,59165943,59166669,726,0.77038878809625
22671,1972.225167,1972.241633,1,59166755,59167248,493,0.8082785477481873
22672,1972.258467,1972.283133,1,59167754,59168493,739,0.8612882481108668
22673,1972.298067,1972.303367,1,59168942,59169101,159,0.8517030854198507
22674,1972.304767,1972.316033,1,59169143,59169480,337,0.9045769039635685
22675,1972.317333,1972.332467,1,59169519,59169974,455,0.6851008517917451
22676,1972.338233,1972.399667,1,59170146,59171990,1844,0.830632491833774
22677,1972.413967,1972.4412,1,59172419,59173236,817,0.7274429062762002
22678,1972.4735,1972.485567,1,59174205,59174567,362,-0.050301992767645465
22679,1972.490533,1972.4977,1,59174715,59174931,216,0.14895655777018382
22680,1972.499133,1972.511667,1,59174973,59175350,377,0.4193922971220507
22681,1972.514467,1972.519,1,59175434,59175570,136,0.3024903435708247
22682,1972.5344,1972.581567,1,59176032,59177447,1415,0.6638271095028341
22683,1972.599267,1972.6627,1,59177978,59179881,1903,0.796698124773363
22684,1972.670933,1972.674067,1,59180127,59180222,95,0.8786507133195163
22685,1972.760433,1972.764167,1,59182812,59182925,113,0.1420717884058256
22686,1972.7652,1972.816567,1,59182956,59184497,1541,0.7984156255008771
22687,1972.826833,1972.8648,1,59184804,59185944,1140,0.8304997982506324
22688,1972.870333,1972.877867,1,59186109,59186336,227,0.42322645549435484
22689,1972.8935,1972.910367,1,59186805,59187311,506,0.02633236828825505
22690,1972.9142,1972.918333,1,59187426,59187549,123,-0.0940143107307126
22691,1972.9195,1972.926633,1,59187585,59187798,213,0.2274829419996369
22692,1973.0193,1973.023233,1,59190579,59190696,117,0.5466832114299679
22693,1973.030033,1973.1797,1,59190900,59195391,4491,0.8298112162308209
22694,1973.194833,1973.2023,1,59195844,59196069,225,0.31452961392840945
22695,1973.245133,1973.270233,1,59197353,59198106,753,0.3285993762873194
22696,1973.396833,1973.399867,1,59201904,59201996,92,-0.19208706708940926
22697,1973.411933,1973.4471,1,59202357,59203413,1056,0.7741245043295604
22698,1973.4562,1973.553067,1,59203686,59206592,2906,0.7957550713315157
22699,1973.559667,1973.567333,1,59206790,59207019,229,0.5420938258243758
22700,1973.574433,1973.604833,1,59207232,59208144,912,0.7326794475448684
22701,1973.637333,1973.647833,1,59209119,59209434,315,0.0026301149486980973
22702,1973.649567,1973.6604,1,59209487,59209812,325,0.11884214217158745
22703,1973.665933,1973.686767,1,59209977,59210603,626,0.22586391304901807
22704,1973.724733,1973.7379,1,59211741,59212137,396,0.8430002908507643
22705,1973.7393,1973.837533,1,59212179,59215125,2946,0.8321497469141013
22706,1973.847933,1973.8522,1,59215437,59215566,129,0.5059301359335212
22707,1973.888167,1974.1389,1,59216645,59224167,7522,0.6938652349000407
22708,1974.1482,1974.206833,1,59224446,59226204,1758,0.6468907650252829
22709,1974.219833,1974.2541,1,59226594,59227623,1029,0.6339126595817672
22710,1974.2557,1974.2979,1,59227671,59228937,1266,0.6784635788094925
22711,1974.306,1974.309833,1,59229180,59229294,114,0.575691559894721
22712,1974.3165,1974.342333,1,59229495,59230269,774,0.582397596343389
22713,1974.369967,1974.396,1,59231099,59231880,781,0.0030801623053169887
22714,1974.398,1974.417867,1,59231940,59232536,596,0.16830538398474656
22715,1974.437133,1974.589433,1,59233113,59237682,4569,0.8086439174105176
22716,1974.604933,1974.677267,1,59238147,59240318,2171,0.7365576696933279
22717,1974.713333,1974.812,1,59241399,59244360,2961,0.8012316343323892
22718,1974.820433,1974.825033,1,59244612,59244750,138,-0.04936328846887976
22719,1974.826633,1974.8298,1,59244798,59244894,96,
22720,1974.903267,1974.913733,1,59247098,59247411,313,-0.2547475709744151
22721,1974.918067,1974.953133,1,59247542,59248593,1051,0.8116205904608678
22722,1974.958767,1975.008133,1,59248763,59250243,1480,0.7806442567835888
22723,1975.019033,1975.077033,1,59250570,59252310,1740,0.051675342013984514
22724,1975.092133,1975.1187,1,59252763,59253561,798,0.8230915689543544
22725,1975.122233,1975.286133,1,59253666,59258583,4917,0.8212555706494581
22726,1975.287967,1975.475633,1,59258639,59264268,5629,0.7927163234230721
22727,1975.482667,1975.522633,1,59264480,59265678,1198,0.03495841030836844
22728,1975.525767,1975.535367,1,59265773,59266061,288,0.3561848318219233
22729,1975.561767,1975.577467,1,59266853,59267324,471,0.46350460927644815
22730,1975.5806,1975.671833,1,59267418,59270154,2736,0.7884243969937916
22731,1975.682833,1975.701767,1,59270484,59271053,569,-0.027236803997174857
22732,1975.704633,1975.7121,1,59271138,59271363,225,0.012635810141081916
22733,1975.7248,1975.840733,1,59271744,59275221,3477,0.8714901239135139
22734,1975.8721,1975.878033,1,59276163,59276340,177,0.3296972272662766
22735,1975.8904,1975.9227,1,59276712,59277681,969,0.04082248748171278
22736,1975.927133,1975.938767,1,59277813,59278163,350,0.6096078945766966
22737,1975.995767,1976.0217,1,59279873,59280651,778,0.7717199594582036
22738,1976.0243,1976.059867,1,59280729,59281796,1067,0.8085759429075982
22739,1976.061033,1976.28,1,59281830,59288400,6570,0.7889100107362472
22740,1976.287067,1976.373267,1,59288612,59291198,2586,0.8030347199380031
22741,1976.374567,1976.410133,1,59291237,59292303,1066,0.6214498203478791
22742,1976.4162,1976.4204,1,59292486,59292612,126,0.5610912501280787
22743,1976.422933,1976.428,1,59292687,59292840,153,-0.08369976791076175
22744,1976.429033,1976.4751,1,59292870,59294253,1383,0.16422431122803202
22745,1976.486833,1976.490667,1,59294604,59294720,116,0.37987393206437503
22746,1976.4947,1976.721233,1,59294841,59301636,6795,0.7735576005936293
22747,1976.819867,1976.8232,1,59304596,59304696,100,0.05067363866300613
22748,1976.837133,1976.8437,1,59305113,59305311,198,0.7933848233850729
22749,1976.844933,1976.8797,1,59305347,59306391,1044,0.4520181742358295
22750,1976.881467,1976.884767,1,59306444,59306543,99,0.39545056413278734
22751,1976.892667,1976.912833,1,59306780,59307384,604,0.7503641701909974
22752,1976.914667,1977.023533,1,59307440,59310705,3265,0.7159062207163075
22753,1977.026567,1977.117767,1,59310797,59313533,2736,0.7011161216280086
22754,1977.1214,1977.135033,1,59313642,59314050,408,0.5995498649258219
22755,1977.145667,1977.152667,1,59314370,59314580,210,0.5084194156409755
22756,1977.154767,1977.170567,1,59314643,59315117,474,0.7997256418729422
22757,1977.1716,1977.203133,1,59315148,59316093,945,0.605410089623022
22758,1977.2107,1977.266433,1,59316321,59317992,1671,0.7558850899056266
22759,1977.270667,1977.314267,1,59318120,59319428,1308,0.7450704884884158
22760,1977.315767,1977.3257,1,59319473,59319771,298,0.5197253314637962
22761,1977.328833,1977.435633,1,59319864,59323068,3204,0.8082066894020249
22762,1977.4384,1977.513933,1,59323152,59325417,2265,0.8299084949483102
22763,1977.518967,1977.538033,1,59325569,59326140,571,0.8034410833407701
22764,1977.5405,1977.553567,1,59326215,59326607,392,0.6181731519061322
22765,1977.566567,1977.571467,1,59326997,59327144,147,-0.1121789266711717
22766,1977.5788,1977.606567,1,59327364,59328197,833,0.2069735206819275
22767,1977.609133,1977.6225,1,59328273,59328675,402,0.25234512827362643
22768,1977.6524,1977.7144,1,59329572,59331432,1860,0.7664946363287967
22769,1977.7159,1977.720333,1,59331477,59331609,132,-0.14790253257187885
22770,1977.7216,1977.770567,1,59331648,59333117,1469,0.8242133898516835
22771,1977.7861,1977.801467,1,59333583,59334044,461,-0.047850157410317146
22772,1977.811133,1977.8157,1,59334333,59334471,138,0.2633349846741291
22773,1977.823533,1977.827533,1,59334705,59334825,120,
22774,1977.857033,1978.081,1,59335710,59342430,6720,0.3104577627188988
22775,1978.0879,1978.2485,1,59342637,59347455,4818,0.7618450711745068
22776,1978.254033,1978.326467,1,59347620,59349794,2174,0.6560992734660269
22777,1978.332333,1978.339233,1,59349969,59350176,207,0.6142001951581275
22778,1978.341433,1978.432067,1,59350242,59352962,2720,0.7716854964963231
22779,1978.552533,1978.565033,1,59356575,59356950,375,0.7581115953022587
22780,1978.5699,1978.606233,1,59357097,59358186,1089,0.766941759044513
22781,1978.607633,1978.654833,1,59358228,59359644,1416,0.418530646278042
22782,1978.672133,1978.678167,1,59360163,59360345,182,
22783,1978.679267,1978.688833,1,59360378,59360664,286,-0.04868170848386577
22784,1978.698133,1978.7018,1,59360943,59361054,111,0.43433835358443823
22785,1978.7085,1978.722633,1,59361255,59361678,423,0.2677368709042388
22786,1978.756,1978.762133,1,59362680,59362863,183,0.6387883157110185
22787,1978.770633,1978.781833,1,59363118,59363454,336,0.7459430750316969
22788,1978.7833,1978.914033,1,59363499,59367420,3921,0.8010969374321795
22789,1978.915167,1978.986733,1,59367455,59369601,2146,0.7621281869447956
22790,1979.0125,1979.035233,1,59370375,59371056,681,0.5392540176604551
22791,1979.061667,1979.085567,1,59371850,59372567,717,0.016111485816252963
22792,1979.090433,1979.0983,1,59372712,59372949,237,0.1037206065946942
22793,1979.111733,1979.139767,1,59373351,59374193,842,0.8087836728787867
22794,1979.141833,1979.302533,1,59374254,59379075,4821,0.8617329918108896
22795,1979.303933,1979.3234,1,59379117,59379702,585,0.8800650234257271
22796,1979.340967,1979.404967,1,59380229,59382149,1920,0.8370045404546345
22797,1979.417233,1979.430767,1,59382516,59382923,407,0.7106906695035012
22798,1979.4402,1979.470067,1,59383206,59384102,896,0.0012271558430110006
22799,1979.471667,1979.4927,1,59384150,59384781,631,0.21531048902507624
22800,1979.518367,1979.5338,1,59385551,59386014,463,0.8224912193793816
22801,1979.537467,1979.627633,1,59386124,59388828,2704,0.7848059377044435
22802,1979.654933,1979.6728,1,59389647,59390184,537,-0.05251949859524495
22803,1979.6776,1979.684,1,59390328,59390520,192,-0.015774526857299374
22804,1979.685333,1979.6891,1,59390559,59390673,114,-0.09061903957988578
22805,1979.692367,1979.700467,1,59390771,59391014,243,0.12236808720706502
22806,1979.710667,1979.7433,1,59391320,59392299,979,0.8515756554761656
22807,1979.747633,1979.909333,1,59392428,59397279,4851,0.8422366815475337
22808,1979.930767,1980.0301,1,59397923,59400903,2980,0.7977333455628307
22809,1980.163767,1980.167867,1,59404913,59405036,123,0.887757587431929
22810,1980.1756,1980.181933,1,59405268,59405457,189,
22811,1980.1842,1980.301733,1,59405526,59409051,3525,0.7416861978220404
22812,1981.4456,1981.4568,1,59443368,59443704,336,0.6826862734791763
22813,1981.4584,1981.473967,1,59443752,59444219,467,0.6541622791962646
22814,1981.5842,1981.5876,1,59447526,59447628,102,0.1532565883352524
22815,1981.5887,1981.592,1,59447661,59447760,99,0.4057496720230899
22816,1981.747667,1981.7508,1,59452430,59452524,94,0.5633358965986386
22817,1981.753833,1981.766467,1,59452614,59452994,380,0.6437228775924693
22818,1981.808833,1981.816433,1,59454264,59454492,228,0.3320814627360975
22819,1982.197667,1982.2056,1,59465930,59466168,238,0.6910506535015007
22820,1982.206667,1982.237167,1,59466200,59467115,915,0.5081255971261988
22821,1982.2432,1982.292233,1,59467296,59468766,1470,0.6501806508577277
22822,1982.319167,1982.335567,1,59469575,59470067,492,0.6927556790002193
22823,1982.360933,1982.3917,1,59470827,59471751,924,0.5772120157926216
22824,1982.393867,1982.3983,1,59471816,59471949,133,0.3960485824714098
22825,1982.422633,1982.429333,1,59472678,59472879,201,0.47601444289852485
22826,1982.4328,1982.4509,1,59472984,59473527,543,0.6142801189444161
22827,1982.471033,1982.5078,1,59474130,59475234,1104,0.6507664369161127
22828,1982.5355,1982.540167,1,59476065,59476205,140,0.7777166315483504
22829,1982.542333,1982.555133,1,59476269,59476653,384,0.6588583589130627
22830,1982.576367,1982.582733,1,59477291,59477481,190,0.6173375294635338
22831,1982.593833,1982.6125,1,59477814,59478375,561,0.8030179998248301
22832,1982.768133,1982.874867,1,59483043,59486246,3203,0.812956652377736
22833,1983.373133,1983.425033,1,59501193,59502750,1557,0.6890614163970824
22834,1983.433867,1983.45,1,59503016,59503500,484,0.5553297986075811
22835,1983.4542,1983.5058,1,59503626,59505174,1548,0.613655815854688
22836,1983.521567,1983.5408,1,59505647,59506224,577,0.6260923174726609
22837,1983.544633,1983.550933,1,59506338,59506527,189,0.548148063761216
22838,1983.554267,1983.6024,1,59506628,59508072,1444,0.75315682881647
22839,1983.607067,1983.611933,1,59508212,59508357,145,0.5251555805163612
22840,1983.621233,1983.642433,1,59508636,59509272,636,0.6433042506744705
22841,1983.6917,1983.699167,1,59510751,59510975,224,-0.0636741940392258
22842,1983.7072,1983.743667,1,59511216,59512310,1094,0.12000354424169558
22843,1983.805867,1983.831867,1,59514176,59514956,780,0.1735556485506665
22844,1983.8332,1983.836867,1,59514996,59515106,110,0.022427545287516237
22845,1983.843333,1983.849267,1,59515299,59515478,179,0.1886485552984666
22846,1983.8537,1983.8749,1,59515611,59516247,636,0.012111970266151338
22847,1983.875967,1983.984733,1,59516279,59519541,3262,0.294500511753244
22848,1983.985767,1984.0123,1,59519573,59520369,796,0.21506136201935105
22849,1984.021033,1984.042533,1,59520630,59521275,645,0.7485276093377554
22850,1984.0791,1984.147067,1,59522373,59524412,2039,0.29071337050641355
22851,1984.1668,1984.287033,1,59525004,59528610,3606,0.187016979521435
22852,1984.2888,1984.397233,1,59528664,59531916,3252,0.6324960692560286
22853,1984.400933,1984.405467,1,59532027,59532164,137,0.426523837296937
22854,1984.4096,1984.429867,1,59532288,59532896,608,0.35536833691267844
22855,1984.448733,1984.506833,1,59533461,59535204,1743,0.14421627967257336
22856,1984.511833,1984.526533,1,59535354,59535795,441,0.05897995562585573
22857,1984.527633,1984.547833,1,59535828,59536434,606,0.5079276066882595
22858,1984.555467,1984.5604,1,59536664,59536812,148,0.08633599840158299
22859,1984.568467,1984.585733,1,59537054,59537571,517,0.028687681307482855
22860,1984.667,1984.673,1,59540010,59540190,180,-0.049594547797982204
22861,1984.693467,1984.706733,1,59540804,59541201,397,0.40051189273617677
22862,1984.741733,1984.754633,1,59542251,59542638,387,0.10512276848866388
22863,1984.797533,1984.801933,1,59543925,59544057,132,0.4064081038550143
22864,1984.809667,1984.842133,1,59544290,59545263,973,0.604844277179261
22865,1984.8715,1984.891033,1,59546145,59546730,585,0.8454629490279806
22866,1984.8983,1984.914767,1,59546949,59547443,494,0.5618431926410073
22867,1984.9201,1984.934033,1,59547603,59548020,417,0.5622986645321942
22868,1984.936867,1984.947967,1,59548106,59548439,333,0.6952734436116775
22869,1984.969033,1984.9878,1,59549070,59549634,564,0.5896241507780008
22870,1984.989233,1985.009133,1,59549676,59550273,597,0.5525074311773653
22871,1985.0209,1985.0722,1,59550627,59552166,1539,0.696897868961839
22872,1985.09,1985.093933,1,59552700,59552817,117,0.015123480411482976
22873,1985.1029,1985.108633,1,59553087,59553258,171,0.5452669552927197
22874,1985.116533,1985.149167,1,59553495,59554475,980,0.5689668517162554
22875,1985.174267,1985.1863,1,59555228,59555589,361,0.6133214849465712
22876,1985.1889,1985.216533,1,59555667,59556495,828,0.07360914049084535
22877,1985.2178,1985.248233,1,59556534,59557446,912,0.22950370216539648
22878,1985.2877,1985.371733,1,59558631,59561151,2520,0.7068257922038946
22879,1985.372967,1985.401,1,59561189,59562030,841,0.6530675142791345
22880,1985.433667,1985.4407,1,59563010,59563221,211,0.2509150633778618
22881,1985.6964,1985.722467,1,59570892,59571674,782,0.4735966195007031
22882,1985.9301,1985.9332,1,59577903,59577996,93,
22883,1985.9343,1985.9722,1,59578029,59579166,1137,0.5999698129937318
22884,1985.974567,1986.0039,1,59579237,59580117,880,0.8279067043635799
22885,1986.0102,1986.026167,1,59580306,59580785,479,0.8828831404947172
22886,1986.032733,1986.090467,1,59580981,59582714,1733,0.7741185405798814
22887,1986.115333,1986.130067,1,59583459,59583902,443,0.7900674370852927
22888,1986.1356,1986.214533,1,59584068,59586435,2367,0.8209883672138539
22889,1986.291033,1986.2968,1,59588730,59588904,174,0.12938006908996486
22890,1986.644267,1986.6705,1,59599328,59600115,787,0.5697995462736618
22891,1986.6715,1986.7129,1,59600145,59601387,1242,0.7531677569883839
22892,1986.714433,1986.769133,1,59601432,59603073,1641,0.6077448014593988
22893,1986.7775,1986.8969,1,59603325,59606907,3582,0.6861728392524437
22894,1986.926967,1986.930633,1,59607809,59607918,109,
22895,1986.939433,1986.944533,1,59608182,59608335,153,0.26475873892750484
22896,1986.950733,1986.957067,1,59608521,59608712,191,0.2779153572691899
22897,1986.961433,1986.966167,1,59608842,59608985,143,-0.08847736145513899
22898,1987.0147,1987.0246,1,59610441,59610738,297,0.6484541263517395
22899,1987.0292,1987.035433,1,59610876,59611062,186,0.3090698070784817
22900,1987.074933,1987.083167,1,59612247,59612495,248,0.6805040409267581
22901,1987.085633,1987.091467,1,59612568,59612744,176,0.46415322933979897
22902,1987.153567,1987.206933,1,59614607,59616207,1600,0.5416037483822506
22903,1987.213933,1987.288933,1,59616417,59618667,2250,0.7215890641985567
22904,1987.304367,1987.314367,1,59619131,59619431,300,0.5318098993714299
22905,1987.369033,1987.379667,1,59621070,59621390,320,0.058310347352602904
22906,1987.380733,1987.412333,1,59621421,59622369,948,0.22379117464464424
22907,1987.436833,1987.456267,1,59623104,59623688,584,0.8726072477422895
22908,1987.459867,1987.495867,1,59623796,59624876,1080,0.8189369760393773
22909,1987.4971,1987.561267,1,59624913,59626838,1925,0.8093469031651241
22910,1987.976833,1988.026833,1,59639304,59640804,1500,0.6732512696947288
22911,1988.036067,1988.097233,1,59641082,59642916,1834,0.6027046110521274
22912,1988.120767,1988.1362,1,59643623,59644086,463,0.6127868377535034
22913,1988.137367,1988.1406,1,59644121,59644218,97,0.25391812780883205
22914,1988.1433,1988.1653,1,59644299,59644959,660,0.5653647164117178
22915,1988.177367,1988.234033,1,59645321,59647020,1699,0.6470938993034607
22916,1988.251267,1988.256967,1,59647538,59647709,171,0.1577545250103817
22917,1988.263633,1988.3022,1,59647908,59649066,1158,0.5964238623050322
22918,1988.3414,1988.348233,1,59650242,59650446,204,-0.24016391835766424
22919,1988.3566,1988.365233,1,59650698,59650956,258,-0.13065164433558765
22920,1988.369667,1988.3929,1,59651090,59651787,697,0.029912410673712142
22921,1988.412333,1988.573967,1,59652369,59657219,4850,0.8242582802347455
22922,1989.006733,1989.025,1,59670201,59670750,549,0.7673844989004455
22923,1989.032933,1989.0589,1,59670987,59671767,780,0.8130532780899975
22924,1989.064533,1989.084067,1,59671935,59672522,587,0.7900493293436657
22925,1989.0981,1989.111533,1,59672943,59673345,402,0.774605397512807
22926,1989.130167,1989.145233,1,59673905,59674356,451,0.589036625133949
22927,1989.172,1989.1774,1,59675160,59675322,162,0.7181641668187881
22928,1989.212133,1989.2186,1,59676363,59676558,195,0.40721105578662853
22929,1989.228833,1989.2442,1,59676864,59677326,462,0.4694956112912512
22930,1989.266567,1989.296533,1,59677997,59678895,898,0.604280747009245
22931,1989.329233,1989.3348,1,59679876,59680044,168,0.5930556119481023
22932,1989.3373,1989.3459,1,59680119,59680377,258,0.540984393975949
22933,1989.3693,1989.381267,1,59681079,59681438,359,0.6141445093499884
22934,1989.387567,1989.397233,1,59681627,59681916,289,0.5592720115905778
22935,1989.4501,1989.480533,1,59683503,59684415,912,0.20696021296765985
22936,1989.487933,1989.494967,1,59684637,59684849,212,0.32251566509035423
22937,1989.517167,1989.660767,1,59685515,59689823,4308,0.7179713101012977
22938,1990.085233,1990.118233,1,59702556,59703546,990,0.6792690437405846
22939,1990.148867,1990.181533,1,59704466,59705445,979,0.7611415752250151
22940,1990.189,1990.2028,1,59705670,59706084,414,0.7737393544328471
22941,1990.213567,1990.258467,1,59706407,59707754,1347,0.70138395986187
22942,1990.278367,1990.317867,1,59708351,59709536,1185,0.6128430096647338
22943,1990.330867,1990.336267,1,59709926,59710088,162,0.2925246174249098
22944,1990.3391,1990.371433,1,59710173,59711142,969,0.6970762520322218
22945,1990.4003,1990.4079,1,59712009,59712237,228,0.7094931779106924
22946,1990.412567,1990.4174,1,59712377,59712522,145,0.6038705866558701
22947,1990.446933,1990.450367,1,59713407,59713511,104,0.633503003804857
22948,1990.453567,1990.467833,1,59713607,59714034,427,0.7607023815396933
22949,1990.475567,1990.4886,1,59714267,59714658,391,0.6402944783064412
22950,1990.527867,1990.5388,1,59715836,59716164,328,0.7791862493801777
22951,1990.561067,1990.577267,1,59716832,59717318,486,0.6838109195256631
22952,1990.5813,1990.593367,1,59717439,59717801,362,0.6549555148973185
22953,1990.605367,1990.616733,1,59718161,59718501,340,0.09169333842302481
22954,1990.629567,1990.632867,1,59718887,59718986,99,
22955,1990.633933,1990.648233,1,59719017,59719446,429,0.11801205103291597
22956,1990.652467,1990.680633,1,59719574,59720418,844,0.1971027942406616
22957,1990.706167,1990.721067,1,59721185,59721632,447,0.6940751952101241
22958,1990.723367,1990.768,1,59721701,59723040,1339,0.7754566336190049
22959,1990.769,1990.813967,1,59723070,59724419,1349,0.8420559187079113
22960,1990.8153,1990.8212,1,59724459,59724636,177,0.050417801587812616
22961,1990.837867,1990.846333,1,59725136,59725389,253,-0.01117309758121885
22962,1990.8487,1990.871233,1,59725461,59726136,675,0.058849614340363836
22963,1990.8759,1990.882933,1,59726277,59726487,210,0.324422876660604
22964,1990.8961,1990.962033,1,59726883,59728860,1977,0.7367697672335348
22965,1990.965567,1991.0374,1,59728967,59731122,2155,0.8093257838352922
22966,1991.04,1991.0433,1,59731200,59731299,99,0.6046670640555223
22967,1991.0465,1991.075633,1,59731395,59732268,873,0.6420313667352378
22968,1991.128333,1991.1323,1,59733849,59733969,120,
22969,1991.139833,1991.148967,1,59734194,59734469,275,0.09642940100715672
22970,1991.166,1991.1694,1,59734980,59735082,102,-0.15878543339574153
22971,1991.338233,1991.3645,1,59740146,59740935,789,0.701277949261391
22972,1991.374033,1991.401967,1,59741220,59742059,839,0.8278544207284205
22973,1991.414867,1991.421067,1,59742446,59742632,186,0.6940012913662509
22974,1991.4221,1991.433133,1,59742663,59742993,330,0.7587291286761817
22975,1991.4342,1991.439033,1,59743026,59743170,144,0.35711583609430775
22976,1991.4483,1991.4783,1,59743449,59744349,900,0.7697717156643951
22977,1991.483833,1991.489433,1,59744514,59744682,168,0.4485939753976282
22978,1991.5084,1991.5719,1,59745252,59747157,1905,0.7872473218494331
22979,1991.600033,1991.631367,1,59748000,59748941,941,0.7866493742777071
22980,1991.928367,1992.032833,1,59757851,59760984,3133,0.8057393040129011
22981,1992.040033,1992.0441,1,59761200,59761323,123,0.04927306774715577
22982,1992.322067,1992.335467,1,59769662,59770064,402,0.5371994052200949
22983,1992.342933,1992.385533,1,59770287,59771565,1278,0.825087330010757
22984,1992.3902,1992.4489,1,59771706,59773467,1761,0.6253719660008469
22985,1992.451033,1992.454467,1,59773530,59773634,104,0.6994175530969963
22986,1992.465033,1992.522467,1,59773950,59775674,1724,0.7944117190453056
22987,1992.535067,1992.550567,1,59776052,59776517,465,0.7227327633788156
22988,1992.556967,1992.565933,1,59776709,59776977,268,0.45175116328530945
22989,1992.605467,1992.6097,1,59778164,59778291,127,0.3324642686272896
22990,1992.613367,1992.6177,1,59778401,59778531,130,
22991,1992.9013,1992.9421,1,59787039,59788263,1224,0.7402629534419446
22992,1993.2734,1993.277933,1,59798202,59798337,135,0.43423311809277954
22993,1993.2832,1993.302433,1,59798496,59799072,576,0.7663294213783753
22994,1993.327667,1993.336667,1,59799830,59800100,270,0.6773556295527423
22995,1993.3574,1993.364067,1,59800722,59800922,200,0.6361353084934687
22996,1993.409,1993.433167,1,59802270,59802995,725,0.7846771393023336
22997,1993.455667,1993.511,1,59803670,59805330,1660,0.7742567031642611
22998,1993.538533,1993.5577,1,59806155,59806731,576,0.6333220518005416
22999,1993.814167,1993.8396,1,59814425,59815188,763,0.8345230076274347
23000,1994.129867,1994.170967,1,59823896,59825129,1233,0.7998601943949663
23001,1994.1749,1994.200067,1,59825247,59826002,755,0.7505265387630831
23002,1994.2314,1994.251267,1,59826942,59827538,596,0.6671423363998201
23003,1994.266067,1994.2919,1,59827982,59828757,775,0.7532769032566397
23004,1994.293767,1994.3029,1,59828813,59829087,274,0.6172073942678855
23005,1994.3092,1994.314567,1,59829276,59829437,161,0.6274888414349492
23006,1994.334033,1994.394233,1,59830020,59831826,1806,0.8110050562087678
23007,1994.5875,1994.595333,1,59837625,59837859,234,0.665274381525124
23008,1994.597233,1994.632133,1,59837916,59838963,1047,0.6256232975491148
23009,1994.9223,1994.939167,1,59847669,59848175,506,0.6662889635849402
23010,1994.950633,1994.955867,1,59848518,59848676,158,
23011,1994.958267,1994.975767,1,59848748,59849273,525,0.8643244546178697
23012,1994.980867,1995.014733,1,59849426,59850441,1015,0.6988488297755997
23013,1995.043367,1995.063133,1,59851301,59851893,592,0.20748859255486937
23014,1995.418333,1995.427933,1,59862549,59862837,288,0.7712445990224186
23015,1995.431867,1995.4381,1,59862956,59863143,187,0.5517694592876677
23016,1995.4407,1995.4483,1,59863221,59863449,228,0.47427507579594974
23017,1995.4845,1995.4959,1,59864535,59864877,342,0.6367144716462538
23018,1995.5166,1995.5226,1,59865498,59865678,180,0.34460148053922485
23019,1995.5707,1995.577767,1,59867121,59867333,212,0.6159159671753326
23020,1995.639933,1995.649933,1,59869197,59869497,300,0.564140501016363
23021,1995.676933,1995.6818,1,59870307,59870454,147,0.7181444329658833
23022,1995.684467,1995.700267,1,59870534,59871008,474,0.5962042204797978
23023,1995.8105,1995.8136,1,59874315,59874408,93,
23024,1995.817067,1995.821667,1,59874512,59874650,138,0.38733600917035294
23025,1995.8255,1995.840767,1,59874765,59875223,458,0.5630096859037432
23026,1995.842333,1995.8789,1,59875269,59876367,1098,0.8120557566519164
23027,1995.879933,1995.942367,1,59876397,59878271,1874,0.8138592970115671
23028,1996.348267,1996.3591,1,59890448,59890773,325,0.6761268255936443
23029,1996.360167,1996.388333,1,59890805,59891649,844,0.644126089833561
23030,1996.4121,1996.4242,1,59892363,59892726,363,0.4555080128100851
23031,1996.443833,1996.453033,1,59893314,59893590,276,0.8391818521375579
23032,1996.471333,1996.506267,1,59894139,59895188,1049,0.6500831015691555
23033,1996.559633,1996.577267,1,59896788,59897318,530,0.7922633395606785
23034,1996.605767,1996.612567,1,59898173,59898377,204,0.6354543401112929
23035,1996.620933,1996.6357,1,59898627,59899071,444,0.719904229372337
23036,1996.7125,1996.7302,1,59901375,59901906,531,0.28882385457926185
23037,1996.7595,1996.768167,1,59902785,59903045,260,0.04651899013657187
23038,1996.771367,1996.784,1,59903141,59903520,379,0.6141407996057772
23039,1996.787567,1996.821333,1,59903627,59904639,1012,0.8057483636225408
23040,1996.8288,1996.870367,1,59904864,59906111,1247,0.7126383905152062
23041,1996.901267,1996.909167,1,59907038,59907275,237,0.017523382536847622
23042,1996.957633,1997.062267,1,59908728,59911868,3140,0.835379391702493
23043,1997.516667,1997.525033,1,59925500,59925750,250,0.6462386454455563
23044,1997.545133,1997.582533,1,59926353,59927475,1122,0.7629014751569665
23045,1997.619,1997.636,1,59928570,59929080,510,0.6088181858639063
23046,1997.638233,1997.6416,1,59929146,59929248,102,0.47350154307460907
23047,1997.644733,1997.6497,1,59929341,59929491,150,0.31655959195868577
23048,1997.658867,1997.668633,1,59929766,59930058,292,0.6851075449844709
23049,1997.702133,1997.722933,1,59931063,59931687,624,0.28611421151016797
23050,1997.7489,1997.752633,1,59932467,59932578,111,0.5461221640937562
23051,1997.7582,1997.768767,1,59932746,59933063,317,0.49077803357227356
23052,1997.7708,1997.786933,1,59933124,59933607,483,0.43893649741275387
23053,1997.804267,1997.807333,1,59934128,59934219,91,0.49335075584388843
23054,1997.808333,1997.8214,1,59934249,59934642,393,0.41877326941483234
23055,1997.824433,1997.8285,1,59934732,59934855,123,-0.46035884269333566
23056,1997.871567,1997.877967,1,59936147,59936339,192,0.6623750032773095
23057,1997.879933,1997.889533,1,59936397,59936685,288,0.5008907249914193
23058,1997.9135,1997.923367,1,59937405,59937701,296,0.6097173174766687
23059,1997.932333,1997.9359,1,59937969,59938077,108,0.41215192546063073
23060,1998.006133,1998.0232,1,59940183,59940696,513,0.1637681985046126
23061,1998.045533,1998.048667,1,59941365,59941460,95,
23062,1998.059233,1998.082233,1,59941776,59942466,690,0.8485725806507958
23063,1998.0834,1998.137033,1,59942502,59944110,1608,0.8236779215540587
23064,1998.1405,1998.1892,1,59944215,59945676,1461,0.8482609085717929
23065,1998.5617,1998.570767,1,59956851,59957123,272,0.6586360151331465
23066,1998.573033,1998.588,1,59957190,59957640,450,0.2844505083139931
23067,1998.601667,1998.606833,1,59958050,59958204,154,0.14665298340849967
23068,1998.612,1998.621467,1,59958360,59958644,284,0.6671890379457838
23069,1998.6387,1998.652433,1,59959161,59959572,411,0.9335774251567217
23070,1998.735,1998.744133,1,59962050,59962323,273,0.7866029039631887
23071,1998.748833,1998.752833,1,59962464,59962584,120,0.5103092968163511
23072,1998.778933,1998.8341,1,59963367,59965023,1656,0.7549646847121869
23073,1998.863267,1998.8804,1,59965898,59966412,514,0.8017879667154877
23074,1998.905367,1998.919767,1,59967161,59967593,432,0.6640085307044092
23075,1998.920833,1998.932733,1,59967624,59967981,357,0.7087020350538077
23076,1998.944367,1998.952967,1,59968331,59968589,258,0.4310473338887561
23077,1999.290033,1999.3267,1,59978700,59979801,1101,0.7210263222981655
23078,1999.604433,1999.629367,1,59988132,59988881,749,0.7748419234033115
23079,1999.630833,1999.661067,1,59988924,59989832,908,0.8587836941553483
23080,1999.684467,1999.7268,1,59990534,59991804,1270,0.7312700207545085
23081,1999.737533,1999.8046,1,59992125,59994138,2013,0.7277005206060013
23082,1999.8304,1999.891,1,59994912,59996730,1818,0.7416299003379959
23083,1999.9002,1999.9162,1,59997006,59997486,480,0.7939353168995016
23084,1999.9207,1999.933933,1,59997621,59998017,396,0.6406819155412984
23085,2000.258633,2000.293967,1,60007758,60008819,1061,0.6464146184066677
23086,2000.320467,2000.336733,1,60009614,60010101,487,0.6808284993582364
23087,2000.342233,2000.3464,1,60010266,60010392,126,0.35310507941969216
23088,2000.3508,2000.364367,1,60010524,60010931,407,0.5983186127498101
23089,2000.599,2000.6873,1,60017970,60020619,2649,0.8545086915034714
23090,2000.688767,2000.765567,1,60020663,60022967,2304,0.7924040968181822
23091,2000.767967,2000.787767,1,60023039,60023633,594,0.6540251279646468
23092,2000.792433,2000.810867,1,60023772,60024326,554,0.8214018183516119
23093,2000.813233,2000.971367,1,60024396,60029141,4745,0.7060841396303444
23094,2000.9805,2000.986633,1,60029415,60029598,183,-0.126519084841661
23095,2000.998333,2001.001533,1,60029949,60030045,96,
23096,2001.399333,2001.403633,1,60041979,60042108,129,0.5899374394666907
23097,2001.4362,2001.474533,1,60043086,60044235,1149,0.6996484243631633
23098,2001.508267,2001.5127,1,60045248,60045381,133,0.232783314277248
23099,2001.522167,2001.5714,1,60045665,60047142,1477,0.7695907189226912
23100,2001.597833,2001.6133,1,60047934,60048399,465,0.6444807552186061
23101,2001.617967,2001.687067,1,60048539,60050612,2073,0.6529263573263651
23102,2001.694167,2001.7122,1,60050825,60051366,541,0.672259076366538
23103,2001.713567,2001.7448,1,60051407,60052344,937,0.7509241927557891
23104,2001.768567,2001.7988,1,60053057,60053964,907,0.6056882275884332
23105,2001.8169,2001.851967,1,60054507,60055559,1052,0.766301635821265
23106,2002.256067,2002.283233,1,60067682,60068496,814,0.5791269588148672
23107,2002.302933,2002.3076,1,60069087,60069228,141,0.5586057230662081
23108,2002.3286,2002.344633,1,60069858,60070338,480,0.7696242224232789
23109,2002.357633,2002.361433,1,60070728,60070842,114,0.7039655174633539
23110,2002.3779,2002.390067,1,60071337,60071702,365,0.6307160392291624
23111,2002.392033,2002.396867,1,60071760,60071906,146,0.7271205831923868
23112,2002.420967,2002.442533,1,60072629,60073275,646,0.5529862063383931
23113,2002.4451,2002.450533,1,60073353,60073515,162,0.4936887752841581
23114,2002.459067,2002.518933,1,60073772,60075567,1795,0.637800057606949
23115,2002.5343,2002.550433,1,60076029,60076512,483,0.5017096397403944
23116,2002.574,2002.628533,1,60077220,60078855,1635,0.5206545875063241
23117,2002.647,2002.662033,1,60079410,60079860,450,0.6280871852247809
23118,2002.6657,2002.669367,1,60079971,60080081,110,-0.0712475731149758
23119,2002.674133,2002.6792,1,60080223,60080376,153,0.15722027070369157
23120,2002.719167,2002.7238,1,60081575,60081714,139,0.6528881455639471
23121,2002.7315,2002.736433,1,60081945,60082092,147,0.405251712538487
23122,2002.754867,2002.761433,1,60082646,60082842,196,-0.08430182432739637
23123,2002.7802,2002.7941,1,60083406,60083823,417,0.6359332772128224
23124,2002.795267,2002.799,1,60083858,60083970,112,0.7663587461080491
23125,2002.8,2002.822267,1,60084000,60084668,668,0.9331987216545393
23126,2002.850167,2002.857367,1,60085505,60085721,216,0.8048487906814025
23127,2002.858967,2002.8719,1,60085769,60086157,388,0.6742125614114541
23128,2002.8948,2002.902633,1,60086844,60087078,234,0.7103735531831539
23129,2002.909167,2002.922267,1,60087275,60087668,393,0.6858868340777687
23130,2003.317333,2003.325233,1,60099519,60099756,237,0.5144264523682506
23131,2003.3301,2003.545233,1,60099903,60106356,6453,0.8307856438864882
23132,2003.5663,2003.576133,1,60106989,60107283,294,0.8515471417212949
23133,2003.5792,2003.706533,1,60107376,60111195,3819,0.7507772234571766
23134,2003.7323,2003.7606,1,60111969,60112818,849,0.6638386567419419
23135,2003.789667,2003.8031,1,60113690,60114093,403,0.3051048626323938
23136,2004.0018,2004.028733,1,60120054,60120861,807,0.6766701840487667
23137,2004.2853,2004.3431,1,60128559,60130293,1734,0.7192576462014579
23138,2004.348767,2004.395,1,60130463,60131850,1387,0.7873561551537978
23139,2004.411233,2004.4385,1,60132336,60133155,819,0.7773244697802855
23140,2004.4441,2004.469067,1,60133323,60134072,749,0.8028124404927608
23141,2004.471367,2004.486033,1,60134141,60134580,439,0.6602714849133499
23142,2004.4904,2004.496033,1,60134712,60134880,168,0.3587432623121004
23143,2004.5116,2004.604533,1,60135348,60138135,2787,0.7639834615847827
23144,2004.609533,2004.6251,1,60138285,60138753,468,0.5673614815248715
23145,2004.6339,2004.683233,1,60139017,60140496,1479,0.6053118798096425
23146,2004.686833,2004.7038,1,60140604,60141114,510,0.5790200886011424
23147,2004.705367,2004.755333,1,60141161,60142659,1498,0.7587810617519022
23148,2004.7599,2004.771533,1,60142797,60143145,348,0.6865952141464503
23149,2004.7828,2004.813067,1,60143484,60144392,908,0.7932039561402205
23150,2004.814467,2004.9132,1,60144434,60147396,2962,0.7835211281917176
23151,2005.469767,2005.4773,1,60164093,60164319,226,0.6560890176528005
23152,2005.540667,2005.549033,1,60166220,60166470,250,0.5094037541746609
23153,2005.591867,2005.602133,1,60167756,60168063,307,0.5570789831569265
23154,2005.663733,2005.670967,1,60169911,60170129,218,0.6445287528758469
23155,2005.7018,2005.705833,1,60171054,60171174,120,0.771905685693024
23156,2005.709733,2005.723433,1,60171291,60171702,411,0.7052267600976498
23157,2005.835867,2005.851533,1,60175076,60175545,469,0.8641851860273293
23158,2005.8526,2005.9407,1,60175578,60178221,2643,0.7714770504250372
23159,2005.943633,2006.006033,1,60178308,60180180,1872,0.7691354440384711
23160,2006.016633,2006.103533,1,60180498,60183105,2607,0.7873948653234512
23161,2006.107733,2006.1696,1,60183231,60185088,1857,0.7997707388836636
23162,2006.175133,2006.1896,1,60185253,60185688,435,0.7351617579962882
23163,2006.197467,2006.2035,1,60185924,60186105,181,0.6088594730643935
23164,2006.6268,2006.635033,1,60198804,60199050,246,0.6364649544254584
23165,2006.6481,2006.676733,1,60199443,60200301,858,0.6941380164022735
23166,2006.702233,2006.7386,1,60201066,60202158,1092,0.9117080120487017
23167,2006.747467,2006.790933,1,60202424,60203727,1303,0.7636138262421243
23168,2006.819533,2006.830967,1,60204585,60204929,344,0.640476730302377
23169,2006.8326,2006.853967,1,60204978,60205619,641,0.6545971269062196
23170,2006.863367,2006.866633,1,60205901,60205998,97,0.667323799840865
23171,2006.868167,2006.898167,1,60206045,60206945,900,0.6247994853187007
23172,2006.916733,2006.919733,1,60207501,60207591,90,0.4534505182529289
23173,2006.925333,2006.950433,1,60207759,60208512,753,0.629935294781061
23174,2006.9518,2007.023033,1,60208554,60210690,2136,0.6426896141769961
23175,2007.032767,2007.053467,1,60210983,60211604,621,0.6986407421599427
23176,2007.059233,2007.072567,1,60211776,60212177,401,0.41609572738247935
23177,2007.1071,2007.1192,1,60213213,60213576,363,0.5880842430009643
23178,2007.1204,2007.140967,1,60213612,60214229,617,0.6729067499614952
23179,2007.158433,2007.187133,1,60214752,60215613,861,0.827289527326754
23180,2007.585033,2007.5903,1,60227550,60227709,159,0.5518924240221362
23181,2007.5922,2007.737567,1,60227766,60232127,4361,0.79987849080336
23182,2007.7524,2007.790233,1,60232572,60233706,1134,0.8467727939349373
23183,2007.792567,2007.8078,1,60233777,60234234,457,0.7920837307760616
23184,2007.8187,2007.8433,1,60234561,60235299,738,0.7983502535240724
23185,2007.873133,2007.9805,1,60236193,60239415,3222,0.7699627231163853
23186,2007.993367,2007.997367,1,60239801,60239921,120,-0.19869284131904402
23187,2008.001267,2008.0057,1,60240038,60240171,133,0.19663652591866718
23188,2008.5499,2008.5591,1,60256497,60256773,276,0.7788490358795311
23189,2008.5637,2008.578167,1,60256911,60257345,434,0.6228827694861113
23190,2008.645733,2008.654767,1,60259371,60259643,272,0.4709510300333927
23191,2008.684667,2008.6906,1,60260540,60260718,178,0.5393328732326238
23192,2008.698267,2008.707767,1,60260948,60261233,285,0.5795335967445912
23193,2008.7671,2008.771633,1,60263013,60263148,135,0.6920618802203459
23194,2008.7771,2008.787067,1,60263313,60263612,299,0.6409023834930606
23195,2008.978033,2009.094033,1,60269340,60272820,3480,0.8076867079371647
23196,2009.123233,2009.300967,1,60273696,60279029,5333,0.786307944794708
23197,2009.3061,2009.316067,1,60279183,60279482,299,0.016869288608189013
23198,2009.7171,2009.722767,1,60291513,60291683,170,0.7739987424737941
23199,2009.728367,2009.7469,1,60291851,60292407,556,0.4188035985428088
23200,2009.7719,2009.788533,1,60293157,60293655,498,0.5101172400315256
23201,2009.971567,2009.9885,1,60299147,60299655,508,0.5696169006107357
23202,2009.9901,2009.9987,1,60299703,60299961,258,0.2608284733974272
23203,2010.039,2010.0476,1,60301170,60301428,258,0.6907719660284373
23204,2010.3043,2010.368933,1,60309129,60311067,1938,0.7025801411244981
23205,2010.371933,2010.396567,1,60311157,60311897,740,0.736392877106239
23206,2010.401567,2010.486433,1,60312047,60314592,2545,0.7472306703217902
23207,2010.496733,2010.509233,1,60314901,60315276,375,0.804216499521315
23208,2010.530633,2010.545367,1,60315918,60316361,443,0.04036046687523313
23209,2010.8313,2010.8736,1,60324939,60326208,1269,0.6473491107819641
23210,2010.889733,2010.912567,1,60326691,60327377,686,0.6801549872499193
23211,2010.9152,2010.920967,1,60327456,60327629,173,0.5563972567109873
23212,2010.934167,2010.943633,1,60328025,60328308,283,0.8418542990699122
23213,2010.963,2010.973733,1,60328890,60329211,321,0.6936026732787334
23214,2011.028867,2011.0339,1,60330866,60331017,151,0.38335704596105313
23215,2011.037733,2011.050367,1,60331131,60331511,380,0.1183919080552604
23216,2011.051633,2011.0555,1,60331548,60331665,117,
23217,2011.095167,2011.109133,1,60332855,60333273,418,0.29098578703760375
23218,2011.112767,2011.204433,1,60333383,60336132,2749,0.8107128878424149
23219,2011.2304,2011.239033,1,60336912,60337170,258,0.027336673925563812
23220,2011.310833,2011.3199,1,60339324,60339597,273,0.4535945656307542
23221,2011.326867,2011.4768,1,60339806,60344304,4498,0.8202990426225418
23222,2011.8143,2011.830533,1,60354429,60354915,486,0.678463425744186
23223,2011.836367,2011.8409,1,60355091,60355227,136,0.2920627220473729
23224,2011.850033,2011.854233,1,60355500,60355626,126,
23225,2011.8743,2011.8857,1,60356229,60356571,342,0.5449665939003264
23226,2011.921667,2011.936833,1,60357650,60358104,454,0.740080113858741
23227,2011.950333,2011.958633,1,60358509,60358758,249,0.6156497767873453
23228,2011.9982,2012.029867,1,60359946,60360896,950,0.8313408421270959
23229,2012.0544,2012.0598,1,60361632,60361794,162,0.47029211078382716
23230,2012.0666,2012.096033,1,60361998,60362880,882,0.44606823488216935
23231,2012.1159,2012.133433,1,60363477,60364002,525,0.7971704957630472
23232,2012.1501,2012.1666,1,60364503,60364998,495,0.5967650480760018
23233,2012.178333,2012.220967,1,60365349,60366629,1280,0.6013502281114276
23234,2012.243067,2012.258833,1,60367292,60367764,472,0.7586096630730466
23235,2012.2779,2012.309767,1,60368337,60369293,956,0.7574364389154145
23236,2012.3499,2012.353633,1,60370497,60370608,111,-0.03805159088792323
23237,2012.354633,2012.358667,1,60370638,60370760,122,0.26799954492072264
23238,2012.3676,2012.371933,1,60371028,60371157,129,-0.21218803805632128
23239,2012.458533,2012.4634,1,60373755,60373902,147,0.04486055628942435
23240,2012.481167,2012.5287,1,60374435,60375861,1426,0.8021920039923286
23241,2012.532967,2012.583867,1,60375989,60377516,1527,0.8713172327354115
23242,2012.837067,2013.025467,1,60385112,60390764,5652,0.793840753437958
23243,2013.044267,2013.081733,1,60391328,60392451,1123,0.7347580026406377
23244,2013.0963,2013.184433,1,60392889,60395532,2643,0.7874569829138409
23245,2013.1864,2013.221867,1,60395592,60396656,1064,0.8520134518304101
23246,2013.533,2013.568533,1,60405990,60407055,1065,0.8034379375595347
23247,2013.5814,2013.669933,1,60407442,60410097,2655,0.7171082555429361
23248,2013.6797,2013.687767,1,60410391,60410633,242,0.6949573908330018
23249,2013.6892,2013.721233,1,60410676,60411636,960,0.6937192062241706
23250,2013.743433,2013.747567,1,60412302,60412427,125,-0.07540266052056162
23251,2013.763467,2013.768133,1,60412904,60413043,139,-0.1480053999266512
23252,2013.774967,2013.8027,1,60413249,60414081,832,0.20617865758487144
23253,2013.827,2013.830667,1,60414810,60414920,110,
23254,2013.832633,2013.9425,1,60414978,60418275,3297,0.7523875240905963
23255,2014.058133,2014.1073,1,60421743,60423219,1476,0.698279584648806
23256,2014.1089,2014.1174,1,60423267,60423522,255,0.8391982632037648
23257,2014.118867,2014.189767,1,60423566,60425693,2127,0.8096830865743699
23258,2014.197367,2014.301233,1,60425921,60429036,3115,0.7829928339413736
23259,2014.5952,2014.6293,1,60437856,60438879,1023,0.6449168529770307
23260,2014.6352,2014.648567,1,60439056,60439457,401,0.7994338095388317
23261,2014.6943,2014.7973,1,60440829,60443919,3090,0.786465077459626
23262,2014.8254,2014.843333,1,60444762,60445299,537,0.634027705926117
23263,2014.856433,2014.862133,1,60445692,60445863,171,0.17888186383069132
23264,2014.8709,2014.8779,1,60446127,60446337,210,-0.08590364015228316
23265,2014.879433,2014.883267,1,60446382,60446498,116,-0.184456332347389
23266,2014.892267,2014.929867,1,60446768,60447896,1128,0.17018525283108063
23267,2014.94,2014.946733,1,60448200,60448401,201,0.23284903405406274
23268,2014.9534,2015.1433,1,60448602,60454299,5697,0.8147032664978985
23269,2015.1482,2015.195567,1,60454446,60455867,1421,0.8930745699235584
23270,2015.4588,2015.4677,1,60463764,60464031,267,0.5795554130719468
23271,2015.4777,2015.486967,1,60464331,60464609,278,0.39295696584763457
23272,2015.490667,2015.553533,1,60464720,60466605,1885,0.7590349883992988
23273,2015.569867,2015.599033,1,60467096,60467970,874,0.7352171370841138
23274,2015.625333,2015.661033,1,60468759,60469830,1071,0.6759937133515406
23275,2015.6755,2015.6867,1,60470265,60470601,336,0.6288305395806159
23276,2015.695533,2015.700833,1,60470865,60471024,159,0.29196725193968065
23277,2015.7105,2015.714033,1,60471315,60471420,105,-0.04353193302662855
23278,2015.729467,2015.738,1,60471884,60472140,256,-0.07508802461810939
23279,2015.741967,2015.7595,1,60472259,60472785,526,0.16757990463970213
23280,2015.761,2015.775967,1,60472830,60473279,449,0.44287214333030256
23281,2015.791367,2015.8103,1,60473741,60474309,568,0.5335135326104882
23282,2015.8133,2015.8472,1,60474399,60475416,1017,0.8199571640081394
23283,2015.849267,2015.855567,1,60475478,60475667,189,0.41450456277617426
23284,2015.856967,2015.866133,1,60475709,60475983,274,0.648869430549503
23285,2015.8672,2015.8711,1,60476016,60476133,117,0.5995255261257496
23286,2015.8752,2015.897733,1,60476256,60476931,675,0.8579480719113717
23287,2015.9073,2015.913233,1,60477219,60477396,177,0.566280231418228
23288,2015.927,2015.933533,1,60477810,60478005,195,-0.11509246861863313
23289,2015.934733,2015.9465,1,60478041,60478395,354,0.010077477186745924
23290,2015.9479,2015.956567,1,60478437,60478697,260,0.10563272623670625
23291,2015.968767,2016.135267,1,60479063,60484058,4995,0.8529381484164129
23292,2016.1562,2016.160533,1,60484686,60484815,129,0.02593453550125632
23293,2016.166167,2016.1703,1,60484985,60485109,124,-0.07774330386516433
23294,2016.177067,2016.186367,1,60485312,60485591,279,0.3459355046456151
23295,2016.1874,2016.199567,1,60485622,60485987,365,-0.02577985022825018
23296,2016.2075,2016.212,1,60486225,60486360,135,
23297,2016.244367,2016.247733,1,60487331,60487431,100,
23298,2016.2534,2016.293367,1,60487602,60488801,1199,0.7875749577691649
23299,2016.295267,2016.420267,1,60488858,60492608,3750,0.8502541090634727
23300,2016.4388,2016.488333,1,60493164,60494649,1485,0.08949355227905015
23301,2016.5017,2016.526667,1,60495051,60495800,749,0.6492872689139291
23302,2016.528133,2016.592733,1,60495843,60497781,1938,0.8824371350307452
23303,2016.596167,2016.668567,1,60497885,60500057,2172,0.8119001233936125
23304,2016.686133,2016.8137,1,60500583,60504411,3828,0.7280805835227147
23305,2016.8223,2016.8255,1,60504669,60504765,96,-0.012871426187926045
23306,2016.984833,2016.994867,1,60509544,60509846,302,0.4254689915881851
23307,2016.996267,2017.0007,1,60509888,60510021,133,0.5434043934221778
23308,2017.0124,2017.055233,1,60510372,60511656,1284,0.8066316676296275
23309,2017.063467,2017.067633,1,60511904,60512028,124,0.8703548248456382
23310,2017.069233,2017.082133,1,60512076,60512463,387,0.7061021522714118
23311,2017.084633,2017.105867,1,60512538,60513176,638,0.6303410084096629
23312,2017.115367,2017.214433,1,60513461,60516432,2971,0.7478134174445885
23313,2017.218333,2017.239867,1,60516549,60517196,647,0.7050293425378626
23314,2017.243033,2017.2896,1,60517290,60518688,1398,0.7323758053901249
23315,2017.294033,2017.3456,1,60518820,60520368,1548,0.8509439626871088
23316,2017.357233,2017.3916,1,60520716,60521748,1032,0.6015208230588158
23317,2017.410833,2017.425233,1,60522324,60522756,432,-0.009338102034369212
23318,2017.43,2017.458033,1,60522900,60523740,840,0.19142130367488583
23319,2017.495833,2017.514733,1,60524874,60525441,567,0.7627317676528256
23320,2017.515767,2017.616233,1,60525473,60528486,3013,0.7757582165810047
23321,2017.931333,2017.9381,1,60537939,60538143,204,0.5753034045287817
23322,2017.939233,2017.964567,1,60538176,60538937,761,0.738926500831393
23323,2017.9676,2018.057867,1,60539028,60541736,2708,0.8085331349333056
23324,2018.071033,2018.074267,1,60542130,60542228,98,0.8253104581789211
23325,2018.140733,2018.144767,1,60544221,60544343,122,-0.2079066422859291
23326,2018.146,2018.162133,1,60544380,60544863,483,0.7048555925806566
23327,2018.1664,2018.1767,1,60544992,60545301,309,0.800500624159873
23328,2018.1864,2018.217933,1,60545592,60546537,945,0.6997881627862249
23329,2018.2498,2018.2536,1,60547494,60547608,114,0.3409947305940111
23330,2018.263,2018.270667,1,60547890,60548120,230,0.287402814211581
23331,2018.279167,2018.3019,1,60548375,60549057,682,-0.033661466174854604
23332,2018.3032,2018.308067,1,60549096,60549242,146,0.02039111411317655
23333,2018.311267,2018.3145,1,60549338,60549435,97,0.07608294166845897
23334,2018.3469,2018.3504,1,60550407,60550512,105,0.6881753866281635
23335,2018.3524,2018.365033,1,60550572,60550950,378,0.9271168356023841
23336,2018.3674,2018.532533,1,60551022,60555975,4953,0.8376532236223624
23337,2018.7665,2018.791833,1,60562995,60563754,759,0.6581189304158438
23338,2018.793067,2018.908833,1,60563792,60567264,3472,0.8352932144928054
23339,2018.910967,2019.0039,1,60567329,60570117,2788,0.8346456491043474
23340,2019.0278,2019.153933,1,60570834,60574617,3783,0.7910577451437802
23341,2019.4007,2019.4155,1,60582021,60582465,444,0.8794299965255966
23342,2019.416667,2019.4237,1,60582500,60582711,211,0.8129660527153891
23343,2019.4265,2019.486233,1,60582795,60584586,1791,0.8514139249284893
23344,2019.488067,2019.560067,1,60584642,60586802,2160,0.8209218692144119
23345,2019.5886,2019.6572,1,60587658,60589716,2058,0.7754013707785525
23346,2019.675533,2019.6801,1,60590265,60590403,138,
23347,2019.696767,2019.731533,1,60590903,60591945,1042,0.12169452533802487
23348,2019.733567,2019.742933,1,60592007,60592287,280,-0.1398976625377785
23349,2019.781133,2019.843433,1,60593433,60595302,1869,0.83174496251306
23350,2019.845167,2020.0508,1,60595355,60601524,6169,0.8472093115484165
23351,2020.052467,2020.103667,1,60601574,60603110,1536,0.8106487081481359
23352,2020.1101,2020.125967,1,60603303,60603779,476,0.7413045023602761
23353,2020.1294,2020.149633,1,60603882,60604488,606,0.5928439351649424
23354,2020.205133,2020.211867,1,60606153,60606356,203,0.5131132739560169
23355,2020.3552,2020.360233,1,60610656,60610806,150,0.478376428896095
23356,2020.3626,2020.366067,1,60610878,60610982,104,
23357,2020.384167,2020.401667,1,60611525,60612050,525,0.8757823090861467
23358,2020.433767,2020.456133,1,60613013,60613683,670,0.8601603163718906
23359,2020.4585,2020.482967,1,60613755,60614489,734,0.8198925258825368
23360,2020.4876,2020.515767,1,60614628,60615473,845,0.7004906125958051
23361,2020.517833,2020.5375,1,60615534,60616125,591,0.6109743586972122
23362,2020.543067,2020.6404,1,60616292,60619212,2920,0.7717604560778745
23363,2020.645533,2020.661267,1,60619365,60619838,473,0.7781359124141205
23364,2020.662267,2020.692267,1,60619868,60620768,900,0.7663185379788976
23365,2020.6937,2020.805367,1,60620811,60624161,3350,0.7533077541813911
23366,2020.917867,2020.937667,1,60627536,60628130,594,0.4035986055378192
23367,2020.938933,2020.975033,1,60628167,60629250,1083,0.8184259647257969
23368,2020.985567,2021.026733,1,60629567,60630801,1234,0.8095356963315015
23369,2021.030667,2021.0362,1,60630920,60631086,166,0.724480520698217
23370,2021.055633,2021.085267,1,60631668,60632558,890,0.05964895539359362
23371,2021.089333,2021.0963,1,60632679,60632889,210,-0.06683542610493967
23372,2021.1314,2021.137567,1,60633942,60634127,185,0.9128359438197992
23373,2021.14,2021.3018,1,60634200,60639054,4854,0.8657257680670847
23374,2021.335133,2021.3391,1,60640053,60640173,120,0.5491193171411439
23375,2021.343633,2021.4286,1,60640308,60642858,2550,0.778838727329496
23376,2021.433967,2021.449067,1,60643019,60643472,453,0.787377609839992
23377,2021.453167,2021.4694,1,60643595,60644082,487,0.6055254153963516
23378,2021.500233,2021.517567,1,60645006,60645527,521,0.24844836998921221
23379,2021.519267,2021.532633,1,60645578,60645978,400,0.14725050837364562
23380,2021.537667,2021.544167,1,60646130,60646325,195,0.22728532945653898
23381,2021.578033,2021.783333,1,60647340,60653499,6159,0.854213673538478
23382,2021.789033,2021.7939,1,60653670,60653817,147,0.4356253571687861
23383,2021.8126,2021.826867,1,60654378,60654806,428,0.042308792288499014
23384,2021.828867,2021.837167,1,60654866,60655115,249,0.14248319338266774
23385,2021.839033,2021.851333,1,60655170,60655539,369,0.17061673216171758
23386,2021.853367,2021.864733,1,60655601,60655941,340,0.5638508055329307
23387,2021.899133,2021.915,1,60656973,60657450,477,0.8955781538716137
23388,2021.9167,2022.0287,1,60657501,60660861,3360,0.8300123793392148
23389,2022.030167,2022.033167,1,60660905,60660995,90,0.6148992682924799
23390,2022.050233,2022.068467,1,60661506,60662054,548,0.7383070012798735
23391,2022.069667,2022.139833,1,60662090,60664194,2104,0.8357990028768714
23392,2022.147233,2022.198367,1,60664416,60665951,1535,0.675161081875175
23393,2022.202667,2022.277267,1,60666080,60668318,2238,0.7196506807560107
23394,2022.286333,2022.31,1,60668589,60669300,711,0.682932760096838
23395,2022.312667,2022.337067,1,60669380,60670112,732,0.745772615994397
23396,2022.346733,2022.3988,1,60670401,60671964,1563,0.058499805782529536
23397,2022.410733,2022.415567,1,60672321,60672467,146,0.005102573941040815
23398,2022.419067,2022.581167,1,60672572,60677435,4863,0.8325710857221164
23399,2022.5923,2022.613133,1,60677769,60678393,624,0.7983118169212745
23400,2022.6158,2022.619133,1,60678474,60678573,99,
23401,2022.6203,2022.656967,1,60678609,60679709,1100,0.6315894879681843
23402,2022.676133,2022.8729,1,60680283,60686187,5904,0.7897184771250774
23403,2022.889667,2022.936767,1,60686690,60688103,1413,0.7802273214437562
23404,2022.938567,2022.979467,1,60688157,60689384,1227,0.8185161312873042
23405,2022.9962,2023.006233,1,60689886,60690186,300,0.20234769242648185
23406,2023.010233,2023.041967,1,60690306,60691259,953,0.18747341653413307
23407,2023.060333,2023.0641,1,60691809,60691923,114,-0.06366780778664262
23408,2023.068833,2023.084633,1,60692064,60692538,474,-0.06389979996125397
23409,2023.088267,2023.127067,1,60692648,60693812,1164,0.8196799241342828
23410,2023.1346,2023.1764,1,60694038,60695292,1254,0.8402642623100427
23411,2023.185533,2023.1906,1,60695565,60695718,153,-0.0003947106103519611
23412,2023.195767,2023.202933,1,60695873,60696087,214,0.15458574643076373
23413,2023.205867,2023.228367,1,60696176,60696851,675,0.2725098911226478
23414,2023.240933,2023.2449,1,60697227,60697347,120,-0.16194864528350764
23415,2023.246567,2023.253467,1,60697397,60697604,207,0.6658889355601879
23416,2023.254733,2023.427533,1,60697641,60702825,5184,0.8196274663738257
23417,2023.4466,2023.449767,1,60703398,60703493,95,
23418,2023.4509,2023.456833,1,60703527,60703704,177,0.04047565084592901
23419,2023.458233,2023.499233,1,60703746,60704976,1230,0.08629747020451642
23420,2023.5014,2023.523667,1,60705042,60705710,668,0.265391997265697
23421,2023.526233,2023.534867,1,60705786,60706046,260,0.5351490136747455
23422,2023.5378,2023.673133,1,60706134,60710193,4059,0.805687081357342
23423,2023.6832,2023.7611,1,60710496,60712833,2337,0.8060890562469317
23424,2023.764367,2023.770933,1,60712931,60713127,196,0.6430537243049043
23425,2023.7852,2023.8529,1,60713556,60715587,2031,0.8373856991605318
23426,2023.865467,2023.8693,1,60715964,60716079,115,0.8562205053087656
23427,2023.874467,2023.903267,1,60716234,60717098,864,0.7634132502890864
23428,2023.9214,2023.953833,1,60717642,60718614,972,0.04549922557548922
23429,2023.957367,2023.980867,1,60718721,60719426,705,0.27302959169249974
23430,2024.0075,2024.224867,1,60720225,60726746,6521,0.8475809377520902
23431,2024.238033,2024.2525,1,60727140,60727575,435,-0.015403877014621568
23432,2024.255367,2024.2686,1,60727661,60728058,397,0.03288817143525014
23433,2024.270733,2024.2855,1,60728121,60728565,444,0.2090607238999993
23434,2024.291567,2024.2997,1,60728747,60728991,244,0.10117564276123371
23435,2024.336867,2024.351233,1,60730106,60730536,430,0.620540463430918
23436,2024.353567,2024.3916,1,60730607,60731748,1141,0.8294808588639895
23437,2024.3962,2024.4186,1,60731886,60732558,672,0.7311596441296622
23438,2024.427433,2024.451233,1,60732822,60733536,714,0.9161872409977337
23439,2024.4559,2024.4656,1,60733677,60733968,291,-0.06122362419911724
23440,2024.485033,2024.527567,1,60734550,60735827,1277,0.19470443494507844
23441,2024.530533,2024.628967,1,60735915,60738869,2954,0.7751547468710325
23442,2024.630067,2024.6917,1,60738902,60740751,1849,0.8359131200473573
23443,2024.6956,2024.699467,1,60740868,60740984,116,0.6740796832059718
23444,2024.705467,2024.766767,1,60741164,60743003,1839,0.8337022147180848
23445,2024.772833,2024.8055,1,60743184,60744165,981,0.6756755470240646
23446,2024.829933,2024.868633,1,60744897,60746058,1161,0.05394805405675389
23447,2024.877067,2024.882,1,60746312,60746460,148,-0.20129702640231992
23448,2024.9035,2025.1174,1,60747105,60753522,6417,0.8505099638861954
23449,2025.121833,2025.2785,1,60753654,60758355,4701,0.7856028380922795
23450,2025.282667,2025.290367,1,60758480,60758711,231,0.7075862874581694
23451,2025.293,2025.372933,1,60758790,60761187,2397,0.7634522608459462
23452,2025.4948,2025.508367,1,60764844,60765251,407,0.8835847536344686
23453,2025.511067,2025.611833,1,60765332,60768354,3022,0.8534272378396338
23454,2025.627333,2025.640967,1,60768819,60769229,410,-0.02448549946619675
23455,2025.642967,2025.650767,1,60769289,60769523,234,-0.07850472534886813
23456,2025.661133,2025.664167,1,60769833,60769925,92,
23457,2025.7099,2025.716467,1,60771297,60771494,197,0.7296601990186455
23458,2025.721033,2025.783167,1,60771630,60773495,1865,0.8442264900765886
23459,2025.7855,2025.841767,1,60773565,60775253,1688,0.7832901137831597
23460,2025.857667,2025.9316,1,60775730,60777948,2218,0.8239787076728875
23461,2025.935667,2026.087267,1,60778070,60782618,4548,0.7594916937454493
23462,2026.090933,2026.1205,1,60782727,60783615,888,0.7168433207139595
23463,2026.1309,2026.152433,1,60783927,60784572,645,0.03322385690091846
23464,2026.154867,2026.167267,1,60784646,60785018,372,0.09645560852285252
23465,2026.172267,2026.1778,1,60785168,60785334,166,0.34692124333686475
23466,2026.211833,2026.2262,1,60786354,60786786,432,0.5085459053981458
23467,2026.228167,2026.325733,1,60786845,60789771,2926,0.8674090853840071
23468,2026.33,2026.366667,1,60789900,60791000,1100,0.8806401455454606
23469,2026.381,2026.405067,1,60791430,60792152,722,-0.05610915309419861
23470,2026.406167,2026.430467,1,60792185,60792914,729,0.12316987376681741
23471,2026.447867,2026.472167,1,60793436,60794165,729,0.36046751238224384
23472,2026.4748,2026.511633,1,60794244,60795348,1104,0.8269572882274855
23473,2026.513333,2026.560967,1,60795399,60796829,1430,0.7922686065798944
23474,2026.580933,2026.612367,1,60797427,60798371,944,0.04429554537879906
23475,2026.6136,2026.6305,1,60798408,60798915,507,0.14774380307049523
23476,2026.650633,2026.823433,1,60799518,60804702,5184,0.8275535769177813
23477,2026.849967,2026.945233,1,60805499,60808356,2857,0.7960339457380592
23478,2027.0373,2027.041833,1,60811119,60811254,135,0.21371800197369178
23479,2027.050833,2027.189533,1,60811524,60815685,4161,0.7606472084307331
23480,2027.190533,2027.194633,1,60815715,60815838,123,0.6670857130752048
23481,2027.1958,2027.261067,1,60815874,60817832,1958,0.7588785070020138
23482,2027.271067,2027.367667,1,60818132,60821030,2898,0.8010350013602179
23483,2027.3691,2027.399767,1,60821073,60821993,920,0.7192242789638705
23484,2027.414067,2027.428267,1,60822422,60822848,426,-0.06512719284608476
23485,2027.430833,2027.4689,1,60822924,60824067,1143,0.30997393614226704
23486,2027.497767,2027.5074,1,60824933,60825222,289,0.6314276104100949
23487,2027.509567,2027.5878,1,60825287,60827634,2347,0.8322461133354697
23488,2027.589467,2027.708867,1,60827684,60831266,3582,0.8544289362383208
23489,2027.718567,2027.7225,1,60831557,60831675,118,
23490,2027.737767,2027.756533,1,60832133,60832695,562,0.009945109698327462
23491,2027.757667,2027.768,1,60832730,60833040,310,0.2112277785060559
23492,2027.7704,2027.7904,1,60833112,60833712,600,0.20248494292654873
23493,2027.816333,2027.8334,1,60834489,60835002,513,0.9378276671642043
23494,2027.837767,2027.842867,1,60835133,60835286,153,0.8355736030715097
23495,2027.846367,2027.935067,1,60835391,60838052,2661,0.7952782817165426
23496,2027.9386,2027.946567,1,60838158,60838397,239,-0.055146621893003483
23497,2027.9584,2027.994567,1,60838752,60839837,1085,0.06866642644719403
23498,2027.9972,2028.0125,1,60839916,60840375,459,0.48068358401628825
23499,2028.033533,2028.0471,1,60841005,60841413,408,0.7745619308529813
23500,2028.048333,2028.228333,1,60841449,60846849,5400,0.7796395998020774
23501,2028.2853,2028.288733,1,60848559,60848661,102,
23502,2028.344767,2028.465767,1,60850343,60853973,3630,0.7654154473090601
23503,2028.476233,2028.5686,1,60854286,60857058,2772,0.7852647768792481
23504,2028.573633,2028.636633,1,60857208,60859098,1890,0.8493648576515876
23505,2028.662433,2028.6864,1,60859872,60860592,720,0.7810636670888503
23506,2028.704967,2028.709567,1,60861149,60861287,138,
23507,2028.7192,2028.731933,1,60861576,60861957,381,0.023054613870846678
23508,2028.736,2028.761467,1,60862080,60862844,764,0.27585761758366645
23509,2028.768233,2028.776433,1,60863046,60863292,246,0.24963826451306748
23510,2028.807067,2028.8845,1,60864212,60866535,2323,0.8370432781433028
23511,2028.8857,2028.9363,1,60866571,60868089,1518,0.8546613119162141
23512,2028.937367,2029.011633,1,60868121,60870348,2227,0.8161225943138671
23513,2029.034733,2029.072633,1,60871041,60872178,1137,-0.004783548665680962
23514,2029.076733,2029.087467,1,60872301,60872624,323,0.1428850281181034
23515,2029.122767,2029.1292,1,60873683,60873876,193,0.3633999302079573
23516,2029.137267,2029.305733,1,60874118,60879171,5053,0.8280754687668629
23517,2029.3069,2029.3608,1,60879207,60880824,1617,0.806488643904542
23518,2029.3625,2029.4814,1,60880875,60884442,3567,0.7781963795742153
23519,2029.488067,2029.497267,1,60884642,60884918,276,0.07892578968206429
23520,2029.511567,2029.521933,1,60885347,60885657,310,-0.06631105426617817
23521,2029.523067,2029.537433,1,60885692,60886122,430,0.17531641378087917
23522,2029.5412,2029.547167,1,60886236,60886415,179,-0.06202798893263177
23523,2029.548167,2029.5558,1,60886445,60886674,229,-0.0682822072079723
23524,2029.584433,2029.5951,1,60887532,60887853,321,0.45759612314940257
23525,2029.596833,2029.603767,1,60887904,60888113,209,0.4215224305893974
23526,2029.614167,2029.738533,1,60888425,60892155,3730,0.7965783520712824
23527,2029.7416,2029.8448,1,60892248,60895344,3096,0.7708312079658447
23528,2029.856733,2029.886067,1,60895701,60896582,881,-0.06357161027920084
23529,2029.887367,2029.895133,1,60896621,60896853,232,0.012251890794636447
23530,2029.908,2029.911633,1,60897240,60897348,108,
23531,2029.924833,2029.928733,1,60897744,60897861,117,0.2216199642991175
23532,2029.9331,2029.951233,1,60897993,60898536,543,0.7957080786047311
23533,2029.952667,2029.955833,1,60898580,60898674,94,0.8031687120107448
23534,2029.957567,2030.1092,1,60898727,60903276,4549,0.8466281644250879
23535,2030.1377,2030.1441,1,60904131,60904323,192,0.8412563286645679
23536,2030.145733,2030.240967,1,60904371,60907229,2858,0.7892108678417216
23537,2030.2444,2030.267233,1,60907332,60908016,684,0.24015171714366243
23538,2030.270067,2030.383667,1,60908102,60911510,3408,0.7614898878715693
23539,2030.385667,2030.4606,1,60911570,60913818,2248,0.8451183372522992
23540,2030.4653,2030.482167,1,60913959,60914465,506,0.7099934436448134
23541,2030.485967,2030.497967,1,60914579,60914939,360,0.4071285205829678
23542,2030.780767,2030.8012,1,60923423,60924036,613,0.8353606495191924
23543,2030.804067,2030.832267,1,60924122,60924968,846,0.8001123042031003
23544,2030.834967,2030.847667,1,60925049,60925430,381,0.8930455926473848
23545,2030.8564,2030.894467,1,60925692,60926834,1142,0.826145200714576
23546,2030.938633,2030.942767,1,60928158,60928283,125,0.23006260830901987
23547,2030.9474,2030.954633,1,60928422,60928638,216,-0.38684169852761224
23548,2031.0556,2031.059233,1,60931668,60931776,108,-0.35755753682533503
23549,2031.064767,2031.0703,1,60931943,60932109,166,0.7253903307674162
23550,2031.073833,2031.090233,1,60932214,60932706,492,0.1756914367706476
23551,2031.120633,2031.124167,1,60933618,60933725,107,
23552,2031.1636,2031.170667,1,60934908,60935120,212,0.7021188740099455
23553,2031.218133,2031.224933,1,60936543,60936747,204,0.5528482713316377
23554,2031.251533,2031.257467,1,60937545,60937724,179,-0.01858475275455762
23555,2031.2589,2031.264567,1,60937767,60937937,170,-0.050503625192708144
23556,2031.3581,2031.440867,1,60940743,60943226,2483,0.7814709520008101
23557,2031.4421,2031.472133,1,60943263,60944163,900,0.8584495591818909
23558,2031.650733,2031.656033,1,60949521,60949680,159,0.23641677905037087
23559,2031.657333,2031.668733,1,60949719,60950061,342,0.17349592665437416
23560,2031.672967,2031.6786,1,60950189,60950358,169,
23561,2031.6822,2031.702367,1,60950466,60951071,605,0.4188012458708899
23562,2031.712167,2031.763267,1,60951365,60952898,1533,0.10504407191289086
23563,2031.780267,2031.889733,1,60953408,60956691,3283,0.8083360165580905
23564,2032.165967,2032.1864,1,60964979,60965592,613,0.6399221202572407
23565,2032.1937,2032.2045,1,60965811,60966135,324,0.7294486392041334
23566,2032.258333,2032.273367,1,60967749,60968201,452,0.6699631715250581
23567,2032.299567,2032.3501,1,60968987,60970503,1516,0.6973422616689368
23568,2032.383433,2032.395967,1,60971502,60971879,377,0.7207685819397481
23569,2032.4202,2032.432867,1,60972606,60972986,380,0.7192466958455067
23570,2032.437367,2032.4522,1,60973121,60973566,445,0.6152633989717544
23571,2032.471833,2032.4834,1,60974154,60974502,348,0.3521466898415576
23572,2032.4894,2032.496567,1,60974682,60974897,215,0.024398662719597668
23573,2032.499067,2032.505367,1,60974972,60975161,189,0.37827443392247634
23574,2032.509033,2032.546433,1,60975270,60976392,1122,0.04664208870133102
23575,2032.576633,2032.692367,1,60977298,60980771,3473,0.7349578983963166
23576,2032.714267,2032.725967,1,60981428,60981779,351,0.4421048719333899
23577,2032.735567,2032.749867,1,60982067,60982496,429,-0.07696792313923777
23578,2032.753233,2032.763367,1,60982596,60982901,305,0.20717993997815418
23579,2032.767433,2032.790033,1,60983022,60983700,678,0.12353984846417475
23580,2032.797067,2032.808367,1,60983912,60984251,339,0.16404113966495304
23581,2032.816533,2032.833967,1,60984495,60985019,524,0.24269900050249885
23582,2032.841333,2032.892167,1,60985239,60986765,1526,0.43723011193711403
23583,2032.902833,2032.9123,1,60987084,60987369,285,0.15167941096646284
23584,2032.913567,2032.9198,1,60987407,60987594,187,
23585,2032.922933,2032.942767,1,60987687,60988283,596,0.024536120498096566
23586,2032.949733,2032.958333,1,60988491,60988749,258,0.068468822831871
23587,2032.964567,2033.0576,1,60988937,60991728,2791,0.5575022558521696
23588,2033.231733,2033.277033,1,60996951,60998310,1359,0.8343816785419422
23589,2033.2784,2033.3113,1,60998352,60999339,987,0.6282961680337493
23590,2033.326867,2033.346467,1,60999806,61000394,588,0.8947471754580135
23591,2033.3566,2033.479067,1,61000698,61004372,3674,0.7925398700202203
23592,2033.5114,2033.514667,1,61005342,61005440,98,-0.09031294637857255
23593,2033.527467,2033.653067,1,61005824,61009592,3768,0.7949527123050484
23594,2033.655633,2033.755167,1,61009668,61012655,2987,0.7864106853121855
23595,2033.757767,2033.768833,1,61012733,61013064,331,0.3002607885575744
23596,2033.778467,2033.815267,1,61013354,61014458,1104,-0.03945521742229086
23597,2033.817267,2033.823667,1,61014518,61014710,192,-0.03649353218372467
23598,2033.8288,2033.833933,1,61014864,61015017,153,0.38783651852928097
23599,2033.844733,2033.8493,1,61015341,61015479,138,0.5503369649190367
23600,2033.8519,2033.9255,1,61015557,61017765,2208,0.8457632737475238
23601,2033.926667,2034.0226,1,61017800,61020678,2878,0.835087286085478
23602,2034.026133,2034.049467,1,61020783,61021484,701,0.8948159007637322
23603,2034.4224,2034.428433,1,61032672,61032852,180,0.7625498581054567
23604,2034.437333,2034.456467,1,61033119,61033694,575,0.7802753455599203
23605,2034.495633,2034.5166,1,61034868,61035498,630,0.8806215319935696
23606,2034.535533,2034.5423,1,61036065,61036269,204,0.170556778169832
23607,2034.5538,2034.578333,1,61036614,61037349,735,0.7907800659628353
23608,2034.5942,2034.602767,1,61037826,61038083,257,0.6769311944392286
23609,2034.609633,2034.6167,1,61038288,61038501,213,0.5796567566096695
23610,2034.626133,2034.6385,1,61038783,61039155,372,0.661138073517376
23611,2034.661467,2034.679867,1,61039844,61040396,552,0.5819031683327662
23612,2034.688267,2034.701067,1,61040648,61041032,384,0.4228887770927827
23613,2034.728233,2034.753233,1,61041846,61042596,750,0.5980442747786611
23614,2034.771967,2034.7834,1,61043159,61043502,343,0.6646498273325724
23615,2034.7899,2034.803333,1,61043697,61044099,402,0.6123708845158984
23616,2034.8258,2034.835267,1,61044774,61045058,284,0.3412194273656071
23617,2034.848133,2034.859567,1,61045443,61045787,344,-0.08014298157334221
23618,2034.860567,2034.886933,1,61045817,61046607,790,0.0016516941244457133
23619,2034.8882,2034.895,1,61046646,61046850,204,-0.09460803901555592
23620,2034.921333,2034.984967,1,61047639,61049549,1910,0.7625067043174145
23621,2034.9862,2035.046067,1,61049586,61051382,1796,0.744936639035094
23622,2035.523067,2035.528333,1,61065692,61065849,157,0.5728415100033486
23623,2035.5309,2035.534133,1,61065927,61066023,96,0.12318538747821993
23624,2035.540367,2035.548533,1,61066211,61066455,244,0.7537968168436067
23625,2035.5509,2035.580733,1,61066527,61067421,894,0.7344362177898509
23626,2035.594033,2035.622933,1,61067820,61068687,867,0.7578940694543309
23627,2035.6259,2035.717167,1,61068777,61071515,2738,0.6926177043397937
23628,2035.729567,2035.746433,1,61071887,61072392,505,0.7095831486664107
23629,2035.813567,2035.8206,1,61074407,61074618,211,0.6013082219884192
23630,2035.825067,2035.829633,1,61074752,61074888,136,0.3474489559781995
23631,2035.839567,2035.845367,1,61075187,61075361,174,0.7339623929067501
23632,2035.8473,2035.8574,1,61075419,61075722,303,0.6232757951729909
23633,2035.861667,2035.873767,1,61075850,61076213,363,0.5622114038896104
23634,2035.907,2035.937967,1,61077210,61078139,929,0.6287155427951084
23635,2035.940033,2035.964,1,61078200,61078920,720,0.606585850163
23636,2035.9867,2035.9993,1,61079601,61079979,378,0.6585515491231106
23637,2036.0012,2036.006033,1,61080036,61080180,144,0.5329458662291318
23638,2036.341233,2036.448233,1,61090236,61093446,3210,0.8394273622703642
23639,2037.8274,2037.831667,1,61134822,61134950,128,0.05432666602125342
23640,2037.8538,2037.858233,1,61135614,61135746,132,0.3706232849729574
23641,2037.859433,2037.8631,1,61135782,61135893,111,0.6105220212060043
23642,2037.892433,2037.912533,1,61136772,61137375,603,0.6040521552421356
23643,2037.948533,2037.953033,1,61138455,61138590,135,0.5935909096692259
23644,2037.958967,2037.969867,1,61138769,61139096,327,0.5906799088768014
23645,2038.035267,2038.042033,1,61141058,61141260,202,0.5703436150374008
23646,2038.249767,2038.2971,1,61147493,61148913,1420,0.7952794263724661
23647,2038.2983,2038.3242,1,61148949,61149726,777,0.72577612263405
23648,2038.326,2038.353467,1,61149780,61150604,824,0.864318838754057
23649,2038.726967,2038.7302,1,61161809,61161906,97,0.5919035485318868
23650,2038.767533,2038.777233,1,61163025,61163316,291,0.5774012648968315
23651,2038.802967,2038.813833,1,61164089,61164414,325,0.7622162360777875
23652,2038.877067,2038.892633,1,61166312,61166778,466,0.5703623296971836
23653,2038.929167,2038.9433,1,61167875,61168299,424,0.7566840523812084
23654,2038.967067,2038.9715,1,61169012,61169145,133,0.15921014103215025
23655,2038.978633,2038.991733,1,61169358,61169751,393,0.6768388804013137
23656,2038.9928,2039.0034,1,61169784,61170102,318,0.46176464530186084
23657,2039.0324,2039.037667,1,61170972,61171130,158,0.6369831606676011
23658,2039.042967,2039.049667,1,61171289,61171490,201,0.5744709709839673
23659,2039.206867,2039.225833,1,61176206,61176774,568,0.7662328979454295
23660,2039.2269,2039.322367,1,61176807,61179671,2864,0.6940779537473072
23661,2039.517467,2039.526367,1,61185524,61185791,267,0.6165951663038004
23662,2039.5332,2039.554133,1,61185996,61186623,627,0.2148714760867042
23663,2039.5559,2039.560667,1,61186677,61186820,143,0.23634247001692768
23664,2039.5746,2039.590133,1,61187238,61187703,465,0.26002984837789955
23665,2039.672167,2039.682933,1,61190165,61190487,322,0.86466988156376
23666,2039.685133,2039.833133,1,61190553,61194993,4440,0.794471884815606
23667,2039.872,2039.8966,1,61196160,61196898,738,0.61979446774938
23668,2039.913133,2040.051033,1,61197393,61201530,4137,0.7524587547644389
23669,2040.057867,2040.14,1,61201736,61204200,2464,0.8191482426823178
23670,2040.146433,2040.171333,1,61204392,61205139,747,0.6856214279312777
23671,2040.181467,2040.192133,1,61205444,61205763,319,0.5708504579781155
23672,2040.207233,2040.214033,1,61206216,61206420,204,0.2058252374633629
23673,2040.2187,2040.224867,1,61206561,61206746,185,-0.11894116564616239
23674,2040.228067,2040.239667,1,61206842,61207190,348,0.042699182427105124
23675,2040.245167,2040.256067,1,61207355,61207682,327,0.23017980854473602
23676,2040.258167,2040.267033,1,61207745,61208010,265,0.22587883755068544
23677,2040.4663,2040.578967,1,61213989,61217369,3380,0.7981060615991407
23678,2040.9109,2040.9176,1,61227327,61227528,201,0.6238444026040616
23679,2040.9263,2040.9496,1,61227789,61228488,699,0.7918871758929357
23680,2040.9553,2041.0318,1,61228659,61230954,2295,0.834936481188751
23681,2041.050933,2041.146533,1,61231527,61234395,2868,0.7980988307988531
23682,2041.1486,2041.154233,1,61234458,61234626,168,0.7769705064445438
23683,2041.167867,2041.183833,1,61235036,61235514,478,0.9050400607730475
23684,2041.4992,2041.512933,1,61244976,61245387,411,0.46183923280619016
23685,2041.513967,2041.5521,1,61245419,61246563,1144,0.8096431701289034
23686,2041.554367,2041.560733,1,61246631,61246821,190,0.869726830913531
23687,2041.564167,2041.6055,1,61246925,61248165,1240,0.784166230664619
23688,2041.6318,2041.636067,1,61248954,61249082,128,-0.1455929325388211
23689,2041.638533,2041.651033,1,61249155,61249530,375,-0.01988223241370871
23690,2041.6542,2041.670233,1,61249626,61250106,480,0.45483625995617627
23691,2041.958133,2041.9642,1,61258743,61258926,183,0.7264672880159622
23692,2041.987267,2041.995167,1,61259618,61259855,237,0.5921700964801363
23693,2041.998567,2042.004067,1,61259957,61260122,165,0.4520731047673619
23694,2042.009067,2042.0156,1,61260272,61260468,196,0.6550170182855012
23695,2042.0245,2042.057533,1,61260735,61261725,990,0.7556529822328877
23696,2042.0753,2042.1043,1,61262259,61263129,870,0.6641904879192969
23697,2042.1377,2042.143767,1,61264131,61264313,182,0.5880933125247163
23698,2042.158633,2042.1687,1,61264758,61265061,303,0.450022268899145
23699,2042.1896,2042.231967,1,61265688,61266959,1271,0.6812619580368516
23700,2042.252767,2042.271033,1,61267583,61268130,547,0.6085265335013779
23701,2042.296067,2042.307867,1,61268882,61269236,354,0.5363050574603474
23702,2042.3202,2042.323333,1,61269606,61269699,93,0.3323891420341172
23703,2042.3577,2042.366067,1,61270731,61270982,251,0.1340931583065173
23704,2042.448367,2042.454867,1,61273451,61273646,195,0.6005532217815529
23705,2042.4594,2042.575833,1,61273782,61277274,3492,0.7484037201954774
23706,2042.9198,2042.970033,1,61287594,61289100,1506,0.7352169381288979
23707,2042.980233,2043.026367,1,61289406,61290791,1385,0.7916787776974415
23708,2043.061467,2043.073433,1,61291844,61292202,358,0.2543376782343048
23709,2043.343433,2043.4261,1,61300302,61302783,2481,0.8328402219259419
23710,2043.429767,2043.507633,1,61302893,61305228,2335,0.7860651031403987
23711,2043.512733,2043.588867,1,61305381,61307666,2285,0.7771922923953685
23712,2043.598567,2043.6259,1,61307957,61308777,820,0.698379449196162
23713,2043.627767,2043.6419,1,61308833,61309257,424,0.6501303862402611
23714,2043.683633,2043.693667,1,61310508,61310810,302,-0.13989280735767018
23715,2043.694967,2043.728867,1,61310849,61311866,1017,0.20499318423221832
23716,2043.990067,2043.9974,1,61319702,61319922,220,0.5918498676730691
23717,2043.9991,2044.1123,1,61319973,61323369,3396,0.7978467381628424
23718,2044.121733,2044.153867,1,61323651,61324616,965,0.8140719546947743
23719,2044.156867,2044.221567,1,61324706,61326647,1941,0.8259268932042846
23720,2044.2302,2044.263267,1,61326906,61327898,992,0.631458226334913
23721,2044.293267,2044.2963,1,61328798,61328889,91,
23722,2044.297333,2044.3093,1,61328919,61329279,360,0.04902937947659428
23723,2044.3103,2044.329833,1,61329309,61329894,585,0.1252946638318961
23724,2044.3362,2044.341267,1,61330086,61330238,152,0.32919483341666944
23725,2044.417767,2044.435567,1,61332533,61333067,534,0.37926345230315334
23726,2044.441867,2044.4686,1,61333256,61334058,802,0.1717832249475654
23727,2044.469667,2044.476167,1,61334090,61334285,195,0.10295086909419902
23728,2044.4801,2044.4939,1,61334403,61334817,414,0.25895010220620474
23729,2044.495233,2044.614667,1,61334856,61338440,3584,0.8201661012475173
23730,2044.628367,2044.635833,1,61338851,61339074,223,-0.1225544389248872
23731,2044.645367,2044.651633,1,61339361,61339548,187,-0.05258480338608179
23732,2044.652833,2044.683533,1,61339584,61340505,921,0.045136022239763
23733,2044.686933,2044.691733,1,61340607,61340751,144,
23734,2045.047067,2045.052833,1,61351412,61351584,172,0.7388748476942103
23735,2045.058,2045.0664,1,61351740,61351992,252,0.5893110738082584
23736,2045.0959,2045.099167,1,61352877,61352975,98,0.7759683040541945
23737,2045.1009,2045.117733,1,61353027,61353531,504,0.6291512472087728
23738,2045.155067,2045.161867,1,61354652,61354856,204,0.4575860064529442
23739,2045.171633,2045.1907,1,61355148,61355721,573,0.5960262871459032
23740,2045.2042,2045.2349,1,61356126,61357047,921,0.6374384057532198
23741,2045.265267,2045.285267,1,61357958,61358558,600,0.5079803965502221
23742,2045.288833,2045.3552,1,61358664,61360656,1992,0.6526405309097767
23743,2045.370333,2045.389667,1,61361109,61361690,581,0.6299772653537288
23744,2045.394267,2045.398933,1,61361828,61361967,139,0.6927778884932728
23745,2045.406167,2045.4439,1,61362185,61363317,1132,0.5739820741750278
23746,2045.4707,2045.4811,1,61364121,61364433,312,0.6462602297779892
23747,2045.482633,2045.495867,1,61364478,61364876,398,0.4956767468234016
23748,2045.529667,2045.534567,1,61365890,61366037,147,-0.08031673172864735
23749,2045.535667,2045.581233,1,61366070,61367436,1366,0.07867980639465529
23750,2045.602667,2045.6242,1,61368080,61368726,646,0.7751029594788064
23751,2045.6252,2045.718333,1,61368756,61371549,2793,0.7887833155677639
23752,2045.749533,2045.753167,1,61372485,61372595,110,0.017632526188712482
23753,2045.765033,2045.768167,1,61372950,61373045,95,
23754,2045.937233,2045.969933,1,61378116,61379097,981,0.7180179612611145
23755,2046.2308,2046.2344,1,61386924,61387032,108,0.2428431580550499
23756,2046.2406,2046.2905,1,61387218,61388715,1497,0.7836851437893335
23757,2046.297833,2046.342633,1,61388934,61390278,1344,0.7582091069754925
23758,2046.365967,2046.369333,1,61390979,61391079,100,
23759,2046.3815,2046.385933,1,61391445,61391577,132,0.20280970059368392
23760,2046.3973,2046.410733,1,61391919,61392321,402,-0.09987599575173504
23761,2046.4123,2046.422967,1,61392369,61392689,320,-0.08789048744104135
23762,2046.459967,2046.539233,1,61393799,61396176,2377,0.4731257833908156
23763,2046.790467,2046.8524,1,61403714,61405572,1858,0.6895945713424125
23764,2046.8607,2046.8794,1,61405821,61406382,561,0.7387057822681077
23765,2046.888033,2046.8984,1,61406640,61406952,312,0.7631105550611997
23766,2046.9298,2046.973033,1,61407894,61409190,1296,0.7713475108411714
23767,2046.985033,2047.021067,1,61409550,61410632,1082,0.6856989111128815
23768,2047.0565,2047.0605,1,61411695,61411815,120,
23769,2047.066633,2047.078933,1,61411998,61412367,369,0.1741065603202892
23770,2047.0804,2047.0924,1,61412412,61412772,360,0.07047350819636704
23771,2047.0945,2047.1026,1,61412835,61413078,243,0.03183439513896254
23772,2047.247567,2047.266733,1,61417427,61418001,574,0.8197815681190538
23773,2047.267967,2047.2782,1,61418039,61418346,307,0.6282424972970548
23774,2047.559733,2047.579733,1,61426791,61427391,600,0.7689701428218225
23775,2047.5813,2047.696133,1,61427439,61430883,3444,0.8559508573374806
23776,2047.702733,2047.756367,1,61431081,61432691,1610,0.8214162133522143
23777,2047.7588,2047.804233,1,61432764,61434126,1362,0.7511462416795774
23778,2047.809433,2047.814133,1,61434282,61434423,141,0.25026207126151595
23779,2047.834,2047.9304,1,61435020,61437912,2892,0.7680377805963473
23780,2047.934233,2047.9561,1,61438026,61438683,657,0.6671169044296884
23781,2047.960067,2047.9826,1,61438802,61439478,676,0.48989389042896175
23782,2047.9851,2048.012167,1,61439553,61440365,812,0.8186587834510916
23783,2048.013833,2048.072933,1,61440414,61442187,1773,0.794887190401603
23784,2048.089633,2048.105167,1,61442688,61443155,467,0.6769059136895216
23785,2048.1102,2048.1214,1,61443306,61443642,336,0.48695362488913846
23786,2048.128767,2048.131833,1,61443863,61443954,91,0.7171359261514674
23787,2048.1582,2048.162,1,61444745,61444859,114,
23788,2048.1642,2048.167967,1,61444926,61445039,113,
23789,2048.176333,2048.182333,1,61445289,61445469,180,0.5531480209252313
23790,2048.265133,2048.272767,1,61447953,61448183,230,-0.16232851880912286
23791,2048.278767,2048.2818,1,61448363,61448454,91,0.4612920895901943
23792,2048.282967,2048.286,1,61448489,61448580,91,-0.10055889378798914
23793,2048.540233,2048.548067,1,61456206,61456442,236,0.7126394777784483
23794,2048.553767,2048.557433,1,61456613,61456722,109,0.2607720680988012
23795,2048.564633,2048.568933,1,61456938,61457067,129,0.4852471291940757
23796,2048.609333,2048.6239,1,61458279,61458717,438,0.6971943469177573
23797,2048.708267,2048.766967,1,61461248,61463009,1761,0.642183177817526
23798,2048.771267,2048.791167,1,61463138,61463735,597,0.6272610904829757
23799,2048.8243,2048.915,1,61464729,61467450,2721,0.8212661509917144
23800,2049.206333,2049.209633,1,61476189,61476288,99,-0.12024912233943912
23801,2049.234433,2049.2452,1,61477032,61477355,323,0.6689433588965202
23802,2049.2474,2049.252467,1,61477422,61477574,152,0.6683578202121044
23803,2049.300333,2049.311033,1,61479009,61479330,321,0.34671252038358735
23804,2049.321433,2049.3246,1,61479642,61479738,96,0.5275231903429002
23805,2049.3278,2049.333833,1,61479834,61480014,180,0.5676955880933137
23806,2049.379833,2049.389833,1,61481394,61481694,300,0.8068876851525139
23807,2049.411767,2049.4724,1,61482353,61484172,1819,0.5189358731294135
23808,2049.484567,2049.499067,1,61484537,61484972,435,0.6642873469567859
23809,2049.5018,2049.5152,1,61485054,61485455,401,0.6313513994850297
23810,2049.683333,2049.6956,1,61490499,61490868,369,0.6875336053966713
23811,2049.696867,2049.729,1,61490906,61491869,963,0.6034876959189542
23812,2049.774967,2049.7937,1,61493249,61493811,562,0.23558313442553996
23813,2049.8112,2049.8223,1,61494336,61494668,332,-0.022418723758119912
23814,2049.8267,2049.831067,1,61494801,61494932,131,-0.036244505972071364
23815,2049.833,2049.838133,1,61494990,61495143,153,-0.10028399316722297
23816,2049.9465,2049.962467,1,61498395,61498874,479,0.4244671248878838
23817,2049.963633,2049.9793,1,61498908,61499379,471,0.6921966250984558
23818,2049.987233,2050.003,1,61499616,61500090,474,0.31166273747510587
23819,2050.018533,2050.0228,1,61500555,61500684,129,0.7836011391176889
23820,2050.028033,2050.0372,1,61500840,61501116,276,0.24243402505847572
23821,2050.211733,2050.220433,1,61506351,61506612,261,0.3584630072080542
23822,2050.2343,2050.251367,1,61507029,61507541,512,0.45797030045158016
23823,2050.253133,2050.329533,1,61507593,61509885,2292,0.26357266360419285
23824,2050.361567,2050.495567,1,61510847,61514867,4020,0.7280163689293622
23825,2050.512767,2050.5203,1,61515383,61515609,226,0.4799816763838543
23826,2050.525167,2050.545,1,61515755,61516350,595,0.14463081514640455
23827,2050.557267,2050.650367,1,61516718,61519511,2793,0.740050396150293
23828,2051.368633,2051.3937,1,61541058,61541811,753,0.6417139676809174
23829,2051.4392,2051.444667,1,61543175,61543340,165,0.41117668236730326
23830,2051.468567,2051.474967,1,61544057,61544249,192,0.5286782464066625
23831,2051.4948,2051.5084,1,61544844,61545252,408,0.8667298275390556
23832,2051.581367,2051.585667,1,61547441,61547570,129,0.5765565226697573
23833,2051.641033,2051.646967,1,61549230,61549409,179,0.6605949193201196
23834,2051.648067,2051.6572,1,61549442,61549716,274,0.6304030310646189
23835,2051.792733,2051.970367,1,61553781,61559111,5330,0.7718165811770713
23836,2051.981533,2052.011633,1,61559445,61560348,903,0.7879434687439523
23837,2052.013,2052.037433,1,61560390,61561122,732,0.6072939172754972
23838,2052.318467,2052.325067,1,61569554,61569752,198,0.42103310915959125
23839,2052.327267,2052.343867,1,61569818,61570316,498,0.7905090027285956
23840,2052.3474,2052.440567,1,61570422,61573217,2795,0.8316378020692857
23841,2052.7412,2052.8392,1,61582236,61585176,2940,0.7412755377110596
23842,2052.844233,2053.058667,1,61585326,61591760,6434,0.7516160254008601
23843,2053.0758,2053.081233,1,61592274,61592436,162,0.16905463774708113
23844,2053.087333,2053.091,1,61592619,61592730,111,0.34126075664131367
23845,2053.0929,2053.0967,1,61592787,61592901,114,0.08882886593842473
23846,2053.235133,2053.241767,1,61597053,61597253,200,0.5702867584966825
23847,2053.245633,2053.264933,1,61597368,61597947,579,0.32818215435964077
23848,2053.267,2053.340967,1,61598009,61600229,2220,0.1833294770499039
23849,2053.380233,2053.4327,1,61601406,61602980,1574,0.7805910586044557
23850,2053.434267,2053.4384,1,61603028,61603152,124,-0.11271765615116325
23851,2053.440033,2053.457133,1,61603200,61603713,513,0.6501828363508699
23852,2053.4586,2053.484433,1,61603758,61604532,774,0.8521507182898083
23853,2053.5015,2053.517967,1,61605044,61605539,495,0.3958557535847698
23854,2053.5282,2053.5425,1,61605846,61606275,429,-0.05158718240263462
23855,2053.544867,2053.555667,1,61606346,61606670,324,0.11478982070366507
23856,2053.560467,2053.5694,1,61606814,61607081,267,0.6151962170877392
23857,2053.8115,2053.814767,1,61614344,61614443,99,0.6412316269791677
23858,2053.823067,2053.989,1,61614692,61619670,4978,0.7922341643039073
23859,2054.004633,2054.0272,1,61620138,61620816,678,0.6032389650947794
23860,2054.033,2054.095033,1,61620990,61622850,1860,0.8445799747091396
23861,2054.098567,2054.1104,1,61622957,61623312,355,0.8546006506411316
23862,2054.1559,2054.244267,1,61624677,61627328,2651,0.7761981375952175
23863,2054.5331,2054.6467,1,61635993,61639400,3407,0.8471708936678332
23864,2054.6761,2054.6794,1,61640283,61640382,99,0.46039438484459233
23865,2054.683267,2054.6886,1,61640498,61640658,160,
23866,2054.954367,2054.9674,1,61648631,61649022,391,0.5867126159024207
23867,2054.970933,2054.9799,1,61649127,61649396,269,0.7543400037061676
23868,2054.981633,2055.119067,1,61649448,61653572,4124,0.7820610255606104
23869,2055.1265,2055.149933,1,61653794,61654497,703,0.7655393525636147
23870,2055.151,2055.288933,1,61654529,61658667,4138,0.701413465567398
23871,2055.2935,2055.298533,1,61658805,61658955,150,0.06849953370423892
23872,2055.367767,2055.372867,1,61661033,61661186,153,0.09649116852693418
23873,2055.378667,2055.381933,1,61661360,61661457,97,-0.42116683631314517
23874,2055.4778,2055.485567,1,61664334,61664567,233,0.3871459133303462
23875,2055.491067,2055.582967,1,61664732,61667489,2757,0.21288942827513668
23876,2055.584833,2055.703367,1,61667544,61671101,3557,0.8124853049871337
23877,2055.726433,2055.7324,1,61671792,61671971,179,0.8330717965531791
23878,2055.7433,2055.750867,1,61672299,61672526,227,-0.09116548049609005
23879,2055.9153,2055.9377,1,61677459,61678131,672,0.6157158268816995
23880,2056.156567,2056.209,1,61684697,61686269,1572,0.8042423905933147
23881,2056.210767,2056.262633,1,61686323,61687878,1555,0.775988848467386
23882,2056.2971,2056.309167,1,61688912,61689275,363,0.06235162880521216
23883,2056.313667,2056.3172,1,61689410,61689516,106,-0.07694793383045913
23884,2056.3304,2056.333567,1,61689911,61690007,96,
23885,2056.3367,2056.3446,1,61690100,61690338,238,-0.04290277761810607
23886,2056.3457,2056.370433,1,61690370,61691112,742,0.20257952201089033
23887,2056.376533,2056.3797,1,61691295,61691391,96,
23888,2056.3993,2056.405,1,61691979,61692150,171,0.10118901473694408
23889,2056.409133,2056.496733,1,61692273,61694901,2628,0.1290755624072285
23890,2056.497767,2056.508033,1,61694933,61695240,307,-0.009491939097184748
23891,2056.5289,2056.6016,1,61695866,61698048,2182,0.7103680977741511
23892,2056.602633,2056.6875,1,61698078,61700625,2547,0.7117256833227965
23893,2056.698833,2056.754967,1,61700964,61702649,1685,0.7709744571606374
23894,2056.771267,2056.774667,1,61703138,61703240,102,-0.15618057681998732
23895,2056.916533,2056.920467,1,61707495,61707614,119,0.10049097445664568
23896,2056.9229,2056.930333,1,61707687,61707909,222,0.5851616015341295
23897,2056.931333,2057.026067,1,61707939,61710782,2843,0.16288980443566917
23898,2057.057867,2057.197067,1,61711736,61715912,4176,0.7577821984388406
23899,2057.6186,2057.6231,1,61728557,61728692,135,0.6599992675883076
23900,2057.625933,2057.629767,1,61728777,61728893,116,0.608867925187545
23901,2057.6417,2057.661633,1,61729251,61729848,597,0.7601254938829467
23902,2057.668567,2057.683167,1,61730057,61730495,438,0.8376130958890226
23903,2057.686067,2057.694,1,61730582,61730820,238,0.7715672877025243
23904,2057.696133,2057.728933,1,61730883,61731867,984,0.676540313409216
23905,2057.7421,2057.788367,1,61732263,61733651,1388,0.7471079732736667
23906,2057.791067,2057.795267,1,61733732,61733858,126,0.36081716627177535
23907,2057.797033,2057.830067,1,61733910,61734902,992,0.7703647898952279
23908,2057.833567,2057.851733,1,61735007,61735551,544,0.7458325036695178
23909,2057.8529,2057.879633,1,61735586,61736388,802,0.6180128328302231
23910,2057.887767,2057.9065,1,61736633,61737195,562,0.8601822990105445
23911,2057.9102,2057.9595,1,61737305,61738785,1480,0.8008015198981434
23912,2057.974533,2057.989567,1,61739235,61739687,452,0.6002785636798552
23913,2057.995367,2058.074767,1,61739861,61742243,2382,0.7324066093027726
23914,2058.3581,2058.484567,1,61750743,61754537,3794,0.77563748657403
23915,2058.485767,2058.4889,1,61754573,61754666,93,-0.1219974109969215
23916,2058.949067,2059.035133,1,61768472,61771053,2581,0.7477834760892879
23917,2059.038567,2059.161667,1,61771157,61774850,3693,0.7150590337269157
23918,2059.1668,2059.2464,1,61775004,61777392,2388,0.7497435271619528
23919,2059.251833,2059.2738,1,61777554,61778214,660,0.7113916688587689
23920,2059.2798,2059.295767,1,61778393,61778873,480,0.7323422990653278
23921,2059.325567,2059.331633,1,61779767,61779948,181,0.7024968864844457
23922,2059.353633,2059.367467,1,61780608,61781024,416,0.18531028085283208
23923,2059.3745,2059.379433,1,61781235,61781382,147,-0.1008680958380667
23924,2059.5943,2059.678267,1,61787829,61790348,2519,0.8535034222414689
23925,2059.679667,2059.7457,1,61790390,61792371,1981,0.7923640301031776
23926,2059.748467,2059.777567,1,61792454,61793327,873,0.7238751100983146
23927,2059.778867,2059.790567,1,61793366,61793717,351,0.8867296910073033
23928,2059.8791,2059.937867,1,61796373,61798136,1763,0.680242071364925
23929,2059.9466,2060.005567,1,61798398,61800167,1769,0.7869252939633101
23930,2060.026633,2060.0304,1,61800798,61800912,114,0.44966182250445297
23931,2060.3316,2060.4883,1,61809948,61814649,4701,0.8245204195115916
23932,2060.8168,2060.826333,1,61824504,61824789,285,0.6734634576721369
23933,2060.837867,2060.873567,1,61825136,61826207,1071,0.7715316771754598
23934,2060.8997,2060.915867,1,61826991,61827476,485,0.758418268961421
23935,2060.9234,2060.946733,1,61827702,61828401,699,0.6882491574887774
23936,2060.955633,2061.0007,1,61828668,61830021,1353,0.5600997128749562
23937,2061.0233,2061.0386,1,61830698,61831157,459,0.8072351659032605
23938,2061.061333,2061.077867,1,61831839,61832336,497,0.8183045812969351
23939,2061.085667,2061.100567,1,61832570,61833017,447,0.8087453288595596
23940,2061.112133,2061.122233,1,61833363,61833666,303,-0.06391348391178645
23941,2061.124667,2061.1337,1,61833740,61834010,270,-0.11832666627594558
23942,2061.141267,2061.164467,1,61834238,61834934,696,0.04815230895646983
23943,2061.170033,2061.1846,1,61835100,61835538,438,0.22521351357547195
23944,2061.2223,2061.2938,1,61836669,61838814,2145,0.818051501841847
23945,2061.294967,2061.344667,1,61838849,61840340,1491,0.8138302485378679
23946,2061.607033,2061.723133,1,61848210,61851693,3483,0.806293073413781
23947,2061.725967,2061.846733,1,61851779,61855401,3622,0.7510333213469759
23948,2061.847733,2061.891833,1,61855431,61856754,1323,0.7085783636016241
23949,2061.892833,2061.9278,1,61856784,61857834,1050,0.8612788814690155
23950,2061.929,2061.982733,1,61857870,61859481,1611,0.7138883559749395
23951,2062.288133,2062.368867,1,61868643,61871066,2423,0.7103968071119156
23952,2062.3758,2062.3829,1,61871273,61871487,214,0.7172880158197577
23953,2062.3851,2062.4999,1,61871553,61874996,3443,0.8057540895659894
23954,2062.6529,2062.656567,1,61879587,61879697,110,0.40124331055443974
23955,2062.668867,2062.677667,1,61880066,61880330,264,0.5965181264365902
23956,2062.680533,2062.685267,1,61880415,61880558,143,0.48132746679912664
23957,2062.688233,2062.757467,1,61880646,61882724,2078,0.2418410784975687
23958,2062.782267,2062.7889,1,61883468,61883667,199,0.6383447103831524
23959,2062.8035,2062.906267,1,61884105,61887188,3083,0.7770060243139635
23960,2062.911633,2062.945167,1,61887348,61888355,1007,0.7658093147282267
23961,2062.961767,2063.028433,1,61888853,61890852,1999,0.7707929672537608
23962,2063.071133,2063.093167,1,61892133,61892795,662,0.5751145815639528
23963,2063.108567,2063.124567,1,61893257,61893737,480,0.6132704042770213
23964,2063.129567,2063.192067,1,61893887,61895762,1875,0.7688106166330416
23965,2063.199233,2063.204567,1,61895976,61896137,161,-0.16422433209030185
23966,2063.4762,2063.662133,1,61904286,61909863,5577,0.773915179768371
23967,2063.680533,2063.693067,1,61910415,61910792,377,0.8242286533503699
23968,2063.697,2063.704633,1,61910910,61911138,228,
23969,2063.710567,2063.713733,1,61911317,61911411,94,0.15747365415880282
23970,2063.732267,2063.775333,1,61911968,61913259,1291,0.6774496099195556
23971,2063.777633,2063.7821,1,61913328,61913463,135,0.18165054806656364
23972,2063.786567,2063.813467,1,61913597,61914404,807,0.7844690323602114
23973,2063.8214,2063.873533,1,61914641,61916205,1564,0.8035151403559065
23974,2064.265133,2064.270067,1,61927953,61928102,149,0.7797816684143266
23975,2064.273467,2064.279733,1,61928204,61928391,187,0.6099333370719834
23976,2064.299933,2064.316833,1,61928997,61929504,507,0.48908202073183865
23977,2064.317967,2064.323767,1,61929539,61929713,174,0.5926190159463649
23978,2064.3258,2064.337733,1,61929774,61930131,357,0.5484099592088622
23979,2064.38,2064.399733,1,61931400,61931991,591,0.3387703367577444
23980,2064.409667,2064.4484,1,61932290,61933452,1162,0.003911055096913611
23981,2064.463767,2064.5261,1,61933913,61935783,1870,0.8447350952188708
23982,2064.528967,2064.585067,1,61935869,61937552,1683,0.816806010763536
23983,2064.590033,2064.622633,1,61937700,61938678,978,0.8229602624044174
23984,2064.627867,2064.6537,1,61938836,61939610,774,0.8304331555650878
23985,2064.6548,2064.664433,1,61939643,61939932,289,0.6686513497865741
23986,2064.691967,2064.756733,1,61940759,61942701,1942,0.7854865834340156
23987,2064.762067,2064.801933,1,61942862,61944057,1195,0.7055251548294896
23988,2064.8392,2064.860567,1,61945176,61945817,641,0.0037228531070730288
23989,2065.1118,2065.1374,1,61953354,61954122,768,0.7586233260365925
23990,2065.140767,2065.293033,1,61954223,61958790,4567,0.835524899523116
23991,2065.337633,2065.3414,1,61960128,61960241,113,0.03615358398165961
23992,2065.344867,2065.472767,1,61960346,61964183,3837,0.8140622335903067
23993,2065.685533,2065.706633,1,61970565,61971198,633,0.6937342766270447
23994,2065.998967,2066.014333,1,61979969,61980429,460,0.8997856897600245
23995,2066.015367,2066.044667,1,61980461,61981340,879,0.6803474519793457
23996,2066.0477,2066.068567,1,61981431,61982057,626,0.6768628938860919
23997,2066.078833,2066.107933,1,61982364,61983237,873,0.8024677301784826
23998,2066.133033,2066.1629,1,61983990,61984886,896,0.7386656463870094
23999,2066.179167,2066.2364,1,61985375,61987091,1716,0.578700395558773
24000,2066.260633,2066.271667,1,61987818,61988150,332,0.6582241111706366
24001,2066.272767,2066.2819,1,61988183,61988457,274,0.3196386998413624
24002,2066.303633,2066.312367,1,61989108,61989371,263,0.4532647303124751
24003,2066.3237,2066.368967,1,61989711,61991069,1358,0.15275758337435638
24004,2066.394733,2066.409033,1,61991841,61992270,429,0.6552987356318537
24005,2066.4121,2066.449267,1,61992363,61993478,1115,0.8252779113216775
24006,2066.451367,2066.4565,1,61993541,61993694,153,0.7263835777000354
24007,2066.459433,2066.502833,1,61993782,61995084,1302,0.8324942315163009
24008,2066.506733,2066.509733,1,61995201,61995291,90,0.13863998039644349
24009,2066.520633,2066.5289,1,61995618,61995866,248,-0.10484982794294755
24010,2066.534933,2066.539367,1,61996047,61996181,134,
24011,2066.799233,2066.804967,1,62003976,62004149,173,0.6993748481449402
24012,2066.807733,2066.8283,1,62004231,62004849,618,0.6647349283163418
24013,2066.829467,2066.9832,1,62004884,62009496,4612,0.7951309079587591
24014,2066.991133,2067.0249,1,62009733,62010747,1014,0.6666898390825646
24015,2067.0469,2067.2415,1,62011406,62017245,5839,0.7928061206583984
24016,2067.2675,2067.273167,1,62018025,62018195,170,0.21286786814064335
24017,2067.279,2067.2831,1,62018370,62018493,123,-0.10662441701301308
24018,2067.2974,2067.304533,1,62018922,62019135,213,-0.023976439002939158
24019,2067.3082,2067.311533,1,62019246,62019345,99,
24020,2067.317533,2067.322067,1,62019525,62019662,137,0.7708763157973229
24021,2067.510333,2067.585333,1,62025309,62027559,2250,0.5940351059817507
24022,2067.588733,2067.6286,1,62027661,62028858,1197,0.5962550330431926
24023,2067.652533,2067.657833,1,62029575,62029734,159,0.6363916236839049
24024,2067.660067,2067.671767,1,62029802,62030153,351,0.5409943950429869
24025,2067.688667,2067.703933,1,62030660,62031117,457,0.6009195490628122
24026,2067.7097,2067.724233,1,62031291,62031726,435,0.4849550863256071
24027,2067.7538,2067.807333,1,62032614,62034219,1605,0.07802350669842771
24028,2067.8227,2067.8257,1,62034681,62034770,89,0.5531831844755021
24029,2067.829333,2067.972967,1,62034879,62039189,4310,0.7992466253151451
24030,2067.994833,2068.004467,1,62039844,62040134,290,0.07435872314971162
24031,2068.010567,2068.0201,1,62040317,62040603,286,0.59783474380835
24032,2068.123733,2068.1311,1,62043711,62043933,222,0.19572341506939078
24033,2068.1361,2068.1405,1,62044083,62044215,132,0.08003919243402
24034,2068.163967,2068.167633,1,62044919,62045028,109,0.765117331435626
24035,2068.172833,2068.224167,1,62045184,62046725,1541,0.6625867524869823
24036,2068.2305,2068.2688,1,62046915,62048063,1148,0.6090473885266523
24037,2068.278367,2068.284633,1,62048351,62048538,187,0.5502104752672392
24038,2068.299967,2068.322133,1,62048999,62049663,664,-0.031964969785780575
24039,2068.327533,2068.336333,1,62049825,62050089,264,0.07720831403939715
24040,2068.340267,2068.351767,1,62050208,62050553,345,0.157024152478032
24041,2068.3557,2068.3643,1,62050671,62050929,258,0.7365481347125791
24042,2068.421,2068.5784,1,62052629,62057351,4722,0.8342590229039388
24043,2068.637433,2068.641033,1,62059122,62059230,108,
24044,2068.642667,2068.647033,1,62059280,62059410,130,0.30840351496536544
24045,2068.800733,2068.8097,1,62064021,62064290,269,0.04286018635377121
24046,2068.811833,2068.8427,1,62064354,62065281,927,0.709142484379527
24047,2069.121133,2069.140467,1,62073633,62074214,581,0.7793201690977712
24048,2069.1422,2069.1531,1,62074265,62074593,328,0.7967561553303685
24049,2069.171933,2069.187333,1,62075157,62075619,462,0.8959621864815012
24050,2069.198433,2069.266433,1,62075952,62077992,2040,0.710123350761629
24051,2069.273867,2069.282033,1,62078216,62078460,244,0.6847964989798349
24052,2069.285033,2069.315033,1,62078550,62079450,900,0.7197107706837409
24053,2069.351333,2069.406233,1,62080539,62082186,1647,0.08050270074709677
24054,2069.4191,2069.4226,1,62082573,62082677,104,-0.029874504281677955
24055,2069.4336,2069.442867,1,62083007,62083286,279,0.5306632525907534
24056,2069.444933,2069.567133,1,62083347,62087013,3666,0.7943812786601179
24057,2069.568767,2069.577067,1,62087063,62087312,249,0.900288850053037
24058,2069.591567,2069.807667,1,62087747,62094230,6483,0.7240381114322852
24059,2069.829267,2069.833533,1,62094878,62095005,127,0.12750382658458603
24060,2069.955267,2070.1592,1,62098658,62104776,6118,0.7479309781526707
24061,2070.172733,2070.176233,1,62105181,62105286,105,
24062,2070.1822,2070.221533,1,62105466,62106645,1179,0.17459678507483017
24063,2070.250233,2070.2564,1,62107506,62107692,186,0.7659822654211402
24064,2070.2575,2070.408567,1,62107725,62112257,4532,0.8241235025858186
24065,2070.429267,2070.469233,1,62112878,62114076,1198,0.07262478432892153
24066,2070.5064,2070.5232,1,62115192,62115696,504,0.7414012966936899
24067,2070.5265,2070.562233,1,62115795,62116866,1071,0.7234529483896693
24068,2070.564833,2070.615433,1,62116944,62118462,1518,0.728865054014323
24069,2070.642933,2070.6481,1,62119287,62119443,156,
24070,2070.650667,2070.654567,1,62119520,62119637,117,
24071,2070.656567,2070.659867,1,62119697,62119796,99,0.3336296445609451
24072,2070.661667,2070.6756,1,62119850,62120268,418,-0.06539594299091342
24073,2070.685267,2070.849833,1,62120558,62125494,4936,0.8014627897872703
24074,2070.869167,2070.8735,1,62126075,62126205,130,
24075,2070.8826,2070.893167,1,62126478,62126795,317,-0.022314351338924163
24076,2070.8943,2070.917033,1,62126829,62127510,681,0.06558825495468873
24077,2070.918867,2070.926,1,62127566,62127780,214,0.4999637632269516
24078,2070.9532,2071.150233,1,62128596,62134506,5910,0.8195138285112447
24079,2071.184767,2071.2328,1,62135543,62136984,1441,0.09514730063375436
24080,2071.246067,2071.2509,1,62137382,62137527,145,0.8519702523945833
24081,2071.255367,2071.283567,1,62137661,62138507,846,0.8052924471893033
24082,2071.294433,2071.365533,1,62138832,62140965,2133,0.7948629063874154
24083,2071.384467,2071.479233,1,62141534,62144376,2842,0.7527105743532727
24084,2071.504467,2071.518633,1,62145134,62145558,424,0.07095585237207958
24085,2071.521433,2071.553867,1,62145642,62146616,974,0.20061364019060704
24086,2071.577,2071.713467,1,62147310,62151404,4094,0.8252537173564486
24087,2071.726733,2071.73,1,62151801,62151900,99,0.7544538562525099
24088,2071.731467,2071.774433,1,62151944,62153232,1288,0.7582884845264445
24089,2071.776867,2071.8549,1,62153306,62155646,2340,0.7974848672964118
24090,2071.8618,2071.9006,1,62155854,62157018,1164,0.7525252682912237
24091,2071.921833,2071.9648,1,62157654,62158944,1290,0.08770237891173134
24092,2071.965933,2071.974967,1,62158977,62159249,272,0.23086921330735996
24093,2071.999333,2072.0049,1,62159979,62160147,168,0.43291314915527956
24094,2072.009667,2072.191,1,62160290,62165729,5439,0.8323582651717388
24095,2072.214633,2072.237167,1,62166438,62167115,677,0.8078922492221137
24096,2072.244933,2072.310867,1,62167347,62169326,1979,0.7698101163581401
24097,2072.312467,2072.3258,1,62169374,62169774,400,0.7220584259714095
24098,2072.340367,2072.345433,1,62170211,62170362,151,-0.08250125564929443
24099,2072.3641,2072.382367,1,62170922,62171471,549,0.13478280036051699
24100,2072.3864,2072.396933,1,62171591,62171907,316,0.41883775601048207
24101,2072.4234,2072.4269,1,62172702,62172807,105,0.7395022283364219
24102,2072.429367,2072.548767,1,62172881,62176463,3582,0.7992338588237519
24103,2072.553067,2072.5596,1,62176592,62176788,196,0.224078658934999
24104,2072.570167,2072.582467,1,62177105,62177474,369,-0.06583784364677896
24105,2072.5838,2072.6147,1,62177514,62178441,927,0.18778757881373434
24106,2072.615867,2072.625267,1,62178476,62178758,282,0.24448314700127627
24107,2072.6361,2072.734567,1,62179083,62182037,2954,0.8195927129935279
24108,2072.735833,2072.916433,1,62182074,62187492,5418,0.7484471566424636
24109,2073.0128,2073.0178,1,62190384,62190534,150,0.6899888948833167
24110,2073.0321,2073.051667,1,62190963,62191550,587,0.6662909449781675
24111,2073.056967,2073.073033,1,62191709,62192190,481,0.48093039115130304
24112,2073.084067,2073.156833,1,62192522,62194704,2182,0.7395289053793034
24113,2073.1712,2073.1775,1,62195136,62195324,188,0.46532559133126594
24114,2073.178733,2073.2119,1,62195361,62196356,995,0.744232498631708
24115,2073.2145,2073.370333,1,62196435,62201109,4674,0.772907174087013
24116,2073.371533,2073.401667,1,62201145,62202050,905,0.6546257100305032
24117,2073.412767,2073.468067,1,62202383,62204042,1659,0.05850940679327344
24118,2073.500733,2073.563067,1,62205021,62206892,1871,0.7560346976554884
24119,2073.5667,2073.612133,1,62207000,62208363,1363,0.6910795271174964
24120,2073.625467,2073.6436,1,62208764,62209308,544,-0.008263038261487603
24121,2073.758167,2073.792,1,62212745,62213760,1015,0.7889944217862597
24122,2073.7937,2073.897833,1,62213811,62216934,3123,0.7761513790920349
24123,2073.902,2073.914367,1,62217060,62217431,371,0.06037966317616279
24124,2073.915467,2074.011033,1,62217464,62220330,2866,0.7514553629837177
24125,2074.0144,2074.024933,1,62220432,62220747,315,0.7121878277019776
24126,2074.026267,2074.116833,1,62220788,62223504,2716,0.755161479268617
24127,2074.213933,2074.217667,1,62226417,62226530,113,0.3010479216394828
24128,2074.229,2074.2375,1,62226869,62227125,256,0.47165161423933144
24129,2074.245067,2074.2514,1,62227352,62227542,190,-0.21173116270251865
24130,2074.2564,2074.277933,1,62227692,62228337,645,0.6655517543966852
24131,2074.280967,2074.341867,1,62228429,62230256,1827,0.7617859975863862
24132,2074.347233,2074.395,1,62230416,62231850,1434,0.7202648056336313
24133,2074.396067,2074.419867,1,62231882,62232596,714,0.7644928465954506
24134,2074.422233,2074.4706,1,62232666,62234118,1452,0.8092841261278287
24135,2074.484867,2074.5834,1,62234546,62237502,2956,0.7756871011506036
24136,2074.5859,2074.670867,1,62237577,62240126,2549,0.7545887196941534
24137,2074.672767,2074.695333,1,62240183,62240859,676,0.6622753890141815
24138,2074.697767,2074.761733,1,62240933,62242851,1918,0.7659248281139801
24139,2074.762767,2074.811967,1,62242883,62244359,1476,0.7834918687945692
24140,2074.813633,2074.904967,1,62244408,62247149,2741,0.791269850913109
24141,2074.9071,2074.9298,1,62247213,62247894,681,0.4871886142609496
24142,2074.9329,2075.022967,1,62247986,62250689,2703,0.8065937469388824
24143,2075.0263,2075.052033,1,62250789,62251560,771,0.6019038127027884
24144,2075.054433,2075.144567,1,62251632,62254337,2705,0.8055853520361822
24145,2075.1472,2075.1732,1,62254416,62255196,780,0.4756320094503581
24146,2075.176633,2075.268467,1,62255298,62258054,2756,0.8095943082441553
24147,2075.271533,2075.298167,1,62258145,62258945,800,0.7867605069422499
24148,2075.3011,2075.395367,1,62259033,62261861,2828,0.7760883521359199
24149,2075.399867,2075.424167,1,62261996,62262725,729,0.7991248603305262
24150,2075.4276,2075.521067,1,62262828,62265632,2804,0.7731082357700784
24151,2075.524567,2075.5377,1,62265737,62266130,393,0.45987923166244477
24152,2075.556233,2075.594833,1,62266686,62267844,1158,0.7821035865812456
24153,2075.596433,2075.612367,1,62267892,62268371,479,0.7370635397758856
24154,2075.627567,2075.644733,1,62268827,62269341,514,0.7334264568755233
24155,2075.649,2075.6629,1,62269470,62269886,416,0.8883502250921216
24156,2075.679167,2075.716933,1,62270375,62271507,1132,0.8034780264234093
24157,2075.718233,2075.734933,1,62271546,62272047,501,0.7400592021619213
24158,2075.7502,2075.771533,1,62272506,62273145,639,0.741502339985772
24159,2075.776967,2075.7835,1,62273309,62273505,196,0.481484543783128
24160,2075.785067,2075.7914,1,62273552,62273742,190,0.9172303352373896
24161,2075.808233,2075.847967,1,62274246,62275439,1193,0.7702465663050664
24162,2075.850367,2075.866233,1,62275511,62275986,475,0.6654271759002762
24163,2075.884367,2075.899667,1,62276531,62276990,459,0.6743842084851667
24164,2075.904533,2075.917533,1,62277135,62277525,390,0.6188272205220938
24165,2075.935433,2075.9755,1,62278062,62279265,1203,0.7964202598011463
24166,2075.976767,2075.9937,1,62279303,62279811,508,0.76113467681145
24167,2076.001633,2076.029,1,62280048,62280870,822,0.7277714610826578
24168,2076.035567,2076.0388,1,62281067,62281163,96,0.429806466725229
24169,2076.064933,2076.1217,1,62281947,62283651,1704,0.7216238469226832
24170,2076.143067,2076.1569,1,62284292,62284707,415,0.7057181930407967
24171,2076.174633,2076.178767,1,62285238,62285363,125,0.7736926556169373
24172,2076.195433,2076.252933,1,62285862,62287587,1725,0.7168175470156026
24173,2076.277433,2076.2889,1,62288322,62288667,345,0.7477026040499067
24174,2076.293467,2076.3009,1,62288804,62289027,223,0.3167927327576199
24175,2076.326067,2076.366533,1,62289782,62290995,1213,0.7641911303932013
24176,2076.370367,2076.385433,1,62291111,62291562,451,0.7161596732230772
24177,2076.411867,2076.422267,1,62292356,62292668,312,0.8100664356196907
24178,2076.427,2076.442533,1,62292810,62293275,465,0.2183922480049421
24179,2076.450833,2076.508533,1,62293524,62295255,1731,0.664534466339066
24180,2076.5439,2076.548433,1,62296317,62296452,135,
24181,2076.6069,2076.6221,1,62298207,62298663,456,0.5098495210374135
24182,2076.640167,2076.645367,1,62299205,62299361,156,0.6400059088258544
24183,2076.646467,2076.738,1,62299394,62302139,2745,0.7805126174376279
24184,2076.755267,2076.7586,1,62302658,62302758,100,
24185,2076.863833,2076.870567,1,62305914,62306117,203,0.3459834430572375
24186,2076.8802,2076.926767,1,62306406,62307803,1397,0.7843495889552246
24187,2076.931033,2076.975733,1,62307930,62309271,1341,0.8198357443169029
24188,2076.991233,2076.995033,1,62309736,62309850,114,
24189,2076.997133,2077.001233,1,62309913,62310036,123,0.11619632323315632
24190,2077.011167,2077.027833,1,62310335,62310834,499,0.7771808169748371
24191,2077.029,2077.0374,1,62310870,62311122,252,0.7485031668479636
24192,2077.0531,2077.1792,1,62311593,62315376,3783,0.7643782410200064
24193,2077.185733,2077.267,1,62315571,62318009,2438,0.7743509985447642
24194,2077.275,2077.3101,1,62318250,62319303,1053,0.772104795415231
24195,2077.312867,2077.383733,1,62319386,62321511,2125,0.7716711419860387
24196,2077.412267,2077.466633,1,62322368,62323998,1630,0.7676042902235972
24197,2077.471533,2077.5005,1,62324145,62325015,870,0.8743396661352321
24198,2077.505867,2077.510467,1,62325176,62325314,138,0.6917012729687466
24199,2077.5371,2077.592667,1,62326113,62327780,1667,0.7631156652462122
24200,2077.5957,2077.604633,1,62327870,62328138,268,0.8736496281882341
24201,2077.606533,2077.6293,1,62328195,62328879,684,0.8007434415151216
24202,2077.633667,2077.648567,1,62329010,62329457,447,-0.02397458660038804
24203,2077.663333,2077.704133,1,62329899,62331123,1224,0.7800708434047336
24204,2077.705367,2077.758867,1,62331161,62332766,1605,0.8435070666535527
24205,2077.7626,2077.770633,1,62332878,62333118,240,0.5065088405734941
24206,2077.794433,2077.851433,1,62333832,62335542,1710,0.8303326433934225
24207,2077.8535,2077.8904,1,62335605,62336712,1107,0.8247909856972004
24208,2077.9044,2077.910933,1,62337132,62337327,195,0.21774309855333485
24209,2077.924367,2078.024867,1,62337731,62340746,3015,0.8035182055745533
24210,2078.028433,2078.050967,1,62340852,62341529,677,0.6147420372061326
24211,2078.0595,2078.158267,1,62341784,62344748,2964,0.8455906300996443
24212,2078.1612,2078.1816,1,62344836,62345448,612,0.7980588222486465
24213,2078.193633,2078.2512,1,62345808,62347536,1728,0.734294448531879
24214,2078.276533,2078.288467,1,62348295,62348654,359,0.7865451100542268
24215,2078.2916,2078.298933,1,62348748,62348967,219,0.7294964921339796
24216,2078.303767,2078.309133,1,62349113,62349273,160,-0.07235292015797516
24217,2078.325367,2078.384067,1,62349761,62351522,1761,0.6986583073109505
24218,2078.413433,2078.421,1,62352402,62352629,227,0.7051667116867539
24219,2078.426267,2078.434367,1,62352788,62353031,243,0.0793681206548879
24220,2078.458933,2078.497767,1,62353767,62354933,1166,0.731671324397141
24221,2078.502267,2078.517033,1,62355068,62355510,442,0.5992558992917361
24222,2078.538567,2078.5523,1,62356157,62356568,411,0.7178027072721509
24223,2078.5576,2078.577867,1,62356728,62357336,608,0.5584822865067857
24224,2078.5897,2078.6513,1,62357691,62359539,1848,0.7323738252408156
24225,2078.673167,2078.688167,1,62360195,62360645,450,0.7581814490154123
24226,2078.706367,2078.711867,1,62361191,62361356,165,0.46452196767628734
24227,2078.727767,2078.767767,1,62361833,62363033,1200,0.6771587456917226
24228,2078.772067,2078.7853,1,62363162,62363559,397,0.6623766203174994
24229,2078.814433,2078.821533,1,62364432,62364645,213,0.7097364129358901
24230,2078.828067,2078.833067,1,62364842,62364992,150,0.27654693509032297
24231,2078.839533,2078.8427,1,62365185,62365281,96,-0.29747860829943734
24232,2078.851133,2078.884533,1,62365533,62366535,1002,0.5391040451820287
24233,2078.885867,2078.894533,1,62366576,62366835,259,0.3462233525886568
24234,2078.920133,2078.936733,1,62367603,62368101,498,-0.11426450584259386
24235,2078.950433,2078.9616,1,62368512,62368848,336,0.5470616351434571
24236,2078.9727,2078.976633,1,62369180,62369298,118,0.03556157413830905
24237,2078.9936,2079.002333,1,62369807,62370069,262,0.14491735548059348
24238,2079.008333,2079.065433,1,62370249,62371962,1713,0.7748797951450871
24239,2079.099,2079.103267,1,62372970,62373098,128,0.1248609946891687
24240,2079.436133,2079.4436,1,62383083,62383308,225,0.7747100858677347
24241,2079.4464,2079.4662,1,62383391,62383985,594,0.5228276656977433
24242,2079.4944,2079.510467,1,62384832,62385314,482,0.6947229927103774
24243,2079.645,2079.648867,1,62389350,62389466,116,0.5074225596076387
24244,2079.6506,2079.654867,1,62389518,62389646,128,0.5958255924717446
24245,2079.656867,2079.8325,1,62389706,62394975,5269,0.8535343111714465
24246,2079.857367,2079.932433,1,62395721,62397972,2251,0.8004866175034389
24247,2079.959333,2079.987633,1,62398779,62399628,849,0.8133233838391621
24248,2079.991233,2080.046367,1,62399736,62401391,1655,0.7922557361030826
24249,2080.0484,2080.096867,1,62401452,62402906,1454,0.778475905972132
24250,2080.099467,2080.194367,1,62402984,62405831,2847,0.8439517399609215
24251,2080.198,2080.2236,1,62405939,62406707,768,0.7928018356752006
24252,2080.227267,2080.301733,1,62406818,62409051,2233,0.8193157730885833
24253,2080.302967,2080.3216,1,62409089,62409648,559,0.7719636502263886
24254,2080.324267,2080.340567,1,62409728,62410217,489,0.7614881873032591
24255,2080.3552,2080.455767,1,62410656,62413673,3017,0.8214166472588569
24256,2080.459133,2080.4629,1,62413773,62413887,114,-0.19168289757236373
24257,2080.466867,2080.476033,1,62414006,62414280,274,0.8391351579808484
24258,2080.490467,2080.591267,1,62414714,62417738,3024,0.8215067471317351
24259,2080.594833,2080.6214,1,62417844,62418642,798,0.8648179790605904
24260,2080.624567,2080.7228,1,62418737,62421684,2947,0.8305230614657426
24261,2080.726533,2080.7479,1,62421795,62422436,641,0.6430486444234265
24262,2080.7593,2080.862267,1,62422779,62425868,3089,0.8166911543725474
24263,2080.8654,2080.869267,1,62425962,62426078,116,0.5702687084538282
24264,2080.896333,2080.993467,1,62426889,62429804,2915,0.7752679454446265
24265,2080.997733,2081.017867,1,62429931,62430536,605,0.5619387154221313
24266,2081.029767,2081.069433,1,62430893,62432082,1189,0.8035663910703867
24267,2081.0712,2081.126367,1,62432135,62433791,1656,0.8139305102627331
24268,2081.130833,2081.150933,1,62433924,62434527,603,0.48976668482015007
24269,2081.1636,2081.262167,1,62434907,62437865,2958,0.7975412162506378
24270,2081.2717,2081.2951,1,62438150,62438852,702,0.6392182129264702
24271,2081.296367,2081.399933,1,62438891,62441997,3106,0.8135005991336701
24272,2081.405667,2081.430967,1,62442170,62442929,759,0.6527493846241816
24273,2081.436133,2081.520233,1,62443083,62445606,2523,0.8147984645702354
24274,2081.528833,2081.541533,1,62445864,62446245,381,0.5706830761809154
24275,2081.547833,2081.5509,1,62446434,62446527,93,0.03732737215113738
24276,2081.554533,2081.646367,1,62446635,62449391,2756,0.7767560290985609
24277,2081.654167,2081.671933,1,62449625,62450157,532,0.625681999322202
24278,2081.675367,2081.6787,1,62450261,62450361,100,0.5883701876998152
24279,2081.6797,2081.736633,1,62450391,62452098,1707,0.7177993644375789
24280,2081.7377,2081.78,1,62452131,62453400,1269,0.6998486984909832
24281,2081.823333,2081.831267,1,62454699,62454938,239,0.3319962027696412
24282,2082.118833,2082.126533,1,62463564,62463795,231,0.7534952926235272
24283,2082.128633,2082.151733,1,62463858,62464551,693,0.6537121384474379
24284,2082.153033,2082.156067,1,62464590,62464682,92,0.6305965215687916
24285,2082.157333,2082.2113,1,62464719,62466339,1620,0.5937395909922626
24286,2082.224467,2082.2575,1,62466734,62467725,991,0.5988248826447279
24287,2082.2763,2082.280333,1,62468289,62468409,120,0.5845587550633837
24288,2082.282467,2082.2941,1,62468474,62468823,349,0.5622446840214158
24289,2082.295533,2082.319433,1,62468865,62469582,717,0.6267699611093417
24290,2082.332633,2082.3426,1,62469978,62470278,300,0.7443029038558511
24291,2082.363633,2082.369267,1,62470908,62471078,170,0.17720079188486648
24292,2082.379133,2082.438267,1,62471373,62473148,1775,0.018687236640968875
24293,2082.4504,2082.458567,1,62473512,62473757,245,-0.12592299382678301
24294,2082.470133,2082.480633,1,62474103,62474418,315,0.6770068117757216
24295,2082.481667,2082.585333,1,62474450,62477559,3109,0.8255778193602177
24296,2082.604767,2082.613167,1,62478143,62478395,252,0.5290878166489602
24297,2082.6274,2082.655933,1,62478821,62479677,856,0.033320795188293194
24298,2082.6571,2082.678033,1,62479713,62480340,627,0.21367950435298658
24299,2082.6813,2082.695567,1,62480439,62480867,428,0.17032372013496705
24300,2082.767533,2082.7889,1,62483025,62483667,642,0.7762806965566643
24301,2082.7926,2082.925233,1,62483778,62487756,3978,0.8203681301389669
24302,2082.947067,2083.0172,1,62488412,62490515,2103,0.8491597564994456
24303,2083.021267,2083.067667,1,62490638,62492030,1392,0.7978503174350439
24304,2083.095167,2083.115267,1,62492855,62493458,603,-0.0016325111676499203
24305,2083.1165,2083.1461,1,62493495,62494383,888,0.17848345370726984
24306,2083.152867,2083.159433,1,62494586,62494782,196,-0.1291026161487361
24307,2083.160933,2083.2783,1,62494827,62498349,3522,0.7838277119270709
24308,2083.2794,2083.283333,1,62498382,62498499,117,
24309,2083.290567,2083.297267,1,62498717,62498918,201,-0.08647898574377863
24310,2083.298867,2083.312267,1,62498966,62499368,402,-0.059148941344642006
24311,2083.314533,2083.319367,1,62499435,62499581,146,-0.07700156168609744
24312,2083.320933,2083.3283,1,62499627,62499849,222,-0.019031100849818294
24313,2083.334533,2083.339967,1,62500035,62500199,164,0.8622791236385094
24314,2083.3462,2083.478533,1,62500386,62504355,3969,0.7487282997694568
24315,2083.4893,2083.501967,1,62504679,62505059,380,-0.10106393461344876
24316,2083.5034,2083.510467,1,62505102,62505314,212,0.00735481723554409
24317,2083.512233,2083.6385,1,62505366,62509155,3789,0.8039507007574612
24318,2083.640567,2083.652633,1,62509217,62509578,361,0.8885387841902569
24319,2083.653967,2083.684733,1,62509619,62510541,922,0.6228643934626986
24320,2083.687133,2083.709033,1,62510613,62511270,657,0.23281284511583764
24321,2083.7152,2083.723767,1,62511456,62511713,257,-0.06915863882285274
24322,2083.7253,2083.736233,1,62511759,62512086,327,0.04521946832814899
24323,2083.7387,2083.7542,1,62512161,62512625,464,0.2034321923598892
24324,2083.757133,2083.772367,1,62512713,62513171,458,0.2651908464426097
24325,2083.787667,2083.948133,1,62513630,62518443,4813,0.8339143632265074
24326,2083.974133,2083.98,1,62519223,62519400,177,0.5138321813793709
24327,2083.9881,2084.027967,1,62519643,62520839,1196,0.09502636987695842
24328,2084.0292,2084.036267,1,62520876,62521088,212,0.17451732401742182
24329,2084.042,2084.2534,1,62521260,62527602,6342,0.8075200814625544
24330,2084.262733,2084.2936,1,62527881,62528808,927,-0.04241405099848561
24331,2084.2969,2084.303,1,62528906,62529090,184,-0.11126248695397531
24332,2084.306067,2084.310633,1,62529182,62529318,136,-0.0705211596953094
24333,2084.316167,2084.325433,1,62529485,62529762,277,0.11679497558318784
24334,2084.350667,2084.361167,1,62530520,62530835,315,0.8108874531782191
24335,2084.363767,2084.498433,1,62530913,62534952,4039,0.7718502435840954
24336,2084.517933,2084.522767,1,62535537,62535683,146,-0.043416714556292396
24337,2084.524667,2084.528167,1,62535740,62535845,105,0.097344641786231
24338,2084.555833,2084.5595,1,62536674,62536784,110,-0.08936684896780042
24339,2085.192267,2085.1994,1,62555768,62555982,214,0.7735890621189577
24340,2085.200967,2085.2332,1,62556029,62556996,967,0.6311483152618789
24341,2085.267333,2085.285733,1,62558019,62558571,552,0.8863170801053533
24342,2085.372033,2085.378667,1,62561160,62561360,200,0.708768373999194
24343,2085.3852,2085.388833,1,62561556,62561664,108,0.4485644847405342
24344,2085.414367,2085.4374,1,62562431,62563121,690,0.618143989350157
24345,2085.441533,2085.462333,1,62563245,62563869,624,0.3372038152622975
24346,2085.496533,2085.508933,1,62564895,62565267,372,0.688713897083128
24347,2085.5325,2085.5476,1,62565974,62566427,453,0.7403975834153782
24348,2085.549267,2085.564933,1,62566478,62566947,469,0.6740685237315442
24349,2085.586667,2085.615967,1,62567600,62568479,879,0.03162971501947125
24350,2085.6203,2085.643167,1,62568609,62569295,686,0.20845742172125759
24351,2085.676067,2085.690333,1,62570282,62570709,427,0.7458360878629987
24352,2085.691467,2085.7858,1,62570744,62573574,2830,0.8262781353923988
24353,2085.790667,2085.804433,1,62573720,62574132,412,0.4299202329216954
24354,2085.818367,2085.839367,1,62574551,62575181,630,0.08878102633631567
24355,2085.842633,2085.851933,1,62575278,62575557,279,0.051660218844918594
24356,2085.853,2085.867267,1,62575590,62576018,428,0.1483865543031032
24357,2085.868333,2085.873333,1,62576049,62576199,150,
24358,2085.900733,2085.904867,1,62577021,62577146,125,0.09111517319363062
24359,2085.906133,2086.098833,1,62577183,62582964,5781,0.8069887236882434
24360,2086.1068,2086.1918,1,62583204,62585754,2550,0.8268590228279747
24361,2086.215467,2086.321367,1,62586464,62589641,3177,0.7495933786308371
24362,2086.3248,2086.330933,1,62589743,62589927,184,-0.12926435182152857
24363,2086.408267,2086.412633,1,62592248,62592378,130,0.2081930731455839
24364,2086.4211,2086.4729,1,62592633,62594187,1554,0.693520233422041
24365,2086.473933,2086.481433,1,62594217,62594442,225,0.5516759469434217
24366,2086.485733,2086.5313,1,62594571,62595939,1368,0.8344372149457228
24367,2086.542833,2086.582433,1,62596284,62597472,1188,0.13428835336370612
24368,2086.5838,2086.5988,1,62597514,62597964,450,0.09207477114617554
24369,2086.604633,2086.609,1,62598138,62598270,132,0.16043248366962598
24370,2086.6103,2086.648633,1,62598308,62599458,1150,0.8075227150117052
24371,2086.650267,2086.732867,1,62599508,62601986,2478,0.8148992911053916
24372,2086.750267,2086.815433,1,62602508,62604462,1954,0.803283603748199
24373,2086.8305,2086.872533,1,62604915,62606175,1260,0.7222274567553831
24374,2086.884933,2086.924067,1,62606547,62607722,1175,0.1269808470008591
24375,2086.9261,2086.9448,1,62607783,62608344,561,0.3327007633468602
24376,2086.978633,2086.9937,1,62609358,62609811,453,0.6670219019718282
24377,2086.9948,2087.144967,1,62609844,62614349,4505,0.8504717325600505
24378,2087.150533,2087.167967,1,62614515,62615039,524,0.8554602241712578
24379,2087.171,2087.2494,1,62615129,62617482,2353,0.7378038941216281
24380,2087.250667,2087.3344,1,62617520,62620032,2512,0.782341226640201
24381,2087.338667,2087.351167,1,62620160,62620535,375,0.7616106672989826
24382,2087.3577,2087.447433,1,62620731,62623422,2691,0.7899078000221949
24383,2087.451567,2087.474433,1,62623547,62624232,685,0.8541644285374311
24384,2087.483467,2087.492167,1,62624504,62624765,261,-0.1098156275388206
24385,2087.495967,2087.504067,1,62624879,62625122,243,-0.056221799418341045
24386,2087.506333,2087.517733,1,62625189,62625531,342,-0.003518997830641218
24387,2087.519367,2087.5308,1,62625581,62625924,343,0.2872563183391664
24388,2087.542233,2087.550733,1,62626266,62626521,255,-0.0615859606273017
24389,2087.562,2087.783067,1,62626860,62633492,6632,0.8384163316643214
24390,2087.786867,2087.807667,1,62633606,62634230,624,0.715800117041541
24391,2087.8089,2087.889133,1,62634267,62636673,2406,0.772429102772298
24392,2087.990633,2087.998067,1,62639718,62639942,224,0.5267555583978885
24393,2088.0095,2088.036033,1,62640285,62641080,795,0.7829176152275796
24394,2088.037533,2088.136067,1,62641125,62644082,2957,0.8768290326531595
24395,2088.1517,2088.162,1,62644551,62644859,308,0.14081144594705053
24396,2088.171867,2088.239967,1,62645156,62647199,2043,0.06467054084019676
24397,2088.283133,2088.442333,1,62648493,62653269,4776,0.8218610357403654
24398,2088.455,2088.459967,1,62653650,62653799,149,0.14282539404158723
24399,2088.4612,2088.490967,1,62653836,62654729,893,0.02467436887195432
24400,2088.4959,2088.516633,1,62654877,62655498,621,0.12477952355196599
24401,2088.559933,2088.7813,1,62656797,62663439,6642,0.8104703724140493
24402,2088.784667,2088.806633,1,62663540,62664198,658,0.8690427617363142
24403,2088.8329,2088.840333,1,62664987,62665209,222,0.49244063079153416
24404,2088.841733,2088.8678,1,62665251,62666034,783,0.03653939886873017
24405,2088.870533,2088.8828,1,62666115,62666483,368,-0.026405164743408528
24406,2088.886367,2088.8951,1,62666591,62666853,262,0.13442624582542567
24407,2088.8984,2088.903,1,62666952,62667089,137,-0.1792522527488311
24408,2088.904033,2088.9114,1,62667120,62667342,222,0.3779870756561602
24409,2088.941767,2088.963267,1,62668253,62668898,645,0.8709911786842286
24410,2088.966733,2089.112233,1,62669001,62673366,4365,0.8577045413542936
24411,2089.1175,2089.1747,1,62673524,62675241,1717,0.7931214118319178
24412,2089.184767,2089.200933,1,62675543,62676027,484,0.7303800481801119
24413,2089.2026,2089.236233,1,62676078,62677086,1008,0.7771714233603493
24414,2089.242767,2089.249233,1,62677283,62677476,193,0.2551827939306102
24415,2089.2619,2089.276633,1,62677857,62678298,441,-0.00041478208279928613
24416,2089.278067,2089.292667,1,62678342,62678780,438,0.17063049443893255
24417,2089.2945,2089.3101,1,62678835,62679303,468,0.25646997130380683
24418,2089.311967,2089.319667,1,62679359,62679590,231,-0.08539814886398696
24419,2089.364567,2089.553367,1,62680937,62686601,5664,0.8360754113776161
24420,2089.555967,2089.578433,1,62686679,62687352,673,0.8222319992086216
24421,2089.6161,2089.642033,1,62688483,62689260,777,-0.00509367492498498
24422,2089.6433,2089.669633,1,62689299,62690088,789,0.22650743851022134
24423,2089.674867,2089.681733,1,62690246,62690451,205,-0.06724618537394252
24424,2089.715333,2089.724433,1,62691459,62691732,273,0.12049912521226909
24425,2089.7357,2089.748767,1,62692071,62692463,392,0.2179421982379701
24426,2089.7517,2089.852033,1,62692550,62695560,3010,0.8546853727368019
24427,2089.856367,2089.8633,1,62695691,62695899,208,0.2932026864015041
24428,2089.866933,2089.877733,1,62696007,62696331,324,0.45900927063182767
24429,2089.8828,2089.920933,1,62696483,62697627,1144,0.22188016689346773
24430,2089.923567,2089.9554,1,62697707,62698661,954,0.052585195076333476
24431,2089.967067,2090.086233,1,62699012,62702586,3574,0.8380579944646043
24432,2090.087567,2090.092633,1,62702627,62702778,151,0.008772362894362704
24433,2090.103567,2090.178967,1,62703107,62705369,2262,0.28318803802455217
24434,2090.1806,2090.186667,1,62705418,62705600,182,-0.36154973581354377
24435,2090.213,2090.3271,1,62706390,62709813,3423,0.8142945103403608
24436,2090.3346,2090.346967,1,62710038,62710409,371,0.13737046929911714
24437,2090.359433,2090.378367,1,62710782,62711351,569,0.05974927082693193
24438,2090.379467,2090.401367,1,62711384,62712041,657,0.10959380672893787
24439,2090.404467,2090.419933,1,62712134,62712597,463,-0.07244094011454776
24440,2090.4283,2090.506067,1,62712849,62715182,2333,0.7902302552076779
24441,2090.507167,2090.5764,1,62715215,62717292,2077,0.790246849917911
24442,2090.577833,2090.5858,1,62717334,62717573,239,0.5405429488394906
24443,2090.592833,2090.609167,1,62717784,62718275,491,0.08815393401374176
24444,2090.610467,2090.629667,1,62718314,62718890,576,0.05799331085756942
24445,2090.631267,2090.648033,1,62718938,62719440,502,0.06615631027130597
24446,2090.659733,2090.664767,1,62719791,62719943,152,0.8411192207205244
24447,2090.672067,2090.6948,1,62720162,62720844,682,0.7908922728925946
24448,2090.6959,2090.800033,1,62720877,62724000,3123,0.7912322751096157
24449,2090.802533,2090.861867,1,62724075,62725856,1781,0.20334292749462857
24450,2090.8641,2090.884833,1,62725922,62726544,622,-0.04426655569420064
24451,2090.887067,2090.930933,1,62726612,62727927,1315,0.36101553500127437
24452,2090.9401,2090.970667,1,62728202,62729120,918,0.1153287770140224
24453,2090.9719,2090.9904,1,62729157,62729712,555,0.00245944681220179
24454,2090.993533,2090.996967,1,62729805,62729909,104,0.5561659568850814
24455,2091.0,2091.220533,1,62730000,62736615,6615,0.4630720565617995
24456,2091.2301,2091.243033,1,62736903,62737290,387,0.5594564279621219
24457,2091.248267,2091.273767,1,62737448,62738213,765,0.3131228541857193
24458,2091.2863,2091.331767,1,62738589,62739953,1364,-0.0065168548161183785
24459,2091.3651,2091.4924,1,62740953,62744772,3819,0.8522263042471042
24460,2091.494433,2091.501067,1,62744832,62745032,200,0.6231555906930413
24461,2091.505367,2091.515933,1,62745161,62745477,316,0.40223986725909866
24462,2091.5176,2091.539333,1,62745528,62746179,651,0.16847119551228884
24463,2091.540833,2091.560933,1,62746224,62746827,603,0.16009933962474607
24464,2091.562567,2091.5782,1,62746877,62747346,469,-0.055849385284827274
24465,2091.590433,2091.600467,1,62747712,62748014,302,0.2950325043509663
24466,2091.601467,2091.615,1,62748044,62748449,405,0.7496816515576712
24467,2091.617867,2091.639067,1,62748536,62749172,636,0.15346468182542816
24468,2091.6482,2091.692667,1,62749446,62750780,1334,0.10907267186152732
24469,2091.693767,2091.698733,1,62750813,62750961,148,0.24014355720734787
24470,2091.714333,2091.849067,1,62751429,62755472,4043,0.8440236706457106
24471,2091.851567,2091.874367,1,62755547,62756231,684,0.21574600240414832
24472,2091.875767,2091.914667,1,62756273,62757440,1167,0.18491602354799963
24473,2091.915933,2091.9357,1,62757477,62758071,594,-0.0420165581156768
24474,2091.9441,2091.993233,1,62758323,62759796,1473,0.22734087859372631
24475,2092.0051,2092.050233,1,62760152,62761506,1354,0.03609224303302532
24476,2092.051233,2092.057833,1,62761536,62761734,198,-0.15505683873351608
24477,2092.0712,2092.0977,1,62762135,62762930,795,0.32526697924492914
24478,2092.107433,2092.2624,1,62763222,62767872,4650,0.8616028344132685
24479,2092.265933,2092.268933,1,62767977,62768067,90,-0.25534120421641876
24480,2092.275067,2092.320267,1,62768252,62769608,1356,0.07689930204237024
24481,2092.3273,2092.335567,1,62769819,62770067,248,-0.09962516458909478
24482,2092.342033,2092.3455,1,62770260,62770365,105,
24483,2092.346867,2092.354333,1,62770406,62770629,223,-0.04766756966506242
24484,2092.371333,2092.380267,1,62771139,62771408,269,0.21998966192897879
24485,2092.3885,2092.416167,1,62771655,62772485,830,0.2865083746411805
24486,2092.417233,2092.422167,1,62772516,62772665,149,0.2950353299885304
24487,2092.425767,2092.465033,1,62772773,62773950,1177,-0.01782773722832624
24488,2092.466267,2092.479033,1,62773988,62774370,382,0.29769925877436265
24489,2092.513967,2092.528767,1,62775419,62775863,444,0.3844531433331529
24490,2092.5379,2092.550567,1,62776136,62776517,381,0.2406752271996241
24491,2092.551567,2092.5546,1,62776547,62776638,91,0.03443828706783068
24492,2092.563933,2092.603267,1,62776917,62778098,1181,0.003141930849861818
24493,2092.605867,2092.823967,1,62778176,62784719,6543,0.79169912116669
24494,2092.849533,2092.868233,1,62785485,62786046,561,0.7763022012225775
24495,2092.8696,2092.914133,1,62786088,62787423,1335,0.7752506448009514
24496,2092.918833,2092.951167,1,62787564,62788535,971,0.6992909679574991
24497,2092.9681,2092.972467,1,62789043,62789174,131,-0.04339147463530262
24498,2092.975567,2092.9992,1,62789267,62789976,709,-0.08581280726155735
24499,2093.034267,2093.054933,1,62791028,62791647,619,0.10994396554829713
24500,2093.0647,2093.071067,1,62791941,62792132,191,-0.03352924219427248
24501,2093.0856,2093.0915,1,62792568,62792745,177,0.34083437392458676
24502,2093.100367,2093.114067,1,62793011,62793422,411,0.25703591695853456
24503,2093.117067,2093.149867,1,62793512,62794496,984,0.2425498843801358
24504,2093.1658,2093.2474,1,62794974,62797422,2448,0.5388994751593872
24505,2093.269733,2093.2831,1,62798091,62798493,402,0.3081419779746695
24506,2093.284167,2093.297667,1,62798525,62798930,405,0.10856648772644419
24507,2093.439367,2093.449767,1,62803181,62803493,312,0.47637027470369764
24508,2093.454167,2093.4582,1,62803625,62803746,121,-0.07770644210012534
24509,2093.465167,2093.476733,1,62803955,62804301,346,0.04370969523373633
24510,2093.477967,2093.494433,1,62804339,62804832,493,0.1611629438413878
24511,2093.542867,2093.5512,1,62806286,62806536,250,0.7820835454041087
24512,2093.5532,2093.598367,1,62806595,62807951,1356,0.7676491504495502
24513,2093.599433,2093.6546,1,62807982,62809637,1655,0.8406579292292174
24514,2093.672733,2093.692067,1,62810181,62810762,581,-0.08204840992993122
24515,2093.698133,2093.708567,1,62810943,62811257,314,0.22507174736609717
24516,2093.709567,2093.717333,1,62811287,62811519,232,0.14781435517561253
24517,2093.726067,2093.736933,1,62811782,62812107,325,0.0032486245266620225
24518,2093.811067,2093.825267,1,62814332,62814758,426,0.21504450819571733
24519,2093.851133,2093.856367,1,62815533,62815691,158,-0.0553100653781031
24520,2093.8771,2093.8803,1,62816313,62816408,95,
24521,2093.881533,2093.8864,1,62816445,62816591,146,-0.06145150414410804
24522,2093.9581,2094.100067,1,62818742,62823002,4260,0.7922255668581109
24523,2094.104233,2094.109933,1,62823126,62823297,171,0.010452560445266717
24524,2094.113133,2094.1453,1,62823393,62824359,966,0.6411494347457406
24525,2094.147267,2094.215033,1,62824418,62826450,2032,0.8041854223813316
24526,2094.229133,2094.2545,1,62826873,62827635,762,-0.03373560824490272
24527,2094.259733,2094.286567,1,62827791,62828597,806,0.393722067081579
24528,2094.289933,2094.295433,1,62828697,62828862,165,
24529,2094.339467,2094.533467,1,62830184,62836004,5820,0.869183326098911
24530,2094.538767,2094.589767,1,62836163,62837693,1530,0.7732173020744725
24531,2094.597767,2094.600833,1,62837933,62838024,91,
24532,2094.608233,2094.6191,1,62838246,62838573,327,-0.13188234072232521
24533,2094.643433,2094.647967,1,62839302,62839439,137,0.1544967983535208
24534,2094.944,2094.9916,1,62848320,62849747,1427,0.6762498213082175
24535,2094.999933,2095.024267,1,62849997,62850728,731,0.6731533866682956
24536,2095.062967,2095.0876,1,62851889,62852627,738,0.6553721231147849
24537,2095.0937,2095.129,1,62852811,62853870,1059,0.7192124456526391
24538,2095.1302,2095.185333,1,62853906,62855559,1653,0.7717603439843526
24539,2095.205333,2095.208467,1,62856159,62856254,95,-0.1103638948442273
24540,2095.216667,2095.240767,1,62856500,62857223,723,-0.028445721628282915
24541,2095.2443,2095.251967,1,62857328,62857559,231,0.23334035919714544
24542,2095.820333,2095.826833,1,62874609,62874804,195,0.6627137010857982
24543,2095.832767,2095.843333,1,62874983,62875299,316,0.5362920023082941
24544,2095.887333,2095.897767,1,62876619,62876933,314,0.5561808402087586
24545,2095.922433,2095.929467,1,62877672,62877884,212,0.549178442178729
24546,2096.136033,2096.139933,1,62884080,62884197,117,0.7320109273724066
24547,2096.1414,2096.157967,1,62884242,62884739,497,0.6673526621484621
24548,2096.194967,2096.224333,1,62885849,62886729,880,0.7113856917598552
24549,2096.261367,2096.271,1,62887841,62888130,289,0.4704142372259267
24550,2096.282033,2096.2988,1,62888460,62888964,504,-0.04445598101223391
24551,2096.2998,2096.311867,1,62888993,62889356,363,0.2997413705998229
24552,2096.3132,2096.3206,1,62889396,62889618,222,-0.11848755436843597
24553,2096.340967,2096.578067,1,62890229,62897342,7113,0.6218049838473791
24554,2096.587633,2096.590667,1,62897628,62897720,92,-0.14012701684606374
24555,2096.732433,2096.7398,1,62901972,62902193,221,0.4320530890126677
24556,2096.7527,2096.7585,1,62902581,62902755,174,0.2185138985148181
24557,2096.760233,2096.795867,1,62902806,62903876,1070,0.7529083313165847
24558,2096.805867,2096.849067,1,62904176,62905472,1296,0.7974237688024565
24559,2096.868767,2096.905867,1,62906063,62907176,1113,0.0037733706313420635
24560,2096.911067,2096.9223,1,62907332,62907669,337,0.13736494440967056
24561,2096.979567,2097.140967,1,62909387,62914229,4842,0.7905336432867983
24562,2097.142133,2097.145433,1,62914263,62914362,99,0.21627789426859712
24563,2097.146667,2097.168233,1,62914400,62915046,646,0.7561575170481465
24564,2097.170567,2097.1745,1,62915117,62915235,118,0.09788414112360294
24565,2097.1771,2097.259267,1,62915313,62917778,2465,0.6799202497916083
24566,2097.260467,2097.316667,1,62917814,62919500,1686,0.7962342698683923
24567,2097.321133,2097.3537,1,62919633,62920611,978,0.8366792100049016
24568,2097.371533,2097.394133,1,62921145,62921823,678,0.0667890790417146
24569,2097.3953,2097.408,1,62921859,62922240,381,0.19598780768128835
24570,2097.411833,2097.422367,1,62922354,62922671,317,-0.1333006900658875
24571,2097.451633,2097.470633,1,62923548,62924118,570,0.671518578408671
24572,2097.474667,2097.569433,1,62924240,62927082,2842,0.7962805339136316
24573,2097.587333,2097.618633,1,62927619,62928558,939,-0.03435729717523656
24574,2097.6382,2097.7962,1,62929145,62933886,4741,0.8220918894098965
24575,2097.8207,2097.850467,1,62934621,62935514,893,-0.06486574147267833
24576,2097.853067,2097.859367,1,62935592,62935781,189,0.2642240997058671
24577,2097.8702,2097.8735,1,62936105,62936205,100,-0.37363504610739473
24578,2098.154533,2098.1957,1,62944635,62945871,1236,0.594380761641371
24579,2098.2087,2098.229233,1,62946261,62946876,615,0.5802222186105414
24580,2098.253633,2098.262,1,62947608,62947860,252,0.8594250981362351
24581,2098.283567,2098.300933,1,62948507,62949027,520,0.7458105474390935
24582,2098.331,2098.3399,1,62949930,62950197,267,0.5545907071075897
24583,2098.349533,2098.354367,1,62950485,62950631,146,-0.012548106097303176
24584,2098.3563,2098.3846,1,62950689,62951537,848,0.0313280408471028
24585,2098.420333,2098.438167,1,62952609,62953145,536,0.8167978983722528
24586,2098.441933,2098.559667,1,62953257,62956790,3533,0.7856819710819991
24587,2098.561233,2098.601967,1,62956836,62958059,1223,0.6975982512474539
24588,2098.603433,2098.784533,1,62958102,62963535,5433,0.7621685630035507
24589,2098.8122,2098.816033,1,62964365,62964480,115,0.3212660745417025
24590,2098.828067,2098.8314,1,62964842,62964942,100,
24591,2099.013067,2099.016533,1,62970392,62970495,103,0.7861864836415215
24592,2099.034533,2099.041367,1,62971035,62971241,206,0.5048330770653725
24593,2099.0425,2099.047067,1,62971275,62971412,137,0.0003430673777577449
24594,2099.050667,2099.131933,1,62971520,62973957,2437,0.7160765332321598
24595,2099.1419,2099.1518,1,62974257,62974554,297,0.6495384524379887
24596,2099.177867,2099.225933,1,62975336,62976777,1441,0.8088620261425024
24597,2099.242633,2099.278367,1,62977278,62978351,1073,0.7090859739867453
24598,2099.3017,2099.318133,1,62979051,62979543,492,0.09069630421678192
24599,2099.319133,2099.3408,1,62979573,62980224,651,0.3438877006908136
24600,2099.3418,2099.351667,1,62980254,62980550,296,0.1098249299911775
24601,2099.3716,2099.579667,1,62981148,62987390,6242,0.8240120921131218
24602,2099.611733,2099.6272,1,62988351,62988816,465,0.028511455082851456
24603,2099.6284,2099.656367,1,62988852,62989691,839,0.14840079368174872
24604,2099.695767,2099.709567,1,62990873,62991287,414,0.878967071673798
24605,2099.711667,2099.748567,1,62991350,62992457,1107,0.8628369394982421
24606,2099.7496,2099.7997,1,62992488,62993991,1503,0.8132128112014005
24607,2099.816367,2099.852267,1,62994491,62995568,1077,-0.026580028086684783
24608,2099.8681,2100.0337,1,62996043,63001011,4968,0.8174086070585512
24609,2100.0578,2100.0735,1,63001734,63002205,471,0.017868038001907158
24610,2100.099233,2100.103033,1,63002976,63003090,114,0.16379353423975596
24611,2100.1041,2100.1084,1,63003123,63003252,129,0.4901280574077252
24612,2100.161033,2100.257367,1,63004830,63007721,2891,0.7744104268037493
24613,2100.259133,2100.289,1,63007773,63008670,897,0.7927283140442052
24614,2100.723033,2100.727867,1,63021690,63021836,146,0.5753372760462593
24615,2100.748967,2100.757667,1,63022469,63022730,261,0.5722495644556872
24616,2100.799267,2100.8293,1,63023978,63024878,900,0.6950154075554568
24617,2100.846667,2100.881133,1,63025400,63026433,1033,0.775120872049658
24618,2100.916167,2100.924267,1,63027485,63027728,243,0.6849943343392532
24619,2100.926167,2100.933767,1,63027785,63028013,228,0.19450382125426707
24620,2100.940567,2100.982067,1,63028217,63029462,1245,0.6406609260567419
24621,2101.009,2101.019667,1,63030270,63030590,320,0.6486423405061796
24622,2101.021967,2101.028233,1,63030659,63030846,187,0.5634157779175026
24623,2101.148233,2101.286067,1,63034446,63038582,4136,0.7885378148627346
24624,2101.300467,2101.324633,1,63039014,63039738,724,0.7937356635773166
24625,2101.3287,2101.488567,1,63039861,63044657,4796,0.7943032835813457
24626,2101.4987,2101.567733,1,63044961,63047031,2070,0.6922641293661788
24627,2101.570167,2101.584667,1,63047105,63047540,435,-0.07649548964232772
24628,2101.817,2101.8297,1,63054510,63054890,380,-0.2926915535779155
24629,2101.831833,2101.870333,1,63054954,63056109,1155,0.7935514066032603
24630,2101.8716,2101.875033,1,63056148,63056250,102,0.8137219501406989
24631,2101.877967,2101.8904,1,63056339,63056712,373,0.9069398016336994
24632,2101.891533,2101.921133,1,63056745,63057633,888,0.8341357395137182
24633,2101.922233,2101.9275,1,63057666,63057824,158,-0.006056683899248833
24634,2101.9585,2101.9699,1,63058755,63059097,342,0.18081275879944017
24635,2101.9711,2101.975533,1,63059133,63059265,132,
24636,2102.248033,2102.253867,1,63067440,63067616,176,0.7094866796384023
24637,2102.261133,2102.373933,1,63067833,63071217,3384,0.7914154798045553
24638,2102.3817,2102.4025,1,63071451,63072075,624,0.8305684326314916
24639,2102.4063,2102.478967,1,63072189,63074369,2180,0.8014624557861937
24640,2102.493,2102.496467,1,63074790,63074894,104,0.21802079551884543
24641,2102.501267,2102.5324,1,63075038,63075972,934,0.7023322752729437
24642,2102.549833,2102.552833,1,63076494,63076584,90,-0.09058736370342096
24643,2102.577833,2102.599467,1,63077334,63077984,650,0.6028138423468236
24644,2102.615033,2102.632233,1,63078450,63078966,516,0.5722408507015213
24645,2102.6337,2102.694367,1,63079010,63080831,1821,0.81780594062789
24646,2102.696033,2102.700167,1,63080880,63081005,125,0.4878090851744205
24647,2102.7136,2102.7175,1,63081408,63081525,117,0.13116657743175036
24648,2102.739533,2102.7448,1,63082185,63082344,159,-0.024111080519142347
24649,2102.746067,2102.7532,1,63082382,63082596,214,0.010834619091422942
24650,2102.880333,2102.8892,1,63086409,63086676,267,0.08622885750193393
24651,2103.7866,2103.793967,1,63113598,63113819,221,0.7340154678829122
24652,2103.810867,2103.817567,1,63114326,63114527,201,0.6696366529234665
24653,2103.850333,2103.8683,1,63115509,63116049,540,0.7226458666973394
24654,2103.979767,2103.985367,1,63119393,63119561,168,0.05016578778670764
24655,2104.038433,2104.055133,1,63121152,63121653,501,0.5833437659857631
24656,2104.198133,2104.318267,1,63125943,63129548,3605,0.828006806697651
24657,2104.340233,2104.369833,1,63130206,63131094,888,0.7609026691605315
24658,2104.371233,2104.440767,1,63131136,63133223,2087,0.7351189040670989
24659,2105.031667,2105.0638,1,63150950,63151914,964,0.6002938264351594
24660,2105.109233,2105.116567,1,63153276,63153497,221,0.6426905194157156
24661,2105.135567,2105.147433,1,63154067,63154422,355,0.7752020784323147
24662,2105.188933,2105.194533,1,63155667,63155835,168,0.740107675573674
24663,2105.213333,2105.217033,1,63156399,63156510,111,
24664,2105.222333,2105.2294,1,63156669,63156882,213,0.23369593162214328
24665,2105.2304,2105.239667,1,63156912,63157190,278,0.31211013724898423
24666,2105.436867,2105.4593,1,63163106,63163779,673,0.8573123714249965
24667,2105.460433,2105.509667,1,63163812,63165290,1478,0.8391497407114945
24668,2105.513033,2105.5631,1,63165390,63166892,1502,0.8229013504947142
24669,2105.576967,2105.5827,1,63167309,63167481,172,-0.0643942572229411
24670,2105.8124,2105.8179,1,63174371,63174537,166,0.5293076027748922
24671,2105.8286,2105.978533,1,63174857,63179355,4498,0.7962065522022103
24672,2105.9991,2106.007967,1,63179973,63180239,266,0.5755903056225039
24673,2106.009833,2106.071833,1,63180294,63182154,1860,0.7811640973304483
24674,2106.0729,2106.076267,1,63182187,63182288,101,-0.4015735510757477
24675,2106.082167,2106.0978,1,63182465,63182934,469,0.6808235928997635
24676,2106.351967,2106.451133,1,63190559,63193533,2974,0.772995404098582
24677,2106.4538,2106.6331,1,63193613,63198993,5380,0.7564375511537919
24678,2106.6522,2106.657167,1,63199566,63199715,149,0.6993406513329988
24679,2106.665333,2106.668367,1,63199959,63200051,92,
24680,2106.8941,2107.0851,1,63206823,63212552,5729,0.780821314664257
24681,2107.087033,2107.095333,1,63212610,63212859,249,0.6901511882845783
24682,2107.120033,2107.188367,1,63213600,63215651,2051,0.7656910835073948
24683,2107.197467,2107.2042,1,63215924,63216126,202,0.3367948833817541
24684,2107.2052,2107.2353,1,63216156,63217058,902,0.8095292969230882
24685,2107.282633,2107.2893,1,63218478,63218679,201,-0.0018163354695523617
24686,2107.2962,2107.3038,1,63218886,63219114,228,-0.01920431594465367
24687,2107.456033,2107.610733,1,63223680,63228321,4641,0.79875224336036
24688,2107.624333,2107.693467,1,63228729,63230804,2075,0.7803059082651582
24689,2107.6947,2107.727567,1,63230841,63231827,986,0.7441898055304854
24690,2107.747933,2107.759767,1,63232437,63232793,356,0.16686642294257079
24691,2107.784433,2107.787633,1,63233532,63233628,96,0.3085825848364018
24692,2107.9543,2107.960467,1,63238628,63238814,186,0.43883098346810273
24693,2107.9774,2108.113833,1,63239322,63243414,4092,0.8091342357696606
24694,2108.1275,2108.150967,1,63243825,63244529,704,0.7855882561777021
24695,2108.153,2108.2003,1,63244589,63246009,1420,0.779300997910193
24696,2108.201933,2108.302767,1,63246057,63249083,3026,0.7895495397370442
24697,2108.332367,2108.4114,1,63249971,63252342,2371,0.803783668170183
24698,2108.428567,2108.431567,1,63252857,63252947,90,-0.09585654835391734
24699,2108.6729,2108.8066,1,63260187,63264198,4011,0.8300241185804195
24700,2109.135233,2109.2734,1,63274056,63278202,4146,0.817921055024833
24701,2109.2832,2109.348933,1,63278495,63280467,1972,0.7344652617733408
24702,2109.362933,2109.374967,1,63280887,63281249,362,0.7994545399292186
24703,2109.383833,2109.453067,1,63281514,63283592,2078,0.7526397343898609
24704,2109.647967,2109.6534,1,63289439,63289602,163,0.478520389041952
24705,2109.6593,2109.665233,1,63289778,63289956,178,0.7032125773649848
24706,2109.6671,2109.972067,1,63290013,63299162,9149,0.7391876979033427
24707,2110.2348,2110.2393,1,63307044,63307179,135,0.5394579975525513
24708,2110.248967,2110.356833,1,63307469,63310704,3235,0.7366046261769303
24709,2110.364533,2110.435,1,63310935,63313050,2115,0.7751282831537446
24710,2110.4381,2110.5125,1,63313142,63315374,2232,0.7749811857307175
24711,2110.772267,2110.7756,1,63323168,63323268,100,
24712,2110.7857,2110.9032,1,63323571,63327096,3525,0.85230156503599
24713,2110.911967,2110.915767,1,63327359,63327473,114,0.6158567235364427
24714,2111.2306,2111.384067,1,63336917,63341522,4605,0.8388602785483829
24715,2111.412833,2111.427867,1,63342384,63342836,452,0.23508261863764846
24716,2111.430767,2111.438633,1,63342923,63343158,235,0.3820235263493718
24717,2111.619833,2111.7408,1,63348594,63352224,3630,0.8431148777542282
24718,2112.0823,2112.0878,1,63362469,63362633,164,0.8002360444036062
24719,2112.107267,2112.2005,1,63363218,63366015,2797,0.7309261914705903
24720,2112.204667,2112.207833,1,63366140,63366234,94,0.11975387967173433
24721,2112.209067,2112.3358,1,63366272,63370073,3801,0.7639894098285602
24722,2112.3646,2112.400067,1,63370938,63372002,1064,0.03795263546762094
24723,2112.405733,2112.4126,1,63372171,63372378,207,0.25912531422589913
24724,2112.563467,2112.567533,1,63376904,63377025,121,0.33828546578958973
24725,2112.571267,2112.778133,1,63377138,63383343,6205,0.8129031489999607
24726,2112.8022,2112.807533,1,63384066,63384225,159,
24727,2112.825167,2112.8331,1,63384755,63384992,237,0.16031490412527125
24728,2112.836233,2112.841733,1,63385086,63385251,165,0.07273693520731306
24729,2113.055133,2113.166767,1,63391653,63395003,3350,0.8198459775152775
24730,2113.178333,2113.429833,1,63395349,63402894,7545,0.7176245912719338
24731,2113.699033,2113.833333,1,63410970,63414999,4029,0.7972708036956314
24732,2113.8346,2113.839633,1,63415038,63415188,150,0.13496297440332472
24733,2115.570067,2115.576567,1,63467102,63467297,195,0.5573427909692088
24734,2115.599067,2115.602267,1,63467972,63468068,96,0.7796419071390234
24735,2115.608667,2115.6121,1,63468260,63468362,102,0.4754016745748529
24736,2115.634467,2115.653833,1,63469034,63469614,580,0.7233692873255563
24737,2115.690333,2115.696367,1,63470709,63470891,182,0.5806059830502865
24738,2115.703567,2115.7176,1,63471107,63471528,421,0.6038436469886982
24739,2115.7252,2115.7375,1,63471755,63472125,370,0.8686637708101606
24740,2115.776467,2115.7896,1,63473294,63473688,394,0.687658871331025
24741,2115.808733,2115.820433,1,63474261,63474612,351,0.6667338558001119
24742,2115.8219,2115.8373,1,63474657,63475119,462,0.6030664787203907
24743,2116.3426,2116.3497,1,63490278,63490491,213,0.6391788696292448
24744,2116.351133,2116.370367,1,63490533,63491111,578,0.6923217041267113
24745,2116.390433,2116.398067,1,63491712,63491942,230,0.7005887293920365
24746,2116.4259,2116.429467,1,63492777,63492884,107,0.6064706133250592
24747,2116.476967,2116.5959,1,63494309,63497876,3567,0.6827956593076754
24748,2116.600733,2116.6206,1,63498021,63498618,597,0.5861267787718542
24749,2116.628067,2116.634267,1,63498842,63499028,186,0.7199321726808146
24750,2116.642033,2116.6865,1,63499260,63500594,1334,0.8241640929248535
24751,2116.695633,2116.710467,1,63500868,63501314,446,0.7630051387080612
24752,2116.713333,2116.7299,1,63501399,63501896,497,0.6752210826853308
24753,2117.189367,2117.198667,1,63515681,63515960,279,0.5559910824740539
24754,2117.199667,2117.217133,1,63515990,63516513,523,0.7170572106129207
24755,2117.225,2117.2923,1,63516750,63518769,2019,0.7722284506824947
24756,2117.306767,2117.328533,1,63519203,63519855,652,0.6633246139415265
24757,2117.331367,2117.375567,1,63519941,63521267,1326,0.6086697888891037
24758,2117.3766,2117.3797,1,63521298,63521391,93,0.4552113705608376
24759,2117.385,2117.400867,1,63521550,63522026,476,0.6214234432802098
24760,2117.4036,2117.407667,1,63522108,63522230,122,0.42596863718846617
24761,2117.409033,2117.419,1,63522270,63522569,299,0.45744991124287604
24762,2117.428567,2117.475433,1,63522857,63524262,1405,0.6125631629314955
24763,2117.479833,2117.5179,1,63524394,63525536,1142,0.5756076085635139
24764,2117.5339,2117.537367,1,63526017,63526121,104,0.5322958297094518
24765,2117.546933,2117.5539,1,63526407,63526617,210,-0.05029498322939026
24766,2117.555233,2117.575667,1,63526656,63527270,614,0.016099325857523397
24767,2117.5786,2117.635133,1,63527357,63529053,1696,0.5399394211858548
24768,2117.654267,2117.675033,1,63529628,63530250,622,0.3726167021690803
24769,2117.676733,2117.7433,1,63530301,63532299,1998,0.5425362434928466
24770,2117.7674,2117.777633,1,63533022,63533328,306,-0.08819032026500999
24771,2117.828733,2117.937767,1,63534861,63538133,3272,0.747502066221291
24772,2118.271767,2118.451167,1,63548153,63553535,5382,0.7849713781061377
24773,2118.4652,2118.486267,1,63553956,63554588,632,0.7281751545927914
24774,2118.4921,2118.5223,1,63554763,63555669,906,0.7292298279739186
24775,2118.5236,2118.531733,1,63555708,63555951,243,0.2822045719597034
24776,2118.5521,2118.6334,1,63556563,63559002,2439,0.7178744638937887
24777,2118.860733,2118.864267,1,63565821,63565928,107,
24778,2118.8829,2119.018067,1,63566487,63570542,4055,0.7072405436559895
24779,2119.021367,2119.0248,1,63570641,63570744,103,0.7061571687458988
24780,2119.069833,2119.093733,1,63572094,63572811,717,0.5989609232470321
24781,2119.1107,2119.123867,1,63573321,63573716,395,0.567438815022009
24782,2119.127767,2119.151933,1,63573833,63574557,724,0.7097250155736531
24783,2119.1558,2119.199867,1,63574674,63575996,1322,0.6739003516109366
24784,2119.201033,2119.2474,1,63576030,63577422,1392,0.7049457725554976
24785,2119.257467,2119.2619,1,63577724,63577857,133,0.6692624667652444
24786,2119.264667,2119.292,1,63577940,63578760,820,0.6618250130418345
24787,2119.528533,2119.544967,1,63585855,63586349,494,0.8440176863599752
24788,2119.5464,2119.6052,1,63586392,63588156,1764,0.47326285523360756
24789,2119.606833,2119.610567,1,63588204,63588317,113,0.3064355652620038
24790,2119.6177,2119.642733,1,63588530,63589281,751,0.5026089471831243
24791,2119.878833,2119.882767,1,63596364,63596483,119,0.5922697192182369
24792,2119.8964,2119.903467,1,63596892,63597104,212,0.5827652713374525
24793,2119.9051,2119.9299,1,63597153,63597897,744,0.3467090600711983
24794,2120.0402,2120.0476,1,63601206,63601427,221,0.36037302579653474
24795,2120.059267,2120.078633,1,63601778,63602358,580,0.44629336948737336
24796,2120.079767,2120.0912,1,63602393,63602735,342,0.3624367250288407
24797,2120.190533,2120.195667,1,63605715,63605870,155,0.2096925169442264
24798,2120.213833,2120.218033,1,63606414,63606540,126,-0.24206131261781674
24799,2120.2297,2120.235433,1,63606890,63607062,172,0.8171560047227691
24800,2120.2418,2120.2525,1,63607253,63607575,322,0.5565089926453397
24801,2120.258267,2120.2709,1,63607748,63608127,379,0.5602471654508226
24802,2120.2765,2120.285733,1,63608295,63608571,276,0.584599832173196
24803,2120.286733,2120.309767,1,63608601,63609293,692,0.7122993314813089
24804,2120.313,2120.3266,1,63609390,63609797,407,0.5391585589514815
24805,2120.3366,2120.3784,1,63610098,63611352,1254,-0.007060829943320396
24806,2120.384233,2120.4966,1,63611526,63614898,3372,0.7664238853116893
24807,2120.5068,2120.515367,1,63615204,63615461,257,-0.0890325837092304
24808,2120.536933,2120.542533,1,63616107,63616275,168,0.5940064959736724
24809,2120.551433,2120.574833,1,63616542,63617244,702,0.06040181671625952
24810,2120.578433,2120.602667,1,63617352,63618080,728,0.13564596199206572
24811,2120.638167,2120.6516,1,63619145,63619548,403,0.3546506297612762
24812,2120.66,2120.691267,1,63619799,63620738,939,0.2598460859162045
24813,2120.6956,2120.717,1,63620868,63621510,642,-0.0074206181112939475
24814,2120.718433,2120.741733,1,63621552,63622251,699,0.2942834784980108
24815,2120.7445,2120.753967,1,63622334,63622619,285,0.3956146019369974
24816,2120.784633,2120.901433,1,63623538,63627042,3504,0.7935050506061726
24817,2120.943633,2120.9473,1,63628308,63628418,110,
24818,2121.1675,2121.186467,1,63635025,63635594,569,0.6453171142257423
24819,2121.194433,2121.197767,1,63635832,63635933,101,0.6482742247115193
24820,2121.200433,2121.206533,1,63636012,63636195,183,0.5994478139186181
24821,2121.261333,2121.2763,1,63637839,63638289,450,0.7180907177048959
24822,2121.310633,2121.347867,1,63639318,63640436,1118,0.6762705543651727
24823,2121.386067,2121.398267,1,63641582,63641948,366,0.6586201565794789
24824,2121.416733,2121.4496,1,63642501,63643488,987,0.7129678461814226
24825,2121.4589,2121.462867,1,63643767,63643886,119,0.7901018726552742
24826,2121.475467,2121.510433,1,63644264,63645312,1048,0.017570334980589547
24827,2121.5116,2121.529633,1,63645347,63645888,541,0.06239417720169613
24828,2121.544267,2121.549833,1,63646328,63646494,166,0.4433154574088146
24829,2121.553067,2121.738633,1,63646592,63652158,5566,0.7404048536046921
24830,2121.7898,2121.796167,1,63653694,63653885,191,-0.03078658633072318
24831,2122.0037,2122.0945,1,63660111,63662835,2724,0.7185271512000287
24832,2122.105333,2122.1097,1,63663159,63663291,132,0.4083801590183055
24833,2122.111833,2122.136033,1,63663354,63664080,726,0.784741297305438
24834,2122.171,2122.186433,1,63665129,63665592,463,0.21446391152416122
24835,2122.207167,2122.228233,1,63666215,63666846,631,0.5899115619359668
24836,2122.243333,2122.2596,1,63667299,63667787,488,0.5998707572400832
24837,2122.263667,2122.324833,1,63667910,63669744,1834,0.7988982515490661
24838,2122.3275,2122.3387,1,63669824,63670160,336,0.5104577781952382
24839,2122.802967,2122.809133,1,63684089,63684273,184,0.5254137199996827
24840,2122.827667,2122.833267,1,63684830,63684998,168,0.6260209796516392
24841,2122.8347,2122.8547,1,63685041,63685640,599,0.7381206424382958
24842,2122.875167,2122.889967,1,63686255,63686699,444,0.7235666046375648
24843,2122.8993,2122.904933,1,63686979,63687147,168,0.7015941491839469
24844,2122.9498,2122.963667,1,63688493,63688910,417,0.5632963538855225
24845,2122.990733,2122.994567,1,63689721,63689837,116,0.5996748707248668
24846,2123.0431,2123.0521,1,63691292,63691563,271,0.7246614064727258
24847,2123.059033,2123.062433,1,63691770,63691872,102,0.49473670327260505
24848,2123.0884,2123.111667,1,63692652,63693350,698,0.6518960850288835
24849,2123.113167,2123.1258,1,63693395,63693773,378,0.2658148653515433
24850,2123.170033,2123.1761,1,63695100,63695283,183,0.47925611538918905
24851,2123.177767,2123.188833,1,63695333,63695664,331,0.6383809547910099
24852,2123.2262,2123.2375,1,63696786,63697125,339,0.42467574433527183
24853,2123.367233,2123.513833,1,63701016,63705414,4398,0.7847484592750982
24854,2123.515333,2123.557033,1,63705459,63706710,1251,0.7782076268382307
24855,2123.5797,2123.586567,1,63707390,63707597,207,0.7474052538119519
24856,2123.588,2123.649633,1,63707640,63709488,1848,0.6134404096117159
24857,2123.6511,2123.6555,1,63709533,63709664,131,0.40877687750766595
24858,2123.659767,2123.688167,1,63709793,63710645,852,0.7418920776245135
24859,2123.6942,2123.7474,1,63710826,63712422,1596,0.6623676338348687
24860,2123.8252,2123.8291,1,63714756,63714873,117,0.1925795391072327
24861,2123.9149,2123.9781,1,63717447,63719342,1895,0.49305936292638614
24862,2124.103967,2124.123233,1,63723119,63723696,577,0.6412559124833049
24863,2124.125167,2124.2383,1,63723755,63727149,3394,0.7309825723566716
24864,2124.245267,2124.326,1,63727358,63729780,2422,0.7700229475910754
24865,2124.346333,2124.444167,1,63730389,63733325,2936,0.8199878372696817
24866,2124.447067,2124.4592,1,63733412,63733775,363,0.3617937398408083
24867,2124.4703,2124.475533,1,63734109,63734265,156,0.34009801333049366
24868,2124.858433,2124.863033,1,63745752,63745890,138,0.41192749318000527
24869,2124.870333,2124.8885,1,63746109,63746655,546,0.6468713795915235
24870,2124.917367,2124.936867,1,63747521,63748106,585,0.5614580446133234
24871,2125.113067,2125.188567,1,63753392,63755657,2265,0.7922050260825246
24872,2125.194733,2125.284633,1,63755841,63758538,2697,0.7624760977909535
24873,2125.324933,2125.360033,1,63759747,63760800,1053,0.7750937199476948
24874,2125.3698,2125.511467,1,63761094,63765344,4250,0.7702590660932861
24875,2125.533133,2125.5387,1,63765993,63766161,168,0.1260754799734214
24876,2125.542667,2125.545967,1,63766280,63766379,99,0.8109078556820466
24877,2125.813733,2125.819567,1,63774411,63774587,176,0.6557707487167944
24878,2125.8206,2125.841133,1,63774618,63775233,615,0.5438169334182233
24879,2125.8555,2125.869567,1,63775665,63776087,422,0.7561277475303879
24880,2125.878067,2125.9016,1,63776342,63777048,706,0.8224179890368114
24881,2125.904033,2125.910533,1,63777120,63777315,195,0.8778263797620608
24882,2125.911667,2125.915667,1,63777350,63777470,120,0.7147752183121259
24883,2125.917967,2125.968267,1,63777539,63779048,1509,0.6770206946019709
24884,2125.9757,2126.0278,1,63779271,63780833,1562,0.645806122963855
24885,2126.046333,2126.078833,1,63781389,63782364,975,0.6858151644465106
24886,2126.089767,2126.145533,1,63782693,63784365,1672,0.6982572556524346
24887,2126.1579,2126.195033,1,63784737,63785850,1113,0.7539410873062931
24888,2126.209533,2126.242067,1,63786285,63787262,977,0.8259377506464225
24889,2126.2561,2126.264133,1,63787683,63787923,240,-0.0009730468937581053
24890,2126.266433,2126.279433,1,63787992,63788382,390,0.2512603786515875
24891,2126.281233,2126.297567,1,63788436,63788927,491,0.08881053342644504
24892,2126.323367,2126.336267,1,63789701,63790088,387,0.5855369568977609
24893,2126.3376,2126.377933,1,63790127,63791337,1210,0.7576258285292607
24894,2126.3797,2126.4294,1,63791391,63792882,1491,0.7606282262367101
24895,2126.443167,2126.480967,1,63793295,63794429,1134,-0.003117824220962674
24896,2126.4949,2126.5046,1,63794847,63795138,291,0.617760271905579
24897,2126.5086,2126.625533,1,63795258,63798765,3507,0.8220818335715934
24898,2126.666933,2126.670433,1,63800007,63800112,105,0.021608717337854928
24899,2126.699967,2126.720433,1,63800999,63801612,613,0.11672439757446829
24900,2126.779633,2126.785367,1,63803388,63803561,173,-0.04975046276984401
24901,2126.793967,2126.812733,1,63803819,63804381,562,0.5875422623423772
24902,2127.055267,2127.0712,1,63811658,63812135,477,0.6337648335413697
24903,2127.072367,2127.164667,1,63812171,63814940,2769,0.7641453550536763
24904,2127.191867,2127.2216,1,63815756,63816647,891,0.7226896608664749
24905,2127.2396,2127.2967,1,63817188,63818900,1712,0.6714969830677533
24906,2127.304967,2127.308433,1,63819149,63819252,103,0.06978128984770295
24907,2127.319433,2127.3303,1,63819582,63819909,327,0.7000678066256981
24908,2127.331933,2127.3429,1,63819957,63820287,330,0.5882298853011422
24909,2127.3484,2127.3527,1,63820451,63820581,130,0.2639536509820724
24910,2127.368067,2127.375133,1,63821042,63821253,211,0.5011573469081243
24911,2127.3763,2127.390033,1,63821289,63821700,411,-0.04886360740356392
24912,2127.392567,2127.4146,1,63821777,63822438,661,0.22792900647143916
24913,2127.423633,2127.4311,1,63822708,63822932,224,0.30450230864856964
24914,2127.441967,2127.741933,1,63823259,63832257,8998,0.7684427239067049
24915,2127.7852,2127.788767,1,63833555,63833663,108,
24916,2127.863967,2127.8694,1,63835919,63836082,163,0.7185702610891938
24917,2127.8825,2127.888,1,63836475,63836640,165,0.9376917860184322
24918,2127.889233,2127.9035,1,63836676,63837105,429,0.4482266583134406
24919,2127.907967,2127.913567,1,63837239,63837407,168,-0.35982529242036765
24920,2127.921367,2127.942833,1,63837641,63838284,643,0.484188125064786
24921,2127.952367,2127.965967,1,63838571,63838979,408,0.3157469422553435
24922,2127.980067,2127.9945,1,63839402,63839834,432,0.7249977028731128
24923,2127.995767,2128.0122,1,63839873,63840366,493,0.7162148842433664
24924,2128.0153,2128.055633,1,63840459,63841668,1209,0.7021796282652507
24925,2128.066767,2128.1038,1,63842003,63843113,1110,0.6729527760108163
24926,2128.104867,2128.112767,1,63843146,63843383,237,-0.16181348862294945
24927,2128.129167,2128.190733,1,63843875,63845721,1846,0.7214279222450946
24928,2128.1964,2128.214533,1,63845891,63846435,544,0.7356209708441992
24929,2128.224833,2128.2284,1,63846744,63846852,108,0.5528883022007092
24930,2128.2406,2128.296467,1,63847218,63848894,1676,-0.005115784796158631
24931,2128.307367,2128.476433,1,63849221,63854292,5071,0.7769161566961699
24932,2128.483433,2128.513133,1,63854502,63855393,891,0.6923388928813298
24933,2128.514167,2128.566833,1,63855425,63857004,1579,0.6008944522287044
24934,2128.568033,2128.6423,1,63857040,63859269,2229,0.7562324796898364
24935,2128.652133,2128.6568,1,63859563,63859704,141,0.7758235612474784
24936,2128.667033,2128.697267,1,63860010,63860918,908,0.8008089911278015
24937,2128.704633,2128.7489,1,63861138,63862467,1329,0.06995560043809508
24938,2128.7802,2128.890167,1,63863406,63866705,3299,0.7239702973674561
24939,2128.904733,2128.919533,1,63867141,63867585,444,-0.09399716174816791
24940,2128.922067,2128.934933,1,63867662,63868047,385,0.2532705540578385
24941,2128.935967,2128.943733,1,63868079,63868311,232,0.29107621690709196
24942,2128.945267,2129.1078,1,63868358,63873234,4876,0.8012083571179567
24943,2129.1215,2129.159867,1,63873645,63874796,1151,-0.0027678808015697063
24944,2129.1643,2129.177533,1,63874929,63875325,396,0.3664577646815113
24945,2129.2004,2129.3387,1,63876012,63880160,4148,0.7718408459035284
24946,2129.345967,2129.354933,1,63880379,63880647,268,0.42394636010289766
24947,2129.360167,2129.379567,1,63880805,63881387,582,-0.01883338608282303
24948,2129.3818,2129.405233,1,63881454,63882156,702,0.13860772236268756
24949,2129.4193,2129.586967,1,63882579,63887609,5030,0.7965630522127207
24950,2129.587967,2129.591867,1,63887639,63887756,117,0.5722122793243083
24951,2129.594033,2129.598033,1,63887820,63887940,120,0.560485917430024
24952,2129.604267,2129.615367,1,63888128,63888461,333,-0.05959426005181338
24953,2129.630333,2129.768567,1,63888909,63893057,4148,0.7931674610976431
24954,2129.772067,2129.877067,1,63893162,63896312,3150,0.8209021443183359
24955,2129.886267,2129.9072,1,63896588,63897216,628,-0.11929046941643666
24956,2129.9082,2129.917433,1,63897245,63897522,277,0.09611106144758798
24957,2129.921067,2129.931567,1,63897632,63897947,315,0.24411331979014683
24958,2129.932667,2129.938933,1,63897980,63898167,187,-0.2584136874684622
24959,2129.947867,2129.952,1,63898436,63898560,124,0.12581498788929876
24960,2129.957133,2130.126533,1,63898713,63903795,5082,0.8093226981157009
24961,2130.171567,2130.1845,1,63905147,63905534,387,0.775546790449684
24962,2130.186967,2130.2362,1,63905609,63907085,1476,0.6708475983598284
24963,2130.2405,2130.2879,1,63907215,63908636,1421,0.7640700682108508
24964,2130.29,2130.359467,1,63908700,63910784,2084,0.7889859452410017
24965,2130.3663,2130.403233,1,63910989,63912096,1107,0.7179239273820648
24966,2130.699867,2130.703367,1,63920996,63921101,105,0.06539759332778754
24967,2130.737567,2130.742333,1,63922127,63922269,142,0.1830078720425413
24968,2130.8791,2130.886933,1,63926373,63926607,234,0.32431464886759354
24969,2130.900267,2130.9045,1,63927008,63927135,127,-0.1951453771106913
24970,2130.905833,2130.936167,1,63927174,63928085,911,0.37089860432604205
24971,2130.9414,2130.9869,1,63928242,63929607,1365,0.08944170928104057
24972,2130.992467,2131.0268,1,63929774,63930804,1030,0.6568208796248647
24973,2131.0624,2131.072433,1,63931871,63932172,301,0.743976443577334
24974,2131.080733,2131.102533,1,63932421,63933075,654,0.8714509946689384
24975,2131.1313,2131.191767,1,63933939,63935753,1814,0.6751747414808782
24976,2131.209467,2131.2265,1,63936284,63936795,511,0.7411535340139805
24977,2131.2434,2131.261967,1,63937301,63937859,558,0.8241511123129466
24978,2131.269733,2131.296667,1,63938091,63938900,809,0.7714082691211969
24979,2131.3042,2131.372133,1,63939126,63941163,2037,0.10774367677371993
24980,2131.3733,2131.378067,1,63941199,63941342,143,0.020179477490723133
24981,2131.420167,2131.423367,1,63942605,63942701,96,
24982,2131.424533,2131.473967,1,63942735,63944219,1484,0.7484945799621667
24983,2131.4762,2131.503467,1,63944286,63945104,818,0.24640985822877684
24984,2131.5061,2131.614467,1,63945183,63948434,3251,0.1348786507619488
24985,2131.6188,2131.633067,1,63948564,63948992,428,0.08892430688029422
24986,2131.637467,2131.681133,1,63949124,63950433,1309,0.219475366922415
24987,2131.683167,2131.686833,1,63950495,63950604,109,-0.2013566015633222
24988,2131.6883,2131.695933,1,63950648,63950877,229,-0.10900240237097715
24989,2131.704033,2131.713667,1,63951120,63951410,290,-0.06962249290233183
24990,2131.7154,2131.739333,1,63951462,63952179,717,0.07662670961974567
24991,2131.740633,2131.855867,1,63952218,63955676,3458,0.18487405692583783
24992,2131.863167,2131.881367,1,63955895,63956441,546,0.7296555819945729
24993,2131.8835,2131.9325,1,63956505,63957975,1470,0.7710322139916442
24994,2131.9361,2131.986567,1,63958083,63959597,1514,0.7995016243216324
24995,2132.058967,2132.075233,1,63961769,63962256,487,0.31035439453027674
24996,2132.079733,2132.106467,1,63962391,63963194,803,0.06901559291022343
24997,2132.1077,2132.1203,1,63963231,63963609,378,0.11628693076026088
24998,2132.121833,2132.1363,1,63963654,63964089,435,0.14326064548982864
24999,2132.196333,2132.2006,1,63965889,63966018,129,0.42159124113310176
25000,2132.204067,2132.2098,1,63966122,63966294,172,0.6619200127881801
25001,2132.2218,2132.230567,1,63966653,63966917,264,0.947710521732829
25002,2132.2316,2132.2458,1,63966948,63967374,426,0.5950093963489997
25003,2132.2475,2132.262667,1,63967425,63967880,455,0.7890758460812007
25004,2132.2657,2132.283433,1,63967971,63968502,531,0.901225618228355
25005,2132.286933,2132.3293,1,63968607,63969878,1271,0.7875508412794477
25006,2132.989267,2132.992333,1,63989678,63989769,91,0.5453643960284346
25007,2133.0111,2133.0353,1,63990333,63991059,726,0.6369299917999081
25008,2133.0479,2133.068833,1,63991437,63992064,627,0.6826505313395312
25009,2133.094467,2133.1138,1,63992834,63993414,580,0.658689346121016
25010,2133.115933,2133.1192,1,63993477,63993576,99,0.6602443492900015
25011,2133.123067,2133.1624,1,63993692,63994872,1180,0.5697585080367599
25012,2133.169567,2133.1736,1,63995087,63995208,121,0.8303012926537439
25013,2133.181267,2133.234267,1,63995438,63997028,1590,0.7161997708729709
25014,2133.257167,2133.288767,1,63997715,63998663,948,0.763782819762631
25015,2133.3086,2133.357967,1,63999257,64000739,1482,0.488538968072403
25016,2133.378233,2133.426833,1,64001346,64002804,1458,0.8109944501188587
25017,2133.437033,2133.459567,1,64003110,64003787,677,0.652302608540845
25018,2133.4685,2133.5463,1,64004055,64006389,2334,0.5075890853781652
25019,2133.576733,2133.684933,1,64007301,64010547,3246,0.8045253323675444
25020,2133.720167,2133.726433,1,64011605,64011792,187,0.11327393979736296
25021,2134.133733,2134.2328,1,64024011,64026984,2973,0.8007059823613537
25022,2134.245333,2134.252167,1,64027359,64027565,206,-0.06728716752850188
25023,2134.260233,2134.2755,1,64027806,64028265,459,0.3959835269925733
25024,2134.276533,2134.3404,1,64028295,64030212,1917,0.20541497853777554
25025,2134.346367,2134.407533,1,64030391,64032225,1834,0.13246242838432287
25026,2134.4099,2134.418833,1,64032297,64032564,267,-0.04316810801427793
25027,2134.424467,2134.5077,1,64032734,64035231,2497,0.3790074530253714
25028,2134.520033,2134.524233,1,64035600,64035726,126,0.30280770491233755
25029,2134.525433,2134.531033,1,64035762,64035930,168,0.36074420089133225
25030,2134.532133,2134.574367,1,64035963,64037231,1268,0.615433133197741
25031,2134.5787,2134.581733,1,64037361,64037451,90,-0.1481009355422374
25032,2134.6081,2134.616133,1,64038243,64038483,240,0.6097089479565034
25033,2134.6176,2134.625933,1,64038528,64038777,249,0.6752287173589337
25034,2134.635533,2134.655367,1,64039065,64039661,596,0.5561665510297022
25035,2134.6656,2134.6718,1,64039967,64040154,187,0.49794776710860256
25036,2134.6916,2134.712233,1,64040748,64041366,618,0.6884124631952291
25037,2134.7247,2134.7394,1,64041741,64042182,441,0.5270343350159281
25038,2134.7436,2134.749167,1,64042307,64042475,168,0.5869521220250681
25039,2134.750767,2134.7584,1,64042523,64042752,229,0.5832167166035715
25040,2134.770033,2134.778,1,64043100,64043339,239,0.6546146432653794
25041,2134.7815,2134.812133,1,64043445,64044363,918,0.7069318760015939
25042,2134.8192,2134.834767,1,64044576,64045043,467,0.3782051413511755
25043,2134.837567,2134.853667,1,64045127,64045610,483,0.5307670066902422
25044,2134.8645,2134.8699,1,64045935,64046097,162,-0.04709793612084867
25045,2134.8713,2134.8749,1,64046138,64046246,108,0.08352128332743985
25046,2134.877167,2134.886067,1,64046315,64046582,267,-0.031003843814025503
25047,2134.887967,2134.9722,1,64046639,64049166,2527,0.5265809587964316
25048,2134.988067,2134.991167,1,64049642,64049735,93,-0.12231132325978111
25049,2135.002333,2135.012367,1,64050069,64050371,302,0.39625570845948926
25050,2135.1096,2135.1126,1,64053287,64053378,91,
25051,2135.1136,2135.117867,1,64053408,64053536,128,0.4602770301994242
25052,2135.152733,2135.157267,1,64054581,64054718,137,0.19020342243439878
25053,2135.258667,2135.2618,1,64057760,64057854,94,0.6143986887410053
25054,2135.267633,2135.284633,1,64058028,64058538,510,0.6041589031990929
25055,2135.3319,2135.3526,1,64059957,64060578,621,0.762352349504265
25056,2135.369267,2135.376133,1,64061078,64061283,205,0.5797696669339775
25057,2135.387467,2135.397467,1,64061624,64061924,300,0.1626380910545246
25058,2135.403467,2135.408033,1,64062104,64062240,136,0.8237168810952132
25059,2135.434233,2135.4535,1,64063026,64063605,579,0.5190681160263758
25060,2135.456233,2135.4751,1,64063686,64064253,567,0.5906288528463897
25061,2135.4869,2135.5834,1,64064607,64067502,2895,0.5355893248562528
25062,2135.6055,2135.619133,1,64068165,64068573,408,0.401994822118673
25063,2135.630267,2135.633967,1,64068908,64069019,111,0.8115823667573903
25064,2135.641667,2135.653467,1,64069250,64069604,354,0.2916204439632145
25065,2135.656533,2135.7022,1,64069695,64071066,1371,0.41177864158159105
25066,2135.7153,2135.7331,1,64071458,64071993,535,0.48093145684959615
25067,2135.7438,2135.7471,1,64072314,64072413,99,0.04979286392525826
25068,2135.757067,2135.808033,1,64072712,64074240,1528,0.6201041175435983
25069,2135.818767,2135.824633,1,64074563,64074738,175,0.429398541849017
25070,2135.8271,2135.859433,1,64074813,64075782,969,0.5568875452959675
25071,2135.889233,2135.896,1,64076676,64076880,204,-0.10341039564638226
25072,2135.9036,2135.952733,1,64077108,64078581,1473,0.07402195313252706
25073,2135.966467,2135.971133,1,64078994,64079133,139,-0.25014355937108906
25074,2135.972567,2136.107033,1,64079177,64083210,4033,0.7650735499791835
25075,2136.133167,2136.250167,1,64083995,64087505,3510,0.7739692953261557
25076,2136.263233,2136.289467,1,64087896,64088684,788,0.5823454946531875
25077,2136.2934,2136.297733,1,64088802,64088931,129,0.7144663426351439
25078,2136.301033,2136.3439,1,64089030,64090316,1286,0.5157801717693941
25079,2136.345767,2136.4348,1,64090373,64093044,2671,0.6575877855205026
25080,2137.169833,2137.321467,1,64115094,64119644,4550,0.8184853384944388
25081,2137.3247,2137.386,1,64119741,64121580,1839,0.7258485251179934
25082,2137.389833,2137.4112,1,64121694,64122336,642,0.7823720102964196
25083,2137.420933,2137.439133,1,64122627,64123173,546,0.687552870067176
25084,2137.603433,2137.6213,1,64128102,64128638,536,0.5140276030726765
25085,2137.625633,2137.633933,1,64128768,64129017,249,0.4519426264106179
25086,2137.678867,2137.6869,1,64130366,64130607,241,0.6799571766735685
25087,2137.689167,2137.6934,1,64130675,64130802,127,0.6836403385054124
25088,2138.022333,2138.027433,1,64140669,64140822,153,0.7429128138314317
25089,2138.029667,2138.1774,1,64140890,64145322,4432,0.8025576435750142
25090,2138.178567,2138.194367,1,64145357,64145831,474,0.8000739872882604
25091,2138.203233,2138.269233,1,64146096,64148076,1980,0.8234435400235933
25092,2138.271733,2138.2772,1,64148151,64148316,165,0.44806801083168474
25093,2138.2814,2138.3058,1,64148441,64149174,733,0.7303629782020316
25094,2138.325567,2138.330633,1,64149767,64149918,151,0.06553084852857695
25095,2138.333667,2138.411633,1,64150010,64152348,2338,0.8062591351178021
25096,2138.830133,2138.8367,1,64164903,64165100,197,0.6340740340144558
25097,2138.838967,2138.851267,1,64165169,64165538,369,0.6485960432900941
25098,2138.877,2138.896233,1,64166310,64166886,576,0.7022911678210728
25099,2138.907633,2138.910833,1,64167228,64167324,96,0.1919554723430498
25100,2138.912367,2138.937933,1,64167371,64168137,766,0.7835195238221941
25101,2138.940667,2138.962033,1,64168220,64168860,640,0.7606316939170066
25102,2138.970967,2139.023833,1,64169129,64170714,1585,0.7499330299469973
25103,2139.026933,2139.065633,1,64170807,64171968,1161,0.7060180818860997
25104,2139.073933,2139.076933,1,64172217,64172307,90,0.20274621692853573
25105,2139.096233,2139.2097,1,64172886,64176291,3405,0.6965638664475414
25106,2139.211067,2139.2151,1,64176332,64176453,121,0.4543792696852193
25107,2139.219533,2139.241767,1,64176585,64177253,668,0.5648554662435467
25108,2139.243133,2139.270733,1,64177293,64178121,828,0.6005272736313017
25109,2139.2753,2139.331167,1,64178258,64179935,1677,0.643856341519963
25110,2139.3415,2139.356733,1,64180245,64180701,456,0.6510087958465774
25111,2139.364933,2139.371333,1,64180947,64181139,192,0.3117192133433986
25112,2139.375533,2139.3829,1,64181265,64181487,222,0.4003958250997696
25113,2139.3974,2139.402267,1,64181921,64182068,147,-0.13890369696258287
25114,2139.406467,2139.414233,1,64182194,64182426,232,-0.047414375427134746
25115,2139.420833,2139.441367,1,64182624,64183241,617,0.14763816279510353
25116,2139.549733,2139.623033,1,64186491,64188690,2199,0.6542073808965897
25117,2139.635467,2139.6412,1,64189064,64189236,172,0.1952250422806906
25118,2139.6467,2139.651667,1,64189400,64189550,150,0.09624258294782335
25119,2139.854467,2139.858767,1,64195634,64195763,129,-0.2767600752975072
25120,2139.869733,2139.972833,1,64196091,64199184,3093,0.6576431630239525
25121,2139.977233,2139.9895,1,64199316,64199685,369,0.7500349917373186
25122,2139.995033,2140.001167,1,64199850,64200035,185,0.39570388855171995
25123,2140.014833,2140.063667,1,64200444,64201910,1466,0.6939671616210356
25124,2140.080833,2140.1082,1,64202424,64203246,822,0.7847180576021648
25125,2140.541967,2140.5548,1,64216259,64216644,385,0.6675754313467127
25126,2140.5666,2140.569933,1,64216998,64217097,99,0.1790727061939493
25127,2140.573333,2140.5868,1,64217199,64217604,405,0.1537302068550867
25128,2140.590333,2140.623333,1,64217709,64218699,990,0.5262575122784262
25129,2140.625,2140.6446,1,64218750,64219338,588,0.4867355065803612
25130,2140.672867,2140.7246,1,64220186,64221738,1552,0.46802751600728587
25131,2140.7563,2140.765233,1,64222689,64222956,267,0.4230361536115843
25132,2140.7666,2140.785633,1,64222998,64223568,570,0.44610954509602807
25133,2140.810367,2140.821167,1,64224311,64224635,324,0.2580272984478144
25134,2140.870233,2140.875033,1,64226106,64226250,144,0.4354588421968689
25135,2140.8764,2140.8872,1,64226292,64226616,324,0.4696643105055664
25136,2140.911633,2140.914933,1,64227348,64227447,99,-0.18620058624983551
25137,2140.927033,2140.939867,1,64227810,64228196,386,0.4877109427721719
25138,2140.9666,2140.973667,1,64228998,64229210,212,0.4324286593276914
25139,2140.991367,2141.0261,1,64229741,64230783,1042,0.048242207013113075
25140,2141.027433,2141.0357,1,64230822,64231071,249,0.48379155300047555
25141,2141.0504,2141.0539,1,64231512,64231617,105,
25142,2141.075433,2141.105633,1,64232262,64233168,906,0.78368472377431
25143,2141.107367,2141.217833,1,64233221,64236534,3313,0.7945328113479033
25144,2141.226,2141.2603,1,64236780,64237809,1029,0.029296998003414752
25145,2141.262133,2141.271467,1,64237863,64238144,281,0.28992709566169395
25146,2141.272567,2141.285467,1,64238177,64238564,387,0.03923043437655431
25147,2141.290333,2141.2934,1,64238709,64238802,93,-0.0644638278911746
25148,2141.347767,2141.3585,1,64240433,64240754,321,0.36979460009084036
25149,2141.367467,2141.404433,1,64241024,64242132,1108,0.02665562265814798
25150,2141.4135,2141.420767,1,64242405,64242623,218,0.16096875206127328
25151,2141.423,2141.429633,1,64242689,64242888,199,0.40146112049726945
25152,2141.4316,2141.478133,1,64242948,64244343,1395,0.8068533369693025
25153,2141.480667,2141.564133,1,64244420,64246923,2503,0.41406822834203066
25154,2141.567033,2141.654067,1,64247010,64249622,2612,0.41448074831341225
25155,2141.655067,2141.903533,1,64249652,64257105,7453,0.30007970343873247
25156,2141.905433,2142.0102,1,64257162,64260306,3144,0.2959422546519461
25157,2142.016733,2142.028533,1,64260501,64260855,354,0.04930348481301288
25158,2142.033267,2142.072633,1,64260998,64262178,1180,0.39630499591426377
25159,2142.074033,2142.085167,1,64262220,64262555,335,0.23266995987525654
25160,2142.088633,2142.0963,1,64262658,64262889,231,0.1908418737617578
25161,2142.104467,2142.1427,1,64263134,64264281,1147,0.334960323157512
25162,2142.1458,2142.150533,1,64264373,64264515,142,0.05220584552288204
25163,2142.153433,2142.201767,1,64264602,64266053,1451,0.5956847667726528
25164,2142.208033,2142.3393,1,64266240,64270179,3939,0.5567206621984105
25165,2142.3468,2142.425233,1,64270403,64272756,2353,0.6824897160718565
25166,2142.426333,2142.482667,1,64272789,64274480,1691,0.4688765359727192
25167,2142.485667,2142.5084,1,64274570,64275252,682,0.23965401923995855
25168,2142.5239,2142.7885,1,64275717,64283655,7938,0.286796192809948
25169,2142.791833,2142.7952,1,64283754,64283856,102,
25170,2142.8039,2142.8453,1,64284117,64285359,1242,0.7773468257491374
25171,2142.8478,2143.0612,1,64285434,64291836,6402,0.624279831446324
25172,2143.067667,2143.4974,1,64292030,64304922,12892,0.30105630454448984
25173,2143.4984,2143.582833,1,64304952,64307484,2532,0.6914862724842544
25174,2143.596833,2143.777633,1,64307904,64313328,5424,0.567185695692929
25175,2143.790167,2143.8573,1,64313705,64315719,2014,0.8001863897735243
25176,2143.884167,2143.893833,1,64316525,64316814,289,0.006546075294892141
25177,2143.898567,2143.905033,1,64316957,64317150,193,0.25173070467470765
25178,2143.910333,2144.0831,1,64317309,64322492,5183,0.7053466826151544
25179,2144.102233,2144.107767,1,64323066,64323233,167,-0.1834259207094152
25180,2144.409433,2144.4213,1,64332282,64332639,357,0.7119919263558191
25181,2144.425933,2144.495733,1,64332777,64334871,2094,0.2365551186098847
25182,2144.507733,2144.515567,1,64335231,64335467,236,0.2238918445207556
25183,2144.535933,2144.5426,1,64336077,64336278,201,0.19115374924653006
25184,2144.580433,2144.6227,1,64337412,64338681,1269,-0.02346066589436513
25185,2144.6266,2144.6347,1,64338798,64339041,243,0.032910508284636056
25186,2144.6413,2144.6446,1,64339238,64339338,100,-0.04506509205983886
25187,2144.7294,2144.769933,1,64341882,64343097,1215,0.5791469280004408
25188,2144.773333,2144.8005,1,64343199,64344014,815,0.6406498294344782
25189,2144.8073,2144.810967,1,64344219,64344329,110,
25190,2144.8194,2144.824067,1,64344581,64344722,141,-0.04568028430637215
25191,2144.831833,2144.850867,1,64344954,64345526,572,-0.03123813313731941
25192,2144.852733,2144.866,1,64345581,64345980,399,-0.04374909850106516
25193,2145.007633,2145.067867,1,64350228,64352036,1808,0.5505220414035757
25194,2145.069333,2145.0736,1,64352079,64352208,129,-0.4718717259315349
25195,2145.1299,2145.133,1,64353897,64353989,92,0.5446212555185954
25196,2145.290567,2145.295933,1,64358717,64358877,160,0.35645792944048177
25197,2145.313033,2145.321533,1,64359390,64359645,255,0.16522711644078092
25198,2145.3249,2145.458767,1,64359747,64363763,4016,0.809334402427765
25199,2145.481733,2145.507467,1,64364451,64365224,773,0.7715099366292095
25200,2145.5122,2145.577533,1,64365366,64367325,1959,0.8194257733163197
25201,2145.578767,2145.586767,1,64367363,64367603,240,0.8438016627038638
25202,2145.604667,2145.617767,1,64368140,64368533,393,0.06259504957926415
25203,2145.631,2145.648967,1,64368929,64369469,540,-0.019562676621127414
25204,2145.660933,2145.665467,1,64369827,64369964,137,0.08196146908299469
25205,2145.708833,2145.7883,1,64371264,64373649,2385,0.2404197444236452
25206,2146.047233,2146.066733,1,64381416,64382001,585,0.7905690325844635
25207,2146.102667,2146.1112,1,64383080,64383335,255,0.32200183478012895
25208,2146.1232,2146.1819,1,64383696,64385457,1761,0.7404538884556099
25209,2146.1914,2146.2143,1,64385742,64386429,687,0.7127214013603574
25210,2146.215967,2146.297333,1,64386479,64388919,2440,0.7274397489179459
25211,2146.2985,2146.3061,1,64388955,64389182,227,0.012779278862622668
25212,2146.3277,2146.331167,1,64389830,64389935,105,0.2981668357790046
25213,2146.332233,2146.397667,1,64389966,64391930,1964,0.7912058381117317
25214,2146.403067,2146.4894,1,64392092,64394682,2590,0.6362390934207031
25215,2146.490867,2146.493867,1,64394726,64394816,90,0.763191121360603
25216,2146.497533,2146.513633,1,64394925,64395408,483,0.7151770530691649
25217,2146.5147,2146.6191,1,64395441,64398573,3132,0.7707338483406091
25218,2146.673067,2146.677367,1,64400192,64400321,129,0.019728288866289218
25219,2146.766633,2146.955233,1,64402998,64408656,5658,0.5047184946513704
25220,2147.8779,2147.909667,1,64436337,64437290,953,0.7050747575711241
25221,2147.9225,2147.927233,1,64437675,64437816,141,0.6183691688018381
25222,2147.928667,2147.945167,1,64437860,64438355,495,0.4223116991979031
25223,2147.9684,2147.972467,1,64439052,64439174,122,-0.29277765299994957
25224,2147.984,2147.987433,1,64439520,64439622,102,0.2714007426693262
25225,2148.281567,2148.295033,1,64448447,64448850,403,0.5129157905000825
25226,2148.304067,2148.360033,1,64449122,64450800,1678,0.8361133907504058
25227,2148.397,2148.400567,1,64451910,64452017,107,0.47245528562764894
25228,2148.4125,2148.430167,1,64452375,64452905,530,0.5904837035831355
25229,2148.4468,2148.465067,1,64453404,64453952,548,0.5232690124255215
25230,2148.517633,2148.523733,1,64455528,64455711,183,0.4169482959383147
25231,2148.5252,2148.534667,1,64455756,64456040,284,0.7833194707138272
25232,2148.5608,2148.582667,1,64456824,64457480,656,0.6183239776653766
25233,2148.679267,2148.750867,1,64460378,64462526,2148,0.8231948402573308
25234,2148.753333,2148.7567,1,64462599,64462701,102,0.34191157200456723
25235,2148.759667,2148.782933,1,64462790,64463487,697,0.4424235335068015
25236,2148.796567,2148.819633,1,64463897,64464588,691,0.7581517651395393
25237,2148.8516,2148.856433,1,64465548,64465692,144,0.11173418536662562
25238,2148.862533,2148.866267,1,64465875,64465988,113,0.4928690116803155
25239,2149.019733,2149.0761,1,64470591,64472283,1692,0.5137398076827684
25240,2149.1032,2149.108833,1,64473096,64473264,168,0.03139987511792041
25241,2149.1126,2149.116033,1,64473378,64473480,102,
25242,2149.461667,2149.4679,1,64483850,64484037,187,0.41221714527023434
25243,2149.504433,2149.5323,1,64485132,64485968,836,0.6794510230301442
25244,2149.543033,2149.554467,1,64486290,64486634,344,0.4894292052983155
25245,2149.562933,2149.593,1,64486887,64487789,902,0.6441504733090285
25246,2149.5969,2149.6384,1,64487907,64489151,1244,0.5168278097688058
25247,2149.641767,2149.6467,1,64489253,64489400,147,0.11859572458315965
25248,2149.657933,2149.692433,1,64489737,64490772,1035,0.6517626922606586
25249,2149.709967,2149.715233,1,64491299,64491456,157,0.7837488178404788
25250,2149.719267,2149.729167,1,64491578,64491875,297,0.618618367131239
25251,2149.7355,2149.750867,1,64492064,64492526,462,0.4609281348455214
25252,2149.768867,2149.819667,1,64493066,64494590,1524,0.7057260102835283
25253,2149.842167,2149.8469,1,64495265,64495407,142,0.6029544771572735
25254,2149.848167,2149.8586,1,64495445,64495758,313,0.7669918860593501
25255,2149.879167,2149.893033,1,64496375,64496790,415,0.7335857862489438
25256,2149.901133,2149.912767,1,64497033,64497383,350,0.5657440063440807
25257,2149.933933,2149.938833,1,64498017,64498164,147,0.10951085461929551
25258,2149.950333,2149.977567,1,64498509,64499327,818,-0.02042181645217308
25259,2149.979767,2150.017733,1,64499393,64500531,1138,0.1659030180982036
25260,2150.039433,2150.087767,1,64501182,64502633,1451,0.6670271637032178
25261,2150.096533,2150.135933,1,64502895,64504077,1182,0.7437265699020005
25262,2150.1427,2150.150133,1,64504281,64504503,222,0.252047029200728
25263,2150.162433,2150.192867,1,64504872,64505786,914,-0.05355020474221732
25264,2150.1947,2150.2022,1,64505841,64506066,225,0.33624906729000853
25265,2150.228,2150.231067,1,64506840,64506932,92,
25266,2150.2341,2150.238567,1,64507023,64507157,134,-0.049293344662490884
25267,2150.247133,2150.271533,1,64507413,64508145,732,0.3664907267328497
25268,2150.272733,2150.292133,1,64508181,64508763,582,0.01744135187633352
25269,2150.296333,2150.313967,1,64508889,64509419,530,0.16008932388312666
25270,2150.318167,2150.325667,1,64509545,64509770,225,-0.09369758765557226
25271,2150.337767,2150.344533,1,64510133,64510335,202,0.4674960794520745
25272,2150.346233,2150.670767,1,64510386,64520123,9737,0.4484563361087658
25273,2150.683633,2150.723433,1,64520508,64521702,1194,0.5833701709884245
25274,2150.729267,2151.105567,1,64521878,64533167,11289,0.6128676954526183
25275,2151.11,2151.124967,1,64533300,64533749,449,-0.08538132947497497
25276,2151.133067,2151.140333,1,64533992,64534209,217,0.007577578683378704
25277,2151.219967,2151.225,1,64536599,64536750,151,0.4694752437196327
25278,2151.2413,2151.247967,1,64537239,64537439,200,0.6553282556440879
25279,2151.2503,2151.2567,1,64537509,64537701,192,0.31533660856168183
25280,2151.272667,2151.2851,1,64538180,64538553,373,0.22785326430816738
25281,2151.315167,2151.336767,1,64539455,64540103,648,0.8322355427913579
25282,2151.3554,2151.359733,1,64540662,64540791,129,0.25844947163505577
25283,2151.380667,2151.4131,1,64541420,64542393,973,-0.06041029673027995
25284,2151.4411,2151.4542,1,64543233,64543626,393,0.6714506663671143
25285,2151.478067,2151.5058,1,64544342,64545174,832,0.48151392126710707
25286,2151.546233,2151.5615,1,64546386,64546844,458,0.41825048711253104
25287,2151.570367,2151.592433,1,64547111,64547772,661,0.5519899446979241
25288,2151.5962,2151.6599,1,64547886,64549797,1911,0.05510950681428916
25289,2151.684633,2151.717067,1,64550538,64551512,974,0.7419345790010228
25290,2151.718467,2151.824033,1,64551554,64554720,3166,0.7181504750417381
25291,2151.8255,2151.832,1,64554765,64554960,195,0.6241675036889408
25292,2151.839467,2151.845133,1,64555184,64555353,169,0.08819268115953789
25293,2151.846267,2151.9209,1,64555388,64557627,2239,0.6266628615800078
25294,2151.921933,2151.929533,1,64557657,64557885,228,0.5986769870066132
25295,2151.966367,2151.975567,1,64558991,64559267,276,0.286703679643222
25296,2151.978933,2152.0536,1,64559367,64561608,2241,0.7077963694250181
25297,2152.055533,2152.0716,1,64561665,64562148,483,0.11754347459324407
25298,2152.301833,2152.3154,1,64569054,64569462,408,0.8041154652133625
25299,2152.333367,2152.4087,1,64570001,64572261,2260,0.7769092669960798
25300,2152.423867,2152.472167,1,64572716,64574165,1449,0.7237193394722802
25301,2152.4767,2152.534,1,64574301,64576020,1719,0.7786678023537105
25302,2152.540567,2152.590367,1,64576217,64577711,1494,0.642126115142883
25303,2152.592567,2152.7087,1,64577777,64581261,3484,0.7176677585444334
25304,2152.715467,2152.7507,1,64581464,64582521,1057,0.6360115602795782
25305,2152.7661,2152.770633,1,64582982,64583118,136,0.5243584765997749
25306,2152.7771,2152.905233,1,64583312,64587156,3844,0.3241096777621532
25307,2152.912267,2152.928067,1,64587368,64587842,474,0.16696254505163383
25308,2152.965467,2152.9842,1,64588964,64589525,561,0.47390607842902954
25309,2153.1813,2153.187067,1,64595439,64595612,173,0.28637670880042776
25310,2153.191067,2153.195767,1,64595732,64595873,141,0.6332105799985712
25311,2153.205267,2153.243467,1,64596158,64597304,1146,0.788134680880624
25312,2153.244733,2153.247833,1,64597341,64597434,93,0.6372944601802043
25313,2153.256067,2153.273333,1,64597682,64598199,517,0.5434606117639743
25314,2153.276933,2153.298467,1,64598307,64598954,647,0.47394247960594776
25315,2153.3344,2153.3993,1,64600032,64601979,1947,0.6892408636525722
25316,2153.427933,2153.4687,1,64602837,64604061,1224,0.7011366897015571
25317,2153.505933,2153.509567,1,64605177,64605287,110,0.6195203313847458
25318,2153.533233,2153.597333,1,64605996,64607919,1923,0.7785175006527275
25319,2153.6004,2153.605567,1,64608011,64608167,156,0.731760956458762
25320,2153.614633,2153.631767,1,64608438,64608953,515,0.6867907239278414
25321,2153.659467,2153.664333,1,64609784,64609929,145,-0.1382469690070305
25322,2153.698167,2153.703733,1,64610945,64611111,166,-0.04136718433470119
25323,2153.7113,2153.7169,1,64611339,64611507,168,0.6659612811442056
25324,2153.8105,2153.814233,1,64614315,64614426,111,0.38687880865224716
25325,2153.819533,2153.8987,1,64614585,64616961,2376,0.41302345927037554
25326,2153.904033,2153.907933,1,64617120,64617237,117,-0.05483308105931714
25327,2153.917033,2153.924467,1,64617510,64617734,224,0.028555091725882935
25328,2153.938167,2153.946133,1,64618145,64618383,238,-0.06554918988133039
25329,2154.018633,2154.166367,1,64620558,64624991,4433,0.7235261888801944
25330,2154.167467,2154.170733,1,64625024,64625121,97,0.7014035318924843
25331,2154.172033,2154.215433,1,64625160,64626462,1302,0.658979893401231
25332,2154.219267,2154.351467,1,64626578,64630544,3966,0.7405735901181997
25333,2154.4391,2154.4852,1,64633173,64634556,1383,0.4687991706568232
25334,2154.6434,2154.760833,1,64639302,64642824,3522,0.7647282800168366
25335,2154.770967,2154.793233,1,64643129,64643796,667,0.6960459447706168
25336,2154.817567,2154.891767,1,64644527,64646753,2226,0.7362377288374219
25337,2154.893167,2154.9126,1,64646795,64647378,583,0.678304183018492
25338,2154.9204,2154.979833,1,64647612,64649394,1782,0.7548554759423456
25339,2154.990233,2154.999467,1,64649706,64649984,278,0.373205652326812
25340,2155.006767,2155.0256,1,64650203,64650768,565,0.7564789337750584
25341,2155.031433,2155.034467,1,64650942,64651034,92,0.6994438227341523
25342,2155.0356,2155.1737,1,64651068,64655210,4142,0.1787717073619566
25343,2155.220767,2155.227367,1,64656623,64656821,198,0.028305208418225227
25344,2155.2286,2155.234233,1,64656858,64657026,168,0.10365967176166362
25345,2155.384867,2155.391933,1,64661546,64661757,211,0.5286592861680718
25346,2155.632567,2155.736767,1,64668977,64672103,3126,0.7055825776373168
25347,2155.739767,2155.774167,1,64672193,64673225,1032,0.7723238202857237
25348,2155.7941,2155.819033,1,64673823,64674570,747,0.751100904694484
25349,2155.8315,2155.870033,1,64674944,64676100,1156,0.6760963116669281
25350,2155.889367,2155.894833,1,64676681,64676844,163,0.25722461451541334
25351,2155.895933,2155.9501,1,64676877,64678503,1626,0.7833001380937087
25352,2155.960767,2156.007,1,64678823,64680210,1387,0.6647573536995096
25353,2156.009567,2156.032367,1,64680287,64680971,684,0.6719755339436816
25354,2156.034767,2156.0555,1,64681043,64681665,622,0.6463130737570875
25355,2156.060633,2156.0799,1,64681818,64682397,579,0.5653787319499975
25356,2156.0886,2156.1308,1,64682658,64683924,1266,0.8183545604059154
25357,2156.133467,2156.141067,1,64684004,64684232,228,0.33035241362108037
25358,2156.142967,2156.1769,1,64684289,64685307,1018,0.8381328289871625
25359,2156.1844,2156.194767,1,64685532,64685843,311,0.27665662364908755
25360,2156.196533,2156.205733,1,64685895,64686171,276,0.29307696085308743
25361,2156.2752,2156.282133,1,64688256,64688463,207,-0.2534019478100469
25362,2156.2908,2156.3365,1,64688724,64690095,1371,0.10054792816409805
25363,2156.339767,2156.3447,1,64690193,64690341,148,
25364,2156.346267,2156.3596,1,64690388,64690787,399,0.07637208893161063
25365,2156.3655,2156.3803,1,64690965,64691408,443,0.03918058001362478
25366,2156.544767,2156.553767,1,64696343,64696613,270,0.501063601217719
25367,2156.558033,2156.748767,1,64696740,64702463,5723,0.7884407879769686
25368,2156.781333,2156.806533,1,64703439,64704195,756,0.764107023357997
25369,2156.810767,2156.820033,1,64704323,64704600,277,0.6275232386458375
25370,2156.8242,2156.859,1,64704726,64705770,1044,0.7320665232062553
25371,2156.8611,2156.906033,1,64705833,64707180,1347,0.7066494320541351
25372,2156.9105,2156.9251,1,64707315,64707753,438,0.2661488010689729
25373,2156.931167,2156.9986,1,64707935,64709958,2023,0.5399950653583331
25374,2157.025033,2157.1012,1,64710750,64713036,2286,0.7842069328766952
25375,2157.133467,2157.1497,1,64714004,64714491,487,0.729428804411821
25376,2157.154667,2157.168733,1,64714640,64715061,421,0.7896609774894517
25377,2157.1699,2157.185167,1,64715096,64715555,459,0.8778782709092862
25378,2157.211167,2157.221,1,64716335,64716630,295,0.7117908920855527
25379,2157.2563,2157.273,1,64717689,64718190,501,0.7467366834175093
25380,2157.2757,2157.287767,1,64718271,64718633,362,0.6355853874075362
25381,2157.2924,2157.309833,1,64718771,64719294,523,0.8314651600620476
25382,2157.334167,2157.344533,1,64720025,64720335,310,0.6270785010067365
25383,2157.3513,2157.3546,1,64720538,64720638,100,0.7174792192604765
25384,2157.3814,2157.4167,1,64721442,64722501,1059,0.6975959988509144
25385,2157.4206,2157.435667,1,64722618,64723070,452,0.8624787887240934
25386,2157.4614,2157.468833,1,64723842,64724064,222,0.557422077232473
25387,2157.474367,2157.4794,1,64724231,64724382,151,0.503618649643696
25388,2157.498167,2157.5021,1,64724945,64725063,118,0.7447338516475629
25389,2157.505267,2157.508767,1,64725158,64725263,105,0.36004404020211583
25390,2157.521633,2157.547567,1,64725648,64726427,779,0.6712595326852945
25391,2157.585367,2157.597033,1,64727561,64727910,349,0.24864197790305875
25392,2157.5985,2157.606833,1,64727955,64728204,249,0.3542272782489713
25393,2157.775267,2157.8372,1,64733258,64735116,1858,0.2893071702932516
25394,2157.840167,2157.8489,1,64735205,64735467,262,0.3563866069954797
25395,2157.852067,2157.8599,1,64735562,64735797,235,0.3418472958467901
25396,2157.8831,2157.892367,1,64736493,64736771,278,0.02644642123415062
25397,2158.1059,2158.248433,1,64743177,64747452,4275,0.8199134236533
25398,2158.257067,2158.358833,1,64747712,64750764,3052,0.7731481772500767
25399,2158.3602,2158.3719,1,64750806,64751157,351,0.033878312504445486
25400,2158.387233,2158.3931,1,64751616,64751792,176,0.2573878704457881
25401,2158.398433,2158.4042,1,64751952,64752126,174,0.5853696964993859
25402,2158.407,2158.434933,1,64752210,64753047,837,0.8262588781957204
25403,2158.4529,2158.471033,1,64753587,64754130,543,0.8019312373319384
25404,2158.494367,2158.500567,1,64754831,64755017,186,0.7396499660110345
25405,2158.5079,2158.554833,1,64755237,64756644,1407,0.7772184000402265
25406,2158.557033,2158.581367,1,64756710,64757441,731,0.8416959758088219
25407,2158.601433,2158.681133,1,64758042,64760433,2391,0.7668160348807852
25408,2158.688167,2158.692233,1,64760645,64760766,121,
25409,2158.708633,2158.715867,1,64761258,64761476,218,0.2719106958363444
25410,2158.723533,2158.7342,1,64761705,64762025,320,0.09694446987995776
25411,2158.860867,2158.871333,1,64765826,64766139,313,0.321637712283743
25412,2158.873467,2158.919467,1,64766204,64767584,1380,0.5697617062855782
25413,2158.954467,2158.958567,1,64768634,64768757,123,0.28684054236343665
25414,2158.9603,2158.964467,1,64768809,64768934,125,0.617109751970296
25415,2159.001733,2159.0058,1,64770051,64770174,123,0.8057725552123648
25416,2159.034467,2159.045933,1,64771034,64771377,343,0.5092876707598869
25417,2159.064267,2159.081133,1,64771928,64772433,505,0.04910573131902742
25418,2159.280267,2159.319467,1,64778408,64779584,1176,0.3347691550219624
25419,2159.323467,2159.349433,1,64779704,64780482,778,0.27556951805562907
25420,2159.351167,2159.3564,1,64780535,64780692,157,0.2366808079080247
25421,2159.3589,2159.376067,1,64780767,64781282,515,0.38838968620604236
25422,2159.402067,2159.416333,1,64782062,64782489,427,0.12473619544081423
25423,2159.443633,2159.459533,1,64783308,64783785,477,0.45459501319649026
25424,2159.4607,2159.463733,1,64783821,64783911,90,-0.1779113383453698
25425,2159.464867,2159.468033,1,64783946,64784040,94,0.14525980214291948
25426,2159.499633,2159.505267,1,64784988,64785158,170,0.4254877384576426
25427,2159.511133,2159.5277,1,64785333,64785831,498,0.5739515237785383
25428,2159.551633,2159.563033,1,64786548,64786890,342,0.02462168941184383
25429,2159.6111,2159.6161,1,64788333,64788483,150,0.4220566602897426
25430,2159.6177,2159.629167,1,64788530,64788875,345,0.5507550051918979
25431,2159.667367,2159.683067,1,64790021,64790492,471,0.15591857176677681
25432,2159.694767,2159.709867,1,64790843,64791296,453,0.05880197777814341
25433,2159.716367,2159.734333,1,64791491,64792029,538,-0.06352828821909787
25434,2159.737533,2159.7639,1,64792125,64792917,792,0.3568039347474162
25435,2159.791533,2159.795433,1,64793745,64793862,117,0.42371167377040386
25436,2159.807433,2159.816233,1,64794222,64794486,264,0.18576281560201494
25437,2159.834867,2159.8382,1,64795046,64795146,100,
25438,2159.839533,2160.0075,1,64795185,64800225,5040,0.41529906851308473
25439,2160.016833,2160.0203,1,64800504,64800609,105,0.5942386937759027
25440,2160.021933,2160.174767,1,64800657,64805243,4586,0.39949764614386024
25441,2160.177167,2160.328333,1,64805315,64809849,4534,0.2442840018547858
25442,2160.329467,2160.3598,1,64809884,64810794,910,0.3760131879366117
25443,2160.360933,2160.415467,1,64810827,64812464,1637,0.6890410048524249
25444,2160.443,2160.454933,1,64813290,64813647,357,0.6157461348018931
25445,2160.460267,2160.4694,1,64813808,64814082,274,0.10913557038769962
25446,2160.491767,2160.5012,1,64814753,64815036,283,0.6326541034764568
25447,2160.504233,2160.5121,1,64815126,64815363,237,0.3187746626759738
25448,2160.515667,2160.519067,1,64815470,64815572,102,0.48497951236483816
25449,2160.543933,2160.584933,1,64816317,64817547,1230,0.23186925384409884
25450,2160.5905,2160.627933,1,64817714,64818837,1123,0.14691483711000233
25451,2160.6336,2160.652933,1,64819008,64819587,579,0.04146569652997515
25452,2160.6824,2160.686967,1,64820472,64820609,137,0.28293901958201073
25453,2160.6897,2160.7913,1,64820691,64823738,3047,0.63295736922733
25454,2160.792533,2160.808833,1,64823775,64824264,489,0.24963806481912815
25455,2160.811167,2160.8323,1,64824335,64824969,634,0.4682973454175593
25456,2160.844667,2160.8787,1,64825340,64826361,1021,0.09159686573086111
25457,2160.883767,2160.8887,1,64826513,64826661,148,0.06562777584866662
25458,2160.9175,2160.9375,1,64827525,64828125,600,0.10196025769868088
25459,2160.9393,2160.942433,1,64828179,64828272,93,-0.08748298569731199
25460,2160.9463,2161.018033,1,64828389,64830540,2151,0.24693638861529024
25461,2161.026067,2161.0478,1,64830782,64831433,651,0.7261031889743376
25462,2161.057133,2161.115167,1,64831713,64833455,1742,0.34195024196149876
25463,2161.125967,2161.169933,1,64833779,64835097,1318,0.7235910452465844
25464,2161.171067,2161.1795,1,64835132,64835385,253,0.048421853731636155
25465,2161.180533,2161.236333,1,64835415,64837089,1674,0.6835462510251706
25466,2161.251767,2161.263733,1,64837553,64837911,358,0.7456579074193619
25467,2161.268967,2161.2925,1,64838069,64838775,706,0.740216408237284
25468,2161.305067,2161.3255,1,64839152,64839765,613,0.6985150067257012
25469,2161.342567,2161.420333,1,64840277,64842609,2332,0.26076031292135043
25470,2161.432367,2161.447967,1,64842971,64843439,468,0.3005663156496423
25471,2161.449067,2161.453333,1,64843472,64843599,127,-0.15792839895323105
25472,2161.4586,2161.4849,1,64843758,64844547,789,0.29666923499351183
25473,2161.487,2161.490167,1,64844610,64844705,95,-0.14712258852829
25474,2161.502933,2161.590967,1,64845087,64847729,2642,0.6376876353669673
25475,2161.5924,2161.642367,1,64847772,64849271,1499,0.35145778314423753
25476,2161.6438,2161.682867,1,64849313,64850486,1173,0.7369099016382182
25477,2161.685333,2161.697067,1,64850559,64850912,353,0.44656153645981217
25478,2161.6993,2161.7128,1,64850979,64851383,404,0.5415748177831557
25479,2161.7179,2161.824167,1,64851537,64854725,3188,0.5026226066578188
25480,2161.825367,2161.829533,1,64854761,64854885,124,-0.16160056795179936
25481,2161.838167,2161.890733,1,64855145,64856721,1576,0.6185710915946058
25482,2161.898067,2161.904233,1,64856942,64857126,184,0.2940524236185086
25483,2161.909167,2161.983533,1,64857275,64859505,2230,0.3298593480680638
25484,2161.9952,2162.120267,1,64859855,64863608,3753,0.32889287426287006
25485,2162.1308,2162.1366,1,64863924,64864097,173,0.24925877503386748
25486,2162.1406,2162.1465,1,64864218,64864394,176,0.0921814213310131
25487,2162.151633,2162.194833,1,64864548,64865844,1296,0.49542972689350523
25488,2162.202533,2162.372667,1,64866075,64871180,5105,0.21638063216282483
25489,2162.401367,2162.407467,1,64872041,64872224,183,0.5399699267772683
25490,2162.411067,2162.437133,1,64872332,64873113,781,0.6895404576031978
25491,2162.441067,2162.457267,1,64873232,64873718,486,0.4346678100137441
25492,2162.467467,2162.471,1,64874024,64874130,106,0.661998179335164
25493,2162.481367,2162.502,1,64874441,64875060,619,0.6232020803800281
25494,2162.514367,2162.617467,1,64875431,64878524,3093,0.5370650706502532
25495,2162.817,2162.822867,1,64884510,64884686,176,0.10650125409495395
25496,2163.138,2163.1661,1,64894140,64894983,843,0.36536279706364244
25497,2163.203767,2163.213733,1,64896113,64896411,298,0.5147012854657329
25498,2163.240133,2163.245033,1,64897203,64897350,147,0.5280590173863023
25499,2163.292733,2163.303233,1,64898781,64899096,315,0.5565250882286219
25500,2163.312767,2163.319867,1,64899383,64899596,213,0.7751686624273371
25501,2163.364833,2163.374733,1,64900944,64901241,297,0.526057734179205
25502,2163.401333,2163.407367,1,64902039,64902221,182,0.4918422874615176
25503,2163.4148,2163.425567,1,64902444,64902767,323,0.4903805664571566
25504,2163.442967,2163.4584,1,64903289,64903752,463,0.5291749705052387
25505,2163.4674,2163.494467,1,64904022,64904834,812,0.07692240115110248
25506,2163.4958,2163.511833,1,64904874,64905354,480,0.0329884323495774
25507,2163.5371,2163.540667,1,64906113,64906220,107,0.430710128775612
25508,2163.553167,2163.6738,1,64906595,64910214,3619,0.7188411798754225
25509,2164.241067,2164.2551,1,64927232,64927652,420,0.4906837532788689
25510,2164.287833,2164.317667,1,64928634,64929530,896,0.5865006346058403
25511,2164.329433,2164.345,1,64929882,64930349,467,0.568842481420135
25512,2164.4079,2164.5126,1,64932237,64935378,3141,0.7309329239117262
25513,2164.537133,2164.542867,1,64936113,64936286,173,-0.11997596531297483
25514,2164.6736,2164.679733,1,64940208,64940391,183,0.32813271594685045
25515,2164.697133,2164.733333,1,64940913,64941999,1086,0.7473661208785651
25516,2164.7349,2164.832433,1,64942047,64944972,2925,0.8263012825179624
25517,2164.833833,2164.8398,1,64945014,64945194,180,0.5669116859597483
25518,2164.856733,2164.887,1,64945701,64946610,909,0.7158886862464735
25519,2164.9002,2164.903967,1,64947006,64947119,113,
25520,2164.9229,2164.960633,1,64947687,64948818,1131,0.11096785210737643
25521,2164.962167,2164.971133,1,64948865,64949133,268,-0.013120807261267731
25522,2165.007933,2165.1366,1,64950237,64954097,3860,0.8362014208081163
25523,2165.1666,2165.3515,1,64954998,64960545,5547,0.7715565103767037
25524,2165.3567,2165.366067,1,64960700,64960982,282,0.48643024385167904
25525,2165.369833,2165.3729,1,64961094,64961186,92,
25526,2165.3761,2165.385367,1,64961283,64961561,278,-0.026347192944789804
25527,2165.395467,2165.398467,1,64961864,64961954,90,0.8683411750631468
25528,2165.4985,2165.508033,1,64964955,64965240,285,0.622520275073032
25529,2165.527067,2165.537933,1,64965812,64966137,325,0.36292183135158934
25530,2165.542833,2165.5463,1,64966284,64966389,105,0.969705712063536
25531,2165.553733,2165.5792,1,64966611,64967376,765,0.7631269296372585
25532,2165.614533,2165.635967,1,64968435,64969079,644,0.702652254115109
25533,2165.637233,2165.640533,1,64969116,64969215,99,-0.5052228445428109
25534,2165.6558,2165.771767,1,64969674,64973153,3479,0.6702669450963995
25535,2165.774667,2165.778233,1,64973240,64973346,106,0.4705940323312867
25536,2165.780967,2165.828667,1,64973429,64974860,1431,0.6340097268481978
25537,2165.832433,2165.894533,1,64974972,64976835,1863,0.7034992541192708
25538,2165.900033,2165.9153,1,64977000,64977459,459,0.7656177627353908
25539,2165.9164,2165.9359,1,64977492,64978077,585,0.613725019088361
25540,2165.9491,2165.992267,1,64978472,64979768,1296,0.08057809574583909
25541,2166.006833,2166.1272,1,64980204,64983816,3612,0.8493414197044505
25542,2166.1335,2166.1395,1,64984005,64984185,180,0.19736150296635055
25543,2166.149667,2166.1799,1,64984490,64985397,907,0.10905103462122212
25544,2166.183433,2166.203133,1,64985502,64986093,591,0.30564713036388536
25545,2166.239467,2166.3193,1,64987184,64989579,2395,0.8022938500523912
25546,2166.3231,2166.423667,1,64989693,64992710,3017,0.8370872977465657
25547,2166.4274,2166.4533,1,64992822,64993599,777,0.7911086994796338
25548,2166.464467,2166.476333,1,64993934,64994289,355,0.7447637378853954
25549,2166.492567,2166.503633,1,64994777,64995108,331,-0.03874000684381206
25550,2166.507333,2166.524967,1,64995219,64995749,530,0.011312593869891363
25551,2166.5303,2166.537067,1,64995909,64996112,203,0.2848946101869198
25552,2166.5639,2166.7256,1,64996917,65001768,4851,0.8050916694810604
25553,2166.737733,2166.786167,1,65002131,65003585,1454,0.7662399972211635
25554,2166.796467,2166.800667,1,65003894,65004020,126,0.9437549503827345
25555,2166.812667,2166.880333,1,65004380,65006409,2029,0.6868975061418212
25556,2166.885067,2166.960733,1,65006552,65008821,2269,0.7134969205703401
25557,2166.9713,2166.9812,1,65009139,65009436,297,0.5612874183309665
25558,2166.983,2166.9919,1,65009490,65009757,267,0.6917029876453352
25559,2167.002933,2167.013567,1,65010087,65010407,320,0.7178117308469708
25560,2167.034567,2167.043233,1,65011037,65011296,259,0.8810457986118002
25561,2167.053033,2167.095433,1,65011590,65012862,1272,0.2327955360671147
25562,2167.129967,2167.133267,1,65013899,65013998,99,0.6786826895083551
25563,2167.1395,2167.146033,1,65014185,65014380,195,0.8269710334302227
25564,2167.147233,2167.252833,1,65014416,65017584,3168,0.7861297785648376
25565,2167.255,2167.2946,1,65017650,65018838,1188,0.7858726487092196
25566,2167.3091,2167.4028,1,65019273,65022083,2810,0.7938970202856295
25567,2167.4227,2167.431733,1,65022681,65022951,270,0.5571648668145565
25568,2167.444367,2167.476933,1,65023331,65024307,976,0.03406954642830492
25569,2167.486067,2167.500967,1,65024582,65025029,447,0.8709884006236761
25570,2167.502033,2167.593167,1,65025060,65027795,2735,0.7822741341331797
25571,2167.599333,2167.6038,1,65027979,65028113,134,0.3194405095461906
25572,2167.609833,2167.615767,1,65028294,65028473,179,-0.1478731715623552
25573,2167.617133,2167.624367,1,65028513,65028731,218,0.26016410402949736
25574,2167.637233,2167.644233,1,65029116,65029326,210,-0.10360638293537187
25575,2167.6466,2167.808433,1,65029398,65034252,4854,0.8244637186934802
25576,2167.824233,2167.8277,1,65034726,65034830,104,-0.3135591871187593
25577,2167.833733,2167.8572,1,65035011,65035716,705,0.0056997735125415335
25578,2167.8582,2167.886167,1,65035746,65036585,839,0.1931829721060646
25579,2167.895067,2167.901833,1,65036852,65037054,202,0.6493901356005201
25580,2167.908,2167.935767,1,65037240,65038073,833,0.7610616118286778
25581,2167.939667,2168.018367,1,65038190,65040551,2361,0.8185519877042567
25582,2168.0335,2168.051933,1,65041005,65041557,552,0.8500876148929151
25583,2168.053833,2168.119067,1,65041614,65043572,1958,0.7589174009867701
25584,2168.125033,2168.1313,1,65043750,65043939,189,0.6549791098078738
25585,2168.132333,2168.1374,1,65043969,65044122,153,0.8840967788945553
25586,2168.138533,2168.170733,1,65044155,65045121,966,0.7041109886659879
25587,2168.1753,2168.2067,1,65045259,65046201,942,0.009859094459705068
25588,2168.208867,2168.2317,1,65046266,65046950,684,0.2019925818789943
25589,2168.2641,2168.280933,1,65047922,65048427,505,0.7942399268906923
25590,2168.2829,2168.291033,1,65048487,65048730,243,0.6437968178822034
25591,2168.292133,2168.386133,1,65048763,65051583,2820,0.8224080722019261
25592,2168.4171,2168.425333,1,65052513,65052759,246,0.6856424732347862
25593,2168.428667,2168.546433,1,65052860,65056392,3532,0.8269806210162103
25594,2168.565567,2168.571333,1,65056967,65057139,172,-0.06825660149237232
25595,2168.572367,2168.577467,1,65057171,65057324,153,0.14313566541061012
25596,2168.6379,2168.6932,1,65059137,65060796,1659,0.7095236769454469
25597,2168.6942,2168.697333,1,65060826,65060919,93,0.2754399895850593
25598,2168.702233,2168.746567,1,65061066,65062397,1331,0.765752947061101
25599,2168.765633,2168.7878,1,65062968,65063634,666,0.18602249243064323
25600,2168.788833,2168.8104,1,65063664,65064311,647,0.40465352816304573
25601,2168.824767,2169.036867,1,65064743,65071106,6363,0.808528246135207
25602,2169.0535,2169.062833,1,65071605,65071884,279,0.013632019800277909
25603,2169.0682,2169.090733,1,65072046,65072721,675,-0.02435291875588163
25604,2169.095567,2169.113267,1,65072867,65073398,531,0.14019421934355747
25605,2169.137833,2169.158267,1,65074134,65074748,614,0.6584899327159808
25606,2169.159333,2169.2606,1,65074779,65077818,3039,0.7939711464502383
25607,2169.269433,2169.272833,1,65078082,65078184,102,0.5873667876229892
25608,2169.2742,2169.304,1,65078225,65079120,895,0.6569762648557224
25609,2169.308133,2169.338267,1,65079243,65080148,905,0.5641819227832018
25610,2169.3493,2169.438633,1,65080478,65083158,2680,0.7737228738482461
25611,2169.447233,2169.479867,1,65083416,65084396,980,0.03385548074195332
25612,2169.516767,2169.566567,1,65085503,65086997,1494,0.503115753678404
25613,2169.567833,2169.576167,1,65087034,65087285,251,0.5719054165634481
25614,2169.580967,2169.8447,1,65087429,65095341,7912,0.7618130238164247
25615,2169.870067,2169.875033,1,65096102,65096250,148,-0.1392639517969802
25616,2169.877467,2169.881533,1,65096324,65096445,121,0.3745567657375618
25617,2169.888233,2169.8925,1,65096646,65096775,129,-0.1718325065240539
25618,2169.9486,2169.9708,1,65098458,65099124,666,0.7291107705198374
25619,2169.982867,2169.989867,1,65099486,65099696,210,0.058231684160262025
25620,2169.991833,2170.001533,1,65099754,65100045,291,0.45556341788782323
25621,2170.0049,2170.195333,1,65100147,65105859,5712,0.7329317374299936
25622,2170.1985,2170.229667,1,65105955,65106890,935,0.7094893828417278
25623,2170.2333,2170.246033,1,65106998,65107380,382,0.589540577005156
25624,2170.257567,2170.264233,1,65107727,65107926,199,0.570485290226477
25625,2170.267633,2170.281,1,65108028,65108430,402,0.9229737938461163
25626,2170.2937,2170.306267,1,65108811,65109188,377,0.5182867484864196
25627,2170.309033,2170.3996,1,65109270,65111988,2718,0.7941332106021493
25628,2170.4006,2170.408967,1,65112018,65112269,251,0.6984135987605482
25629,2170.411333,2170.523067,1,65112339,65115692,3353,0.7809936800048229
25630,2170.525367,2170.617833,1,65115761,65118534,2773,0.8111505892185114
25631,2170.619433,2170.623433,1,65118582,65118702,120,0.8658922360173322
25632,2170.624433,2170.6469,1,65118732,65119407,675,0.9190974391661589
25633,2170.6502,2170.7722,1,65119506,65123166,3660,0.7572810888141253
25634,2170.7756,2170.855767,1,65123268,65125673,2405,0.7827457698414239
25635,2170.8625,2170.8776,1,65125875,65126327,452,0.6710047437713021
25636,2170.8893,2170.894167,1,65126678,65126825,147,0.20555476026158084
25637,2170.924467,2170.9319,1,65127734,65127957,223,-0.015572260818707348
25638,2170.941933,2170.945733,1,65128257,65128371,114,
25639,2171.2424,2171.245833,1,65137272,65137374,102,-0.2597331473415974
25640,2171.2493,2171.2525,1,65137479,65137575,96,-0.06070134377552035
25641,2171.267867,2171.285433,1,65138036,65138562,526,0.7587609585413908
25642,2171.3177,2171.325733,1,65139531,65139771,240,0.7269949540401316
25643,2171.357533,2171.361067,1,65140725,65140832,107,0.40920319189067533
25644,2171.3891,2171.398533,1,65141672,65141955,283,0.6355763330726095
25645,2171.414567,2171.4181,1,65142437,65142542,105,-0.2726874399213682
25646,2171.423333,2171.4275,1,65142699,65142824,125,0.7861645641731336
25647,2171.435233,2171.4398,1,65143056,65143194,138,0.6618947604742164
25648,2171.468033,2171.515767,1,65144040,65145473,1433,0.7228761523588413
25649,2171.557167,2171.570567,1,65146715,65147117,402,0.6599593066428004
25650,2171.595433,2171.602,1,65147862,65148059,197,0.5508313066311734
25651,2171.6045,2171.620133,1,65148135,65148603,468,0.6679205265357813
25652,2171.766967,2171.8848,1,65153009,65156543,3534,0.8020463766628457
25653,2171.8872,2171.986267,1,65156616,65159588,2972,0.8389492216269622
25654,2171.989867,2171.9947,1,65159696,65159841,145,-0.17189613204832593
25655,2172.0101,2172.0494,1,65160303,65161482,1179,0.7151554430441586
25656,2172.050667,2172.071833,1,65161520,65162154,634,0.7918021831715969
25657,2172.077533,2172.092533,1,65162325,65162775,450,0.6940309375552486
25658,2172.099767,2172.108533,1,65162993,65163255,262,0.5409673695066373
25659,2172.151667,2172.164,1,65164550,65164920,370,0.21790417701983028
25660,2172.167367,2172.173967,1,65165021,65165219,198,0.6226644034536574
25661,2172.283767,2172.290167,1,65168513,65168705,192,0.5499001089751238
25662,2172.294867,2172.300567,1,65168846,65169017,171,0.5646097443176391
25663,2172.3477,2172.356033,1,65170430,65170680,250,0.4907002736852192
25664,2172.380067,2172.3837,1,65171402,65171510,108,
25665,2172.4882,2172.521,1,65174645,65175630,985,0.78844604512996
25666,2172.522667,2172.691233,1,65175680,65180736,5056,0.7945728683212021
25667,2172.695933,2172.709433,1,65180877,65181282,405,0.6467195821618843
25668,2172.714533,2172.865633,1,65181435,65185968,4533,0.6928638297664783
25669,2172.8863,2172.8971,1,65186589,65186913,324,-0.015377611205994247
25670,2172.899833,2172.903433,1,65186994,65187102,108,-0.23316664131936077
25671,2172.980433,2173.029833,1,65189412,65190894,1482,0.7959154738788013
25672,2173.037867,2173.076933,1,65191136,65192307,1171,0.7254191682388592
25673,2173.078867,2173.084,1,65192366,65192519,153,0.29959989635577544
25674,2173.096,2173.0969,1,65192880,65192907,27,
25675,2173.104233,2173.118667,1,65193126,65193560,434,-0.014241346788553272
25676,2173.121267,2173.148267,1,65193638,65194448,810,0.12486468081869165
25677,2173.149333,2173.153833,1,65194479,65194614,135,
25678,2173.174333,2173.180733,1,65195229,65195421,192,0.6225982112508998
25679,2173.184533,2173.312567,1,65195535,65199377,3842,0.8169715660879379
25680,2173.317867,2173.365,1,65199536,65200949,1413,0.7551497734421125
25681,2173.3667,2173.4155,1,65201001,65202465,1464,0.7665923499281448
25682,2173.4389,2173.478633,1,65203167,65204358,1191,0.7757718555859692
25683,2173.4923,2173.5413,1,65204769,65206238,1469,0.03211945580510438
25684,2173.5521,2173.5769,1,65206563,65207307,744,0.7001244981099197
25685,2173.5792,2173.767767,1,65207376,65213033,5657,0.8105467097699337
25686,2173.768933,2173.780667,1,65213067,65213420,353,0.7075255221617472
25687,2173.793233,2173.8065,1,65213796,65214195,399,-0.02666553147537223
25688,2173.8094,2173.815933,1,65214282,65214477,195,0.14503926569783415
25689,2173.819733,2173.839833,1,65214591,65215194,603,0.23041054987895593
25690,2173.8596,2173.881833,1,65215787,65216454,667,0.5561395897079295
25691,2173.896867,2173.978033,1,65216906,65219340,2434,0.7923275874905619
25692,2173.980367,2173.984367,1,65219411,65219531,120,0.3044071535903373
25693,2173.999967,2174.004533,1,65219999,65220135,136,-0.10414522096336008
25694,2174.082767,2174.097,1,65222483,65222910,427,0.43698904508176817
25695,2174.099233,2174.1345,1,65222976,65224035,1059,0.8155434868409913
25696,2174.144133,2174.191467,1,65224323,65225744,1421,0.8215056863444113
25697,2174.212633,2174.256933,1,65226378,65227707,1329,-0.009607721230402645
25698,2174.275467,2174.3957,1,65228264,65231871,3607,0.8471560963202243
25699,2174.400767,2174.403967,1,65232023,65232119,96,0.17757199417858185
25700,2174.421133,2174.428967,1,65232633,65232869,236,0.11699254015489712
25701,2174.441733,2174.4875,1,65233251,65234625,1374,0.07573669892065571
25702,2174.4995,2174.6307,1,65234985,65238921,3936,0.8168611871379982
25703,2174.631867,2174.636867,1,65238956,65239106,150,
25704,2174.652133,2174.6697,1,65239563,65240091,528,-0.10642058278608928
25705,2174.6708,2174.6893,1,65240123,65240679,556,0.1265218543633082
25706,2174.6919,2174.700033,1,65240756,65241000,244,0.348117093351365
25707,2174.713267,2174.718367,1,65241398,65241551,153,0.7714695383164535
25708,2174.719667,2174.81,1,65241590,65244300,2710,0.8519882959364246
25709,2174.812033,2174.866567,1,65244360,65245997,1637,0.770133015651106
25710,2174.881,2174.885133,1,65246429,65246553,124,
25711,2174.8961,2174.9161,1,65246883,65247483,600,0.07980150232603556
25712,2174.9192,2174.943133,1,65247575,65248293,718,0.1487491036934407
25713,2174.9618,2174.969,1,65248854,65249070,216,0.6291467010520101
25714,2174.971,2175.1252,1,65249130,65253756,4626,0.828373437889603
25715,2175.138,2175.154333,1,65254140,65254629,489,-0.03684093938788232
25716,2175.157567,2175.191333,1,65254727,65255739,1012,0.12943860304096635
25717,2175.214367,2175.371333,1,65256431,65261139,4708,0.8046021528047242
25718,2175.381367,2175.410967,1,65261441,65262329,888,-0.07255728036875006
25719,2175.412333,2175.423367,1,65262369,65262701,332,-0.025729286212325276
25720,2175.4343,2175.437367,1,65263029,65263121,92,0.10373475596640891
25721,2175.447,2175.547833,1,65263410,65266434,3024,0.8331237606603746
25722,2175.549267,2175.594433,1,65266478,65267832,1354,0.6765147778261913
25723,2175.604767,2175.6268,1,65268143,65268804,661,-0.06497717355843004
25724,2175.6278,2175.632467,1,65268834,65268974,140,-0.030606813830996726
25725,2175.6486,2175.652467,1,65269458,65269574,116,0.2843683933397644
25726,2175.694,2175.8522,1,65270820,65275565,4745,0.8369810667935201
25727,2176.031167,2176.0393,1,65280935,65281179,244,0.7268412979055787
25728,2176.041533,2176.2087,1,65281245,65286261,5016,0.8695321077036114
25729,2176.221067,2176.329267,1,65286632,65289878,3246,0.8176603906074533
25730,2176.546933,2176.551233,1,65296407,65296536,129,0.2467719342154361
25731,2176.638867,2176.705433,1,65299166,65301162,1996,0.7961430754879235
25732,2176.709467,2176.809267,1,65301284,65304278,2994,0.8473121550117323
25733,2176.833667,2176.9185,1,65305010,65307555,2545,0.7954169148027784
25734,2176.9416,2176.946667,1,65308248,65308400,152,-0.21183467866638803
25735,2176.959767,2176.9646,1,65308793,65308937,144,
25736,2177.1774,2177.335133,1,65315322,65320053,4731,0.8214113908594534
25737,2177.3537,2177.4324,1,65320611,65322972,2361,0.8510648843478942
25738,2177.496567,2177.5099,1,65324897,65325297,400,0.3913547201426353
25739,2177.516,2177.554633,1,65325480,65326638,1158,0.051694258396734444
25740,2177.5558,2177.581867,1,65326674,65327456,782,0.109307993028813
25741,2177.631133,2177.798133,1,65328933,65333943,5010,0.8318704074580408
25742,2177.800567,2177.848567,1,65334017,65335457,1440,0.8093775677804778
25743,2177.8548,2177.942867,1,65335644,65338286,2642,0.7548931842742106
25744,2177.998733,2178.0097,1,65339961,65340291,330,0.3478100359453607
25745,2178.010967,2178.0264,1,65340329,65340792,463,0.6353481352838344
25746,2178.0336,2178.091667,1,65341008,65342750,1742,0.8203596350722971
25747,2178.1217,2178.131167,1,65343651,65343935,284,0.6143227638060207
25748,2178.150767,2178.1659,1,65344523,65344977,454,-0.04683935384503033
25749,2178.1738,2178.179733,1,65345214,65345391,177,0.4456092137957083
25750,2178.195433,2178.201333,1,65345862,65346039,177,0.3907716166979643
25751,2178.2394,2178.243,1,65347182,65347290,108,0.45981095802616145
25752,2178.287967,2178.4904,1,65348639,65354712,6073,0.8238715120501477
25753,2178.491433,2178.500033,1,65354742,65355000,258,0.9117761679587477
25754,2178.549467,2178.567167,1,65356484,65357015,531,0.12807147154090326
25755,2178.583433,2178.589367,1,65357502,65357681,179,0.3735120494819724
25756,2178.710367,2178.716933,1,65361311,65361507,196,0.5772097811002995
25757,2178.719467,2178.736733,1,65361584,65362101,517,0.8043359990907735
25758,2178.7408,2178.885967,1,65362224,65366579,4355,0.843016542740951
25759,2178.9093,2179.009533,1,65367278,65370285,3007,0.7258446658388994
25760,2179.045967,2179.0556,1,65371379,65371668,289,0.46407379459635
25761,2179.0748,2179.0933,1,65372243,65372799,556,-0.05968032153912062
25762,2179.1024,2179.1111,1,65373072,65373333,261,-0.09965900831586083
25763,2179.158067,2179.164967,1,65374742,65374949,207,0.46678386443495173
25764,2179.166033,2179.196333,1,65374980,65375889,909,0.27941137340682126
25765,2179.224767,2179.241967,1,65376743,65377259,516,0.08054058743174619
25766,2179.2437,2179.250633,1,65377311,65377518,207,-0.08435461865119495
25767,2179.3066,2179.5373,1,65379198,65386119,6921,0.8300768687706993
25768,2179.582367,2179.5863,1,65387471,65387589,118,-0.029092471025603774
25769,2179.589167,2179.5927,1,65387675,65387781,106,-0.007521933851192672
25770,2179.807233,2179.812,1,65394216,65394360,144,0.33183647212826295
25771,2179.835233,2179.980133,1,65395056,65399403,4347,0.8023084723494303
25772,2179.981167,2180.1015,1,65399435,65403045,3610,0.7351135088832846
25773,2180.429833,2180.5465,1,65412894,65416395,3501,0.8203295826278338
25774,2180.786767,2180.992867,1,65423603,65429786,6183,0.8142580453277375
25775,2180.994967,2181.178533,1,65429849,65435355,5506,0.8133145350755319
25776,2181.2295,2181.3261,1,65436885,65439783,2898,0.7934737181935595
25777,2181.330433,2181.335633,1,65439912,65440068,156,0.19528951901244224
25778,2181.604467,2181.725133,1,65448134,65451753,3619,0.8433673047888677
25779,2181.758667,2181.775167,1,65452760,65453255,495,0.10425598191796412
25780,2181.7767,2181.7802,1,65453301,65453406,105,
25781,2181.781733,2181.785367,1,65453451,65453561,110,-0.06924814664824125
25782,2181.961967,2182.0596,1,65458859,65461788,2929,0.7827989446681878
25783,2182.061067,2182.067267,1,65461832,65462018,186,0.4321408555768467
25784,2182.070033,2182.074667,1,65462100,65462240,140,0.12584889444432173
25785,2182.0769,2182.181133,1,65462307,65465433,3126,0.7908333326296756
25786,2182.198167,2182.255267,1,65465945,65467658,1713,0.7580272112459215
25787,2182.261733,2182.2753,1,65467851,65468258,407,0.660629544641425
25788,2182.278467,2182.297,1,65468354,65468910,556,0.61999768242694
25789,2182.352567,2182.3644,1,65470577,65470932,355,0.20421274064757422
25790,2182.4024,2182.492333,1,65472072,65474769,2697,0.7944844663886445
25791,2182.508667,2182.512733,1,65475260,65475381,121,
25792,2182.8269,2182.965767,1,65484807,65488973,4166,0.83288668880133
25793,2183.343467,2183.348633,1,65500304,65500458,154,0.7259000653494788
25794,2183.371067,2183.375233,1,65501132,65501256,124,0.6458871346867854
25795,2183.4086,2183.426833,1,65502258,65502804,546,0.607190763281677
25796,2183.430767,2183.4349,1,65502923,65503047,124,-0.04476270731867703
25797,2183.4779,2183.4925,1,65504336,65504774,438,0.5142383354437153
25798,2183.4944,2183.505167,1,65504832,65505155,323,0.7784429464154685
25799,2183.552367,2183.5666,1,65506571,65506998,427,0.5716588368662848
25800,2183.589533,2183.597033,1,65507685,65507910,225,0.4982760549423596
25801,2183.598567,2183.6155,1,65507957,65508465,508,0.669003885629031
25802,2183.648467,2183.6539,1,65509454,65509616,162,0.7877834650938786
25803,2183.6685,2183.689933,1,65510055,65510697,642,0.388468277934925
25804,2183.691467,2183.6952,1,65510744,65510856,112,
25805,2183.706567,2183.710333,1,65511197,65511309,112,0.48019589013806413
25806,2183.716,2183.897267,1,65511480,65516918,5438,0.7684837975268063
25807,2183.919367,2184.007133,1,65517581,65520213,2632,0.7687228165263843
25808,2184.008433,2184.014633,1,65520252,65520438,186,0.5976826243031674
25809,2184.268067,2184.280767,1,65528042,65528423,381,0.6064607407061106
25810,2184.281867,2184.375733,1,65528456,65531271,2815,0.7943233109599489
25811,2184.4096,2184.412833,1,65532288,65532384,96,
25812,2184.646967,2184.651667,1,65539409,65539550,141,0.7837645311433648
25813,2184.659633,2184.818367,1,65539788,65544551,4763,0.7418266142778456
25814,2184.820367,2184.886367,1,65544611,65546591,1980,0.7114486625802117
25815,2185.157667,2185.282167,1,65554730,65558465,3735,0.8069298603344149
25816,2187.268333,2187.300233,1,65618049,65619006,957,0.2899023284786278
25817,2187.318467,2187.335433,1,65619554,65620062,508,0.08547680110517786
25818,2190.040933,2190.0493,1,65701227,65701479,252,0.5339005844190771
25819,2190.053233,2190.056367,1,65701596,65701691,95,0.4214235575053776
25820,2190.064767,2190.0881,1,65701943,65702643,700,0.21956153716609453
25821,2190.090633,2190.129333,1,65702718,65703879,1161,0.07440281390268198
25822,2190.143867,2190.209433,1,65704316,65706282,1966,0.1605065311537579
25823,2190.299433,2190.303967,1,65708982,65709119,137,-0.060182263188491444
25824,2197.3612,2197.369233,1,65920835,65921076,241,-0.05383252495122813
25825,2197.3762,2197.3794,1,65921286,65921381,95,0.35552204026649575
25826,2197.3926,2197.450833,1,65921778,65923524,1746,0.2341606989868268
25827,2197.452,2197.455767,1,65923560,65923673,113,-0.10461663354628933
25828,2197.4707,2197.5479,1,65924120,65926437,2317,0.12904359128933982
25829,2197.554267,2197.5677,1,65926628,65927031,403,0.1203704606063522
25830,2197.584867,2197.596333,1,65927546,65927889,343,-0.0661091394190041
25831,2197.653033,2197.660033,1,65929590,65929800,210,0.7010265608707965
25832,2197.664967,2197.675967,1,65929949,65930279,330,0.7049333781459032
25833,2197.719367,2197.732967,1,65931581,65931989,408,0.5154422595887104
25834,2201.048033,2201.053267,1,66031440,66031598,158,0.14327375564928993
25835,2201.1384,2201.160267,1,66034151,66034808,657,0.10595499889739173
25836,2201.168,2201.222633,1,66035040,66036678,1638,0.1465071359177697
25837,2201.250233,2201.32,1,66037506,66039600,2094,0.047835129758311924
25838,2201.3212,2201.327267,1,66039635,66039818,183,-0.13343661396190845
25839,2201.3857,2201.391667,1,66041570,66041750,180,0.21864363438498338
25840,2201.7353,2201.741833,1,66052058,66052254,196,0.2946120794127899
25841,2201.7506,2201.7791,1,66052517,66053373,856,0.21623451766226534
25842,2201.8,2201.857667,1,66054000,66055730,1730,0.277983068126451
25843,2201.863533,2201.8735,1,66055905,66056205,300,-0.09769476579569804
25844,2201.875367,2201.916067,1,66056261,66057482,1221,0.0014609596926338944
25845,2201.9214,2201.9268,1,66057642,66057804,162,-0.006164673033197911
25846,2201.958333,2201.9663,1,66058749,66058989,240,0.1382638797581337
25847,2201.974033,2201.9792,1,66059220,66059376,156,0.06300934788560661
25848,2201.980933,2201.984367,1,66059427,66059531,104,0.09035720598169225
25849,2201.9886,2201.995533,1,66059658,66059865,207,0.10552041613413048
25850,2201.999667,2202.009433,1,66059990,66060282,292,-0.03582224571685145
25851,2202.0148,2202.0205,1,66060444,66060615,171,-0.06563295322182675
25852,2202.0268,2202.111633,1,66060804,66063348,2544,0.37016324446651944
25853,2202.117067,2202.123867,1,66063512,66063716,204,0.38807841058501175
25854,2203.340033,2203.362733,1,66100200,66100881,681,0.08132108287024836
25855,2203.407633,2203.415067,1,66102228,66102452,224,0.027260710634085146
25856,2203.4268,2203.442333,1,66102804,66103269,465,0.03708570346114215
25857,2203.451367,2203.467233,1,66103541,66104016,475,0.03427700400904333
25858,2203.559733,2203.578033,1,66106791,66107340,549,0.37069206453665404
25859,2203.587767,2203.5964,1,66107633,66107892,259,0.3289510200190424
25860,2203.597433,2203.670133,1,66107922,66110103,2181,0.06261962301505278
25861,2203.672867,2203.702433,1,66110186,66111072,886,-0.03466683781962842
25862,2203.7047,2203.715667,1,66111140,66111470,330,-0.03321688639946651
25863,2203.718433,2203.7411,1,66111552,66112233,681,-0.025293411851447452
25864,2203.7433,2203.7581,1,66112299,66112743,444,-0.01580756214745899
25865,2203.7706,2203.774,1,66113117,66113220,103,
25866,2203.777333,2203.7817,1,66113319,66113451,132,
25867,2203.785,2203.845,1,66113549,66115349,1800,0.5985145044058758
25868,2203.8463,2203.853167,1,66115389,66115595,206,-0.09629811178311685
25869,2203.860333,2203.8778,1,66115809,66116334,525,0.009082261312921011
25870,2203.888233,2203.955667,1,66116646,66118670,2024,0.1651395011166311
25871,2203.9849,2203.989767,1,66119547,66119693,146,-0.04117467981924039
25872,2205.0179,2205.034467,1,66150536,66151034,498,0.23411454497435455
25873,2205.035967,2205.0632,1,66151079,66151896,817,0.07842363872158997
25874,2205.0643,2205.076133,1,66151929,66152283,354,0.059577971037649266
25875,2205.0962,2205.113467,1,66152886,66153404,518,0.09855405132251831
25876,2205.118467,2205.127433,1,66153554,66153822,268,0.1605726201540951
25877,2205.1665,2205.180533,1,66154994,66155415,421,0.19759505628969865
25878,2205.189067,2205.212133,1,66155672,66156363,691,0.13894855882110585
25879,2205.2134,2205.226,1,66156402,66156780,378,-0.014530185130364326
25880,2205.227433,2205.244667,1,66156822,66157340,518,0.08995479302756818
25881,2205.3051,2205.314833,1,66159153,66159444,291,0.08212706739419265
25882,2205.316,2205.342133,1,66159479,66160263,784,0.20802967472363543
25883,2205.344,2205.377233,1,66160320,66161316,996,-0.03343164541114961
25884,2205.3817,2205.397267,1,66161451,66161918,467,0.03501493743376454
25885,2205.3988,2205.420267,1,66161964,66162608,644,-0.09308477158448468
25886,2205.426467,2205.442567,1,66162794,66163277,483,0.12773251050954518
25887,2205.454667,2205.470467,1,66163640,66164114,474,-0.06937178045641092
25888,2205.477367,2205.4957,1,66164321,66164871,550,-0.021033987966110508
25889,2205.500067,2205.515733,1,66165002,66165471,469,-0.05347943598840646
25890,2205.517067,2205.523833,1,66165512,66165714,202,-0.05212370476575647
25891,2205.532533,2205.5482,1,66165975,66166446,471,-0.06063138172169188
25892,2205.5493,2205.552667,1,66166479,66166580,101,-0.07839057893461449
25893,2205.558533,2205.5788,1,66166755,66167363,608,-0.11845356147247357
25894,2205.582033,2205.598233,1,66167460,66167946,486,-0.025634482033613338
25895,2205.601333,2205.616233,1,66168039,66168486,447,0.1143402665949049
25896,2205.617367,2205.625133,1,66168521,66168753,232,-0.008398829297905893
25897,2205.637267,2205.6559,1,66169118,66169677,559,-0.06298449764764674
25898,2205.660967,2205.682433,1,66169829,66170472,643,-0.06598242707233784
25899,2205.690233,2205.704533,1,66170706,66171135,429,-0.09483748658333967
25900,2205.707533,2205.711567,1,66171225,66171347,122,0.04440622485496435
25901,2205.7164,2205.732533,1,66171491,66171975,484,0.019688729723255225
25902,2205.739467,2205.759633,1,66172184,66172788,604,-0.01686658726615038
25903,2205.764233,2205.768433,1,66172926,66173052,126,
25904,2205.773167,2205.788167,1,66173195,66173645,450,0.03448375253096703
25905,2205.797967,2205.813767,1,66173939,66174413,474,-0.07998402766422
25906,2205.820033,2205.8233,1,66174600,66174699,99,
25907,2205.834933,2205.843433,1,66175047,66175302,255,-0.14105583469946348
25908,2205.847833,2205.8539,1,66175434,66175617,183,-0.1914604616987539
25909,2205.8606,2205.892167,1,66175818,66176765,947,0.1999121688365009
25910,2205.906667,2205.919067,1,66177200,66177572,372,-0.05228025010482643
25911,2205.9256,2205.939767,1,66177768,66178193,425,0.13634992305835653
25912,2205.9426,2205.9459,1,66178277,66178377,100,-0.015836692291521622
25913,2205.9485,2205.9598,1,66178455,66178794,339,0.11871295787722826
25914,2205.962167,2205.969333,1,66178865,66179079,214,-0.0893436886975997
25915,2205.9728,2206.010367,1,66179184,66180311,1127,0.09038027311213503
25916,2206.0127,2206.016867,1,66180381,66180506,125,0.42821165500813296
25917,2207.050467,2207.067233,1,66211514,66212016,502,0.13082367777311857
25918,2207.070667,2207.089933,1,66212120,66212697,577,0.21161345813602625
25919,2207.1087,2207.116567,1,66213261,66213497,236,0.0623837519078129
25920,2207.118367,2207.125333,1,66213551,66213759,208,0.2095029360242457
25921,2207.133267,2207.171767,1,66213998,66215153,1155,0.05113225092402078
25922,2207.220567,2207.2239,1,66216617,66216717,100,-0.16205470732814495
25923,2207.2579,2207.281633,1,66217737,66218448,711,0.3094079568150663
25924,2207.292,2207.296633,1,66218760,66218898,138,-0.13384164792201275
25925,2207.299867,2207.3033,1,66218996,66219099,103,0.034620927887066014
25926,2207.397533,2207.407733,1,66221925,66222231,306,0.28216888052467737
25927,2207.690333,2207.782667,1,66230709,66233480,2771,0.1760725745655128
25928,2207.787967,2207.7936,1,66233639,66233808,169,0.03476082864582258
25929,2207.7993,2207.8153,1,66233979,66234459,480,0.015718055199749715
25930,2207.8237,2207.831933,1,66234711,66234957,246,-0.016268366260285674
25931,2207.833533,2207.866667,1,66235005,66236000,995,-0.04437980600998128
25932,2207.868867,2207.884333,1,66236066,66236529,463,0.007710654430737322
25933,2207.885867,2207.913933,1,66236576,66237417,841,-0.007301817253032312
25934,2207.918667,2207.935167,1,66237560,66238055,495,0.35648281004210486
25935,2207.9407,2207.947767,1,66238221,66238433,212,0.1358450549059993
25936,2207.9527,2208.037333,1,66238580,66241119,2539,0.07091284264556252
25937,2208.058633,2208.062033,1,66241758,66241860,102,0.8576099228788052
25938,2208.0679,2208.0726,1,66242037,66242178,141,-0.026880591674014596
25939,2208.075067,2208.081667,1,66242252,66242450,198,0.5954215137481466
25940,2208.083467,2208.093067,1,66242504,66242792,288,0.10424290561920156
25941,2208.102367,2208.106467,1,66243071,66243194,123,-0.23209460205544213
25942,2208.1075,2208.1112,1,66243225,66243335,110,
25943,2208.112933,2208.126667,1,66243387,66243800,413,0.5660054142501806
25944,2208.142567,2208.157433,1,66244277,66244722,445,0.32837404709783313
25945,2208.1589,2208.162,1,66244767,66244859,92,0.20894006413101
25946,2208.169833,2208.173433,1,66245094,66245202,108,
25947,2209.012333,2209.019867,1,66270369,66270596,227,0.6238148020774004
25948,2209.054567,2209.0577,1,66271637,66271730,93,-0.12512489194054593
25949,2210.046533,2210.051267,1,66301395,66301538,143,0.5891797362684322
25950,2210.172467,2210.175967,1,66305174,66305279,105,
25951,2210.176967,2210.180567,1,66305309,66305417,108,0.36524716388964695
25952,2210.186033,2210.198933,1,66305580,66305967,387,0.07692248478929697
25953,2210.206533,2210.213633,1,66306195,66306408,213,0.026330736516325563
25954,2210.225267,2210.235733,1,66306758,66307071,313,0.13419583156483636
25955,2210.239567,2210.2484,1,66307187,66307452,265,0.14220630638346057
25956,2210.250533,2210.2554,1,66307515,66307662,147,-0.023641966202145887
25957,2210.2649,2210.271433,1,66307947,66308142,195,-0.06379864098672923
25958,2210.295333,2210.305367,1,66308859,66309161,302,0.2852000400626477
25959,2210.314433,2210.405067,1,66309432,66312152,2720,0.7420478740833616
25960,2210.409867,2210.420967,1,66312296,66312629,333,-0.08539375150871335
25961,2210.424,2210.4541,1,66312720,66313623,903,-0.09450981730239198
25962,2210.4655,2210.481333,1,66313964,66314439,475,0.05297937416358343
25963,2210.494633,2210.558567,1,66314838,66316757,1919,0.40260125536325403
25964,2210.568967,2210.584333,1,66317069,66317529,460,0.5692610432142191
25965,2210.5863,2210.600267,1,66317589,66318008,419,-0.06700454294882577
25966,2210.6097,2210.615533,1,66318291,66318465,174,-0.09067654147454265
25967,2211.662233,2211.683333,1,66349866,66350499,633,0.30104195904508513
25968,2211.685167,2211.692233,1,66350555,66350766,211,0.20591388389963072
25969,2211.699633,2211.703633,1,66350988,66351108,120,0.6472855915454024
25970,2211.746967,2211.7756,1,66352409,66353268,859,0.03863556939168078
25971,2211.7774,2211.8053,1,66353322,66354159,837,0.42374721703440293
25972,2211.8657,2211.870533,1,66355970,66356115,145,
25973,2211.879433,2211.887533,1,66356382,66356625,243,-0.01651585216465829
25974,2211.905367,2211.924833,1,66357161,66357744,583,0.26873984696863107
25975,2211.931033,2211.939067,1,66357930,66358172,242,0.3275693731031564
25976,2211.940367,2212.052467,1,66358211,66361574,3363,0.16768805369723824
25977,2212.0609,2212.0725,1,66361827,66362175,348,0.11055808147389497
25978,2212.074333,2212.114,1,66362229,66363420,1191,0.279341153866145
25979,2212.1233,2212.186033,1,66363699,66365580,1881,0.12697694827992664
25980,2212.191,2212.197867,1,66365729,66365936,207,
25981,2212.205167,2212.213733,1,66366155,66366411,256,0.5167108017950394
25982,2212.808,2212.8477,1,66384240,66385430,1190,0.08622450470228563
25983,2212.848967,2212.858567,1,66385469,66385757,288,0.07364979961318124
25984,2212.861233,2212.8895,1,66385836,66386685,849,0.10524840828698831
25985,2212.916867,2212.920067,1,66387506,66387602,96,0.46363574918195105
25986,2212.948833,2212.9579,1,66388464,66388737,273,0.4282179104016829
25987,2212.965233,2212.986567,1,66388956,66389597,641,0.13339900168846888
25988,2212.993633,2213.0241,1,66389808,66390723,915,0.026597213741974497
25989,2213.028333,2213.036133,1,66390849,66391083,234,0.4274737604672078
25990,2213.078967,2213.086,1,66392369,66392579,210,0.36981784842620796
25991,2213.122467,2213.192533,1,66393674,66395775,2101,0.08292868679155274
25992,2213.195833,2213.2279,1,66395874,66396836,962,0.028597971287244353
25993,2213.234967,2213.2482,1,66397049,66397446,397,0.09540498014575294
25994,2213.252233,2213.2928,1,66397566,66398784,1218,0.044060981958754485
25995,2213.3023,2213.3491,1,66399068,66400473,1405,0.0047188148623867054
25996,2213.3508,2213.355933,1,66400524,66400677,153,-0.07194956729058039
25997,2213.3588,2213.3651,1,66400764,66400953,189,0.023670584195545866
25998,2213.3705,2213.389733,1,66401115,66401691,576,0.17821919979238754
25999,2213.402667,2213.4562,1,66402080,66403686,1606,0.12902045987189673
26000,2213.463467,2213.469267,1,66403904,66404078,174,0.3478303311852419
26001,2213.879067,2213.8845,1,66416372,66416535,163,0.44403353422949954
26002,2213.9229,2213.9259,1,66417687,66417777,90,
26003,2213.927167,2213.9312,1,66417815,66417936,121,0.1761836404957128
26004,2213.983967,2213.9924,1,66419519,66419772,253,0.1257899604443181
26005,2213.994733,2214.041333,1,66419841,66421239,1398,0.15794993158706216
26006,2214.048,2214.075267,1,66421439,66422258,819,-0.04631843108827531
26007,2214.076267,2214.104567,1,66422288,66423137,849,-0.029590949207279813
26008,2214.111667,2214.121633,1,66423350,66423648,298,0.045448053450462204
26009,2214.124867,2214.204167,1,66423746,66426125,2379,0.20011439153151112
26010,2214.207833,2214.2158,1,66426234,66426474,240,0.05203300296161023
26011,2214.2225,2214.2267,1,66426674,66426801,127,0.687984711845978
26012,2214.2427,2214.2481,1,66427280,66427442,162,-0.0664259791367317
26013,2214.284933,2214.291033,1,66428547,66428730,183,-0.14980555083676494
26014,2214.310333,2214.317233,1,66429309,66429516,207,0.30273146272138934
26015,2214.3327,2214.347667,1,66429981,66430430,449,0.20361545735428704
26016,2214.3561,2214.367267,1,66430683,66431018,335,-0.027441628991883224
26017,2214.368467,2214.377133,1,66431054,66431313,259,0.036132065504033174
26018,2214.380533,2214.385667,1,66431415,66431570,155,0.08888347205009405
26019,2214.398167,2214.401467,1,66431945,66432044,99,-0.08739650479609118
26020,2214.4136,2214.4209,1,66432407,66432627,220,0.17358072712490505
26021,2214.508367,2214.515333,1,66435251,66435459,208,0.058187908010314794
26022,2215.364333,2215.374167,1,66460929,66461225,296,0.050712021349733516
26023,2215.3791,2215.4543,1,66461373,66463628,2255,0.1214358332476882
26024,2215.457533,2215.465667,1,66463725,66463970,245,0.43522037678193054
26025,2215.471667,2215.4976,1,66464150,66464928,778,-0.056857590384912025
26026,2215.503633,2215.5129,1,66465108,66465387,279,-0.03797494154436059
26027,2215.5345,2215.548467,1,66466035,66466454,419,-0.04403413835657371
26028,2215.553633,2215.567867,1,66466608,66467036,428,-0.0464649393661897
26029,2215.574333,2215.5819,1,66467229,66467457,228,0.20025250127581307
26030,2215.586767,2215.593667,1,66467603,66467810,207,-0.06352004103581906
26031,2215.606867,2215.6137,1,66468206,66468411,205,-0.008932346449258534
26032,2215.6152,2215.6278,1,66468456,66468834,378,0.04738171857721163
26033,2215.633067,2215.650767,1,66468992,66469523,531,0.016543513248257966
26034,2215.653967,2215.6679,1,66469619,66470037,418,-0.00023532025970440714
26035,2215.6691,2215.690667,1,66470073,66470720,647,-0.05044821321414256
26036,2215.695033,2215.714933,1,66470850,66471447,597,0.031735296479987636
26037,2215.719567,2215.733867,1,66471587,66472016,429,0.17904576709997072
26038,2215.7413,2215.753267,1,66472239,66472598,359,0.14625257071326972
26039,2215.754867,2215.817733,1,66472646,66474531,1885,0.16539819495055685
26040,2215.819467,2215.8245,1,66474584,66474735,151,
26041,2215.8329,2215.8445,1,66474987,66475335,348,0.3233076570532841
26042,2215.855333,2215.876,1,66475659,66476280,621,-0.060489937276570975
26043,2215.877633,2215.8827,1,66476328,66476481,153,-0.032150644224943334
26044,2216.342033,2216.3477,1,66490260,66490430,170,0.2693254174329221
26045,2216.348867,2216.3548,1,66490466,66490644,178,0.29287187462288905
26046,2216.3664,2216.3837,1,66490992,66491510,518,0.541341094727777
26047,2216.387533,2216.3992,1,66491625,66491975,350,-0.04065022074798639
26048,2216.4193,2216.425433,1,66492579,66492762,183,0.11285590221695051
26049,2216.4301,2216.435567,1,66492903,66493067,164,0.5447534686097776
26050,2216.4562,2216.460033,1,66493686,66493800,114,0.010781397665506596
26051,2216.467233,2216.498367,1,66494016,66494951,935,0.37494524494793036
26052,2216.542433,2216.5553,1,66496272,66496659,387,0.2939011081026852
26053,2216.5576,2216.569267,1,66496728,66497078,350,0.6068534832778066
26054,2216.585833,2216.6003,1,66497574,66498009,435,0.0614264620069808
26055,2216.6322,2216.6436,1,66498966,66499308,342,0.48706523020984677
26056,2216.6483,2216.654633,1,66499448,66499638,190,0.4415631640915421
26057,2216.660367,2216.671533,1,66499811,66500145,334,0.09552626521742842
26058,2216.674167,2216.7317,1,66500225,66501950,1725,0.12179014703188124
26059,2216.736533,2216.739667,1,66502095,66502190,95,0.092961644357268
26060,2216.7424,2216.751267,1,66502272,66502538,266,0.09443976269915881
26061,2216.7531,2216.773033,1,66502593,66503190,597,-0.023324094955814955
26062,2216.777867,2216.794633,1,66503336,66503838,502,0.046051894614642624
26063,2216.795633,2216.8136,1,66503868,66504408,540,-0.0410751231037489
26064,2216.820033,2216.846267,1,66504600,66505388,788,-0.03273277296110938
26065,2216.850467,2216.854433,1,66505514,66505632,118,-0.04407993302462303
26066,2216.8596,2216.872433,1,66505787,66506172,385,0.10135990759010964
26067,2216.8764,2216.895667,1,66506292,66506870,578,0.18312559361873582
26068,2216.900067,2216.927367,1,66507002,66507821,819,0.13702893513776687
26069,2216.930133,2216.934033,1,66507903,66508020,117,0.02589329281084097
26070,2216.937667,2217.004933,1,66508130,66510147,2017,0.15060429449877516
26071,2217.010767,2217.017767,1,66510323,66510533,210,-0.06051176289804831
26072,2217.021833,2217.0305,1,66510654,66510914,260,0.28722976624413277
26073,2217.039133,2217.0521,1,66511173,66511563,390,0.030994766946061993
26074,2217.053167,2217.057033,1,66511595,66511710,115,0.18096525247066553
26075,2217.061467,2217.0677,1,66511844,66512031,187,0.2235448901024367
26076,2217.077933,2217.082533,1,66512337,66512475,138,0.3290139051677169
26077,2218.0626,2218.0695,1,66541878,66542085,207,-0.04266348538920921
26078,2218.079867,2218.1523,1,66542396,66544569,2173,0.13377049625814066
26079,2218.1585,2218.1938,1,66544755,66545814,1059,0.03860334382008156
26080,2218.1984,2218.212767,1,66545952,66546383,431,0.03980855677044842
26081,2218.217567,2218.222133,1,66546527,66546663,136,0.19988500032262374
26082,2218.2243,2218.2309,1,66546728,66546927,199,0.14340927467837525
26083,2218.235267,2218.239633,1,66547058,66547188,130,-0.1784011111541523
26084,2218.241567,2218.249633,1,66547247,66547488,241,0.06398690003612814
26085,2218.254567,2218.2679,1,66547637,66548036,399,0.16941895736466836
26086,2218.279467,2218.3307,1,66548384,66549921,1537,0.054556233564589274
26087,2218.334167,2218.3409,1,66550025,66550227,202,0.42733305653740433
26088,2218.343033,2218.3649,1,66550290,66550947,657,0.41401735353205427
26089,2218.3661,2218.3802,1,66550983,66551406,423,0.1828513930439134
26090,2218.381633,2218.385033,1,66551448,66551550,102,-0.1832957475149234
26091,2219.3078,2219.313967,1,66579234,66579419,185,0.38129218701450457
26092,2219.363,2219.372733,1,66580889,66581181,292,0.45072040123693274
26093,2219.6918,2219.703633,1,66590754,66591108,354,0.2686891684368553
26094,2219.706933,2219.710633,1,66591207,66591318,111,0.4705483019059637
26095,2219.713467,2219.7262,1,66591404,66591786,382,0.04471080656714488
26096,2219.727533,2219.7523,1,66591825,66592569,744,-0.0025390797122170254
26097,2219.7701,2219.777633,1,66593103,66593328,225,-0.18789557777172763
26098,2219.779333,2219.785633,1,66593379,66593568,189,-0.031634677903309164
26099,2219.798133,2219.808767,1,66593943,66594263,320,0.12024752752310594
26100,2219.843533,2219.848267,1,66595305,66595448,143,-0.08557746415415285
26101,2219.854333,2219.871533,1,66595629,66596145,516,0.14274834236564374
26102,2219.874833,2219.917933,1,66596244,66597537,1293,0.16997648023916634
26103,2219.935067,2219.949333,1,66598052,66598479,427,-0.05431657146489289
26104,2219.9576,2219.963033,1,66598728,66598890,162,0.1368062845289323
26105,2219.9791,2220.0042,1,66599373,66600125,752,0.40247029126940537
26106,2220.010167,2220.078733,1,66600305,66602361,2056,0.15143770668969397
26107,2220.081233,2220.101967,1,66602436,66603059,623,0.09041906975229266
26108,2220.1045,2220.15,1,66603135,66604500,1365,0.034778109233110845
26109,2220.1533,2220.1564,1,66604599,66604691,92,
26110,2220.208133,2220.211167,1,66606243,66606335,92,0.3790637632568714
26111,2220.2904,2220.294433,1,66608711,66608832,121,0.16299221863373736
26112,2220.3053,2220.308467,1,66609159,66609254,95,
26113,2221.126467,2221.142233,1,66633794,66634266,472,0.138570594805633
26114,2221.146433,2221.177533,1,66634392,66635325,933,0.06440747847564046
26115,2221.214867,2221.2352,1,66636446,66637056,610,0.03902134679897641
26116,2221.2511,2221.271233,1,66637533,66638136,603,0.4648596806262386
26117,2221.281633,2221.3084,1,66638448,66639252,804,0.044622747091238334
26118,2221.366533,2221.383567,1,66640995,66641507,512,0.08807790462715372
26119,2221.3886,2221.458767,1,66641658,66643763,2105,0.07519788854237178
26120,2221.482,2221.486,1,66644460,66644580,120,-0.17526447767694162
26121,2221.493067,2221.497533,1,66644792,66644925,133,-0.21219369267132254
26122,2221.502833,2221.508267,1,66645084,66645248,164,0.5462867064033637
26123,2221.539033,2221.542967,1,66646170,66646289,119,-0.007402043870910745
26124,2221.549133,2221.558933,1,66646473,66646767,294,0.23091595938706772
26125,2221.696567,2221.705833,1,66650897,66651174,277,0.13082170179168845
26126,2221.727067,2221.7319,1,66651812,66651957,145,0.6939235893126473
26127,2221.8783,2221.884667,1,66656348,66656540,192,0.33304598610648106
26128,2221.8916,2221.895333,1,66656748,66656859,111,-0.21007964082444472
26129,2221.912933,2221.928467,1,66657387,66657854,467,0.22385582044952118
26130,2221.9329,2221.943067,1,66657986,66658292,306,-0.057393483524074626
26131,2222.004267,2222.0105,1,66660128,66660314,186,0.14938765222152448
26132,2222.0137,2222.0226,1,66660411,66660677,266,0.3251444212488768
26133,2222.0337,2222.0559,1,66661011,66661676,665,0.22564200473748586
26134,2222.058133,2222.08,1,66661743,66662400,657,-0.026882992962079914
26135,2222.081133,2222.092567,1,66662433,66662777,344,0.3354278324979357
26136,2222.098633,2222.1045,1,66662958,66663135,177,0.12251253727078489
26137,2222.151433,2222.155,1,66664542,66664650,108,0.41798129045779486
26138,2222.161833,2222.179067,1,66664854,66665372,518,0.2112643658973971
26139,2222.192267,2222.210967,1,66665768,66666329,561,0.0892300156431412
26140,2222.2121,2222.217067,1,66666363,66666512,149,
26141,2222.2436,2222.247967,1,66667307,66667439,132,0.4193516690727319
26142,2222.262267,2222.269233,1,66667868,66668076,208,0.19959620834925493
26143,2222.3449,2222.348367,1,66670347,66670451,104,0.6264582824144113
26144,2222.350433,2222.3733,1,66670512,66671199,687,0.15419338529632043
26145,2222.378167,2222.4026,1,66671345,66672078,733,0.39241573791115847
26146,2222.413967,2222.439067,1,66672419,66673172,753,0.19668235661969743
26147,2222.4465,2222.457867,1,66673395,66673736,341,0.3857860611273317
26148,2222.516033,2222.519667,1,66675480,66675590,110,0.665474477558466
26149,2222.5207,2222.538267,1,66675621,66676148,527,0.2739332484515532
26150,2222.5393,2222.543,1,66676179,66676290,111,
26151,2222.549567,2222.5692,1,66676487,66677076,589,0.4202847404587494
26152,2222.580767,2222.5943,1,66677423,66677829,406,0.33629910581026334
26153,2222.6281,2222.6327,1,66678843,66678981,138,-0.2656149527057982
26154,2222.658867,2222.697333,1,66679766,66680919,1153,0.3113400109115002
26155,2222.699,2222.789833,1,66680970,66683694,2724,0.2871623031680191
26156,2222.791,2222.883733,1,66683730,66686511,2781,0.28294108126032996
26157,2224.403,2224.4067,1,66732089,66732201,112,0.010834913352774115
26158,2226.287967,2226.313033,1,66788639,66789390,751,0.1739073867438351
26159,2226.322333,2226.346567,1,66789669,66790397,728,0.1312478780239387
26160,2226.3575,2226.3678,1,66790725,66791034,309,0.013744910334719338
26161,2226.3701,2226.387533,1,66791103,66791625,522,-0.00456119124181264
26162,2226.4166,2226.419833,1,66792498,66792594,96,0.40911779370875045
26163,2226.436667,2226.4455,1,66793100,66793364,264,-0.02316129394888416
26164,2226.453267,2226.472667,1,66793598,66794180,582,0.3633903287532279
26165,2226.483033,2226.497267,1,66794490,66794918,428,0.4386320792621839
26166,2226.498267,2226.513233,1,66794948,66795396,448,0.48360962981513217
26167,2227.524633,2227.528033,1,66825738,66825840,102,0.3852837583841328
26168,2229.110533,2229.130833,1,66873315,66873924,609,0.15801395477604
26169,2229.132733,2229.1498,1,66873981,66874494,513,0.35139834022081146
26170,2229.1576,2229.162267,1,66874728,66874868,140,0.07577046627561432
26171,2229.1636,2229.167467,1,66874907,66875024,117,0.32532942002349063
26172,2229.209,2229.2569,1,66876269,66877706,1437,0.2956180572106683
26173,2229.301733,2229.306367,1,66879051,66879191,140,-0.35397158461949413
26174,2229.3269,2229.335367,1,66879807,66880061,254,0.4130356945123409
26175,2229.3382,2229.342267,1,66880146,66880268,122,
26176,2229.354767,2229.364533,1,66880643,66880935,292,-0.12153933085724576
26177,2229.365633,2229.372667,1,66880968,66881180,212,0.1453334780442629
26178,2229.798933,2229.802033,1,66893967,66894060,93,-0.25056240203449875
26179,2229.885433,2229.892867,1,66896562,66896786,224,-0.16428321677101523
26180,2230.914667,2230.9494,1,66927440,66928482,1042,0.19509458173196623
26181,2230.957633,2230.961933,1,66928728,66928857,129,-0.05005349679790398
26182,2230.9667,2231.0504,1,66929001,66931512,2511,0.4546093503932525
26183,2231.0668,2231.117667,1,66932004,66933530,1526,0.05250766969178756
26184,2231.118767,2231.155133,1,66933563,66934653,1090,0.07708150477583445
26185,2231.1916,2231.195233,1,66935748,66935856,108,0.6609709238035064
26186,2240.332367,2240.339867,1,67209971,67210196,225,-0.08219443015200759
26187,2240.415567,2240.425867,1,67212467,67212776,309,0.049243731427922245
26188,2240.471433,2240.480967,1,67214142,67214429,287,0.40921622052391565
26189,2240.4884,2240.4954,1,67214652,67214862,210,0.003894552356870838
26190,2240.555767,2240.564733,1,67216673,67216941,268,0.39032890593782954
26191,2240.5995,2240.604167,1,67217985,67218125,140,0.25715197987357447
26192,2240.617267,2240.620433,1,67218518,67218612,94,
26193,2240.621967,2240.632467,1,67218659,67218974,315,-0.02345903930547526
26194,2243.4332,2243.437667,1,67302996,67303130,134,0.6693321707869948
26195,2246.805933,2246.809067,1,67404177,67404272,95,
26196,2246.824833,2246.848433,1,67404744,67405452,708,0.29328166644838954
26197,2246.849967,2246.861133,1,67405499,67405833,334,0.5424310602874455
26198,2246.863233,2246.869833,1,67405896,67406094,198,0.1996015470225666
26199,2246.881767,2246.8882,1,67406453,67406646,193,0.005403430511868934
26200,2246.922167,2246.942867,1,67407665,67408286,621,0.031637723458469026
26201,2247.189733,2247.201567,1,67415691,67416047,356,0.11634692316498998
26202,2247.203367,2247.206933,1,67416101,67416207,106,
26203,2247.2934,2247.311367,1,67418802,67419341,539,0.19085857587289132
26204,2247.3287,2247.342467,1,67419861,67420274,413,0.09041793609625773
26205,2247.346133,2247.383667,1,67420383,67421510,1127,0.17126550543191169
26206,2249.069233,2249.075933,1,67472076,67472277,201,-0.0480996794915263
26207,2249.139367,2249.1541,1,67474181,67474623,442,0.029872938162868446
26208,2249.170733,2249.177967,1,67475121,67475339,218,0.005443675018590979
26209,2262.015433,2262.0202,1,67860462,67860606,144,-0.22526569384403708
26210,2271.3187,2271.323167,1,68139561,68139695,134,0.14588570080812763
26211,2271.327733,2271.3325,1,68139831,68139975,144,0.5285846798481493
26212,2271.334833,2271.3404,1,68140044,68140212,168,0.3331157050862972
26213,2276.248267,2276.27,1,68287448,68288100,652,0.14426844469897623
26214,2276.312433,2276.316167,1,68289372,68289485,113,-0.2449552423170153
26215,2276.3638,2276.388367,1,68290914,68291651,737,0.093993695298455
26216,2276.415633,2276.426,1,68292468,68292780,312,-0.09363648271791591
26217,2276.4391,2276.4442,1,68293173,68293326,153,-0.08718001748018932
26218,2276.446767,2276.4643,1,68293403,68293929,526,-0.006582199574227239
26219,2276.474067,2276.4813,1,68294222,68294439,217,0.10169405531046115
26220,2276.486467,2276.523433,1,68294594,68295702,1108,0.041887440188561526
26221,2276.544867,2276.577667,1,68296346,68297330,984,0.0584719090022769
26222,2276.601767,2276.6065,1,68298053,68298195,142,0.08812923116500032
26223,2276.6103,2276.626433,1,68298309,68298792,483,0.030511657678811845
26224,2276.640367,2276.650467,1,68299211,68299514,303,-0.1636085292138628
26225,2276.7833,2276.863633,1,68303499,68305908,2409,0.11143501682909389
26226,2276.8868,2276.897133,1,68306604,68306913,309,-0.04322887866299894
26227,2276.902833,2276.932,1,68307084,68307960,876,-0.07004232774057646
26228,2276.935933,2276.942633,1,68308077,68308278,201,0.018116368196704122
26229,2276.953967,2276.963033,1,68308619,68308890,271,-0.07243540034017677
26230,2276.994867,2276.998,1,68309846,68309940,94,0.5217762622671432
26231,2277.476467,2277.4807,1,68324294,68324421,127,-0.03849793365887063
26232,2277.4841,2277.494033,1,68324523,68324820,297,0.014682280412587137
26233,2277.5047,2277.5116,1,68325141,68325348,207,-0.10162367670117584
26234,2277.522567,2277.527633,1,68325677,68325828,151,
26235,2277.5376,2277.571833,1,68326128,68327154,1026,0.043795119365292075
26236,2277.5787,2277.5896,1,68327361,68327688,327,-0.09084477002732652
26237,2277.623633,2277.6284,1,68328708,68328852,144,
26238,2277.6294,2277.6382,1,68328882,68329146,264,-0.017119368150732082
26239,2277.641033,2277.646433,1,68329230,68329392,162,0.21649399800030353
26240,2277.649933,2277.6572,1,68329497,68329716,219,0.1847657822659934
26241,2277.677767,2277.6878,1,68330333,68330634,301,-0.0959663207373335
26242,2277.6891,2277.693833,1,68330673,68330814,141,-0.15797395873272405
26243,2277.700367,2277.704467,1,68331011,68331134,123,
26244,2277.708167,2277.714067,1,68331245,68331422,177,-0.16795300615896683
26245,2277.722233,2277.7256,1,68331666,68331768,102,
26246,2277.741367,2277.7446,1,68332241,68332338,97,
26247,2277.745833,2277.750633,1,68332374,68332518,144,-0.14386921006115175
26248,2277.765233,2277.805433,1,68332956,68334162,1206,0.11730159744757945
26249,2277.807567,2277.8228,1,68334227,68334684,457,0.12255281409049676
26250,2277.842533,2277.8485,1,68335275,68335455,180,-0.0008323651356824459
26251,2277.905,2277.910667,1,68337150,68337320,170,0.6625859702620716
26252,2277.932267,2277.967533,1,68337968,68339025,1057,0.04193360484473211
26253,2277.971767,2277.975633,1,68339153,68339268,115,
26254,2277.976633,2277.983533,1,68339298,68339505,207,-0.10307005628469422
26255,2277.990567,2278.0,1,68339717,68340000,283,
26256,2278.0063,2278.060333,1,68340189,68341809,1620,0.04217759138551423
26257,2278.062333,2278.071633,1,68341869,68342148,279,-0.044712935747183095
26258,2278.075567,2278.081167,1,68342267,68342435,168,0.10993197007103231
26259,2278.1094,2278.158333,1,68343282,68344749,1467,0.432294077882068
26260,2278.1602,2278.302067,1,68344806,68349062,4256,0.19169272794889455
26261,2278.3035,2278.312733,1,68349105,68349381,276,0.26597866874469284
26262,2278.316067,2278.347233,1,68349482,68350416,934,-0.05909179571749253
26263,2278.348467,2278.4107,1,68350454,68352321,1867,0.29645415650570645
26264,2278.4121,2278.439333,1,68352363,68353179,816,0.05406570571042268
26265,2278.4444,2278.451967,1,68353332,68353559,227,0.5488795804811761
26266,2278.4549,2278.458633,1,68353647,68353758,111,0.5562133052642112
26267,2278.4599,2278.468333,1,68353797,68354049,252,0.10798589718739657
26268,2278.473767,2278.484733,1,68354213,68354541,328,-0.01201540668233172
26269,2278.4858,2278.503033,1,68354574,68355090,516,0.3141089097126316
26270,2278.5058,2278.5166,1,68355174,68355498,324,0.09609798120390653
26271,2278.529067,2278.6051,1,68355872,68358153,2281,0.08748768630241668
26272,2278.611867,2278.680267,1,68358356,68360408,2052,0.20020377176699108
26273,2278.681333,2278.724333,1,68360439,68361729,1290,0.07246343763722168
26274,2278.7338,2278.738267,1,68362014,68362148,134,0.04666790011082283
26275,2278.7567,2278.768467,1,68362701,68363054,353,0.11868682275568876
26276,2278.770167,2278.7977,1,68363105,68363931,826,0.22407117164964374
26277,2278.798933,2278.8083,1,68363967,68364249,282,0.30860453897579937
26278,2278.941567,2278.947667,1,68368247,68368430,183,-0.2566411463997988
26279,2278.9616,2278.968733,1,68368848,68369061,213,-0.11249260188235444
26280,2279.019967,2279.025167,1,68370599,68370755,156,0.3206219713023436
26281,2279.116833,2279.130167,1,68373504,68373905,401,0.5219032153602272
26282,2279.1499,2279.1549,1,68374497,68374647,150,
26283,2279.157633,2279.181467,1,68374728,68375444,716,0.22158628753480197
26284,2279.182633,2279.188733,1,68375478,68375661,183,0.5252506110825579
26285,2279.243667,2279.251067,1,68377310,68377532,222,0.10205192331021073
26286,2279.299933,2279.3069,1,68378997,68379207,210,0.5335401817279516
26287,2279.335533,2279.339333,1,68380065,68380179,114,0.031626586003023205
26288,2279.343733,2279.3572,1,68380311,68380716,405,-0.16608940334553943
26289,2279.407733,2279.4115,1,68382231,68382345,114,0.7632359212549091
26290,2279.423267,2279.439867,1,68382698,68383196,498,0.2495679978708436
26291,2279.452533,2279.478467,1,68383575,68384354,779,0.21178893888131345
26292,2279.485867,2279.4924,1,68384576,68384772,196,-0.016558876063652243
26293,2279.494933,2279.500233,1,68384847,68385006,159,0.7329499004763467
26294,2279.503433,2279.5122,1,68385102,68385366,264,0.37344946858564554
26295,2279.737967,2279.756267,1,68392139,68392688,549,0.13685191455892914
26296,2279.866133,2279.8724,1,68395983,68396172,189,-0.06381561606339212
26297,2279.936733,2279.978133,1,68398101,68399343,1242,-0.04905492564846109
26298,2279.979267,2280.076033,1,68399378,68402280,2902,0.035694761531456974
26299,2280.081033,2280.122567,1,68402430,68403677,1247,0.07615254513656584
26300,2280.1251,2280.1527,1,68403753,68404581,828,0.0022072647616435312
26301,2280.161867,2280.1953,1,68404856,68405859,1003,-0.007374875276799126
26302,2280.1967,2280.230133,1,68405901,68406903,1002,0.35575570519455657
26303,2280.236633,2280.2792,1,68407098,68408376,1278,0.3181784216161777
26304,2280.281133,2280.2964,1,68408433,68408892,459,0.015036495533231957
26305,2280.3038,2280.310167,1,68409114,68409305,191,0.26749532107583746
26306,2280.312667,2280.3165,1,68409380,68409495,115,-0.10437126001871692
26307,2280.329633,2280.346033,1,68409888,68410380,492,0.1575104663639902
26308,2280.3474,2280.3953,1,68410422,68411859,1437,0.15461579721463548
26309,2280.4009,2280.425933,1,68412027,68412777,750,0.3947677677043724
26310,2280.428567,2280.434567,1,68412857,68413037,180,0.5442212304626971
26311,2280.492467,2280.525267,1,68414774,68415758,984,0.294390259264652
26312,2280.542033,2280.5904,1,68416260,68417712,1452,0.3051252355069322
26313,2280.6068,2280.6365,1,68418204,68419095,891,0.2379601321988362
26314,2280.657167,2280.6682,1,68419715,68420046,331,0.2184814382457241
26315,2280.67,2280.6804,1,68420100,68420412,312,0.07100919605378267
26316,2280.780967,2280.790067,1,68423429,68423702,273,-0.12617066662432444
26317,2280.800067,2280.8047,1,68424002,68424141,139,-0.12622280311803838
26318,2280.814967,2280.821833,1,68424449,68424654,205,-0.054102258102086714
26319,2280.848267,2280.8554,1,68425448,68425662,214,0.3612759040268714
26320,2280.8584,2280.877233,1,68425752,68426316,564,0.1509790582648093
26321,2280.881867,2280.9734,1,68426456,68429202,2746,0.16405129113708736
26322,2280.974867,2280.988933,1,68429246,68429667,421,-0.1272083447258646
26323,2280.998467,2281.0229,1,68429954,68430687,733,0.025605940538444626
26324,2281.0289,2281.0836,1,68430867,68432508,1641,0.09684919086949868
26325,2281.0866,2281.092433,1,68432598,68432772,174,-0.08853109357319405
26326,2281.160233,2281.173567,1,68434806,68435207,401,0.11651288492937972
26327,2281.176167,2281.189133,1,68435285,68435673,388,0.042700758408632376
26328,2281.195533,2281.235533,1,68435865,68437065,1200,0.00021363476601058795
26329,2281.368933,2281.372167,1,68441067,68441165,98,
26330,2281.376067,2281.424133,1,68441282,68442723,1441,0.002371070550604808
26331,2281.428433,2281.441067,1,68442852,68443232,380,0.0284374503257774
26332,2281.485967,2281.489067,1,68444579,68444672,93,0.30307839499950495
26333,2281.4942,2281.501933,1,68444826,68445057,231,0.2738348375875141
26334,2281.507433,2281.556,1,68445222,68446680,1458,0.13649490638485048
26335,2281.634867,2281.640167,1,68449046,68449205,159,-0.13852652394338197
26336,2281.671367,2281.7115,1,68450141,68451345,1204,0.0293883214670604
26337,2281.7781,2281.794933,1,68453343,68453847,504,0.14903019316010596
26338,2281.795933,2281.839733,1,68453877,68455191,1314,0.25421966851885786
26339,2281.888467,2281.893067,1,68456654,68456792,138,0.41638981269054626
26340,2281.9195,2281.959367,1,68457585,68458781,1196,0.08836673385193046
26341,2281.962733,2281.966567,1,68458881,68458997,116,-0.09625245170457292
26342,2281.9714,2281.975167,1,68459142,68459255,113,
26343,2282.008767,2282.035933,1,68460263,68461077,814,-0.07903229986690147
26344,2282.036967,2282.041067,1,68461109,68461232,123,-0.10000888756509711
26345,2282.042667,2282.089067,1,68461280,68462672,1392,-0.007037836999941879
26346,2282.091033,2282.115533,1,68462730,68463465,735,0.09963147859053165
26347,2282.1167,2282.1214,1,68463501,68463642,141,0.015943474014479098
26348,2282.123667,2282.1267,1,68463710,68463801,91,
26349,2282.1442,2282.15,1,68464326,68464500,174,0.6017948639412598
26350,2282.155933,2282.163967,1,68464677,68464919,242,0.12490378558331344
26351,2282.1686,2282.172133,1,68465058,68465163,105,
26352,2282.1763,2282.1794,1,68465289,68465382,93,0.4338295830515994
26353,2282.1821,2282.200133,1,68465463,68466003,540,0.08540580134977105
26354,2282.2015,2282.2077,1,68466045,68466231,186,0.4078385190888869
26355,2282.2408,2282.251967,1,68467224,68467559,335,0.23367569876373004
26356,2282.254833,2282.267067,1,68467644,68468012,368,0.49720013762766746
26357,2282.310733,2282.314667,1,68469321,68469440,119,
26358,2282.3593,2282.4602,1,68470779,68473806,3027,0.025379634874693042
26359,2282.4673,2282.5118,1,68474019,68475354,1335,-0.03995415045540185
26360,2282.515633,2282.524767,1,68475468,68475743,275,-0.011802782975277096
26361,2282.530233,2282.541633,1,68475906,68476248,342,0.14051582958794456
26362,2282.549933,2282.5568,1,68476497,68476704,207,0.7459544497696814
26363,2282.605833,2282.6161,1,68478174,68478483,309,0.4814147472115011
26364,2282.634733,2282.642233,1,68479041,68479266,225,-0.21232905326425805
26365,2282.698867,2282.703033,1,68480966,68481090,124,
26366,2282.704133,2282.7295,1,68481123,68481885,762,-0.11988164189309294
26367,2282.737567,2282.751467,1,68482127,68482544,417,-0.10757576961826228
26368,2282.7691,2282.772933,1,68483073,68483187,114,-0.0416201108685233
26369,2282.781733,2282.793,1,68483451,68483790,339,0.29001015971388333
26370,2282.799933,2282.8032,1,68483997,68484096,99,
26371,2282.8044,2282.8154,1,68484132,68484462,330,-0.049158142756554654
26372,2282.8564,2282.958633,1,68485692,68488758,3066,0.009814387438957775
26373,2282.9598,2282.970033,1,68488794,68489100,306,0.32967112072618404
26374,2282.980133,2283.135033,1,68489403,68494050,4647,0.4624810060573656
26375,2283.136633,2283.167267,1,68494098,68495018,920,0.10859768773843768
26376,2283.1764,2283.1826,1,68495292,68495478,186,
26377,2283.186767,2283.19,1,68495603,68495700,97,
26378,2283.355067,2283.360033,1,68500652,68500800,148,-0.04951799467961231
26379,2283.369433,2283.3729,1,68501082,68501187,105,
26380,2283.398667,2283.406033,1,68501960,68502180,220,-0.08521342705066198
26381,2283.4417,2283.453033,1,68503251,68503590,339,0.5714214050425935
26382,2283.534167,2283.5413,1,68506025,68506239,214,0.16113516843374726
26383,2283.571067,2283.5767,1,68507132,68507301,169,0.5223176663854332
26384,2283.715267,2283.729867,1,68511458,68511896,438,0.07010432641236047
26385,2283.965267,2283.979667,1,68518958,68519390,432,0.01445631768243625
26386,2284.0032,2284.0073,1,68520096,68520219,123,-0.11485740921070937
26387,2284.078533,2284.0877,1,68522355,68522631,276,-0.030147081339472907
26388,2284.090567,2284.104733,1,68522717,68523141,424,0.09953203904766589
26389,2284.1083,2284.117833,1,68523249,68523534,285,-0.04572970143713666
26390,2284.119433,2284.1249,1,68523582,68523747,165,0.31106152925250813
26391,2284.140667,2284.145533,1,68524220,68524365,145,
26392,2284.150533,2284.177467,1,68524515,68525324,809,-0.017052316891668317
26393,2284.179,2284.198233,1,68525370,68525946,576,0.16522736595401932
26394,2284.201367,2284.262967,1,68526041,68527889,1848,0.05388914884589234
26395,2284.264833,2284.2703,1,68527944,68528109,165,-0.09726291815139568
26396,2284.280867,2284.354333,1,68528426,68530629,2203,0.05215483331370916
26397,2284.360433,2284.3646,1,68530812,68530938,126,
26398,2284.4272,2284.430867,1,68532816,68532926,110,-0.1273648051135604
26399,2284.560133,2284.5647,1,68536803,68536941,138,-0.10577715977202853
26400,2284.582567,2284.587133,1,68537477,68537613,136,
26401,2284.6148,2284.6179,1,68538444,68538537,93,0.06969720611072719
26402,2284.624567,2284.6529,1,68538737,68539587,850,-0.11354809583667745
26403,2284.655767,2284.665633,1,68539673,68539968,295,-0.0014525355178998992
26404,2284.667733,2284.802367,1,68540031,68544071,4040,0.5653100173552293
26405,2284.804367,2284.832233,1,68544131,68544966,835,0.19266263535527925
26406,2284.837367,2284.903667,1,68545121,68547110,1989,0.10299561832420584
26407,2284.9052,2284.963833,1,68547156,68548914,1758,0.0641744772965376
26408,2285.1649,2285.168367,1,68554947,68555051,104,0.7129633094722515
26409,2285.234467,2285.2392,1,68557034,68557176,142,
26410,2285.322,2285.3257,1,68559660,68559771,111,0.7262750833639303
26411,2285.353667,2285.356933,1,68560610,68560707,97,
26412,2285.538633,2285.541867,1,68566158,68566256,98,0.6643607284838293
26413,2285.8371,2285.841267,1,68575113,68575238,125,0.47055846590438766
26414,2285.8907,2285.9077,1,68576721,68577231,510,-0.06850388932504588
26415,2285.980367,2285.9922,1,68579411,68579766,355,0.08978804382434419
26416,2285.993867,2286.004567,1,68579816,68580137,321,0.010445532471234321
26417,2286.005733,2286.013267,1,68580171,68580398,227,0.09596934579344148
26418,2286.107267,2286.112267,1,68583218,68583368,150,
26419,2286.152867,2286.174433,1,68584586,68585232,646,-0.009790800393455682
26420,2286.197033,2286.2023,1,68585910,68586069,159,-0.08076004696225686
26421,2286.231967,2286.235267,1,68586959,68587058,99,
26422,2286.236267,2286.242233,1,68587088,68587266,178,-0.0068770262275723365
26423,2286.252433,2286.2579,1,68587572,68587737,165,0.012396273002864241
26424,2286.271133,2286.274533,1,68588133,68588235,102,
26425,2286.3372,2286.341467,1,68590116,68590244,128,0.15939458866728862
26426,2286.3448,2286.356967,1,68590344,68590709,365,0.16407670319310091
26427,2286.542167,2286.5482,1,68596265,68596446,181,-0.026493241993063455
26428,2286.610567,2286.665133,1,68598317,68599953,1636,-0.005565211734990006
26429,2286.667933,2286.6984,1,68600037,68600952,915,0.1243042214506711
26430,2286.7041,2286.754433,1,68601123,68602632,1509,0.29261370979382356
26431,2286.773,2286.779433,1,68603190,68603382,192,-0.12717032066402179
26432,2286.782133,2286.798967,1,68603463,68603969,506,0.22011381821925302
26433,2286.801333,2286.831633,1,68604039,68604948,909,0.011888475622299015
26434,2286.835267,2286.967433,1,68605058,68609022,3964,0.07803872180886304
26435,2286.968467,2287.031133,1,68609054,68610933,1879,-0.030722132636036136
26436,2287.035233,2287.0435,1,68611056,68611305,249,0.3390778215315785
26437,2287.045333,2287.056367,1,68611359,68611691,332,0.11095269392685841
26438,2287.063633,2287.106633,1,68611908,68613198,1290,0.5715715118559596
26439,2287.1107,2287.1138,1,68613321,68613414,93,
26440,2287.122533,2287.1365,1,68613675,68614095,420,0.140303962606593
26441,2287.138467,2287.1541,1,68614154,68614623,469,0.2972110078392099
26442,2287.16,2287.1806,1,68614800,68615418,618,0.16939074722518432
26443,2287.1846,2287.264933,1,68615538,68617947,2409,0.14957974569304205
26444,2287.270867,2287.299733,1,68618126,68618991,865,0.05320967501609617
26445,2287.304767,2287.3086,1,68619143,68619258,115,0.5303305206145101
26446,2287.3133,2287.328967,1,68619399,68619869,470,-0.08942320097908894
26447,2287.330133,2287.349167,1,68619903,68620475,572,0.10670324525125793
26448,2287.3559,2287.365367,1,68620677,68620961,284,-0.037770741110650714
26449,2287.483567,2287.515767,1,68624507,68625473,966,-0.000490893577178346
26450,2287.517,2287.532233,1,68625510,68625966,456,0.07738706510229944
26451,2287.549667,2287.555667,1,68626490,68626670,180,
26452,2287.6696,2287.7135,1,68630088,68631405,1317,0.1619996193094376
26453,2287.7155,2287.7186,1,68631465,68631558,93,0.7447874583218485
26454,2287.814733,2287.818433,1,68634441,68634552,111,
26455,2287.826833,2287.878567,1,68634804,68636357,1553,0.07028002207249595
26456,2287.9535,2287.957933,1,68638605,68638737,132,-0.1185292378038681
26457,2287.985333,2288.017733,1,68639559,68640531,972,0.13725150362844502
26458,2288.1611,2288.164833,1,68644833,68644944,111,0.15457472801691394
26459,2288.174467,2288.184,1,68645234,68645520,286,0.1660035744968914
26460,2288.189633,2288.193167,1,68645688,68645795,107,0.23141445393411805
26461,2288.212267,2288.228133,1,68646368,68646843,475,0.24633472580473975
26462,2288.2307,2288.233833,1,68646921,68647014,93,
26463,2288.235667,2288.2426,1,68647070,68647278,208,0.6026989566322799
26464,2288.326833,2288.3377,1,68649804,68650131,327,0.11472687392296205
26465,2288.338767,2288.3419,1,68650163,68650257,94,0.13175636925930556
26466,2288.362267,2288.3953,1,68650868,68651859,991,0.3511516525234481
26467,2288.401567,2288.425,1,68652047,68652750,703,0.22597734995057941
26468,2288.434633,2288.438,1,68653038,68653140,102,
26469,2288.620433,2288.627367,1,68658612,68658821,209,0.2595624087261231
26470,2288.684567,2288.6899,1,68660537,68660697,160,0.6328820782079756
26471,2288.7019,2288.706367,1,68661057,68661191,134,0.07749354195878638
26472,2288.762267,2288.7964,1,68662868,68663892,1024,0.00973726580246839
26473,2288.8018,2288.8246,1,68664054,68664738,684,0.5030758567156525
26474,2288.8328,2288.835933,1,68664984,68665077,93,0.4535495425004416
26475,2288.837733,2288.869767,1,68665131,68666093,962,0.17306813606005778
26476,2288.879333,2288.891067,1,68666379,68666732,353,-0.03437341762604222
26477,2288.897133,2288.980067,1,68666913,68669402,2489,0.5219183263390671
26478,2288.986033,2288.998133,1,68669580,68669943,363,0.30739333706478106
26479,2289.000167,2289.0198,1,68670005,68670594,589,0.19064773418470266
26480,2289.021467,2289.1087,1,68670644,68673261,2617,0.10822368875177446
26481,2289.114,2289.119233,1,68673420,68673576,156,0.02525523179899905
26482,2289.123733,2289.152967,1,68673711,68674589,878,-0.0058678537294035256
26483,2289.160367,2289.163767,1,68674811,68674913,102,0.3641811711947942
26484,2289.1648,2289.1847,1,68674944,68675541,597,0.2737737212342699
26485,2289.1864,2289.2137,1,68675592,68676411,819,0.11850353723558067
26486,2289.250233,2289.256667,1,68677506,68677700,194,-0.09969706241097033
26487,2289.2713,2289.275,1,68678139,68678250,111,0.5807880643403129
26488,2289.476533,2289.481667,1,68684295,68684450,155,0.27099280268402814
26489,2289.638867,2289.645233,1,68689166,68689356,190,0.11214492830340003
26490,2289.6481,2289.653067,1,68689443,68689592,149,
26491,2289.654733,2289.6641,1,68689641,68689923,282,-0.09891253263925028
26492,2289.667,2289.69,1,68690010,68690700,690,-0.04825740043655946
26493,2289.691367,2289.706533,1,68690741,68691195,454,0.0451801219422406
26494,2289.725767,2289.7548,1,68691773,68692644,871,0.12780691150164367
26495,2289.755867,2289.762867,1,68692676,68692886,210,-0.10212408080340017
26496,2289.764033,2289.788967,1,68692920,68693669,749,0.18116264187904477
26497,2289.801967,2289.806533,1,68694059,68694195,136,0.4188577648815199
26498,2289.819133,2289.86,1,68694573,68695800,1227,0.06906861804571898
26499,2289.864367,2289.878933,1,68695931,68696367,436,0.26300012662289635
26500,2289.8973,2289.905167,1,68696919,68697155,236,-0.07243609835073354
26501,2289.9196,2289.9511,1,68697588,68698533,945,0.32332882898552745
26502,2290.0069,2290.0421,1,68700207,68701263,1056,-0.00997845998476927
26503,2290.043433,2290.064633,1,68701302,68701938,636,0.3555785155682291
26504,2290.065933,2290.074267,1,68701977,68702228,251,-0.12407636187880436
26505,2290.082133,2290.0871,1,68702463,68702613,150,-0.029838837015323205
26506,2290.088567,2290.116667,1,68702657,68703500,843,0.07805843953540137
26507,2290.141133,2290.164833,1,68704233,68704944,711,-0.0035859287622436644
26508,2290.165933,2290.201133,1,68704977,68706033,1056,0.200297770721509
26509,2290.202167,2290.221467,1,68706065,68706644,579,0.1181358339208197
26510,2290.2258,2290.240133,1,68706774,68707203,429,0.07653148131564284
26511,2290.2447,2290.248633,1,68707341,68707458,117,0.3670447870940269
26512,2290.249867,2290.2651,1,68707496,68707953,457,0.11436425949554821
26513,2290.266867,2290.278033,1,68708006,68708340,334,-0.031861738677872634
26514,2290.341667,2290.350133,1,68710250,68710503,253,-0.09641101585057138
26515,2290.3624,2290.368833,1,68710872,68711064,192,0.02376583932207209
26516,2290.370267,2290.375867,1,68711108,68711276,168,0.5111811009386265
26517,2290.393933,2290.3996,1,68711817,68711988,171,0.04710393208777067
26518,2290.409267,2290.414867,1,68712278,68712446,168,0.07805552744145745
26519,2290.421767,2290.426133,1,68712653,68712783,130,-0.16645526074983671
26520,2290.480033,2290.4996,1,68714400,68714988,588,0.48259114730791014
26521,2290.5058,2290.514667,1,68715174,68715440,266,0.06738073136691256
26522,2290.516867,2290.540233,1,68715506,68716206,700,-0.05621439296696872
26523,2290.5471,2290.569667,1,68716413,68717090,677,0.04764298188142913
26524,2290.572533,2290.579667,1,68717175,68717390,215,0.24984663850158104
26525,2290.5838,2290.6098,1,68717514,68718294,780,0.14194777596601002
26526,2290.623667,2290.633867,1,68718710,68719016,306,0.04309093765390462
26527,2290.642733,2290.655733,1,68719281,68719671,390,-0.10600623511178003
26528,2290.6648,2290.671133,1,68719944,68720133,189,-0.10022813758300174
26529,2290.679467,2290.6851,1,68720384,68720553,169,-0.0017924199968298853
26530,2290.695333,2290.700533,1,68720859,68721015,156,-0.039438332646901844
26531,2290.704633,2290.710067,1,68721138,68721302,164,0.11652597276005319
26532,2290.715633,2290.7322,1,68721468,68721966,498,0.07176694461889788
26533,2290.7351,2290.7452,1,68722053,68722356,303,-0.009274375426268277
26534,2290.754,2290.764133,1,68722620,68722923,303,-0.002352458966550586
26535,2290.808933,2290.844867,1,68724267,68725346,1079,-0.058121356129681306
26536,2290.8533,2290.8666,1,68725599,68725998,399,0.09550479367661566
26537,2290.870133,2290.895167,1,68726103,68726855,752,0.20169320723276324
26538,2290.896233,2290.9028,1,68726886,68727084,198,0.16394821552478223
26539,2290.907133,2290.9146,1,68727213,68727438,225,-0.10224663002934264
26540,2290.918367,2290.925367,1,68727551,68727761,210,-0.031279593564431225
26541,2290.928333,2290.932533,1,68727849,68727975,126,
26542,2290.9336,2290.963733,1,68728008,68728911,903,0.21163424643269485
26543,2290.964767,2290.9823,1,68728943,68729469,526,0.3778084656719244
26544,2290.985867,2291.034433,1,68729576,68731032,1456,0.3144398565405508
26545,2291.035467,2291.112733,1,68731064,68733381,2317,0.210050499761027
26546,2291.1157,2291.143933,1,68733471,68734317,846,-0.06280615576995117
26547,2291.157067,2291.1617,1,68734712,68734851,139,0.17855354825127948
26548,2291.1631,2291.171167,1,68734893,68735135,242,-0.11838081482901527
26549,2291.1752,2291.1992,1,68735256,68735976,720,0.12797813768275773
26550,2291.2837,2291.286733,1,68738511,68738601,90,
26551,2291.314733,2291.359167,1,68739441,68740775,1334,-0.052311967941005226
26552,2291.4538,2291.4577,1,68743614,68743731,117,
26553,2291.543533,2291.548067,1,68746305,68746442,137,0.5176687687580831
26554,2291.580133,2291.587,1,68747403,68747610,207,0.4044255608402351
26555,2291.591767,2291.6026,1,68747753,68748078,325,0.012601203940753225
26556,2291.607633,2291.616767,1,68748228,68748503,275,0.1637047876366324
26557,2291.6278,2291.6401,1,68748834,68749203,369,0.2676813967767301
26558,2291.739367,2291.757867,1,68752181,68752736,555,0.3426287760188044
26559,2291.841967,2291.847267,1,68755259,68755418,159,
26560,2291.848667,2291.852167,1,68755460,68755565,105,-0.2051197469945637
26561,2291.863767,2291.870233,1,68755913,68756106,193,-0.10405274707784903
26562,2291.8749,2291.8893,1,68756247,68756679,432,-0.03887266442585645
26563,2291.8903,2291.9537,1,68756709,68758611,1902,0.05594239248621527
26564,2291.955767,2291.989533,1,68758673,68759685,1012,0.006829999807644973
26565,2291.990633,2292.0648,1,68759718,68761944,2226,0.44054149193277936
26566,2292.0703,2292.077133,1,68762109,68762313,204,0.08841866831212326
26567,2292.081733,2292.132,1,68762451,68763960,1509,0.19098394104578753
26568,2292.133067,2292.2034,1,68763992,68766102,2110,0.036482578609122414
26569,2292.2061,2292.2168,1,68766183,68766504,321,-0.04598969529095199
26570,2292.218367,2292.24,1,68766551,68767200,649,0.03457603193499402
26571,2292.2437,2292.273467,1,68767311,68768204,893,0.20783776204264132
26572,2292.277333,2292.309333,1,68768319,68769279,960,0.03462129053921079
26573,2292.310767,2292.321733,1,68769323,68769651,328,
26574,2292.323967,2292.327467,1,68769719,68769824,105,-0.17527656663980257
26575,2292.400467,2292.4039,1,68772014,68772117,103,0.32772834962556535
26576,2292.412433,2292.4166,1,68772372,68772498,126,-0.06129012206494344
26577,2292.431367,2292.466333,1,68772941,68773989,1048,0.1654769309607562
26578,2292.484367,2292.490967,1,68774531,68774729,198,0.22693656684165903
26579,2292.5841,2292.5875,1,68777523,68777625,102,0.1452178234183941
26580,2292.616467,2292.629967,1,68778494,68778899,405,-0.027371118422279513
26581,2293.060167,2293.087033,1,68791805,68792610,805,0.131315467944203
26582,2293.098533,2293.108033,1,68792955,68793240,285,0.02806103152867881
26583,2293.1961,2293.2072,1,68795883,68796216,333,0.20969325082697102
26584,2293.2536,2293.257033,1,68797608,68797710,102,0.37969884223543215
26585,2293.261967,2293.2678,1,68797859,68798034,175,-0.07231164884422252
26586,2293.269133,2293.2996,1,68798073,68798988,915,-0.10698725544065224
26587,2293.341833,2293.360533,1,68800254,68800815,561,-0.09105176566179071
26588,2293.3616,2293.381467,1,68800848,68801444,596,-0.08618211492299205
26589,2293.3862,2293.3918,1,68801586,68801754,168,
26590,2293.4015,2293.407433,1,68802045,68802222,177,0.1928113700031687
26591,2293.4144,2293.440833,1,68802432,68803224,792,0.19225646449438147
26592,2293.454033,2293.4776,1,68803620,68804328,708,-0.03519414836130662
26593,2293.483133,2293.486667,1,68804493,68804600,107,
26594,2293.4877,2293.490767,1,68804631,68804723,92,-0.32793559579298004
26595,2293.5036,2293.558867,1,68805108,68806766,1658,0.5469536673980739
26596,2293.562567,2293.588433,1,68806877,68807652,775,0.1727304632953312
26597,2293.5996,2293.717367,1,68807988,68811521,3533,0.18803730562739218
26598,2293.726467,2293.751133,1,68811794,68812533,739,-0.030232581316957254
26599,2293.752333,2293.756333,1,68812569,68812689,120,
26600,2293.7612,2293.765167,1,68812836,68812955,119,0.8030979937933943
26601,2293.767533,2293.791833,1,68813025,68813754,729,0.08439613101308234
26602,2293.797,2293.8005,1,68813910,68814015,105,0.6097782750335993
26603,2293.926633,2293.9374,1,68817798,68818122,324,0.00015451191351392905
26604,2294.0793,2294.109967,1,68822379,68823299,920,0.011649935112092388
26605,2294.207333,2294.226933,1,68826219,68826807,588,0.08412531737399542
26606,2294.234467,2294.247233,1,68827034,68827416,382,0.010798618361169084
26607,2294.323933,2294.328433,1,68829717,68829852,135,0.21400254502240695
26608,2294.358967,2294.388467,1,68830769,68831654,885,0.033695110410439405
26609,2294.4289,2294.432733,1,68832867,68832981,114,0.23389064412251245
26610,2294.452067,2294.4652,1,68833562,68833956,394,0.44363731607693907
26611,2294.468833,2294.474133,1,68834064,68834223,159,
26612,2294.490467,2294.499967,1,68834714,68834999,285,-0.024026773996446076
26613,2294.5785,2294.584,1,68837355,68837520,165,0.06884661072100194
26614,2294.603767,2294.61,1,68838113,68838300,187,-0.09805991145626254
26615,2294.6123,2294.6539,1,68838369,68839617,1248,0.006208749808812575
26616,2294.662567,2294.665667,1,68839877,68839970,93,
26617,2294.667367,2294.689733,1,68840021,68840691,670,0.0018898672135828716
26618,2294.6918,2294.724533,1,68840754,68841735,981,-0.10882776991670053
26619,2294.740233,2294.7556,1,68842206,68842668,462,-0.09869449954725266
26620,2294.758,2294.770167,1,68842740,68843105,365,0.13289971116732346
26621,2294.773567,2294.783767,1,68843207,68843513,306,0.0960236530977955
26622,2294.7848,2294.789267,1,68843544,68843678,134,
26623,2294.803333,2294.8099,1,68844099,68844297,198,0.004321453717820937
26624,2294.8187,2294.8257,1,68844561,68844771,210,0.18065211685694654
26625,2294.830367,2294.834133,1,68844911,68845023,112,0.2148014705638376
26626,2294.841033,2294.855967,1,68845230,68845679,449,-0.004346028504693633
26627,2294.913867,2294.932767,1,68847416,68847983,567,-0.0476523914072957
26628,2294.934567,2294.941667,1,68848037,68848250,213,-0.09892830347974649
26629,2294.943233,2294.990267,1,68848296,68849708,1412,0.035912869007759696
26630,2294.991667,2294.9974,1,68849750,68849922,172,0.419897490671461
26631,2294.998967,2295.019967,1,68849969,68850599,630,0.23400394878370034
26632,2295.026767,2295.0313,1,68850803,68850939,136,0.16996743423552618
26633,2295.046,2295.067333,1,68851380,68852019,639,0.06793658135887769
26634,2295.072033,2295.075367,1,68852160,68852261,101,
26635,2295.151233,2295.168067,1,68854536,68855042,506,0.0738364446103703
26636,2295.169767,2295.193267,1,68855093,68855798,705,-0.050760238462508836
26637,2295.2043,2295.2366,1,68856129,68857098,969,0.15730311393664748
26638,2295.253033,2295.2588,1,68857590,68857764,174,-0.004266306508772368
26639,2295.261833,2295.273933,1,68857854,68858217,363,0.10627416900004129
26640,2295.346467,2295.3633,1,68860394,68860899,505,-0.04399006567826938
26641,2295.396033,2295.3992,1,68861880,68861976,96,
26642,2295.446133,2295.4509,1,68863383,68863527,144,
26643,2295.6525,2295.6593,1,68869575,68869779,204,
26644,2295.688367,2295.695133,1,68870651,68870853,202,0.21741100080790057
26645,2295.7158,2295.727867,1,68871474,68871836,362,-0.05266465998702788
26646,2295.7387,2295.747767,1,68872161,68872433,272,0.348628106986623
26647,2295.821167,2295.829467,1,68874635,68874884,249,-0.09268169241263692
26648,2295.860167,2295.877733,1,68875805,68876331,526,0.2040303746461886
26649,2295.883767,2295.8989,1,68876513,68876967,454,0.09641970363200443
26650,2295.9039,2295.909633,1,68877117,68877288,171,0.5141415311917669
26651,2295.938067,2295.947267,1,68878142,68878418,276,0.058101941550274566
26652,2295.948533,2295.9523,1,68878455,68878569,114,-0.08134358792266194
26653,2295.956433,2295.967167,1,68878692,68879015,323,-0.05467851178528478
26654,2295.988367,2295.994333,1,68879651,68879829,178,0.11871231821307313
26655,2295.995667,2296.006967,1,68879870,68880209,339,0.5868402217848019
26656,2296.108367,2296.112,1,68883251,68883360,109,
26657,2296.132633,2296.1529,1,68883978,68884587,609,-0.036567859308855005
26658,2296.154033,2296.162133,1,68884620,68884863,243,-0.0657974781682146
26659,2296.165067,2296.1705,1,68884952,68885115,163,
26660,2296.214367,2296.221367,1,68886431,68886641,210,-0.13440315585386822
26661,2296.241167,2296.254367,1,68887235,68887631,396,0.10107340318842956
26662,2296.256,2296.2694,1,68887680,68888082,402,0.20253487766111364
26663,2296.270467,2296.2942,1,68888114,68888826,712,0.12325493687910544
26664,2296.300167,2296.307567,1,68889005,68889227,222,-0.05745283399846631
26665,2296.3348,2296.341833,1,68890044,68890254,210,0.438418843098508
26666,2296.348033,2296.366867,1,68890440,68891006,566,-0.08396492510292058
26667,2296.3717,2296.379167,1,68891151,68891375,224,0.01467435654595662
26668,2296.404267,2296.419467,1,68892128,68892584,456,0.15420605029033224
26669,2296.4211,2296.4275,1,68892633,68892825,192,0.30501552411163263
26670,2296.4323,2296.448133,1,68892969,68893443,474,-0.05339813638836885
26671,2296.8857,2296.890467,1,68906571,68906714,143,0.679459850035791
26672,2296.911467,2296.9716,1,68907344,68909148,1804,-0.008031141427861429
26673,2296.985933,2296.991,1,68909577,68909730,153,-0.06053520908807071
26674,2296.9994,2297.014767,1,68909982,68910443,461,0.12537245462573396
26675,2297.022,2297.026333,1,68910660,68910789,129,-0.046080082532154884
26676,2297.027933,2297.041267,1,68910837,68911238,401,-0.0466308537589095
26677,2297.042567,2297.048833,1,68911277,68911464,187,-0.20467746911679247
26678,2297.053867,2297.0571,1,68911616,68911713,97,
26679,2297.0594,2297.089567,1,68911782,68912687,905,0.0959605994541672
26680,2297.092767,2297.1059,1,68912783,68913177,394,0.15705476859796247
26681,2297.111633,2297.120633,1,68913348,68913618,270,0.022356454504215084
26682,2297.121967,2297.138767,1,68913659,68914163,504,0.24351176991298587
26683,2297.1441,2297.168667,1,68914323,68915060,737,0.336731472138084
26684,2297.179933,2297.271133,1,68915397,68918133,2736,0.43685772414125223
26685,2297.274667,2297.284733,1,68918240,68918541,301,-0.10727412521471942
26686,2297.285733,2297.456667,1,68918571,68923700,5129,0.22785284430290134
26687,2297.4602,2297.478933,1,68923806,68924367,561,0.18602921214849574
26688,2297.509167,2297.5157,1,68925275,68925471,196,0.00891275446677695
26689,2297.5858,2297.620133,1,68927574,68928603,1029,-0.020519310480866908
26690,2297.621967,2297.658367,1,68928659,68929751,1092,0.0511138511256511
26691,2297.665533,2297.670767,1,68929965,68930123,158,0.18607811253253348
26692,2297.731233,2297.734933,1,68931936,68932047,111,-0.11446696359455343
26693,2297.765067,2297.8046,1,68932952,68934138,1186,0.030089356098473255
26694,2297.910733,2297.9631,1,68937321,68938893,1572,0.07083960482383621
26695,2298.0412,2298.0457,1,68941236,68941371,135,0.08662714701523826
26696,2298.077667,2298.116767,1,68942330,68943503,1173,0.0426469137701644
26697,2298.335933,2298.346967,1,68950077,68950409,332,0.3649189012204954
26698,2298.3554,2298.365533,1,68950662,68950965,303,0.3730487977727793
26699,2298.3728,2298.402633,1,68951184,68952078,894,0.32579046806223927
26700,2298.411267,2298.4195,1,68952338,68952585,247,0.23248206154513704
26701,2298.495567,2298.5146,1,68954867,68955438,571,0.25945927543387104
26702,2298.578733,2298.611867,1,68957361,68958356,995,-0.09560991314315902
26703,2298.614533,2298.653133,1,68958435,68959593,1158,0.10406634332230172
26704,2298.6638,2298.675667,1,68959914,68960270,356,0.276293056392168
26705,2298.693967,2298.718867,1,68960819,68961566,747,0.06274496609162342
26706,2298.726167,2298.7393,1,68961785,68962179,394,0.2605614506958277
26707,2298.743333,2298.778833,1,68962299,68963364,1065,0.2252834069045028
26708,2298.780567,2298.811833,1,68963417,68964354,937,0.014710044828295172
26709,2298.813333,2298.865533,1,68964399,68965965,1566,0.5771538915770318
26710,2298.8667,2298.915433,1,68966001,68967462,1461,0.07957038543201261
26711,2298.917133,2298.9405,1,68967513,68968215,702,0.058947574921271645
26712,2298.9415,2298.9538,1,68968245,68968614,369,0.383300129018844
26713,2298.974333,2298.982,1,68969229,68969460,231,0.16076084323206896
26714,2299.019533,2299.0248,1,68970585,68970744,159,0.03865122880190538
26715,2299.0476,2299.061533,1,68971428,68971845,417,-0.09414283038538097
26716,2299.0632,2299.103333,1,68971896,68973099,1203,0.4056316531557681
26717,2299.104533,2299.161,1,68973135,68974830,1695,0.48087073411003084
26718,2299.1641,2299.173833,1,68974923,68975214,291,-0.03547002421371548
26719,2299.175167,2299.245567,1,68975255,68977367,2112,0.22089279353301783
26720,2299.247133,2299.267367,1,68977413,68978021,608,0.14040525122709094
26721,2299.270867,2299.308833,1,68978126,68979264,1138,0.35581479929466636
26722,2299.3121,2299.3164,1,68979363,68979492,129,
26723,2299.3174,2299.325167,1,68979522,68979755,233,-0.0065039245903379134
26724,2299.330333,2299.357,1,68979909,68980710,801,0.13887712492009807
26725,2299.359467,2299.374933,1,68980784,68981247,463,0.050038991966745994
26726,2299.3766,2299.4518,1,68981298,68983554,2256,0.03533494335172811
26727,2299.4575,2299.462567,1,68983725,68983877,152,
26728,2299.4643,2299.4674,1,68983929,68984022,93,
26729,2299.5453,2299.549067,1,68986359,68986472,113,
26730,2299.566133,2299.586733,1,68986983,68987601,618,-0.0042473071282060045
26731,2299.602733,2299.6069,1,68988081,68988207,126,-0.13287531365256025
26732,2299.639567,2299.645767,1,68989187,68989373,186,0.7994383829160607
26733,2299.656633,2299.664233,1,68989698,68989926,228,0.26199830997027534
26734,2299.668867,2299.678633,1,68990066,68990358,292,0.17288195278205915
26735,2299.687733,2299.705633,1,68990631,68991168,537,0.051879434507788
26736,2299.794333,2299.8095,1,68993829,68994285,456,0.2866684613268376
26737,2299.813733,2299.817033,1,68994411,68994510,99,
26738,2299.825,2299.8286,1,68994750,68994858,108,0.05139466590839012
26739,2299.831367,2299.839467,1,68994941,68995184,243,-0.23661974697082408
26740,2299.889433,2299.8993,1,68996682,68996979,297,0.34483500582886717
26741,2299.955767,2300.0005,1,68998673,69000015,1342,-0.052612394217941505
26742,2300.0164,2300.022667,1,69000492,69000680,188,0.3914034658482595
26743,2300.0303,2300.0352,1,69000909,69001056,147,-0.10443828492643151
26744,2300.036467,2300.049867,1,69001094,69001496,402,-0.12300122321502234
26745,2300.0555,2300.061567,1,69001665,69001847,182,-0.11687438677258201
26746,2300.081633,2300.0906,1,69002448,69002718,270,-0.04550103654827255
26747,2300.095,2300.098733,1,69002850,69002961,111,
26748,2300.1031,2300.124967,1,69003093,69003749,656,-0.11552859484210987
26749,2300.127567,2300.161067,1,69003827,69004832,1005,-0.052037358323093516
26750,2300.177167,2300.186567,1,69005315,69005597,282,-0.016036558797552607
26751,2300.1883,2300.2137,1,69005649,69006411,762,-0.04544832950199847
26752,2300.215667,2300.242333,1,69006470,69007269,799,0.005350914698650905
26753,2300.248167,2300.268867,1,69007445,69008066,621,0.08967687137626854
26754,2300.286033,2300.299367,1,69008580,69008981,401,0.14531969202766712
26755,2300.3028,2300.3066,1,69009084,69009198,114,0.3463168452711379
26756,2300.318133,2300.327167,1,69009543,69009815,272,-0.15508961566572976
26757,2300.511633,2300.515133,1,69015348,69015453,105,-0.13765184644029654
26758,2300.5457,2300.582633,1,69016371,69017478,1107,0.08347985112280062
26759,2300.585567,2300.590433,1,69017567,69017712,145,0.6554003582424212
26760,2300.593,2300.6001,1,69017790,69018003,213,0.3512881830262771
26761,2300.602433,2300.609033,1,69018072,69018270,198,0.2655675271832824
26762,2300.610167,2300.631167,1,69018305,69018935,630,0.22421697588737582
26763,2300.6347,2300.654333,1,69019041,69019629,588,0.12210099989324472
26764,2300.663167,2300.736567,1,69019895,69022097,2202,0.5904347324313063
26765,2300.738233,2300.772967,1,69022146,69023189,1043,0.21533103447800567
26766,2300.774333,2300.814567,1,69023229,69024437,1208,0.09488681204132716
26767,2300.8156,2300.885233,1,69024468,69026556,2088,0.15984835450623064
26768,2300.890467,2300.903133,1,69026714,69027093,379,-0.05036853370588619
26769,2300.905333,2300.9358,1,69027159,69028074,915,0.045609137549374755
26770,2300.9388,2300.955,1,69028164,69028650,486,0.06727109335754082
26771,2301.136367,2301.15,1,69034091,69034500,409,0.45802209820866674
26772,2301.201,2301.2136,1,69036030,69036408,378,0.14280543761313555
26773,2301.214633,2301.242567,1,69036438,69037277,839,0.03741999603712811
26774,2301.2542,2301.259567,1,69037626,69037787,161,0.013318940158261799
26775,2301.261767,2301.285733,1,69037853,69038571,718,-0.0647345545120417
26776,2301.287333,2301.3054,1,69038619,69039162,543,-0.027579041211956045
26777,2301.3225,2301.334433,1,69039675,69040032,357,0.2842179318220879
26778,2301.3358,2301.359367,1,69040074,69040781,707,-0.02646195267135889
26779,2301.360533,2301.375533,1,69040815,69041265,450,-0.09090288141970682
26780,2301.3866,2301.434833,1,69041598,69043044,1446,0.07968633755191565
26781,2301.4391,2301.452567,1,69043173,69043577,404,0.5083228987367397
26782,2301.454267,2301.465867,1,69043628,69043976,348,-0.15003797141350522
26783,2301.469067,2301.476533,1,69044072,69044295,223,0.24658238727073536
26784,2301.484967,2301.490433,1,69044549,69044712,163,0.5107300271708978
26785,2301.4916,2301.535967,1,69044748,69046079,1331,0.36383290799263807
26786,2301.540333,2301.549267,1,69046209,69046478,269,0.3466886587662708
26787,2301.5505,2301.5626,1,69046515,69046878,363,0.17190172332548329
26788,2301.565933,2301.644233,1,69046977,69049326,2349,0.2028890280608145
26789,2301.650167,2301.654833,1,69049505,69049644,139,-0.07563446129104423
26790,2301.6666,2301.710633,1,69049998,69051318,1320,-0.06444551411022668
26791,2301.711667,2301.747733,1,69051350,69052431,1081,0.047994834761275126
26792,2301.752933,2301.783267,1,69052587,69053498,911,0.10260874583577595
26793,2301.8829,2301.887133,1,69056487,69056613,126,-0.08252881162342166
26794,2301.896933,2301.926067,1,69056907,69057782,875,-0.02425357032527273
26795,2301.9285,2301.939333,1,69057855,69058179,324,0.07380583801693687
26796,2302.034367,2302.0587,1,69061031,69061761,730,-0.0376357177407069
26797,2302.391067,2302.413967,1,69071732,69072419,687,0.26401788932620296
26798,2302.480267,2302.491567,1,69074408,69074747,339,-0.07927396814846398
26799,2302.5021,2302.533767,1,69075063,69076013,950,-0.05497088895459976
26800,2302.535633,2302.542667,1,69076068,69076280,212,-0.0032290339840634705
26801,2302.545767,2302.5559,1,69076373,69076677,304,0.05607100553368345
26802,2302.588967,2302.598767,1,69077669,69077963,294,-0.16158047899203765
26803,2302.622933,2302.641733,1,69078687,69079251,564,-0.005352697733188471
26804,2302.642767,2302.65,1,69079283,69079500,217,0.4860655882061725
26805,2302.651067,2302.666333,1,69079532,69079989,457,-0.010021328334802104
26806,2302.823267,2302.8301,1,69084698,69084903,205,0.24702248589541145
26807,2302.8339,2302.840633,1,69085017,69085218,201,0.27207249733790506
26808,2302.863967,2302.869033,1,69085919,69086070,151,0.30214683866006586
26809,2302.953167,2302.960767,1,69088595,69088823,228,0.14523134295115456
26810,2303.034,2303.038367,1,69091020,69091151,131,
26811,2303.1234,2303.1278,1,69093702,69093834,132,-0.08474835869244994
26812,2303.1313,2303.169567,1,69093939,69095087,1148,-0.08694565845544426
26813,2303.172967,2303.204333,1,69095189,69096129,940,0.14467417091085297
26814,2303.210833,2303.4002,1,69096324,69102006,5682,0.3980222402369959
26815,2303.499067,2303.502267,1,69104972,69105068,96,
26816,2303.503833,2303.5086,1,69105114,69105258,144,-0.16964368072129166
26817,2303.5106,2303.516267,1,69105318,69105488,170,0.34093808928351155
26818,2303.524767,2303.5959,1,69105743,69107877,2134,0.006445468511915134
26819,2303.5982,2303.6285,1,69107946,69108855,909,0.03983563055093692
26820,2303.6446,2303.652067,1,69109338,69109562,224,0.3266744818355366
26821,2303.672833,2303.675833,1,69110184,69110274,90,
26822,2303.7198,2303.723633,1,69111594,69111708,114,0.8287424864206692
26823,2303.7356,2303.739433,1,69112068,69112182,114,
26824,2303.7519,2303.7697,1,69112557,69113091,534,0.19449332351849638
26825,2303.7715,2303.7832,1,69113145,69113496,351,0.2914246899982628
26826,2303.7847,2303.8005,1,69113541,69114015,474,0.19259824870129957
26827,2303.960167,2303.967033,1,69118805,69119010,205,0.11961116408743004
26828,2304.005567,2304.008833,1,69120167,69120264,97,-0.0027004857315825258
26829,2304.010267,2304.088433,1,69120308,69122652,2344,0.0193683028758442
26830,2304.1295,2304.145067,1,69123885,69124352,467,0.15749111394576604
26831,2304.1464,2304.153333,1,69124392,69124599,207,-0.13533899681734382
26832,2304.1704,2304.175,1,69125112,69125250,138,
26833,2304.181667,2304.214233,1,69125450,69126426,976,0.08428942496102473
26834,2304.2724,2304.358633,1,69128172,69130758,2586,0.05977295465606749
26835,2304.362267,2304.372833,1,69130868,69131184,316,0.019526317152756583
26836,2304.382333,2304.391867,1,69131469,69131756,287,-0.07334223236474635
26837,2304.423333,2304.432867,1,69132699,69132986,287,0.16877615715588562
26838,2304.502267,2304.5057,1,69135068,69135171,103,
26839,2304.535633,2304.590967,1,69136068,69137729,1661,-0.037229269427507726
26840,2304.596633,2304.614,1,69137898,69138420,522,0.23395961456406572
26841,2304.6188,2304.636433,1,69138564,69139092,528,0.2921496749678624
26842,2304.644467,2304.650967,1,69139334,69139529,195,-0.16344142485734547
26843,2304.6548,2304.660067,1,69139644,69139802,158,-0.15190869097207524
26844,2304.661967,2304.668833,1,69139859,69140064,205,-0.10968021305956911
26845,2304.670133,2304.674633,1,69140103,69140238,135,
26846,2304.6792,2304.682633,1,69140376,69140478,102,0.6858557470915534
26847,2304.683733,2304.8347,1,69140511,69145041,4530,0.39792853133524747
26848,2304.835733,2304.854133,1,69145071,69145623,552,0.0027165297557137894
26849,2304.8599,2304.886567,1,69145797,69146597,800,-0.039912314545061306
26850,2304.899833,2304.9042,1,69146994,69147126,132,
26851,2304.909133,2304.963833,1,69147273,69148914,1641,-0.0531486991392148
26852,2304.984567,2304.9878,1,69149537,69149634,97,
26853,2304.989,2304.9924,1,69149670,69149772,102,0.05443378897554879
26854,2305.053633,2305.0567,1,69151608,69151701,93,
26855,2305.067467,2305.1222,1,69152024,69153666,1642,0.019896866778015193
26856,2305.182767,2305.1883,1,69155483,69155649,166,-0.18983760265296618
26857,2305.215033,2305.252833,1,69156450,69157584,1134,0.2148020794730981
26858,2305.288133,2305.291367,1,69158643,69158741,98,-0.519746721458883
26859,2305.303133,2305.353,1,69159093,69160590,1497,-0.07218684398498829
26860,2305.357667,2305.367567,1,69160730,69161027,297,-0.17166885909315807
26861,2305.410367,2305.416333,1,69162311,69162489,178,0.14269137308932123
26862,2305.466867,2305.505033,1,69164006,69165150,1144,0.015411724923646047
26863,2305.511467,2305.533733,1,69165344,69166011,667,0.023764108245426945
26864,2305.536267,2305.567,1,69166088,69167010,922,0.148486316309196
26865,2305.5682,2305.577433,1,69167046,69167322,276,0.1363179159554001
26866,2305.579567,2305.616667,1,69167387,69168500,1113,0.06920152795519333
26867,2305.619433,2305.6283,1,69168582,69168849,267,-0.0525205114173218
26868,2305.6313,2305.638767,1,69168939,69169163,224,-0.14599355087172006
26869,2305.640233,2305.644733,1,69169206,69169341,135,0.42109864534380587
26870,2305.6461,2305.725733,1,69169383,69171771,2388,0.44911966226666894
26871,2305.7281,2305.7315,1,69171843,69171945,102,
26872,2305.736433,2305.7426,1,69172092,69172278,186,0.06594769623491877
26873,2305.748033,2305.778367,1,69172440,69173351,911,0.2253814962142806
26874,2305.7799,2305.870333,1,69173397,69176109,2712,0.43343090385158756
26875,2305.885333,2305.897467,1,69176559,69176924,365,0.07471687238042153
26876,2305.900133,2306.004267,1,69177003,69180128,3125,0.06862400031092979
26877,2306.005633,2306.0183,1,69180168,69180549,381,-0.07190878273651742
26878,2306.024067,2306.038833,1,69180722,69181164,442,0.039839995486100475
26879,2306.040033,2306.0493,1,69181200,69181479,279,0.3462267839510337
26880,2306.0511,2306.0651,1,69181533,69181953,420,0.08350384313207865
26881,2306.0691,2306.1056,1,69182073,69183168,1095,0.19270482298694272
26882,2306.110367,2306.1175,1,69183311,69183525,214,-0.056106898371330816
26883,2306.2058,2306.256033,1,69186174,69187680,1506,0.10949461152272674
26884,2306.319667,2306.323867,1,69189590,69189716,126,-0.1484779494385473
26885,2306.3536,2306.391733,1,69190608,69191751,1143,0.1423357853861582
26886,2306.439633,2306.446033,1,69193188,69193380,192,0.4629108543474269
26887,2306.447367,2306.473267,1,69193421,69194198,777,0.254436414531406
26888,2306.585333,2306.595867,1,69197559,69197876,317,0.11390453981797229
26889,2306.655467,2306.663033,1,69199664,69199890,226,-0.059447741346373914
26890,2306.6673,2306.6787,1,69200019,69200361,342,-0.02020885259647753
26891,2306.682133,2306.693733,1,69200463,69200811,348,-0.08534814660612974
26892,2306.7013,2306.708533,1,69201039,69201255,216,
26893,2306.709967,2306.758533,1,69201299,69202755,1456,0.09977388507931025
26894,2306.766333,2306.7932,1,69202989,69203796,807,0.016184921153063123
26895,2306.7979,2306.803867,1,69203937,69204116,179,0.09276647203872158
26896,2306.820167,2306.8247,1,69204605,69204741,136,
26897,2306.826633,2306.835367,1,69204798,69205061,263,-0.12898155744957013
26898,2306.836467,2306.878367,1,69205094,69206351,1257,0.40690743542799834
26899,2306.879667,2306.899,1,69206390,69206970,580,0.23167612172352597
26900,2306.901967,2307.016533,1,69207059,69210495,3436,0.24351079113227433
26901,2307.146967,2307.151533,1,69214409,69214545,136,
26902,2307.190033,2307.2167,1,69215700,69216501,801,-0.08209265146689983
26903,2307.2312,2307.254233,1,69216936,69217626,690,0.13166758341643384
26904,2307.273333,2307.289933,1,69218199,69218697,498,0.21203260018517792
26905,2307.2938,2307.297,1,69218814,69218910,96,-0.14069168734585508
26906,2307.306333,2307.320833,1,69219189,69219624,435,0.06842626427784723
26907,2307.3238,2307.3405,1,69219714,69220215,501,0.18584039289086274
26908,2307.344033,2307.347867,1,69220320,69220436,116,0.6164939966071108
26909,2307.3514,2307.3557,1,69220542,69220671,129,0.08715209450223083
26910,2307.364567,2307.404267,1,69220937,69222128,1191,0.059118652129390235
26911,2307.406667,2307.416967,1,69222200,69222509,309,-0.02491074000221645
26912,2307.4197,2307.425667,1,69222591,69222770,179,0.18293346034941815
26913,2307.4269,2307.4377,1,69222807,69223131,324,0.5942153733361335
26914,2307.4388,2307.4491,1,69223164,69223473,309,0.06370655050798855
26915,2307.4522,2307.4685,1,69223566,69224055,489,0.18843310670276925
26916,2307.4741,2307.487133,1,69224223,69224613,390,0.08772969486677229
26917,2307.498867,2307.5538,1,69224966,69226614,1648,0.18089769692575822
26918,2307.556233,2307.563533,1,69226686,69226905,219,0.3606932429972555
26919,2307.574567,2307.609633,1,69227237,69228288,1051,0.33349803607696243
26920,2307.610833,2307.7043,1,69228324,69231129,2805,0.19417337183034108
26921,2307.710733,2307.729933,1,69231321,69231897,576,0.39932545797434754
26922,2307.733167,2307.7447,1,69231995,69232341,346,0.0730991614052351
26923,2307.7529,2307.768233,1,69232587,69233046,459,-0.14084383778483717
26924,2307.783967,2307.792433,1,69233519,69233772,253,0.34571638571344326
26925,2307.823667,2307.832767,1,69234710,69234983,273,-0.0029981326172880936
26926,2307.834767,2307.8396,1,69235043,69235188,145,-0.07285320742385215
26927,2307.859333,2307.892433,1,69235779,69236772,993,0.06530313574534914
26928,2307.8985,2307.911167,1,69236955,69237335,380,0.08634762630013862
26929,2307.914233,2307.9213,1,69237426,69237639,213,-0.044888044937280054
26930,2307.9981,2308.005633,1,69239943,69240168,225,-0.05199165374688508
26931,2308.316067,2308.3258,1,69249482,69249774,292,-0.11066984553895608
26932,2308.333433,2308.3452,1,69250002,69250356,354,0.06882454088428491
26933,2308.572267,2308.615233,1,69257168,69258456,1288,-0.0004974797150708676
26934,2308.616333,2308.628833,1,69258489,69258864,375,-0.11187364951501273
26935,2308.630233,2308.639433,1,69258906,69259182,276,-0.06655260244933145
26936,2308.641433,2308.661333,1,69259242,69259839,597,0.24732348599015658
26937,2308.664333,2308.669567,1,69259929,69260087,158,0.29355516780264357
26938,2308.6841,2308.694633,1,69260523,69260838,315,-0.06135380657648085
26939,2308.9223,2308.929033,1,69267669,69267870,201,0.16782471291002282
26940,2308.9475,2308.951433,1,69268425,69268542,117,0.15780931742169896
26941,2309.067367,2309.093133,1,69272021,69272793,772,-0.03115656721755901
26942,2309.095733,2309.138633,1,69272871,69274158,1287,-0.06972130415943065
26943,2309.141967,2309.164467,1,69274259,69274934,675,0.09147922588663959
26944,2309.1668,2309.170233,1,69275004,69275106,102,
26945,2309.1797,2309.185067,1,69275391,69275552,161,0.003188539689916682
26946,2309.1919,2309.199467,1,69275757,69275984,227,-0.05221170937713854
26947,2309.202767,2309.2203,1,69276083,69276609,526,0.2623432127341302
26948,2309.222567,2309.225833,1,69276677,69276774,97,
26949,2309.3284,2309.413,1,69279852,69282390,2538,-0.012126868503888142
26950,2309.427633,2309.431833,1,69282828,69282954,126,0.7171249863405683
26951,2309.4348,2309.441667,1,69283044,69283250,206,0.0742225083999687
26952,2309.4473,2309.4776,1,69283419,69284328,909,0.1362628772990769
26953,2309.478767,2309.5257,1,69284363,69285771,1408,0.483544679981663
26954,2309.5271,2309.5439,1,69285813,69286317,504,0.15891993773701268
26955,2309.544933,2309.5539,1,69286347,69286617,270,-0.0383838618282845
26956,2309.557767,2309.588867,1,69286733,69287666,933,0.08349661691982802
26957,2309.5934,2309.599467,1,69287802,69287984,182,
26958,2309.699433,2309.702833,1,69290982,69291084,102,0.2901976292489925
26959,2309.740167,2309.769267,1,69292205,69293078,873,-0.03368476301572072
26960,2309.7977,2309.810933,1,69293931,69294327,396,-0.06016279974858123
26961,2309.8121,2309.855033,1,69294363,69295650,1287,-0.09924863026871414
26962,2309.8642,2309.8701,1,69295926,69296103,177,0.3164021572503013
26963,2309.876433,2309.883567,1,69296292,69296507,215,0.21467253867339142
26964,2309.901133,2309.9114,1,69297033,69297342,309,0.2777164105668509
26965,2309.912767,2309.930233,1,69297383,69297906,523,0.31478549221070723
26966,2309.939033,2309.9437,1,69298170,69298311,141,0.43511233477188377
26967,2309.9492,2309.953367,1,69298476,69298601,125,0.13417504119260226
26968,2309.955967,2310.018667,1,69298679,69300560,1881,0.41266449164065966
26969,2310.020233,2310.054967,1,69300606,69301649,1043,0.09149341940345974
26970,2310.065,2310.081333,1,69301950,69302439,489,0.0041561792826948505
26971,2310.084467,2310.176933,1,69302534,69305307,2773,0.04291516718943608
26972,2310.181167,2310.184833,1,69305435,69305544,109,0.6720889960660088
26973,2310.186167,2310.208533,1,69305585,69306255,670,-0.04469746655837461
26974,2310.227333,2310.2683,1,69306819,69308049,1230,-0.02146713215106505
26975,2310.282267,2310.2858,1,69308468,69308574,106,0.35956254657276376
26976,2310.311933,2310.317433,1,69309357,69309522,165,0.09986518835249994
26977,2310.3399,2310.345867,1,69310197,69310376,179,
26978,2310.3557,2310.360967,1,69310671,69310829,158,0.05844188712787765
26979,2310.394,2310.397567,1,69311820,69311927,107,
26980,2310.6293,2310.639733,1,69318879,69319191,312,0.004530155189062317
26981,2310.641567,2310.663,1,69319247,69319890,643,0.03036031504778726
26982,2310.6716,2310.689,1,69320148,69320670,522,0.08910202691841339
26983,2310.701567,2310.710433,1,69321047,69321312,265,0.0081110876246528
26984,2310.711833,2310.7219,1,69321354,69321657,303,0.2810512777150166
26985,2310.723767,2310.740167,1,69321713,69322205,492,0.3857376603666384
26986,2310.829067,2310.840333,1,69324872,69325209,337,0.37218358967532167
26987,2310.846667,2310.852167,1,69325400,69325565,165,0.36337565761684504
26988,2310.8667,2310.8708,1,69326001,69326124,123,-0.2745715103720294
26989,2310.8721,2310.888167,1,69326163,69326645,482,0.00942872210070957
26990,2310.944967,2310.958333,1,69328349,69328749,400,0.46682988338881165
26991,2311.014,2311.025867,1,69330420,69330776,356,0.17029566607103383
26992,2311.142667,2311.1465,1,69334280,69334395,115,-0.09143338111074553
26993,2311.148267,2311.158,1,69334448,69334740,292,-0.09054208488986737
26994,2311.1746,2311.177833,1,69335238,69335334,96,0.5367899277841343
26995,2311.196167,2311.209933,1,69335885,69336297,412,0.31928117389550625
26996,2311.2129,2311.232333,1,69336387,69336969,582,-0.00019257360707069179
26997,2311.2661,2311.312067,1,69337983,69339362,1379,-0.012022535814868772
26998,2311.314633,2311.319567,1,69339438,69339587,149,0.546715692447458
26999,2311.3208,2311.3526,1,69339624,69340578,954,0.11970242755097975
27000,2311.3608,2311.365867,1,69340824,69340976,152,
27001,2311.377067,2311.416633,1,69341312,69342498,1186,0.0672496740211304
27002,2311.4189,2311.432033,1,69342567,69342960,393,0.05986664482139237
27003,2311.4332,2311.444967,1,69342996,69343349,353,0.2694125481820137
27004,2311.4626,2311.482,1,69343878,69344460,582,0.05486792289301596
27005,2311.483233,2311.511033,1,69344496,69345330,834,0.04515856879404011
27006,2311.515533,2311.5711,1,69345465,69347133,1668,0.10935726903215676
27007,2311.593033,2311.880767,1,69347790,69356423,8633,0.4411548200570075
27008,2311.884067,2311.8895,1,69356522,69356685,163,
27009,2311.9042,2311.910733,1,69357126,69357321,195,0.16984284820873183
27010,2311.998967,2312.067567,1,69359969,69362027,2058,0.0021956597993897714
27011,2312.068867,2312.128933,1,69362066,69363867,1801,0.015986266351232934
27012,2312.2739,2312.283067,1,69368217,69368492,275,0.17777652502745678
27013,2312.284133,2312.287733,1,69368523,69368631,108,0.08644144888089948
27014,2312.303733,2312.311033,1,69369111,69369330,219,-0.2165911488338575
27015,2312.3155,2312.322067,1,69369465,69369662,197,0.09084932097397386
27016,2312.3241,2312.3291,1,69369723,69369873,150,0.4283231829087901
27017,2312.330333,2312.3352,1,69369909,69370056,147,-0.05033807324953992
27018,2312.405467,2312.409267,1,69372164,69372278,114,0.08327321484667737
27019,2312.453567,2312.4799,1,69373607,69374397,790,-0.043268685534807554
27020,2312.5032,2312.5083,1,69375096,69375249,153,-0.07679409491570856
27021,2312.528967,2312.542233,1,69375869,69376266,397,-0.07472535553984584
27022,2312.545,2312.549333,1,69376350,69376479,129,-0.006070726109961622
27023,2312.5516,2312.554633,1,69376548,69376638,90,-0.021476363835710246
27024,2312.5826,2312.586033,1,69377478,69377580,102,0.685585590160469
27025,2312.588067,2312.6077,1,69377642,69378231,589,-0.0766876901270162
27026,2312.609133,2312.613733,1,69378273,69378411,138,0.17135630613884972
27027,2312.6151,2312.6383,1,69378453,69379149,696,0.0011665656071803926
27028,2312.642133,2312.6952,1,69379263,69380856,1593,0.1431396832567433
27029,2312.702667,2312.711933,1,69381080,69381357,277,0.21944728554697254
27030,2312.7227,2312.888067,1,69381681,69386642,4961,0.5162320784186787
27031,2312.8919,2312.935133,1,69386757,69388053,1296,0.016396369681208157
27032,2312.936533,2312.941967,1,69388095,69388259,164,0.6372035956731584
27033,2312.954833,2312.9584,1,69388644,69388752,108,
27034,2313.020067,2313.024567,1,69390602,69390737,135,0.25951081523184455
27035,2313.0645,2313.077633,1,69391935,69392328,393,0.024108081519225374
27036,2313.080533,2313.094267,1,69392415,69392828,413,-0.05992623520534367
27037,2313.096967,2313.115033,1,69392909,69393450,541,0.01099163860520809
27038,2313.1164,2313.133433,1,69393492,69394002,510,-0.004608571418952175
27039,2313.1387,2313.1503,1,69394161,69394509,348,-0.009722979865415064
27040,2313.159467,2313.1705,1,69394784,69395115,331,0.00559819566602915
27041,2313.181067,2313.2254,1,69395432,69396762,1330,0.02923238661179192
27042,2313.270033,2313.2755,1,69398100,69398265,165,0.44554352908726513
27043,2313.426633,2313.426767,1,69402798,69402803,5,
27044,2313.753333,2313.757067,1,69412599,69412712,113,
27045,2313.7583,2313.7666,1,69412749,69412998,249,-0.06036901680985295
27046,2313.8343,2313.8433,1,69415029,69415299,270,0.02828059114271113
27047,2313.8865,2313.981,1,69416595,69419430,2835,0.010771316837552353
27048,2313.982867,2313.991833,1,69419486,69419754,268,0.4579458738649287
27049,2314.005467,2314.0165,1,69420164,69420495,331,0.2535976243595641
27050,2314.153667,2314.163733,1,69424610,69424911,301,0.05098518984198872
27051,2314.231233,2314.238133,1,69426936,69427143,207,0.051852546319750725
27052,2314.2442,2314.263633,1,69427326,69427908,582,-0.05737970567890807
27053,2314.265633,2314.3084,1,69427968,69429252,1284,0.226166510019885
27054,2314.3145,2314.327133,1,69429435,69429813,378,-0.044504725819405594
27055,2314.3404,2314.3517,1,69430212,69430551,339,0.22425661644947786
27056,2314.3542,2314.4295,1,69430626,69432885,2259,0.4293403718115097
27057,2314.435267,2314.441967,1,69433058,69433259,201,0.04703799096635708
27058,2314.445333,2314.456633,1,69433359,69433698,339,0.28442358598000467
27059,2314.4605,2314.592633,1,69433815,69437778,3963,0.23021093219027902
27060,2314.599667,2314.644433,1,69437990,69439332,1342,0.09997936598856323
27061,2314.7247,2314.728967,1,69441741,69441869,128,-0.2245311764119346
27062,2314.7412,2314.749533,1,69442236,69442485,249,-0.2165744841983909
27063,2314.750567,2314.755767,1,69442517,69442673,156,-0.1570485040772116
27064,2314.756867,2314.797167,1,69442706,69443915,1209,0.0690623506310604
27065,2314.7987,2314.806267,1,69443961,69444188,227,-0.030609670385722987
27066,2314.878733,2314.885367,1,69446361,69446561,200,0.1844723986583716
27067,2314.8921,2314.8959,1,69446763,69446877,114,0.5232322313223465
27068,2314.912233,2314.951667,1,69447366,69448550,1184,0.05137537261243674
27069,2315.005,2315.011833,1,69450150,69450354,204,0.3189677639106444
27070,2315.044267,2315.0823,1,69451328,69452469,1141,0.03886005138211672
27071,2315.1205,2315.1265,1,69453615,69453795,180,0.3487815319708966
27072,2315.130533,2315.139233,1,69453915,69454176,261,0.1556417519101938
27073,2315.154967,2315.1694,1,69454649,69455082,433,0.42472478541699843
27074,2315.193633,2315.213933,1,69455808,69456417,609,0.3548111419133626
27075,2315.2378,2315.2425,1,69457134,69457275,141,
27076,2315.2667,2315.288433,1,69458001,69458652,651,0.149980604911723
27077,2315.295667,2315.304667,1,69458870,69459140,270,0.10327400748246378
27078,2315.307433,2315.3112,1,69459222,69459336,114,0.1728079813431951
27079,2315.389333,2315.397833,1,69461679,69461934,255,0.4489722571570653
27080,2315.406533,2315.412833,1,69462195,69462384,189,-0.12544374306566788
27081,2315.415933,2315.445267,1,69462477,69463358,881,-0.0058421111384459705
27082,2315.4486,2315.4709,1,69463458,69464127,669,0.24647326619981544
27083,2315.486233,2315.489533,1,69464586,69464685,99,0.002909672079224615
27084,2315.4915,2315.502933,1,69464745,69465087,342,0.17055741284047302
27085,2315.511733,2315.545967,1,69465351,69466379,1028,0.020357226080348033
27086,2315.573667,2315.577067,1,69467210,69467312,102,0.5017493966998295
27087,2315.618967,2315.6366,1,69468569,69469098,529,-0.05463198060487115
27088,2315.649833,2315.654533,1,69469494,69469635,141,
27089,2315.6561,2315.6626,1,69469683,69469878,195,-0.063299025859096
27090,2315.687533,2315.6916,1,69470625,69470748,123,-0.10198325697462338
27091,2315.696367,2315.710333,1,69470891,69471309,418,-0.06391431772412239
27092,2315.715967,2315.7201,1,69471479,69471603,124,
27093,2315.721833,2315.7368,1,69471654,69472104,450,-0.11735519938301221
27094,2315.738233,2315.742467,1,69472146,69472274,128,0.1261372850615627
27095,2315.751367,2315.786633,1,69472541,69473598,1057,0.2117142096899729
27096,2315.790233,2315.8789,1,69473706,69476367,2661,0.5181129151928964
27097,2315.8859,2315.911833,1,69476577,69477354,777,0.18174388749718395
27098,2315.916567,2315.947467,1,69477497,69478424,927,0.4066442162363137
27099,2315.949233,2315.995233,1,69478476,69479856,1380,0.118708884035524
27100,2315.996267,2316.042733,1,69479888,69481281,1393,0.046261351497380414
27101,2316.048933,2316.0555,1,69481467,69481665,198,-0.19391326313986346
27102,2316.0572,2316.0604,1,69481716,69481812,96,
27103,2316.0669,2316.108133,1,69482007,69483243,1236,0.031104756092171004
27104,2316.113867,2316.118067,1,69483416,69483542,126,-0.10574509595649907
27105,2316.140467,2316.173433,1,69484214,69485202,988,0.01945801330532597
27106,2316.1821,2316.1907,1,69485463,69485721,258,-0.00023839119653951992
27107,2316.193067,2316.209033,1,69485792,69486270,478,0.08539355499007055
27108,2316.2109,2316.220433,1,69486327,69486612,285,0.7115805125724389
27109,2316.2215,2316.233367,1,69486645,69487001,356,0.36172675928192916
27110,2316.241433,2316.248767,1,69487242,69487463,221,-0.033188817452957785
27111,2316.2518,2316.266,1,69487554,69487980,426,0.008889531456777414
27112,2316.275767,2316.2816,1,69488273,69488448,175,-0.008136000347438594
27113,2316.2841,2316.2914,1,69488523,69488742,219,0.0035444249256244235
27114,2316.298067,2316.309,1,69488942,69489270,328,0.2521479314060677
27115,2316.328933,2316.335533,1,69489867,69490065,198,0.2592732082045912
27116,2316.360667,2316.405667,1,69490820,69492170,1350,0.08490102429736787
27117,2316.4083,2316.423433,1,69492249,69492702,453,-0.0434464051787162
27118,2316.4461,2316.456533,1,69493383,69493695,312,0.3635482688645376
27119,2316.463067,2316.4843,1,69493892,69494529,637,0.02635200370178114
27120,2316.497367,2316.5119,1,69494921,69495357,436,0.32248810464499716
27121,2316.615833,2316.621667,1,69498474,69498650,176,0.42487552464948886
27122,2316.6629,2316.6999,1,69499887,69500997,1110,-0.03587800136575652
27123,2316.715,2316.741733,1,69501450,69502251,801,0.08547298742535529
27124,2316.745533,2316.753967,1,69502365,69502619,254,-0.27095189478698234
27125,2316.757333,2316.761133,1,69502719,69502833,114,-0.11227059066987945
27126,2316.7648,2316.817333,1,69502944,69504519,1575,0.3733939651831678
27127,2316.819767,2316.824667,1,69504593,69504740,147,-0.014176837879074122
27128,2316.832,2316.950867,1,69504960,69508526,3566,0.20336595946461478
27129,2316.959567,2316.990967,1,69508787,69509729,942,-0.03599695081191962
27130,2317.0392,2317.043967,1,69511176,69511319,143,0.06196754333964837
27131,2317.0527,2317.094767,1,69511581,69512843,1262,-0.09975680836922392
27132,2317.1053,2317.109133,1,69513159,69513273,114,
27133,2317.110467,2317.114267,1,69513314,69513428,114,
27134,2317.215733,2317.222033,1,69516471,69516660,189,0.22059972868611574
27135,2317.2463,2317.2493,1,69517389,69517479,90,
27136,2317.252333,2317.271967,1,69517569,69518159,590,-0.10717837629839118
27137,2317.273133,2317.2884,1,69518193,69518652,459,0.2011432005087527
27138,2317.296067,2317.301333,1,69518882,69519039,157,0.21388739351551136
27139,2317.356533,2317.3596,1,69520695,69520788,93,-0.10596194567676223
27140,2317.3676,2317.3707,1,69521028,69521121,93,
27141,2317.403667,2317.423733,1,69522110,69522711,601,0.03360136037813887
27142,2317.4294,2317.445367,1,69522882,69523361,479,0.1270078184333799
27143,2317.4798,2317.483967,1,69524394,69524519,125,-0.32863327762992905
27144,2317.4869,2317.4927,1,69524607,69524781,174,0.01480031639485666
27145,2317.496333,2317.5268,1,69524889,69525804,915,0.028465115243816928
27146,2317.531433,2317.546067,1,69525942,69526382,440,-0.0033635674397289954
27147,2317.5532,2317.558367,1,69526596,69526751,155,0.539984327110912
27148,2317.559467,2317.5757,1,69526784,69527271,487,0.17189959334857854
27149,2317.5876,2317.593667,1,69527628,69527810,182,0.6197760960179981
27150,2317.603367,2317.6069,1,69528101,69528207,106,
27151,2317.619267,2317.624733,1,69528578,69528741,163,
27152,2317.690733,2317.703133,1,69530721,69531093,372,0.32161173288351486
27153,2317.751067,2317.7763,1,69532532,69533289,757,0.012929946113630483
27154,2317.778867,2317.809,1,69533366,69534270,904,-0.02706854021862379
27155,2317.810667,2317.817933,1,69534320,69534537,217,-0.06572383178845911
27156,2317.819033,2317.828967,1,69534570,69534869,299,0.23394362042865052
27157,2317.832267,2317.8383,1,69534968,69535149,181,-0.11527917861469947
27158,2317.844,2317.854333,1,69535320,69535629,309,-0.03583010549689906
27159,2317.855867,2317.861833,1,69535676,69535854,178,0.024813834338284085
27160,2318.092467,2318.1971,1,69542774,69545913,3139,0.04717394329951906
27161,2318.199433,2318.2141,1,69545982,69546423,441,-0.0937305769743153
27162,2318.2151,2318.2183,1,69546453,69546549,96,
27163,2318.223233,2318.233633,1,69546696,69547008,312,0.1911209673522071
27164,2318.234733,2318.2381,1,69547041,69547143,102,0.34308416937350855
27165,2318.240667,2318.249667,1,69547220,69547490,270,0.19175714841332786
27166,2318.256067,2318.269133,1,69547682,69548073,391,0.10667689898335259
27167,2318.272867,2318.288733,1,69548186,69548661,475,-0.17138419825315993
27168,2318.344167,2318.353633,1,69550325,69550608,283,-0.00021052718423006213
27169,2318.3555,2318.366733,1,69550665,69551001,336,-0.016185976725296192
27170,2318.4056,2318.410733,1,69552168,69552321,153,0.1752230883271012
27171,2318.414867,2318.422633,1,69552446,69552678,232,0.1857347612802422
27172,2318.431133,2318.448,1,69552933,69553440,507,0.007320636222020361
27173,2318.4568,2318.46,1,69553704,69553800,96,-0.1918442719891566
27174,2318.512967,2318.5165,1,69555389,69555495,106,-0.20108544645169352
27175,2318.5201,2318.527633,1,69555603,69555828,225,-0.11048595399719563
27176,2318.528633,2318.533467,1,69555858,69556004,146,
27177,2318.5405,2318.559967,1,69556215,69556799,584,-0.04203427087908692
27178,2318.5611,2318.568067,1,69556833,69557042,209,0.46374001105912427
27179,2318.578833,2318.5868,1,69557364,69557604,240,0.235372602098812
27180,2318.589467,2318.6032,1,69557684,69558096,412,0.471921640152359
27181,2318.6093,2318.637867,1,69558279,69559136,857,0.07716979623049251
27182,2318.644167,2318.6551,1,69559325,69559653,328,0.044613127761867946
27183,2318.6598,2318.667067,1,69559794,69560012,218,0.14252810656171136
27184,2318.6687,2318.695267,1,69560061,69560858,797,0.07673567689559876
27185,2318.6982,2318.7284,1,69560946,69561852,906,0.5451434568700783
27186,2318.730567,2318.748833,1,69561917,69562464,547,0.06733351036420762
27187,2318.7504,2318.762367,1,69562512,69562871,359,-0.07218688401972498
27188,2318.7648,2318.7974,1,69562944,69563922,978,0.04495833809467623
27189,2318.800767,2318.948833,1,69564023,69568464,4441,0.1077686770347286
27190,2319.0365,2319.039567,1,69571095,69571187,92,0.007173584464188352
27191,2319.0676,2319.091733,1,69572028,69572751,723,-0.04354983098308037
27192,2319.205233,2319.209667,1,69576156,69576290,134,0.30477399815739786
27193,2319.227067,2319.2497,1,69576812,69577491,679,0.11732908173581237
27194,2319.263033,2319.321233,1,69577890,69579636,1746,0.09254558765178895
27195,2319.322567,2319.340833,1,69579677,69580224,547,0.2916359011868713
27196,2319.397733,2319.4025,1,69581931,69582075,144,0.3629822169318435
27197,2319.4215,2319.464133,1,69582645,69583923,1278,0.0118152236419302
27198,2319.465233,2319.482,1,69583956,69584460,504,-0.0851048559637763
27199,2319.486567,2319.515667,1,69584597,69585470,873,0.12266621769534207
27200,2319.519433,2319.532733,1,69585582,69585981,399,0.11435471050328462
27201,2319.5348,2319.544767,1,69586044,69586343,299,-0.03109615648602974
27202,2319.552833,2319.561,1,69586584,69586830,246,0.08482297457087472
27203,2319.618933,2319.633967,1,69588567,69589019,452,0.10023990950572301
27204,2319.642667,2319.666333,1,69589280,69589989,709,0.01653058506748531
27205,2319.7544,2319.788333,1,69592632,69593649,1017,0.18445349947971842
27206,2319.791733,2319.8014,1,69593751,69594042,291,-0.08688899196919224
27207,2319.808467,2319.813233,1,69594254,69594396,142,0.01357676969519045
27208,2319.815233,2319.8183,1,69594456,69594549,93,0.34288653338532366
27209,2319.819367,2319.844433,1,69594581,69595332,751,0.12633001522889994
27210,2319.845833,2319.854733,1,69595374,69595641,267,-0.12413687836065536
27211,2319.866667,2319.906867,1,69596000,69597206,1206,0.16303825493351715
27212,2319.916033,2319.9506,1,69597480,69598518,1038,0.18840871519524463
27213,2319.9546,2319.967033,1,69598638,69599010,372,0.4261429747174407
27214,2319.969667,2319.992833,1,69599090,69599784,694,-0.026406117335306834
27215,2319.994233,2320.061367,1,69599826,69601841,2015,0.4048664559336856
27216,2320.067233,2320.072367,1,69602016,69602171,155,0.002962406931119238
27217,2320.075533,2320.118133,1,69602265,69603543,1278,0.26067405976338165
27218,2320.1197,2320.199,1,69603591,69605970,2379,0.09557993255777816
27219,2320.201567,2320.226033,1,69606047,69606780,733,0.25353811484894606
27220,2320.2375,2320.2425,1,69607125,69607275,150,0.3292420595513043
27221,2320.2992,2320.302867,1,69608976,69609086,110,-0.26169840597134275
27222,2320.305767,2320.318333,1,69609173,69609549,376,-0.11285241866255244
27223,2320.329333,2320.333867,1,69609879,69610016,137,0.30056889264497727
27224,2320.340467,2320.390867,1,69610214,69611726,1512,0.051758851151326
27225,2320.489767,2320.493067,1,69614693,69614792,99,0.48528859714621503
27226,2320.507867,2320.5442,1,69615236,69616326,1090,0.038618369558613266
27227,2320.569933,2320.573733,1,69617097,69617211,114,-0.033507030503099694
27228,2320.576433,2320.584033,1,69617292,69617520,228,0.31398210302963403
27229,2320.6012,2320.607933,1,69618036,69618237,201,0.556774258193501
27230,2320.619333,2320.638933,1,69618579,69619167,588,0.28547939560069224
27231,2320.640233,2320.6648,1,69619206,69619944,738,-0.11044193554351765
27232,2320.7007,2320.704033,1,69621021,69621120,99,
27233,2320.705867,2320.710433,1,69621176,69621312,136,-0.1663114257436798
27234,2320.714767,2320.724967,1,69621443,69621749,306,-0.1023166674264347
27235,2320.728,2320.743,1,69621840,69622290,450,0.11615449080119146
27236,2320.744233,2320.7564,1,69622326,69622692,366,0.3158173234911704
27237,2320.758867,2320.765833,1,69622766,69622974,208,0.1146314227936789
27238,2320.770067,2320.808167,1,69623102,69624245,1143,0.22005596560161084
27239,2320.8146,2320.8227,1,69624438,69624681,243,
27240,2320.826067,2320.878867,1,69624782,69626366,1584,0.2816061700948968
27241,2320.8827,2321.007667,1,69626481,69630230,3749,0.2984126008485155
27242,2321.015167,2321.024633,1,69630455,69630738,283,-0.04674694931970198
27243,2321.027033,2321.070067,1,69630810,69632102,1292,0.06763548341502908
27244,2321.0728,2321.076733,1,69632184,69632301,117,
27245,2321.080767,2321.1087,1,69632423,69633261,838,0.14903781523164805
27246,2321.146733,2321.1521,1,69634401,69634563,162,-0.17534381124679937
27247,2321.167,2321.170367,1,69635010,69635111,101,
27248,2321.171633,2321.187133,1,69635148,69635613,465,-0.07968265467536086
27249,2321.192167,2321.2097,1,69635765,69636291,526,0.0051839434829010975
27250,2321.215133,2321.259833,1,69636453,69637794,1341,0.23622475210487828
27251,2321.479767,2321.525367,1,69644393,69645761,1368,-0.010086256378828613
27252,2321.527833,2321.569333,1,69645834,69647079,1245,0.07471941286930443
27253,2321.573433,2321.5876,1,69647202,69647628,426,0.12694565261898108
27254,2321.590133,2321.600967,1,69647703,69648029,326,-0.13088261463477935
27255,2321.647967,2321.661233,1,69649439,69649836,397,-0.001780066845965078
27256,2321.6646,2321.669433,1,69649938,69650082,144,-0.08638045576013448
27257,2321.6716,2321.683067,1,69650148,69650492,344,0.5893429129517596
27258,2321.6883,2321.700467,1,69650649,69651014,365,-0.09303806675369303
27259,2321.760467,2321.781967,1,69652814,69653459,645,0.05029865250088714
27260,2321.7866,2321.8036,1,69653598,69654108,510,0.005006924718312043
27261,2321.804933,2321.8473,1,69654147,69655419,1272,0.016647025404553144
27262,2321.848967,2321.8697,1,69655469,69656091,622,0.15448396420340374
27263,2321.870733,2321.968,1,69656121,69659040,2919,0.5069130507245064
27264,2321.969067,2321.983933,1,69659072,69659517,445,0.152218714592686
27265,2321.986867,2322.0002,1,69659606,69660006,400,0.06082132411315961
27266,2322.001533,2322.0159,1,69660045,69660477,432,0.19920479951002848
27267,2322.0265,2322.0572,1,69660795,69661716,921,0.23190477417025454
27268,2322.061967,2322.086733,1,69661859,69662601,742,0.08790816637224441
27269,2322.0881,2322.2032,1,69662643,69666096,3453,0.527173420444843
27270,2322.205733,2322.215633,1,69666171,69666468,297,0.23796733467732656
27271,2322.223567,2322.257733,1,69666707,69667731,1024,0.1218642032968489
27272,2322.2802,2322.322533,1,69668406,69669675,1269,0.010478029647197467
27273,2322.332533,2322.3358,1,69669975,69670074,99,
27274,2322.3542,2322.357567,1,69670626,69670727,101,0.2974918227594019
27275,2322.395633,2322.400033,1,69671868,69672000,132,0.11320097054014547
27276,2322.5452,2322.554467,1,69676356,69676634,278,0.4161073317747054
27277,2322.555767,2322.567567,1,69676673,69677027,354,0.17459963545157928
27278,2322.5724,2322.590767,1,69677172,69677723,551,0.22935830944859198
27279,2322.594533,2322.600967,1,69677835,69678029,194,-0.12192557666484963
27280,2322.602433,2322.609333,1,69678072,69678279,207,0.17510377513824246
27281,2322.610733,2322.628567,1,69678321,69678857,536,0.1922201949454065
27282,2322.631433,2322.6438,1,69678942,69679314,372,0.30078625913923646
27283,2322.654667,2322.668133,1,69679640,69680043,403,0.17664788241463728
27284,2322.772167,2322.796867,1,69683165,69683906,741,0.39527233290943886
27285,2322.797933,2322.801733,1,69683937,69684051,114,0.6859510037337537
27286,2322.811967,2322.8195,1,69684359,69684585,226,0.4780002939126977
27287,2322.876567,2322.8817,1,69686297,69686451,154,-0.11195799647548854
27288,2322.8844,2322.923733,1,69686532,69687711,1179,-0.022714192249340244
27289,2322.934967,2322.945633,1,69688049,69688368,319,-0.0025402331572587393
27290,2322.951333,2322.970967,1,69688539,69689129,590,0.12422096604020517
27291,2322.971967,2322.9764,1,69689159,69689292,133,0.85713641598696
27292,2322.978867,2322.982167,1,69689366,69689465,99,
27293,2322.983933,2322.994833,1,69689517,69689844,327,-0.07776706365923672
27294,2323.0534,2323.0572,1,69691602,69691716,114,0.4754024892520334
27295,2323.079267,2323.083733,1,69692378,69692511,133,-0.01973980638844363
27296,2323.090867,2323.145433,1,69692726,69694362,1636,-0.08591437201211839
27297,2323.146667,2323.163733,1,69694400,69694911,511,-0.07087739168512003
27298,2323.2001,2323.207833,1,69696003,69696234,231,-0.0595777660916081
27299,2323.233933,2323.2389,1,69697017,69697167,150,0.5152935919086868
27300,2323.241633,2323.248033,1,69697248,69697440,192,
27301,2323.324933,2323.3363,1,69699747,69700089,342,0.24138284330306975
27302,2323.379233,2323.4068,1,69701376,69702204,828,-0.014251474162645012
27303,2323.4155,2323.421967,1,69702465,69702659,194,-0.07917383411552284
27304,2323.423367,2323.427533,1,69702701,69702825,124,
27305,2323.4319,2323.464267,1,69702957,69703928,971,0.012963399509968151
27306,2323.472,2323.494333,1,69704160,69704829,669,-0.06213311477757706
27307,2323.505433,2323.540567,1,69705162,69706217,1055,0.14300716395372193
27308,2323.552533,2323.555867,1,69706575,69706676,101,
27309,2323.557467,2323.563533,1,69706724,69706905,181,0.24551265739633185
27310,2323.565,2323.574767,1,69706950,69707243,293,-0.03344142966324664
27311,2323.5808,2323.600333,1,69707424,69708009,585,-0.012060201010264305
27312,2323.603867,2323.614767,1,69708116,69708443,327,0.32664953696789684
27313,2323.6175,2323.6285,1,69708525,69708855,330,0.33092011173545843
27314,2323.630067,2323.647967,1,69708902,69709439,537,0.17286667971323305
27315,2323.6519,2323.6586,1,69709557,69709758,201,-0.039105847389012384
27316,2323.679033,2323.6841,1,69710370,69710523,153,-0.05493510158133066
27317,2323.7185,2323.730467,1,69711555,69711914,359,-0.09440488075527392
27318,2323.741867,2323.751733,1,69712256,69712551,295,-0.0911359396241735
27319,2323.757833,2323.7636,1,69712734,69712908,174,0.03481340188279217
27320,2323.766233,2323.7727,1,69712986,69713181,195,-0.11164553622237794
27321,2323.777867,2323.8081,1,69713336,69714243,907,0.2445393903650311
27322,2323.809267,2323.8195,1,69714278,69714585,307,0.22157741464160682
27323,2323.8247,2323.835833,1,69714741,69715074,333,0.2824631512601188
27324,2323.837633,2323.841333,1,69715128,69715239,111,0.3928070028607127
27325,2323.843,2323.849133,1,69715290,69715473,183,
27326,2323.851933,2323.889,1,69715557,69716670,1113,0.4859034494960193
27327,2323.893333,2323.921833,1,69716799,69717654,855,0.16533154272794795
27328,2323.9232,2324.024033,1,69717696,69720720,3024,0.1629478088792711
27329,2324.0253,2324.031167,1,69720759,69720935,176,
27330,2324.042067,2324.0666,1,69721262,69721998,736,-0.08587333399085563
27331,2324.071633,2324.0757,1,69722148,69722271,123,0.41205325635486145
27332,2324.079133,2324.115833,1,69722373,69723474,1101,0.08217658797301665
27333,2324.146933,2324.150133,1,69724407,69724503,96,-0.4290385311673968
27334,2324.158667,2324.1633,1,69724760,69724899,139,
27335,2324.1777,2324.1809,1,69725331,69725427,96,
27336,2324.1849,2324.207333,1,69725547,69726219,672,-0.033096906285028045
27337,2324.208367,2324.2149,1,69726251,69726447,196,0.09426545968773475
27338,2324.227933,2324.238533,1,69726837,69727155,318,
27339,2324.241167,2324.246233,1,69727235,69727386,151,-0.013419342250181106
27340,2324.2626,2324.2658,1,69727878,69727974,96,-0.0443814687185584
27341,2324.3002,2324.3041,1,69729006,69729123,117,-0.31549202769639617
27342,2324.315833,2324.3466,1,69729474,69730398,924,0.17755188726017235
27343,2324.3584,2324.3638,1,69730752,69730914,162,
27344,2324.512633,2324.5737,1,69735378,69737211,1833,0.01989032601099362
27345,2324.5765,2324.595667,1,69737295,69737870,575,0.17737202877868974
27346,2324.6038,2324.608267,1,69738114,69738248,134,0.0700725973370916
27347,2324.615933,2324.636467,1,69738477,69739094,617,0.0730230366682489
27348,2324.6415,2324.691133,1,69739245,69740733,1488,0.5363469618190057
27349,2324.693867,2324.860933,1,69740816,69745827,5011,0.30751707392006794
27350,2324.869033,2324.873267,1,69746070,69746198,128,-0.04187268551116779
27351,2324.874333,2324.9161,1,69746229,69747483,1254,0.08552427741919105
27352,2324.984067,2324.989333,1,69749522,69749679,157,-0.003499901370446755
27353,2325.03,2325.033833,1,69750900,69751014,114,-0.04407317852620745
27354,2325.035733,2325.057833,1,69751071,69751734,663,0.04215539065842912
27355,2325.073267,2325.085467,1,69752198,69752564,366,-0.0863444478344658
27356,2325.190567,2325.202833,1,69755717,69756084,367,0.1700735080679127
27357,2325.2097,2325.214633,1,69756291,69756438,147,-0.09780369406618072
27358,2325.312067,2325.323667,1,69759362,69759710,348,-0.10654768396934043
27359,2325.3996,2325.442967,1,69761988,69763289,1301,-0.011508315640512733
27360,2325.455133,2325.4612,1,69763653,69763836,183,-0.09471938999019051
27361,2325.469733,2325.4738,1,69764091,69764214,123,0.15063588381459259
27362,2325.490633,2325.498633,1,69764718,69764958,240,0.18428823582562032
27363,2325.503333,2325.5182,1,69765099,69765546,447,0.1499874358830018
27364,2325.524,2325.543233,1,69765720,69766296,576,0.26336091119568406
27365,2325.564167,2325.574433,1,69766925,69767232,307,0.041419683260669214
27366,2325.774833,2325.782167,1,69773244,69773465,221,
27367,2325.832467,2325.841233,1,69774974,69775236,262,-0.1146265370028519
27368,2325.8539,2325.882633,1,69775617,69776478,861,-0.029307178704240423
27369,2325.9239,2325.9273,1,69777717,69777819,102,
27370,2325.9285,2325.946967,1,69777855,69778409,554,-0.07678994592850989
27371,2325.975567,2325.9797,1,69779267,69779391,124,0.18674162594459173
27372,2325.986567,2326.007767,1,69779597,69780233,636,-0.03180886368749995
27373,2326.010633,2326.019767,1,69780318,69780593,275,0.1826510619455948
27374,2326.022167,2326.026067,1,69780665,69780782,117,
27375,2326.029733,2326.039767,1,69780891,69781193,302,0.2120873403066796
27376,2326.047033,2326.0905,1,69781410,69782715,1305,-0.009940716571482742
27377,2326.0922,2326.1102,1,69782766,69783306,540,0.0035080658851317837
27378,2326.112333,2326.1319,1,69783369,69783957,588,0.21854021153273456
27379,2326.135667,2326.1418,1,69784070,69784254,184,0.12223909614224088
27380,2326.143167,2326.1483,1,69784295,69784449,154,0.446467793017772
27381,2326.157967,2326.173133,1,69784739,69785193,454,0.12061893627001366
27382,2326.1814,2326.188333,1,69785442,69785649,207,0.027107498257759023
27383,2326.208,2326.251933,1,69786240,69787557,1317,0.09773917477717634
27384,2326.255567,2326.2861,1,69787667,69788583,916,0.09777124729827595
27385,2326.2997,2326.355967,1,69788991,69790679,1688,0.18537508977387604
27386,2326.3629,2326.383533,1,69790887,69791505,618,-0.021286589201147788
27387,2326.3896,2326.447133,1,69791688,69793413,1725,0.42601747816394836
27388,2326.4483,2326.4551,1,69793449,69793653,204,
27389,2326.458633,2326.483,1,69793758,69794490,732,0.08773079266754001
27390,2326.488267,2326.492833,1,69794648,69794784,136,-0.20344262835890878
27391,2326.495167,2326.5482,1,69794855,69796446,1591,0.06215822968344269
27392,2326.549367,2326.618733,1,69796481,69798561,2080,0.07028532992165953
27393,2326.6369,2326.6824,1,69799107,69800472,1365,0.1760042346983591
27394,2326.734267,2326.737567,1,69802028,69802127,99,
27395,2326.783467,2326.794167,1,69803504,69803825,321,0.10964972416814607
27396,2326.8387,2326.8786,1,69805161,69806358,1197,-0.009220617517143726
27397,2326.968267,2326.975067,1,69809048,69809252,204,-0.20304494878030638
27398,2327.0017,2327.0395,1,69810051,69811185,1134,0.03474269073230422
27399,2327.083033,2327.086133,1,69812490,69812583,93,-0.02904678277769766
27400,2327.096633,2327.0997,1,69812898,69812991,93,0.17794976289187042
27401,2327.2275,2327.232967,1,69816825,69816989,164,0.4910331003367262
27402,2327.2548,2327.259433,1,69817644,69817782,138,-0.30522848645836076
27403,2327.317067,2327.3204,1,69819512,69819612,100,0.39995596181096343
27404,2327.355267,2327.358667,1,69820658,69820760,102,0.4225640573439458
27405,2327.404033,2327.420933,1,69822120,69822627,507,-0.0665492546995624
27406,2327.422567,2327.428167,1,69822677,69822845,168,-0.08651776572098026
27407,2327.558433,2327.5635,1,69826752,69826905,153,-0.12277546810846647
27408,2327.5988,2327.617867,1,69827964,69828536,572,-0.017633795119638206
27409,2327.620133,2327.632,1,69828603,69828960,357,-0.03137082316658061
27410,2327.643033,2327.686367,1,69829290,69830591,1301,0.13930310240306393
27411,2327.688967,2327.7619,1,69830669,69832857,2188,0.2748774744022979
27412,2327.764233,2327.7874,1,69832926,69833622,696,0.06509571916037044
27413,2327.791833,2327.799033,1,69833754,69833970,216,
27414,2327.809,2327.820933,1,69834270,69834627,357,0.21169394864811078
27415,2327.8284,2327.900767,1,69834852,69837023,2171,0.2797138317722987
27416,2327.9022,2327.9291,1,69837066,69837873,807,0.02160839717816481
27417,2327.932733,2327.9604,1,69837981,69838812,831,0.3151220763215772
27418,2327.9811,2328.004833,1,69839433,69840144,711,0.0036699949864662166
27419,2328.006733,2328.0134,1,69840201,69840402,201,0.03171413643180725
27420,2328.0144,2328.017733,1,69840432,69840531,99,-0.054495163735252795
27421,2328.066833,2328.074133,1,69842004,69842223,219,0.3060609600240897
27422,2328.082133,2328.085167,1,69842463,69842555,92,
27423,2328.106833,2328.165667,1,69843204,69844970,1766,0.09692740700787449
27424,2328.202767,2328.208033,1,69846083,69846240,157,0.5699876723471461
27425,2328.250767,2328.2541,1,69847523,69847623,100,0.419297324420199
27426,2328.2557,2328.258833,1,69847671,69847764,93,0.5761763230895309
27427,2328.269833,2328.2755,1,69848094,69848265,171,0.18917155510358116
27428,2328.303933,2328.307667,1,69849117,69849230,113,
27429,2328.309267,2328.422067,1,69849278,69852662,3384,0.07952606129427153
27430,2328.429967,2328.439067,1,69852899,69853172,273,0.42042299375597025
27431,2328.442167,2328.456267,1,69853265,69853688,423,0.22093133314077035
27432,2328.457967,2328.497733,1,69853739,69854931,1192,0.2966718153941179
27433,2328.499833,2328.6401,1,69854994,69859203,4209,0.37173644117634047
27434,2328.643,2328.6601,1,69859290,69859803,513,0.554525574895898
27435,2328.661633,2328.678467,1,69859848,69860354,506,-0.030212110625022714
27436,2328.680767,2328.683867,1,69860423,69860516,93,
27437,2328.6863,2328.690033,1,69860589,69860700,111,
27438,2328.695767,2328.741033,1,69860873,69862230,1357,0.007535879127040291
27439,2328.8372,2328.842267,1,69865116,69865268,152,0.16994979486226863
27440,2328.856933,2328.897233,1,69865707,69866916,1209,0.06850119946272118
27441,2328.921967,2328.926,1,69867659,69867780,121,
27442,2328.927967,2328.9333,1,69867839,69867999,160,0.3282277425423538
27443,2328.943833,2328.9469,1,69868314,69868407,93,0.6766641511187835
27444,2328.947967,2328.952367,1,69868439,69868571,132,0.5337968687328152
27445,2328.977333,2328.983467,1,69869319,69869504,185,0.3771833313712424
27446,2329.035567,2329.039567,1,69871067,69871187,120,-0.09229513881776157
27447,2329.0491,2329.060333,1,69871473,69871809,336,0.12989225391895504
27448,2329.061567,2329.064933,1,69871847,69871947,100,0.7769467727815718
27449,2329.114833,2329.141,1,69873444,69874230,786,-0.010160492393289953
27450,2329.1442,2329.158033,1,69874326,69874740,414,-0.08758094014295668
27451,2329.166367,2329.201367,1,69874991,69876041,1050,0.14837782511391842
27452,2329.2067,2329.210967,1,69876201,69876329,128,0.36078448153725384
27453,2329.216067,2329.223833,1,69876482,69876714,232,0.21797514623442713
27454,2329.2315,2329.2437,1,69876945,69877311,366,0.08962074027586521
27455,2329.2511,2329.269267,1,69877533,69878078,545,0.007544288893652889
27456,2329.2715,2329.308033,1,69878145,69879240,1095,0.022016752466511642
27457,2329.3094,2329.3142,1,69879282,69879426,144,0.1441086583398277
27458,2329.3153,2329.328133,1,69879459,69879843,384,0.07137662363344195
27459,2329.329267,2329.367567,1,69879878,69881027,1149,0.2025831998891901
27460,2329.369633,2329.372867,1,69881088,69881186,98,
27461,2329.3743,2329.401267,1,69881229,69882038,809,0.047208408496275056
27462,2329.404467,2329.4129,1,69882134,69882387,253,-0.004128241432819347
27463,2329.4174,2329.420733,1,69882522,69882621,99,
27464,2329.433367,2329.445267,1,69883001,69883358,357,0.07856875572403459
27465,2329.448133,2329.460433,1,69883443,69883812,369,-0.056200027356230066
27466,2329.470367,2329.474267,1,69884111,69884228,117,0.7453601562875459
27467,2329.496233,2329.5005,1,69884886,69885015,129,-0.06446933258944836
27468,2329.542733,2329.547667,1,69886281,69886430,149,
27469,2329.549267,2329.552533,1,69886478,69886575,97,
27470,2329.5882,2329.592033,1,69887646,69887760,114,0.782058864679557
27471,2329.611433,2329.629233,1,69888342,69888876,534,0.11470114416653232
27472,2329.6352,2329.640967,1,69889056,69889229,173,
27473,2329.657933,2329.694767,1,69889737,69890843,1106,0.05080876991038262
27474,2329.6961,2329.727333,1,69890883,69891819,936,-0.07144802459206313
27475,2329.745233,2329.749533,1,69892356,69892485,129,0.12540052070486712
27476,2329.750733,2329.7607,1,69892521,69892821,300,0.1462740067330028
27477,2329.7766,2329.811567,1,69893298,69894347,1049,0.03533316962190557
27478,2329.818733,2329.8978,1,69894561,69896934,2373,0.02299294417736603
27479,2329.9009,2329.932,1,69897027,69897960,933,-0.0028217824908210593
27480,2329.9391,2329.952267,1,69898173,69898568,395,-0.01298224865293075
27481,2329.9671,2329.996367,1,69899013,69899891,878,-0.036913603572989284
27482,2329.9992,2330.0037,1,69899976,69900111,135,-0.04902981043878739
27483,2330.009433,2330.016833,1,69900282,69900504,222,-0.12944646066754883
27484,2330.0317,2330.044033,1,69900951,69901320,369,-0.15242489856249822
27485,2330.0523,2330.0571,1,69901569,69901713,144,-0.11774109314382876
27486,2330.0791,2330.083,1,69902373,69902490,117,0.421928936838154
27487,2330.090433,2330.105467,1,69902712,69903164,452,-0.020810538343654317
27488,2330.112833,2330.1673,1,69903384,69905019,1635,0.05492009580305431
27489,2330.237233,2330.243967,1,69907116,69907319,203,0.3232080257903024
27490,2330.273833,2330.296,1,69908214,69908880,666,0.05217059014823859
27491,2330.316867,2330.323067,1,69909506,69909692,186,-0.09695681587729864
27492,2330.3751,2330.379167,1,69911253,69911375,122,-0.13486121673104007
27493,2330.412567,2330.423933,1,69912377,69912717,340,-0.09658360204075273
27494,2330.428267,2330.4429,1,69912848,69913287,439,-0.0007512178255391174
27495,2330.4465,2330.4544,1,69913395,69913632,237,0.09900693992271986
27496,2330.5305,2330.539233,1,69915915,69916176,261,0.2715335287928762
27497,2330.5497,2330.563967,1,69916491,69916919,428,0.05790931446700724
27498,2330.569867,2330.581433,1,69917096,69917442,346,0.15395011876234482
27499,2330.6516,2330.655967,1,69919548,69919679,131,0.021402790724760076
27500,2330.688133,2330.7499,1,69920643,69922497,1854,0.09592021316647639
27501,2330.973867,2331.027333,1,69929216,69930819,1603,0.017770036032506247
27502,2331.032133,2331.039067,1,69930963,69931172,209,-0.06156096458199493
27503,2331.052,2331.064967,1,69931560,69931949,389,0.20447969493042137
27504,2331.067167,2331.076733,1,69932015,69932301,286,0.07224584332356895
27505,2331.089733,2331.129533,1,69932691,69933885,1194,0.2075406280717374
27506,2331.130767,2331.141467,1,69933923,69934244,321,0.5253456036932553
27507,2331.149267,2331.2318,1,69934478,69936954,2476,0.4747827680802712
27508,2331.2407,2331.246167,1,69937221,69937385,164,0.09372616032423989
27509,2331.248933,2331.2673,1,69937467,69938019,552,0.1362873580608543
27510,2331.2703,2331.3681,1,69938109,69941043,2934,0.2029077679635872
27511,2331.3694,2331.384433,1,69941082,69941532,450,-0.02920676810272786
27512,2331.385767,2331.393533,1,69941573,69941805,232,0.10050145774185931
27513,2331.396067,2331.4176,1,69941882,69942528,646,0.10952320228693264
27514,2331.418933,2331.426967,1,69942567,69942809,242,0.1382633080180993
27515,2331.482667,2331.489367,1,69944480,69944681,201,-0.07511326379956788
27516,2331.493133,2331.501833,1,69944793,69945054,261,0.00017922932748557695
27517,2331.502967,2331.521667,1,69945089,69945650,561,-0.07761568660774701
27518,2331.532767,2331.591467,1,69945983,69947744,1761,0.06315492175022035
27519,2331.657267,2331.6629,1,69949718,69949887,169,0.10640385615609281
27520,2331.6963,2331.7248,1,69950889,69951744,855,0.061735002261378714
27521,2331.7703,2331.777633,1,69953109,69953328,219,0.5748935605244835
27522,2331.8164,2331.875633,1,69954492,69956268,1776,0.0437790701901195
27523,2331.876867,2331.8895,1,69956306,69956685,379,-0.011740366614036997
27524,2331.911167,2331.9142,1,69957335,69957426,91,
27525,2331.919767,2331.948667,1,69957593,69958460,867,0.15881981579067586
27526,2331.953467,2331.959233,1,69958604,69958776,172,0.2973814097964314
27527,2331.960533,2331.998833,1,69958815,69959964,1149,0.12062067056948438
27528,2332.0058,2332.009333,1,69960174,69960279,105,
27529,2332.0193,2332.0277,1,69960579,69960831,252,-0.06228187828564842
27530,2332.029167,2332.107467,1,69960875,69963224,2349,0.3787204358113716
27531,2332.1276,2332.209333,1,69963828,69966279,2451,0.13879575658346516
27532,2332.210967,2332.221967,1,69966329,69966659,330,
27533,2332.223433,2332.2366,1,69966702,69967098,396,-0.03965544703519955
27534,2332.246633,2332.264267,1,69967398,69967928,530,-0.006613450223216154
27535,2332.265433,2332.271367,1,69967962,69968141,179,0.07116647958081726
27536,2332.281933,2332.306733,1,69968457,69969201,744,0.03930019275893066
27537,2332.314533,2332.327067,1,69969435,69969812,377,-0.07255189725780199
27538,2332.396567,2332.4026,1,69971897,69972078,181,0.9999999999999999
27539,2332.427267,2332.4798,1,69972818,69974394,1576,-0.0012945743795084702
27540,2332.556933,2332.571167,1,69976707,69977135,428,0.5064674350696847
27541,2332.575967,2332.580033,1,69977279,69977400,121,-0.14168853334678408
27542,2332.5824,2332.592467,1,69977472,69977774,302,0.5637718472192184
27543,2332.688267,2332.691933,1,69980648,69980757,109,0.4380448295804216
27544,2332.724367,2332.736733,1,69981731,69982101,370,-0.0439785114686917
27545,2332.7412,2332.768533,1,69982236,69983055,819,-0.04768773963293952
27546,2332.769933,2332.777833,1,69983097,69983334,237,0.21995002250969947
27547,2332.780267,2332.814533,1,69983408,69984435,1027,0.18231121061287534
27548,2332.819333,2332.8263,1,69984579,69984789,210,-0.13087164649446828
27549,2332.829633,2332.834333,1,69984888,69985029,141,0.51123523041321
27550,2332.838133,2333.024633,1,69985143,69990738,5595,0.38803820329555977
27551,2333.0257,2333.061333,1,69990771,69991839,1068,0.006097396326245448
27552,2333.067767,2333.071467,1,69992033,69992144,111,0.15427398514312596
27553,2333.074033,2333.104667,1,69992220,69993140,920,-0.012719875616187664
27554,2333.11,2333.1165,1,69993300,69993495,195,-0.16091174878437647
27555,2333.132967,2333.138,1,69993989,69994140,151,
27556,2333.16,2333.1754,1,69994800,69995262,462,0.0026884567196206726
27557,2333.202633,2333.2405,1,69996078,69997215,1137,0.02854510623892421
27558,2333.2789,2333.2832,1,69998367,69998496,129,0.4157765947834382
27559,2333.284333,2333.2888,1,69998529,69998664,135,0.1770314535559363
27560,2333.348267,2333.448233,1,70000448,70003446,2998,0.07355094334483478
27561,2333.452767,2333.475333,1,70003583,70004259,676,0.05328668522801716
27562,2333.491367,2333.529433,1,70004741,70005882,1141,0.12934290433602852
27563,2333.5362,2333.5486,1,70006086,70006458,372,0.022074025398618146
27564,2333.551567,2333.560867,1,70006547,70006826,279,0.17631737759993
27565,2333.566067,2333.571167,1,70006982,70007135,153,-0.15474554219003556
27566,2333.590533,2333.5961,1,70007715,70007883,168,0.3329606196892983
27567,2333.626233,2333.660867,1,70008786,70009826,1040,0.16903434886634147
27568,2333.6763,2333.687767,1,70010289,70010633,344,0.08277961660122858
27569,2333.6908,2333.707733,1,70010724,70011231,507,0.08035392644127684
27570,2333.718633,2333.750767,1,70011558,70012523,965,0.07422321482775253
27571,2333.751767,2333.9014,1,70012553,70017042,4489,0.4855939459340123
27572,2333.9025,2333.9578,1,70017075,70018734,1659,0.02621717232544071
27573,2334.0292,2334.034133,1,70020876,70021023,147,0.3563144204197804
27574,2334.101333,2334.105233,1,70023039,70023156,117,
27575,2334.124033,2334.166633,1,70023720,70024998,1278,0.023381253631608954
27576,2334.167767,2334.18,1,70025033,70025400,367,0.5168438775517956
27577,2334.194767,2334.206967,1,70025843,70026209,366,0.46402999605742246
27578,2334.3174,2334.321967,1,70029522,70029659,137,0.5518733697038194
27579,2334.370567,2334.391967,1,70031117,70031759,642,-0.04320377333882952
27580,2334.3933,2334.412233,1,70031799,70032366,567,-0.042835891562292144
27581,2334.415933,2334.4392,1,70032477,70033176,699,0.16116472644179353
27582,2334.449167,2334.462033,1,70033475,70033860,385,-0.02835670959008733
27583,2334.4691,2334.4845,1,70034073,70034535,462,0.2502247481940821
27584,2334.542033,2334.569267,1,70036260,70037078,818,-0.10671781137836837
27585,2334.576033,2334.5906,1,70037280,70037718,438,-0.07482507277598494
27586,2334.594533,2334.628333,1,70037835,70038849,1014,0.06179073239067143
27587,2334.630167,2334.7336,1,70038905,70042008,3103,0.5691896525946901
27588,2334.746333,2334.816,1,70042389,70044480,2091,0.12931666942599554
27589,2334.8177,2334.848667,1,70044531,70045460,929,-0.029471219279640425
27590,2334.861167,2334.879967,1,70045835,70046399,564,0.042269889557146195
27591,2334.880967,2334.916667,1,70046429,70047500,1071,0.08746752557153087
27592,2334.985333,2335.056667,1,70049559,70051700,2141,0.0016587922363177447
27593,2335.058233,2335.077267,1,70051746,70052318,572,-0.015960822068426736
27594,2335.1051,2335.1195,1,70053153,70053585,432,0.08205809727610258
27595,2335.133667,2335.138767,1,70054010,70054163,153,-0.026309360701260977
27596,2335.1406,2335.146367,1,70054218,70054391,173,-0.051522071994576125
27597,2335.157833,2335.2395,1,70054734,70057185,2451,0.01740200234940107
27598,2335.240833,2335.259667,1,70057224,70057790,566,0.11230957516926086
27599,2335.268367,2335.307733,1,70058051,70059231,1180,0.1766381393100607
27600,2335.310033,2335.323033,1,70059300,70059690,390,0.40867613266718156
27601,2335.327667,2335.3896,1,70059830,70061688,1858,0.10844607929187536
27602,2335.392733,2335.397167,1,70061781,70061915,134,
27603,2335.3993,2335.413733,1,70061979,70062411,432,0.20187232647500725
27604,2335.475733,2335.481567,1,70064271,70064447,176,0.06748084235727056
27605,2335.505533,2335.5114,1,70065165,70065342,177,0.42158356666636626
27606,2335.512567,2335.517767,1,70065377,70065533,156,0.4122507122898222
27607,2335.532133,2335.545067,1,70065963,70066352,389,0.010344036333422017
27608,2335.7087,2335.7641,1,70071261,70072923,1662,0.12823661880624054
27609,2335.771733,2335.784133,1,70073151,70073523,372,0.03573796243789872
27610,2335.809467,2335.813233,1,70074284,70074396,112,-0.021883781922219504
27611,2335.816,2335.8312,1,70074480,70074936,456,0.0033504721615865572
27612,2335.845467,2335.865033,1,70075364,70075950,586,-0.07011964106467593
27613,2335.8813,2335.891867,1,70076439,70076756,317,0.026145449136011002
27614,2335.894267,2335.898467,1,70076828,70076954,126,0.6943522947675784
27615,2335.899467,2335.907767,1,70076984,70077233,249,0.027607361382698422
27616,2335.911033,2335.941133,1,70077330,70078233,903,0.16732321585125942
27617,2335.9506,2335.966167,1,70078518,70078985,467,0.06845428052359576
27618,2335.9672,2335.998367,1,70079016,70079951,935,0.2925067118782805
27619,2336.0004,2336.008433,1,70080012,70080252,240,0.32790867274462626
27620,2336.018,2336.044467,1,70080540,70081334,794,0.2786892262222038
27621,2336.048467,2336.082967,1,70081454,70082489,1035,0.13004500016872356
27622,2336.0943,2336.105267,1,70082829,70083158,329,0.2510136203322114
27623,2336.1113,2336.1383,1,70083339,70084149,810,0.029961950805766455
27624,2336.143633,2336.153933,1,70084308,70084617,309,-0.08908501787630685
27625,2336.1558,2336.161567,1,70084674,70084847,173,
27626,2336.162767,2336.182567,1,70084883,70085477,594,0.05018444999948264
27627,2336.184567,2336.2085,1,70085537,70086255,718,0.08167654671435093
27628,2336.218367,2336.2281,1,70086551,70086843,292,0.24591449550547495
27629,2336.234467,2336.2521,1,70087034,70087563,529,0.0076817428826583285
27630,2336.253333,2336.273933,1,70087599,70088217,618,0.0219136017340615
27631,2336.276633,2336.354533,1,70088298,70090635,2337,0.08391311554670011
27632,2336.3574,2336.404333,1,70090722,70092129,1407,-0.03868604762510385
27633,2336.409033,2336.4245,1,70092270,70092735,465,0.16445558394369902
27634,2336.426067,2336.438967,1,70092782,70093169,387,-0.016769598977551144
27635,2336.445033,2336.479233,1,70093350,70094376,1026,0.150876003866199
27636,2336.565067,2336.568733,1,70096952,70097061,109,
27637,2336.5796,2336.583667,1,70097388,70097510,122,
27638,2336.693533,2336.704767,1,70100805,70101143,338,-0.03180621285293585
27639,2336.7121,2336.762067,1,70101363,70102862,1499,0.2585393192481717
27640,2336.7779,2336.813967,1,70103337,70104419,1082,0.06817811111462128
27641,2336.8169,2336.8238,1,70104507,70104714,207,-0.018446875947982562
27642,2336.824933,2336.8359,1,70104747,70105077,330,0.19497529681385947
27643,2337.066033,2337.071133,1,70111980,70112133,153,0.10085098092660913
27644,2337.072733,2337.077233,1,70112181,70112316,135,
27645,2337.662933,2337.668067,1,70129887,70130042,155,0.3896902648380614
27646,2338.4063,2338.418367,1,70152189,70152551,362,0.5327945556574476
27647,2339.798833,2339.809867,1,70193964,70194296,332,-0.08245149120949263
27648,2339.829833,2339.853033,1,70194894,70195590,696,0.2966272485786224
27649,2339.876567,2339.892333,1,70196297,70196769,472,0.03789804647558134
27650,2339.893433,2339.902867,1,70196802,70197086,284,-0.06622781079278924
27651,2340.056733,2340.066167,1,70201701,70201985,284,0.171002897240919
27652,2340.0697,2340.0751,1,70202091,70202253,162,-0.045300626201880516
27653,2340.291067,2340.364,1,70208732,70210920,2188,0.016791869373601963
27654,2340.491933,2340.4975,1,70214757,70214925,168,0.25573934261424935
27655,2340.7617,2340.778433,1,70222851,70223352,501,-0.015056711635007882
27656,2340.779767,2340.785667,1,70223393,70223570,177,
27657,2340.801867,2340.809,1,70224056,70224270,214,-0.075547654039285
27658,2340.815,2340.820933,1,70224450,70224627,177,-0.08572359400498224
27659,2340.8222,2340.831633,1,70224666,70224948,282,-0.07093310474074263
27660,2340.8357,2340.857233,1,70225071,70225716,645,0.05350170284742835
27661,2340.863033,2340.892233,1,70225890,70226766,876,0.09592248440115558
27662,2340.895,2340.8981,1,70226850,70226943,93,0.3399315424384656
27663,2340.8992,2340.904667,1,70226976,70227140,164,0.051523805492275906
27664,2340.905967,2340.913467,1,70227179,70227404,225,-0.11025403380661754
27665,2340.915533,2340.919567,1,70227465,70227587,122,-0.2543723691570941
27666,2340.922333,2340.929067,1,70227669,70227872,203,
27667,2340.9315,2340.953733,1,70227945,70228611,666,0.03887295104179778
27668,2340.957733,2341.0291,1,70228731,70230873,2142,0.37713761803268003
27669,2341.030567,2341.128433,1,70230917,70233852,2935,0.10372379700368567
27670,2341.134867,2341.143267,1,70234046,70234298,252,0.05132530307177374
27671,2341.145933,2341.155167,1,70234377,70234655,278,0.062080695341565684
27672,2341.1568,2341.174267,1,70234704,70235228,524,0.1158062652110014
27673,2341.1806,2341.194767,1,70235418,70235843,425,0.09003208210939286
27674,2341.202,2341.215667,1,70236060,70236470,410,0.004544623213714447
27675,2341.216967,2341.227567,1,70236509,70236827,318,-0.010226822988868981
27676,2341.228733,2341.2387,1,70236861,70237161,300,0.4852248291871293
27677,2341.2401,2341.265267,1,70237203,70237958,755,0.19899393425930328
27678,2341.2748,2341.314433,1,70238244,70239432,1188,0.1064621659059583
27679,2341.3204,2341.329833,1,70239612,70239894,282,-0.14921791094683948
27680,2341.331067,2341.337533,1,70239932,70240125,193,-0.07913893423890181
27681,2341.343867,2341.355,1,70240316,70240650,334,0.33808729163831963
27682,2341.357333,2341.360533,1,70240719,70240815,96,0.4636001226273233
27683,2341.371567,2341.377267,1,70241147,70241318,171,0.12874489968043787
27684,2341.3869,2341.432167,1,70241607,70242965,1358,0.010530218227074678
27685,2341.4346,2341.443933,1,70243038,70243317,279,0.37501608898135186
27686,2341.447667,2341.5465,1,70243430,70246395,2965,0.015182942980606113
27687,2341.5475,2341.6187,1,70246425,70248561,2136,0.1127604011062901
27688,2341.6264,2341.632133,1,70248792,70248963,171,-0.05857559866130561
27689,2341.6334,2341.6417,1,70249002,70249251,249,0.1860988295910589
27690,2341.651967,2341.886867,1,70249559,70256606,7047,0.338431063960107
27691,2341.893367,2341.9014,1,70256801,70257042,241,0.08326670462376179
27692,2341.909133,2341.918767,1,70257273,70257563,290,-0.02642784455182332
27693,2341.924733,2341.932567,1,70257741,70257977,236,-0.058761626551147104
27694,2342.012567,2342.0193,1,70260377,70260579,202,-0.0804752936130277
27695,2342.0323,2342.035967,1,70260969,70261079,110,
27696,2342.147633,2342.181733,1,70264428,70265451,1023,0.21416762164677217
27697,2342.183867,2342.215533,1,70265516,70266465,949,-0.024415977285983367
27698,2342.2283,2342.2391,1,70266849,70267173,324,-0.0589583841797454
27699,2342.243933,2342.258067,1,70267317,70267742,425,-0.06831352394421436
27700,2342.263533,2342.269533,1,70267905,70268085,180,0.3909038533595974
27701,2342.272733,2342.329167,1,70268181,70269875,1694,0.18655447655104704
27702,2342.3729,2342.4656,1,70271187,70273968,2781,0.1000173588691048
27703,2342.485667,2342.490433,1,70274570,70274712,142,-0.1455953224878943
27704,2342.492167,2342.5202,1,70274765,70275606,841,-0.007486026350133173
27705,2342.545867,2342.554467,1,70276376,70276634,258,-0.06733635826440994
27706,2342.583767,2342.612867,1,70277513,70278386,873,0.29850258762435056
27707,2342.6157,2342.6191,1,70278471,70278573,102,
27708,2342.6443,2342.649167,1,70279329,70279475,146,0.026675785452340225
27709,2342.680367,2342.706067,1,70280411,70281182,771,0.0937914171042251
27710,2342.750333,2342.7585,1,70282509,70282755,246,0.27714429961787546
27711,2342.764367,2342.7933,1,70282931,70283799,868,0.06571562975857895
27712,2342.8331,2342.841533,1,70284993,70285245,252,-0.19762246769699535
27713,2342.9933,2343.000967,1,70289799,70290029,230,-0.04903898217624781
27714,2343.0024,2343.0198,1,70290072,70290594,522,-0.08322636143828456
27715,2343.0309,2343.0376,1,70290927,70291128,201,-0.06094240837858199
27716,2343.038833,2343.043733,1,70291164,70291311,147,0.07988816811215858
27717,2343.046367,2343.056533,1,70291391,70291695,304,0.09757297102255781
27718,2343.058733,2343.0713,1,70291761,70292139,378,0.14037732096063274
27719,2343.074133,2343.1312,1,70292223,70293936,1713,0.2010180703225155
27720,2343.1358,2343.140667,1,70294074,70294220,146,0.057292238966814076
27721,2343.143033,2343.1992,1,70294290,70295976,1686,0.4913899556377707
27722,2343.200667,2343.208033,1,70296020,70296240,220,0.11464373027808165
27723,2343.2137,2343.2402,1,70296411,70297206,795,0.006219993626169426
27724,2343.2466,2343.257033,1,70297398,70297710,312,0.3249692964341494
27725,2343.2587,2343.291633,1,70297761,70298748,987,0.4612223964187988
27726,2343.294833,2343.3252,1,70298844,70299756,912,0.15711199182900154
27727,2343.329733,2343.332767,1,70299891,70299983,92,0.23931213072035742
27728,2343.3342,2343.341733,1,70300026,70300251,225,0.2704122972969823
27729,2343.347367,2343.4547,1,70300421,70303641,3220,0.5722145021250477
27730,2343.4559,2343.458967,1,70303677,70303769,92,
27731,2343.463333,2343.467867,1,70303899,70304036,137,-0.049543853513368104
27732,2343.475067,2343.495667,1,70304252,70304870,618,0.035369411294692246
27733,2343.4972,2343.5156,1,70304916,70305468,552,0.2786548647000972
27734,2343.5167,2343.576067,1,70305501,70307282,1781,0.31038936281856383
27735,2343.587333,2343.634833,1,70307619,70309044,1425,0.1738471245385714
27736,2343.643067,2343.6618,1,70309292,70309854,562,0.2536177834252257
27737,2343.671067,2343.699,1,70310132,70310970,838,0.11962135796106357
27738,2343.713967,2343.725,1,70311419,70311750,331,0.432249430439906
27739,2343.7291,2343.7322,1,70311873,70311966,93,
27740,2343.739833,2343.773833,1,70312194,70313214,1020,0.31842649438454207
27741,2343.8097,2343.818867,1,70314291,70314566,275,0.4198113869326251
27742,2343.8251,2343.828367,1,70314753,70314851,98,
27743,2343.836233,2343.840833,1,70315086,70315224,138,-0.013557662487847488
27744,2343.8437,2343.886367,1,70315311,70316591,1280,0.47768913847741007
27745,2343.891733,2343.941833,1,70316751,70318254,1503,0.05835041265293739
27746,2343.946467,2343.967167,1,70318394,70319015,621,0.19784684197235824
27747,2343.969667,2343.986,1,70319090,70319580,490,-0.06541640257539594
27748,2343.987767,2343.990933,1,70319633,70319727,94,-0.18566647949444554
27749,2343.993567,2344.043667,1,70319807,70321310,1503,0.08620037557725739
27750,2344.050433,2344.056433,1,70321512,70321692,180,-0.1402715745472728
27751,2344.1078,2344.111033,1,70323234,70323330,96,
27752,2344.128,2344.131333,1,70323840,70323939,99,0.12030443740692427
27753,2344.161033,2344.167133,1,70324830,70325013,183,-0.11795533934684833
27754,2344.171833,2344.176667,1,70325154,70325300,146,0.1825534154339452
27755,2344.188233,2344.1945,1,70325646,70325835,189,0.539669329892961
27756,2344.2776,2344.2807,1,70328328,70328421,93,0.2634060382551913
27757,2344.3255,2344.337367,1,70329765,70330121,356,0.3406773055402184
27758,2344.338433,2344.342067,1,70330152,70330262,110,
27759,2344.343067,2344.362667,1,70330292,70330880,588,0.2575427711414718
27760,2344.368967,2344.3767,1,70331069,70331301,232,-0.03488295907988978
27761,2344.378533,2344.386033,1,70331355,70331580,225,-0.06402449490180451
27762,2344.472433,2344.481267,1,70334172,70334438,266,0.15791946215750258
27763,2344.498533,2344.502367,1,70334955,70335071,116,-0.0035718054174979945
27764,2344.560967,2344.602967,1,70336829,70338089,1260,0.06931175738937684
27765,2344.604167,2344.608167,1,70338125,70338245,120,0.3560122383175186
27766,2344.6132,2344.616267,1,70338396,70338488,92,
27767,2344.621367,2344.644233,1,70338641,70339326,685,-0.03548259615709669
27768,2344.656367,2344.7089,1,70339691,70341267,1576,0.0012131000020516006
27769,2344.7104,2344.7145,1,70341312,70341435,123,-0.038983473582168734
27770,2344.715567,2344.718633,1,70341467,70341558,91,
27771,2344.7217,2344.7329,1,70341651,70341987,336,-0.048169868119736524
27772,2344.735433,2344.752567,1,70342062,70342577,515,0.1665661879479171
27773,2344.756567,2344.765267,1,70342697,70342958,261,0.06762910265892585
27774,2344.793333,2344.797667,1,70343799,70343930,131,0.6196790094992324
27775,2344.829567,2344.8547,1,70344887,70345641,754,0.10285876419880065
27776,2344.863133,2344.8888,1,70345893,70346664,771,-0.05813216043993884
27777,2344.9172,2344.9203,1,70347516,70347609,93,0.7394371190224441
27778,2344.923233,2344.955067,1,70347696,70348652,956,-0.025381297916318157
27779,2344.9681,2344.975033,1,70349043,70349250,207,-0.02690538795327899
27780,2344.984233,2344.997833,1,70349526,70349934,408,-0.08525446725299825
27781,2344.999167,2345.004533,1,70349975,70350135,160,0.08859360154369932
27782,2345.007667,2345.030967,1,70350230,70350929,699,0.1434106389553424
27783,2345.0324,2345.056067,1,70350972,70351682,710,-0.01579516361272081
27784,2345.058533,2345.0872,1,70351755,70352616,861,0.1415140046906984
27785,2345.0924,2345.098033,1,70352772,70352940,168,0.7498551314414355
27786,2345.1027,2345.126533,1,70353081,70353795,714,0.11327753265480023
27787,2345.132533,2345.135733,1,70353975,70354071,96,-0.06145750677489255
27788,2345.148833,2345.1558,1,70354464,70354674,210,-0.0002560048536634152
27789,2345.156833,2345.170433,1,70354704,70355112,408,0.019167138674759474
27790,2345.178433,2345.192,1,70355352,70355760,408,0.11800879584016583
27791,2345.195267,2345.207533,1,70355858,70356225,367,0.019208494161028048
27792,2345.2086,2345.2345,1,70356258,70357035,777,0.05957107192709183
27793,2345.238833,2345.263533,1,70357164,70357905,741,0.11363014194903201
27794,2345.2671,2345.273167,1,70358013,70358195,182,0.2636864916914943
27795,2345.282033,2345.309567,1,70358460,70359287,827,0.26801585423314855
27796,2345.315467,2345.4273,1,70359464,70362819,3355,0.11101386453185638
27797,2345.429,2345.458733,1,70362870,70363761,891,0.08614460989021061
27798,2345.489833,2345.5029,1,70364694,70365087,393,0.01833078023489938
27799,2345.5039,2345.524267,1,70365117,70365728,611,0.08350835377023125
27800,2345.526233,2345.529233,1,70365786,70365876,90,0.7551050875266428
27801,2345.530967,2345.535433,1,70365929,70366062,133,0.017371891347042152
27802,2345.549533,2345.5613,1,70366485,70366839,354,0.26712557288798566
27803,2345.563733,2345.5807,1,70366911,70367421,510,-0.011842142947569159
27804,2345.587167,2345.6144,1,70367615,70368432,817,0.12708644566111055
27805,2345.6154,2345.6198,1,70368462,70368594,132,-0.24957666972099174
27806,2345.683333,2345.686533,1,70370499,70370595,96,-0.2600496091306963
27807,2345.720467,2345.759833,1,70371614,70372794,1180,0.12169217130440466
27808,2345.761867,2345.767533,1,70372856,70373025,169,-0.06075877389970583
27809,2345.7732,2345.777233,1,70373196,70373316,120,
27810,2345.855633,2345.8597,1,70375668,70375791,123,-0.1475212298170616
27811,2345.8771,2345.919367,1,70376313,70377581,1268,0.1064789890686922
27812,2345.9341,2345.9375,1,70378023,70378125,102,0.1898933633417496
27813,2346.008233,2346.044667,1,70380246,70381340,1094,0.06095819601585867
27814,2346.103533,2346.111467,1,70383105,70383344,239,-0.2639873094211285
27815,2346.113333,2346.120067,1,70383399,70383602,203,0.46291726397886607
27816,2346.1323,2346.14,1,70383969,70384200,231,-0.01664814947521888
27817,2346.149067,2346.155333,1,70384472,70384659,187,-0.14900749034416444
27818,2346.158733,2346.1677,1,70384761,70385031,270,0.0034548163408872237
27819,2346.255833,2346.2722,1,70387674,70388166,492,0.2695770836072991
27820,2346.2732,2346.277967,1,70388196,70388339,143,0.22083122788102996
27821,2346.288867,2346.308133,1,70388666,70389243,577,0.4037888235806494
27822,2346.385333,2346.3925,1,70391559,70391775,216,-0.08413428072165621
27823,2346.4522,2346.4556,1,70393566,70393668,102,-0.20060346774471755
27824,2346.491167,2346.501467,1,70394735,70395044,309,0.007751155843056188
27825,2346.768567,2346.7776,1,70403057,70403328,271,0.29299485537710634
27826,2346.8404,2346.846533,1,70405212,70405395,183,0.48019368866599343
27827,2346.893367,2346.905067,1,70406801,70407152,351,-0.08965352200769788
27828,2346.907633,2346.934333,1,70407228,70408029,801,-0.09543073090974434
27829,2346.946367,2346.962233,1,70408391,70408866,475,0.005218414017230578
27830,2346.963267,2346.9874,1,70408898,70409622,724,0.1141585296399224
27831,2347.341767,2347.3456,1,70420253,70420368,115,0.29667146979832165
27832,2347.381167,2347.394567,1,70421435,70421837,402,0.10579851641070409
27833,2347.396467,2347.422567,1,70421894,70422677,783,-0.0932578695203102
27834,2347.428333,2347.4411,1,70422849,70423233,384,-0.0692235529283189
27835,2347.466567,2347.498433,1,70423997,70424952,955,0.056671265025980105
27836,2347.499867,2347.554333,1,70424996,70426629,1633,-0.049140103624562226
27837,2347.5558,2347.560233,1,70426674,70426806,132,-0.04034002013354529
27838,2347.566833,2347.576867,1,70427004,70427306,302,-0.11734318518530237
27839,2347.5791,2347.6165,1,70427373,70428495,1122,-0.0217791643801568
27840,2347.617533,2347.634733,1,70428525,70429041,516,-0.11673255220947422
27841,2347.655433,2347.6768,1,70429662,70430304,642,0.200969702891729
27842,2347.678533,2347.7017,1,70430355,70431051,696,-0.06528135168361905
27843,2347.861767,2347.865767,1,70435853,70435973,120,-0.0480112565112094
27844,2347.932067,2347.989267,1,70437962,70439678,1716,0.14975557311485896
27845,2347.993967,2348.0216,1,70439819,70440648,829,0.04945825657842318
27846,2348.033033,2348.071233,1,70440990,70442136,1146,0.1592058031836958
27847,2348.0755,2348.0836,1,70442265,70442508,243,0.0652370314393976
27848,2348.089433,2348.0955,1,70442682,70442865,183,
27849,2348.0997,2348.337933,1,70442991,70450137,7146,0.5024421554020941
27850,2348.364833,2348.368933,1,70450944,70451067,123,0.2856396067015924
27851,2348.370033,2348.411933,1,70451100,70452357,1257,0.14385826128303916
27852,2348.413367,2348.4368,1,70452401,70453104,703,0.3927765072611424
27853,2348.439,2348.4772,1,70453170,70454316,1146,0.023316983426337954
27854,2348.5671,2348.6242,1,70457013,70458726,1713,-0.006432859748313644
27855,2348.625233,2348.628667,1,70458756,70458860,104,-0.12201855679706627
27856,2348.646433,2348.6823,1,70459392,70460469,1077,0.07799393269968123
27857,2348.863567,2348.871567,1,70465907,70466147,240,0.6296374933331504
27858,2348.875733,2348.882233,1,70466271,70466466,195,-0.05883183116374179
27859,2348.9463,2348.950733,1,70468389,70468521,132,
27860,2348.9521,2349.056467,1,70468563,70471694,3131,0.2986383042892854
27861,2349.057867,2349.071567,1,70471736,70472147,411,-0.003994457876215417
27862,2349.166467,2349.1944,1,70474994,70475832,838,0.07333711974924759
27863,2349.201167,2349.221333,1,70476035,70476639,604,0.0006975625541166249
27864,2349.2225,2349.2281,1,70476675,70476843,168,0.3698571381767697
27865,2349.345767,2349.350033,1,70480373,70480500,127,-0.10995012919513308
27866,2349.364367,2349.440267,1,70480931,70483208,2277,0.05675358362388651
27867,2349.457533,2349.533833,1,70483725,70486014,2289,0.1827585628962631
27868,2349.5349,2349.5524,1,70486047,70486572,525,0.07197159163151
27869,2349.5579,2349.652367,1,70486737,70489571,2834,0.1343479376326511
27870,2349.659233,2349.704967,1,70489776,70491149,1373,-0.006064194361796401
27871,2349.750467,2349.755333,1,70492514,70492659,145,
27872,2349.7963,2349.815467,1,70493889,70494464,575,0.2517275869184928
27873,2349.816567,2349.844333,1,70494497,70495329,832,0.11356676092795592
27874,2349.8463,2349.863767,1,70495389,70495913,524,0.00040420036036065886
27875,2349.8649,2349.867933,1,70495947,70496037,90,0.2129846088822633
27876,2349.9417,2349.944967,1,70498251,70498349,98,0.0031417318694208314
27877,2349.978933,2349.983233,1,70499367,70499496,129,-0.11887855715023049
27878,2350.105167,2350.1373,1,70503155,70504119,964,0.06955440254867787
27879,2350.2386,2350.2678,1,70507158,70508034,876,0.06566955288794088
27880,2350.3004,2350.303833,1,70509012,70509114,102,0.8248268829658577
27881,2350.310267,2350.317467,1,70509308,70509524,216,0.27161582797908246
27882,2350.3301,2350.339467,1,70509903,70510184,281,0.33270342644925543
27883,2350.355367,2350.364133,1,70510661,70510923,262,-0.23008923425020317
27884,2350.381267,2350.392533,1,70511438,70511775,337,0.08455481378085374
27885,2350.4437,2350.4557,1,70513311,70513671,360,0.2851547243903724
27886,2350.544967,2350.5522,1,70516349,70516566,217,-0.04873117913061709
27887,2350.560067,2350.608367,1,70516802,70518251,1449,0.11875569644095275
27888,2350.612067,2350.626233,1,70518362,70518786,424,-0.06797503276214457
27889,2350.6284,2350.6419,1,70518852,70519257,405,0.00372600362678125
27890,2350.648133,2350.660967,1,70519443,70519829,386,0.09362276295264171
27891,2350.6629,2350.677033,1,70519887,70520310,423,0.08044310279703333
27892,2350.693467,2350.699,1,70520804,70520970,166,0.19154506719392422
27893,2350.701067,2350.7149,1,70521032,70521447,415,-0.15923602032745626
27894,2350.717433,2350.7528,1,70521522,70522584,1062,0.47273420071632516
27895,2350.7549,2350.787333,1,70522647,70523619,972,0.058764673346130974
27896,2350.7946,2350.797767,1,70523838,70523933,95,0.008201306587855678
27897,2350.815633,2350.8305,1,70524468,70524915,447,0.02453967048764515
27898,2350.833167,2350.839333,1,70524995,70525179,184,0.18760469916464248
27899,2351.110767,2351.1303,1,70533323,70533909,586,-0.09987169794858204
27900,2351.133933,2351.140667,1,70534017,70534220,203,-0.12569386061000085
27901,2351.142,2351.165433,1,70534260,70534962,702,-0.07450241612139619
27902,2351.167167,2351.176033,1,70535015,70535280,265,-0.043591593739654655
27903,2351.178633,2351.182033,1,70535358,70535460,102,
27904,2351.186567,2351.261133,1,70535597,70537833,2236,0.1804417170966263
27905,2351.265133,2351.284067,1,70537953,70538522,569,0.19240497223863767
27906,2351.285633,2351.4191,1,70538568,70542573,4005,0.4160518017844849
27907,2351.421433,2351.424667,1,70542642,70542740,98,
27908,2351.427667,2351.459233,1,70542830,70543776,946,-0.04161076858030997
27909,2351.482867,2351.488133,1,70544486,70544643,157,-0.06016291316324514
27910,2351.489233,2351.509833,1,70544676,70545294,618,0.18422559550713682
27911,2351.5149,2351.5285,1,70545447,70545855,408,0.19346024622332159
27912,2351.530833,2351.5696,1,70545924,70547088,1164,0.16762814386641073
27913,2351.578467,2351.585333,1,70547354,70547559,205,0.13258099429742784
27914,2351.587133,2351.622833,1,70547613,70548684,1071,0.09764591158362143
27915,2351.623933,2351.636933,1,70548717,70549107,390,-0.07342531937536437
27916,2351.6563,2351.673467,1,70549689,70550204,515,0.11082314057820104
27917,2351.674833,2351.683,1,70550244,70550490,246,0.06215923152116663
27918,2351.689967,2351.693233,1,70550699,70550796,97,0.14672303652874627
27919,2351.6983,2351.71,1,70550949,70551300,351,-0.0072682788950303445
27920,2351.816067,2351.852367,1,70554482,70555571,1089,0.10291500369049138
27921,2351.8548,2351.858267,1,70555644,70555748,104,0.1757535562064749
27922,2351.898367,2351.902267,1,70556951,70557068,117,0.5468242609269377
27923,2351.9582,2351.974067,1,70558746,70559222,476,0.05409344815986372
27924,2351.9894,2351.992867,1,70559682,70559786,104,-0.2097640943341664
27925,2352.029733,2352.0347,1,70560891,70561041,150,0.286737148263598
27926,2352.040433,2352.043533,1,70561212,70561305,93,0.15529480068438958
27927,2352.061633,2352.071267,1,70561848,70562138,290,0.42168969841265996
27928,2352.081033,2352.0843,1,70562430,70562529,99,0.07155476184820446
27929,2352.0859,2352.094767,1,70562577,70562843,266,-0.1072154897778898
27930,2352.0999,2352.111267,1,70562997,70563338,341,0.04787983374541186
27931,2352.158467,2352.1626,1,70564754,70564878,124,0.0008489198802952148
27932,2352.185067,2352.195533,1,70565552,70565865,313,0.15012421629636688
27933,2352.225367,2352.2287,1,70566761,70566861,100,0.28920616137419797
27934,2352.234067,2352.292233,1,70567022,70568766,1744,-0.05960853972760452
27935,2352.344233,2352.350733,1,70570326,70570521,195,
27936,2352.3958,2352.4035,1,70571874,70572105,231,0.5373416821268178
27937,2352.417233,2352.432167,1,70572516,70572965,449,-0.08511552682439263
27938,2352.606433,2352.621267,1,70578192,70578638,446,0.2782357052719857
27939,2352.6564,2352.6733,1,70579692,70580199,507,-0.06472041974773678
27940,2352.7205,2352.724333,1,70581615,70581729,114,-0.11717777892590758
27941,2352.8837,2352.889833,1,70586511,70586694,183,0.3121022650844088
27942,2352.915633,2352.986133,1,70587468,70589583,2115,0.03378313012635346
27943,2353.0112,2353.014267,1,70590336,70590428,92,
27944,2353.0202,2353.0244,1,70590606,70590732,126,-0.09191318617073745
27945,2353.025633,2353.0736,1,70590768,70592208,1440,-0.09213791608788564
27946,2353.0747,2353.098433,1,70592241,70592952,711,-0.10132529085907328
27947,2353.099433,2353.1066,1,70592982,70593198,216,-0.05293436686760154
27948,2353.1241,2353.154033,1,70593723,70594620,897,-0.08498438030567625
27949,2353.156667,2353.166233,1,70594700,70594986,286,0.12054746054788645
27950,2353.169933,2353.1814,1,70595097,70595442,345,0.1869849780017233
27951,2353.1824,2353.1861,1,70595472,70595583,111,0.45654799110486516
27952,2353.189267,2353.258733,1,70595678,70597761,2083,0.1286686784681947
27953,2353.259833,2353.348533,1,70597794,70600455,2661,0.46087370007071926
27954,2353.349767,2353.365467,1,70600493,70600964,471,0.10249438765601446
27955,2353.371267,2353.4511,1,70601138,70603533,2395,0.030316411839449622
27956,2353.452467,2353.4807,1,70603574,70604421,847,0.04661063213377473
27957,2353.4838,2353.5228,1,70604514,70605684,1170,-0.05366400962460648
27958,2353.583333,2353.590833,1,70607499,70607724,225,-0.023982444942857513
27959,2353.594133,2353.6044,1,70607823,70608132,309,-0.009116900528642977
27960,2353.6113,2353.6222,1,70608339,70608666,327,0.049962869985994376
27961,2353.6285,2353.701667,1,70608855,70611050,2195,0.06887409828683204
27962,2353.704033,2353.707633,1,70611120,70611228,108,0.5329678604941445
27963,2353.763033,2353.7687,1,70612890,70613061,171,-0.3259307056832137
27964,2353.7985,2353.8192,1,70613955,70614576,621,-0.003372416917411545
27965,2353.821133,2353.834033,1,70614633,70615020,387,0.10296667255972963
27966,2353.914167,2353.9178,1,70617425,70617534,109,0.18247115301462483
27967,2353.946533,2353.985933,1,70618395,70619577,1182,0.08141924661198868
27968,2353.987133,2353.992333,1,70619613,70619769,156,0.5456073846400666
27969,2354.006733,2354.011133,1,70620201,70620333,132,0.12480305527918858
27970,2354.045733,2354.053833,1,70621371,70621614,243,0.018263808528102752
27971,2354.0627,2354.0722,1,70621881,70622166,285,0.6294230079647197
27972,2354.2038,2354.216667,1,70626114,70626500,386,0.40091458374854005
27973,2354.221467,2354.226833,1,70626644,70626804,160,0.13429950169969065
27974,2354.2347,2354.2566,1,70627041,70627698,657,0.24846681077291724
27975,2354.351733,2354.445067,1,70630551,70633352,2801,0.13467474734099974
27976,2354.446233,2354.4501,1,70633386,70633503,117,0.5368749511934159
27977,2354.451567,2354.468667,1,70633547,70634060,513,0.3568577872775262
27978,2354.477767,2354.505433,1,70634333,70635162,829,0.1768738808369461
27979,2354.509967,2354.5681,1,70635299,70637043,1744,0.017727275069192774
27980,2354.579667,2354.588433,1,70637390,70637652,262,0.016208350849613667
27981,2354.597733,2354.6832,1,70637931,70640496,2565,0.3407291948641882
27982,2354.6852,2354.688267,1,70640556,70640648,92,
27983,2354.692567,2354.718767,1,70640777,70641563,786,0.04932316386159434
27984,2354.720033,2354.7974,1,70641600,70643922,2322,0.04636393704604587
27985,2354.798967,2354.8171,1,70643969,70644513,544,0.04444786250794435
27986,2354.821033,2354.827033,1,70644630,70644810,180,0.45400572100920356
27987,2354.831567,2354.854867,1,70644947,70645646,699,-0.09668888769414799
27988,2354.856033,2354.869767,1,70645680,70646093,413,-0.029490331866883053
27989,2354.8797,2354.8846,1,70646391,70646538,147,
27990,2354.953167,2354.9584,1,70648595,70648752,157,-0.15506110357145966
27991,2354.9914,2355.0297,1,70649742,70650891,1149,0.03763377054310085
27992,2355.0326,2355.040567,1,70650978,70651217,239,-0.04298189761384821
27993,2355.083733,2355.087267,1,70652511,70652618,107,0.47387517717574723
27994,2355.0938,2355.101433,1,70652814,70653042,228,-0.07580988414368961
27995,2355.102433,2355.1145,1,70653072,70653435,363,-0.11307398288977115
27996,2355.124867,2355.1281,1,70653746,70653843,97,-0.17192632688854548
27997,2355.1343,2355.140867,1,70654029,70654226,197,
27998,2355.1599,2355.167033,1,70654797,70655010,213,-0.0455778089218205
27999,2355.168367,2355.173133,1,70655051,70655193,142,0.06646753038907022
28000,2355.176333,2355.179467,1,70655289,70655384,95,-0.11328876002136933
28001,2355.203533,2355.207467,1,70656105,70656224,119,0.27885931323549284
28002,2355.288067,2355.302467,1,70658642,70659074,432,0.4387044087504596
28003,2355.306267,2355.3163,1,70659188,70659489,301,0.41624021968275027
28004,2355.326367,2355.344133,1,70659791,70660323,532,-0.024539778307403847
28005,2355.345533,2355.348667,1,70660365,70660460,95,
28006,2355.413933,2355.4193,1,70662417,70662579,162,-0.18353799802862392
28007,2355.446333,2355.4772,1,70663389,70664316,927,-0.016409895869669497
28008,2355.514333,2355.518433,1,70665429,70665552,123,-0.06668488416170479
28009,2355.522933,2355.526833,1,70665687,70665804,117,
28010,2355.533667,2355.5391,1,70666010,70666173,163,-0.20804916076701763
28011,2355.5403,2355.553867,1,70666209,70666616,407,0.05604695890747572
28012,2355.5723,2355.579733,1,70667169,70667391,222,0.25101840945094767
28013,2355.6065,2355.6103,1,70668195,70668309,114,
28014,2355.615967,2355.634667,1,70668479,70669040,561,0.25969533421624186
28015,2355.637,2355.654933,1,70669110,70669647,537,-0.09000789726494267
28016,2355.659067,2355.7013,1,70669772,70671039,1267,0.2277207624883498
28017,2355.703433,2355.713167,1,70671102,70671395,293,0.46801727818597977
28018,2355.7159,2355.7246,1,70671477,70671738,261,0.10357043069300843
28019,2355.726767,2355.746567,1,70671803,70672397,594,0.14471851658499402
28020,2355.7477,2355.7523,1,70672431,70672569,138,
28021,2355.7534,2355.7586,1,70672602,70672758,156,0.20655515461690618
28022,2355.841133,2355.845767,1,70675233,70675373,140,
28023,2355.881567,2355.8904,1,70676447,70676712,265,-0.018012127204064022
28024,2355.891767,2355.896233,1,70676753,70676886,133,0.14276644613856732
28025,2355.915733,2355.9353,1,70677471,70678059,588,-0.09149421988006894
28026,2355.9539,2355.9599,1,70678617,70678797,180,-0.08113942628741681
28027,2355.965467,2355.9733,1,70678964,70679199,235,-0.09360161633493809
28028,2355.993833,2356.0113,1,70679814,70680339,525,0.22451335537503528
28029,2356.038967,2356.0465,1,70681169,70681395,226,
28030,2356.067733,2356.075633,1,70682031,70682268,237,
28031,2356.076933,2356.080067,1,70682307,70682402,95,-0.1556538100807596
28032,2356.123533,2356.127033,1,70683705,70683810,105,0.27179880920963767
28033,2356.130867,2356.138833,1,70683926,70684164,238,-0.08975349747709238
28034,2356.164267,2356.1708,1,70684928,70685124,196,-0.08621810715766724
28035,2356.172033,2356.182033,1,70685160,70685460,300,0.35497817018250744
28036,2356.1835,2356.196567,1,70685505,70685897,392,-0.0006371576124721754
28037,2356.198,2356.201433,1,70685940,70686042,102,
28038,2356.244733,2356.266767,1,70687341,70688003,662,0.1429936061250036
28039,2356.2688,2356.273767,1,70688064,70688213,149,
28040,2356.2811,2356.285133,1,70688433,70688553,120,-0.23813276954976373
28041,2356.287833,2356.307767,1,70688634,70689233,599,-0.10344865235699006
28042,2356.318267,2356.331167,1,70689548,70689935,387,-0.034084692849770844
28043,2356.335533,2356.365167,1,70690065,70690955,890,0.13105169594874752
28044,2356.368633,2356.383567,1,70691058,70691507,449,0.31362299657022
28045,2356.385933,2356.446767,1,70691577,70693403,1826,0.10295559172890684
28046,2356.4482,2356.533933,1,70693446,70696017,2571,0.586565066130202
28047,2356.5352,2356.660367,1,70696056,70699811,3755,0.23602186938948347
28048,2356.664933,2356.668667,1,70699947,70700060,113,
28049,2356.669667,2356.677933,1,70700090,70700337,247,0.30071431589181535
28050,2356.682867,2356.6995,1,70700486,70700985,499,-0.014135164906612332
28051,2356.7074,2356.723933,1,70701222,70701717,495,0.13338239184067888
28052,2356.7332,2356.748267,1,70701996,70702448,452,0.1308082810605699
28053,2356.753733,2356.781467,1,70702611,70703444,833,-0.06684967337191294
28054,2356.784833,2356.8013,1,70703544,70704039,495,0.08649796967072733
28055,2356.8025,2356.846033,1,70704075,70705380,1305,0.005358369780244235
28056,2356.848467,2356.853567,1,70705454,70705607,153,0.14718471860730567
28057,2356.926033,2356.934033,1,70707780,70708020,240,0.26451042692962534
28058,2356.937133,2356.947667,1,70708113,70708430,317,0.021941556456352068
28059,2356.961367,2356.988133,1,70708841,70709643,802,0.1190230442589226
28060,2356.998,2357.0083,1,70709940,70710249,309,-0.07083641219579669
28061,2357.108467,2357.140267,1,70713254,70714208,954,-0.018995871282153666
28062,2357.160733,2357.165267,1,70714821,70714958,137,-0.20354983444448393
28063,2357.182733,2357.1874,1,70715481,70715622,141,0.18404960358292774
28064,2357.2321,2357.236167,1,70716963,70717085,122,-0.20252471333425318
28065,2357.2448,2357.2479,1,70717344,70717437,93,
28066,2357.355067,2357.358567,1,70720652,70720757,105,
28067,2357.371733,2357.400233,1,70721151,70722006,855,-0.10491205405134779
28068,2357.4027,2357.405767,1,70722081,70722173,92,0.13758219642603045
28069,2357.410767,2357.4179,1,70722323,70722537,214,-0.127926297906527
28070,2357.420133,2357.436167,1,70722603,70723085,482,-0.10680189914419824
28071,2357.437267,2357.4457,1,70723118,70723371,253,
28072,2357.732733,2357.763933,1,70731981,70732917,936,-0.10462976034070924
28073,2357.7659,2357.7777,1,70732977,70733331,354,0.2710844157075901
28074,2357.7849,2357.7899,1,70733547,70733697,150,
28075,2357.8039,2357.8114,1,70734117,70734342,225,0.43523628275590426
28076,2358.002267,2358.0094,1,70740068,70740282,214,0.3184772847133353
28077,2358.0752,2358.0813,1,70742256,70742439,183,
28078,2358.119733,2358.125433,1,70743591,70743762,171,-0.09252995023668124
28079,2358.1287,2358.1334,1,70743861,70744002,141,
28080,2358.181967,2358.188833,1,70745459,70745664,205,0.6971473756356842
28081,2358.1975,2358.214433,1,70745925,70746432,507,0.013982077239849088
28082,2358.238067,2358.2448,1,70747142,70747344,202,-0.11516301753630713
28083,2358.924967,2358.9306,1,70767749,70767918,169,0.33554712692696964
28084,2358.969467,2358.9932,1,70769084,70769796,712,-0.06135374415811016
28085,2358.994333,2359.019367,1,70769829,70770581,752,-0.0859866272814332
28086,2359.028067,2359.047333,1,70770842,70771419,577,0.6722558945105487
28087,2359.049833,2359.0655,1,70771494,70771965,471,0.12171579137113937
28088,2359.07,2359.073133,1,70772100,70772193,93,
28089,2359.082833,2359.0859,1,70772484,70772577,93,-0.0067072964267242755
28090,2359.0877,2359.0991,1,70772631,70772973,342,0.0508220463015571
28091,2359.102533,2359.109,1,70773075,70773270,195,0.19372797755249005
28092,2359.115367,2359.120667,1,70773461,70773620,159,0.4673991109797637
28093,2359.123433,2359.1334,1,70773702,70774002,300,-0.08670961033557505
28094,2359.1345,2359.140533,1,70774035,70774215,180,0.1305198314944892
28095,2359.151933,2359.2131,1,70774557,70776393,1836,0.12470924206195905
28096,2359.2143,2359.231233,1,70776429,70776936,507,0.41556140820224285
28097,2359.232633,2359.2484,1,70776978,70777452,474,0.12496473128777806
28098,2359.250167,2359.265933,1,70777505,70777977,472,0.2738181932148657
28099,2359.267833,2359.350233,1,70778034,70780506,2472,0.2676851430414814
28100,2359.354533,2359.367233,1,70780635,70781016,381,-0.026010972754718982
28101,2359.3684,2359.386833,1,70781052,70781604,552,0.13112478944908815
28102,2359.3929,2359.432533,1,70781787,70782975,1188,0.08792221892218231
28103,2359.523067,2359.5277,1,70785692,70785831,139,
28104,2359.533033,2359.5371,1,70785990,70786113,123,
28105,2359.5455,2359.550467,1,70786365,70786514,149,-0.05123157376274831
28106,2359.5542,2359.6049,1,70786626,70788147,1521,0.1148387724896267
28107,2359.606133,2359.609667,1,70788183,70788290,107,0.47874596975665473
28108,2359.6231,2359.6261,1,70788693,70788783,90,-0.2527010281489686
28109,2359.706633,2359.729,1,70791198,70791870,672,0.10221431412325291
28110,2359.730233,2359.743633,1,70791906,70792308,402,-0.0021625663015611106
28111,2359.7764,2359.780767,1,70793292,70793423,131,0.6318850259717594
28112,2359.850267,2359.853267,1,70795508,70795598,90,0.12464927309193888
28113,2359.854333,2359.8628,1,70795629,70795884,255,0.14448190834515048
28114,2359.8723,2359.875467,1,70796169,70796264,95,-0.3151152161841782
28115,2359.8766,2359.888533,1,70796298,70796655,357,0.824007350613023
28116,2359.890833,2359.894367,1,70796724,70796831,107,0.28947669726253
28117,2359.895633,2359.8996,1,70796868,70796988,120,
28118,2359.9693,2359.980967,1,70799079,70799429,350,0.14557360691784327
28119,2359.990367,2359.9963,1,70799711,70799889,178,0.5038640947219145
28120,2360.1244,2360.1274,1,70803732,70803822,90,-0.07588090924284424
28121,2360.1669,2360.1736,1,70805007,70805208,201,-0.08800096362145243
28122,2360.183133,2360.1862,1,70805493,70805586,93,0.27733013134847095
28123,2360.189067,2360.195667,1,70805672,70805870,198,
28124,2360.227767,2360.238867,1,70806833,70807166,333,-0.013587741290229964
28125,2360.243967,2360.298433,1,70807319,70808952,1633,-0.02643328757173356
28126,2360.299433,2360.3273,1,70808982,70809819,837,0.07832225409732567
28127,2360.338833,2360.342067,1,70810164,70810262,98,0.07665809467368637
28128,2360.353333,2360.3728,1,70810599,70811184,585,0.05876869433551452
28129,2360.376767,2360.3957,1,70811303,70811871,568,-0.047905268115711004
28130,2360.4412,2360.450433,1,70813236,70813512,276,-0.11597484252147663
28131,2360.526967,2360.536267,1,70815809,70816088,279,-0.01791208782543332
28132,2360.5696,2360.603233,1,70817088,70818096,1008,-0.014182517324281748
28133,2360.654533,2360.6677,1,70819635,70820031,396,-0.10388909793026554
28134,2360.669567,2360.691633,1,70820087,70820748,661,0.013507179649662566
28135,2360.7087,2360.714367,1,70821261,70821431,170,0.3911708620793236
28136,2360.7197,2360.7306,1,70821591,70821918,327,-0.013035567114879508
28137,2360.732867,2360.7406,1,70821986,70822218,232,0.11842340276897245
28138,2360.749067,2360.755767,1,70822472,70822673,201,0.38320015829037435
28139,2360.756967,2360.7621,1,70822709,70822863,154,-0.06873384335389801
28140,2360.764133,2360.771133,1,70822923,70823133,210,
28141,2360.9737,2361.0504,1,70829211,70831512,2301,0.06272720607563612
28142,2361.052467,2361.0565,1,70831574,70831695,121,0.1574290927333792
28143,2361.059667,2361.075333,1,70831790,70832259,469,-0.014272244239738894
28144,2361.080633,2361.085233,1,70832418,70832556,138,-0.09237969469851227
28145,2361.0929,2361.1018,1,70832787,70833054,267,-0.0948621632703555
28146,2361.103467,2361.119033,1,70833104,70833570,466,-0.10390743094584463
28147,2361.127167,2361.139033,1,70833815,70834170,355,0.09349325237983871
28148,2361.149133,2361.153667,1,70834473,70834610,137,
28149,2361.281467,2361.2878,1,70838444,70838634,190,-0.041044646983612605
28150,2361.289733,2361.295633,1,70838691,70838868,177,0.17517528211468103
28151,2361.298433,2361.314067,1,70838952,70839422,470,0.20477722426089381
28152,2361.338033,2361.351467,1,70840140,70840544,404,0.005280675329092965
28153,2361.3528,2361.356933,1,70840584,70840707,123,0.5547819414504727
28154,2361.359933,2361.366267,1,70840797,70840988,191,-0.11822306447983871
28155,2361.376967,2361.385033,1,70841309,70841550,241,-0.07146292118410447
28156,2361.388167,2361.462733,1,70841645,70843881,2236,0.0072476109837448935
28157,2361.463967,2361.471367,1,70843919,70844141,222,0.20154777296022588
28158,2361.4724,2361.480233,1,70844172,70844406,234,-0.0871383419625884
28159,2361.482233,2361.525933,1,70844466,70845777,1311,0.29351283045446197
28160,2361.526967,2361.558167,1,70845809,70846745,936,0.22977765084425597
28161,2361.5595,2361.565967,1,70846785,70846979,194,0.19118751135503462
28162,2361.566967,2361.5716,1,70847009,70847148,139,
28163,2361.573067,2361.5775,1,70847192,70847325,133,-0.13579915517197064
28164,2361.579733,2361.583133,1,70847391,70847493,102,0.03116611251366911
28165,2361.584133,2361.747067,1,70847523,70852412,4889,0.2346972296710689
28166,2361.805333,2361.8175,1,70854159,70854525,366,-0.06607365624799057
28167,2361.820033,2361.826367,1,70854600,70854791,191,-0.008490440878475706
28168,2361.827733,2361.843567,1,70854831,70855307,476,0.11082997281148121
28169,2361.850233,2361.876067,1,70855506,70856282,776,-0.01718373983753893
28170,2361.880933,2361.888733,1,70856427,70856661,234,3.2321388274384796e-05
28171,2361.979,2361.9846,1,70859370,70859538,168,0.08488179905120065
28172,2362.014833,2362.020567,1,70860444,70860617,173,0.0018612667719722189
28173,2362.022433,2362.049567,1,70860672,70861487,815,0.0880208487199889
28174,2362.264167,2362.2676,1,70867925,70868028,103,
28175,2362.2925,2362.301,1,70868775,70869030,255,0.34137911573186
28176,2362.3041,2362.3106,1,70869123,70869318,195,0.2741117484910832
28177,2362.3214,2362.329067,1,70869642,70869872,230,-0.08975403746783162
28178,2362.3813,2362.391067,1,70871439,70871732,293,0.05536251237732448
28179,2362.4194,2362.4245,1,70872582,70872735,153,-0.12027365508670738
28180,2362.430233,2362.4481,1,70872906,70873443,537,0.055140126662459904
28181,2362.452333,2362.4748,1,70873569,70874244,675,-0.07430448063079113
28182,2362.480633,2362.520533,1,70874418,70875615,1197,0.11043648034713946
28183,2362.533833,2362.596433,1,70876014,70877892,1878,0.5392757586483211
28184,2362.604333,2362.6139,1,70878129,70878417,288,0.050119165501874986
28185,2362.6162,2362.717333,1,70878486,70881519,3033,0.10133144507709221
28186,2362.7248,2362.755067,1,70881744,70882652,908,-0.041738599888280756
28187,2362.771533,2362.776,1,70883145,70883280,135,0.09578765479507372
28188,2362.780767,2362.7846,1,70883423,70883538,115,-0.1137718795630603
28189,2362.788133,2362.810333,1,70883643,70884309,666,0.014505854321551272
28190,2362.812467,2362.8432,1,70884374,70885296,922,0.037246078103105054
28191,2362.919,2362.9236,1,70887570,70887708,138,-0.008690258839458653
28192,2362.950133,2363.001233,1,70888503,70890036,1533,0.0008504753383930261
28193,2363.057867,2363.067833,1,70891736,70892034,298,0.1466043617443182
28194,2363.0734,2363.079467,1,70892202,70892384,182,0.5057628069990641
28195,2363.095633,2363.1272,1,70892868,70893816,948,0.049597364258632023
28196,2363.178,2363.181,1,70895340,70895430,90,
28197,2363.196067,2363.201967,1,70895882,70896059,177,0.004074810985374761
28198,2363.245633,2363.279567,1,70897368,70898387,1019,-0.06395361767794906
28199,2363.282267,2363.2925,1,70898468,70898775,307,-0.06447038309024015
28200,2363.293867,2363.299667,1,70898816,70898990,174,0.01469876639911365
28201,2363.303767,2363.342867,1,70899113,70900286,1173,-0.06686657446685655
28202,2363.347633,2363.352333,1,70900428,70900569,141,0.1152851771542669
28203,2363.3539,2363.368867,1,70900617,70901066,449,0.035513529309156466
28204,2363.371033,2363.438967,1,70901130,70903169,2039,0.05732599629094037
28205,2363.446,2363.665033,1,70903380,70909950,6570,0.18466539759969894
28206,2363.6687,2363.689033,1,70910061,70910670,609,0.2658721424740527
28207,2363.6929,2363.700867,1,70910787,70911026,239,0.08265978824020354
28208,2363.706433,2363.727767,1,70911192,70911833,641,0.05703255719309031
28209,2363.7289,2363.7383,1,70911867,70912149,282,0.16335640204813984
28210,2363.754233,2363.7581,1,70912626,70912743,117,
28211,2363.808933,2363.813067,1,70914267,70914392,125,-0.33583164653709646
28212,2363.8433,2363.877167,1,70915299,70916315,1016,0.08711292971223578
28213,2363.878367,2363.944433,1,70916351,70918332,1981,0.034508432054916646
28214,2363.988833,2363.991867,1,70919664,70919756,92,-0.18475135219831465
28215,2364.0229,2364.026567,1,70920687,70920797,110,-0.08626501375481067
28216,2364.092533,2364.112367,1,70922775,70923371,596,0.26195046000207906
28217,2364.114367,2364.118233,1,70923431,70923546,115,0.29260577027694973
28218,2364.125267,2364.133867,1,70923758,70924016,258,0.0704315479930087
28219,2364.2065,2364.209767,1,70926195,70926293,98,0.2103489880146067
28220,2364.220367,2364.226367,1,70926611,70926791,180,0.13463264836153468
28221,2364.229567,2364.2391,1,70926887,70927173,286,0.040186395907627494
28222,2364.2407,2364.3298,1,70927221,70929894,2673,-0.03720267016020932
28223,2364.335233,2364.3418,1,70930056,70930254,198,0.22690748122333515
28224,2364.345,2364.379267,1,70930350,70931378,1028,0.16840382368324638
28225,2364.3821,2364.427867,1,70931463,70932836,1373,0.213341376898637
28226,2364.429367,2364.451033,1,70932881,70933530,649,0.056980458237202554
28227,2364.452067,2364.4624,1,70933562,70933872,310,0.33205707381856714
28228,2364.4793,2364.484,1,70934379,70934520,141,
28229,2364.487033,2364.5113,1,70934610,70935339,729,0.24939566669091856
28230,2364.516267,2364.566267,1,70935488,70936988,1500,0.041080781081815045
28231,2364.5677,2364.581,1,70937031,70937430,399,0.08864776870693737
28232,2364.582,2364.595667,1,70937460,70937870,410,-0.17898403616278183
28233,2364.609967,2364.6264,1,70938299,70938792,493,-0.012775094687224948
28234,2364.6379,2364.6642,1,70939137,70939926,789,0.0661144341130378
28235,2364.666833,2364.677833,1,70940004,70940334,330,0.05844158279079044
28236,2364.6811,2364.7064,1,70940433,70941192,759,0.009563092715438731
28237,2364.713933,2364.7196,1,70941417,70941588,171,-0.27372285415141895
28238,2364.753367,2364.757567,1,70942601,70942727,126,
28239,2364.827267,2364.854133,1,70944818,70945623,805,0.008256591834741945
28240,2364.864367,2364.8674,1,70945931,70946022,91,
28241,2364.872167,2364.875467,1,70946165,70946264,99,
28242,2364.915267,2364.931967,1,70947458,70947959,501,-0.09967319770557306
28243,2364.940267,2365.0111,1,70948208,70950333,2125,0.14616415826691206
28244,2365.018733,2365.035967,1,70950561,70951079,518,0.2787400496411579
28245,2365.037067,2365.042067,1,70951112,70951262,150,0.07467342044867187
28246,2365.134033,2365.153267,1,70954020,70954598,578,0.2376282350630749
28247,2365.166367,2365.175933,1,70954991,70955277,286,0.30028263787793413
28248,2365.321433,2365.329133,1,70959642,70959873,231,0.3155819157889848
28249,2366.278167,2366.287967,1,70988345,70988639,294,0.3974214575428967
28250,2366.290167,2366.296567,1,70988705,70988897,192,-0.10999216411154261
28251,2367.523267,2367.526667,1,71025698,71025800,102,-0.10119532256962825
28252,2367.5959,2367.601633,1,71027877,71028048,171,0.3471074721404426
28253,2367.648467,2367.6562,1,71029454,71029686,232,0.3063555303470931
28254,2367.752233,2367.759067,1,71032566,71032772,206,0.3100478851462633
28255,2367.814267,2367.824933,1,71034428,71034747,319,0.4472425910515306
28256,2368.7206,2368.723733,1,71061618,71061711,93,0.6148613439925935
28257,2368.750833,2368.760967,1,71062524,71062829,305,0.15031567396648715
28258,2368.7653,2368.7878,1,71062959,71063634,675,0.1996521820700179
28259,2368.798133,2368.820933,1,71063943,71064627,684,0.28386260468507085
28260,2369.015367,2369.020667,1,71070461,71070620,159,0.1412698741623013
28261,2369.170333,2369.178267,1,71075109,71075348,239,
28262,2369.221733,2369.230467,1,71076651,71076914,263,0.006979090600772394
28263,2369.231867,2369.258333,1,71076956,71077749,793,0.004986191722384012
28264,2369.2623,2369.309067,1,71077869,71079272,1403,0.027602914959161905
28265,2369.3141,2369.323467,1,71079423,71079704,281,0.4407420071392883
28266,2369.324467,2369.351,1,71079734,71080530,796,0.010480535444339542
28267,2369.357533,2369.3645,1,71080725,71080935,210,0.3961622943998303
28268,2369.371667,2369.4451,1,71081150,71083353,2203,0.5014198153968331
28269,2369.446167,2369.460833,1,71083385,71083824,439,0.10613262331815657
28270,2369.4654,2369.584367,1,71083962,71087531,3569,0.12566393016663835
28271,2369.586133,2369.592667,1,71087583,71087780,197,-0.07178426376229716
28272,2369.596333,2369.641867,1,71087889,71089256,1367,0.0578960157786695
28273,2369.687067,2369.695733,1,71090612,71090871,259,-0.06027030795817341
28274,2369.709333,2369.715867,1,71091279,71091476,197,0.6078046209086627
28275,2369.722933,2369.737433,1,71091687,71092122,435,0.058603115724266984
28276,2369.740933,2369.785167,1,71092227,71093555,1328,0.07158257921192342
28277,2369.849567,2369.852633,1,71095487,71095578,91,-0.15529199815206876
28278,2369.892467,2369.9068,1,71096774,71097204,430,-0.040856126502483915
28279,2369.911633,2369.9267,1,71097348,71097801,453,-0.09874113817656081
28280,2369.9282,2369.931767,1,71097846,71097953,107,0.11698198296802975
28281,2369.9354,2369.967133,1,71098062,71099013,951,0.15991784022495395
28282,2369.969033,2370.147733,1,71099070,71104431,5361,0.5442640521430024
28283,2370.1514,2370.162733,1,71104542,71104881,339,0.287569613559315
28284,2370.166667,2370.183367,1,71105000,71105501,501,0.014036733126410374
28285,2370.194767,2370.1984,1,71105843,71105952,109,0.6587083619093036
28286,2370.200433,2370.210067,1,71106012,71106302,290,0.008363463694069814
28287,2370.216067,2370.245267,1,71106482,71107358,876,0.07092515390854892
28288,2370.248,2370.2536,1,71107440,71107608,168,0.22650130325476925
28289,2370.3069,2370.3123,1,71109207,71109369,162,
28290,2370.313967,2370.321433,1,71109419,71109642,223,-0.015196414087340739
28291,2370.326267,2370.330733,1,71109788,71109921,133,
28292,2370.335567,2370.341333,1,71110067,71110239,172,0.11515647804734648
28293,2370.348,2370.383267,1,71110440,71111498,1058,0.030546643750877848
28294,2370.462133,2370.469567,1,71113863,71114087,224,0.6374830682393703
28295,2370.4762,2370.479433,1,71114286,71114382,96,
28296,2370.491233,2370.521033,1,71114736,71115630,894,-0.010138845427742729
28297,2370.5881,2370.5991,1,71117643,71117973,330,0.5394642027133866
28298,2370.604733,2370.617767,1,71118141,71118533,392,0.0984632740314879
28299,2370.6304,2370.637133,1,71118912,71119113,201,-0.01929192562639186
28300,2370.642733,2370.6511,1,71119281,71119533,252,-0.0986317948487635
28301,2370.712467,2370.742867,1,71121374,71122286,912,0.4083914313938611
28302,2370.745,2370.766833,1,71122350,71123004,654,0.09892350128133758
28303,2370.813767,2370.817133,1,71124413,71124513,100,0.5164000097515687
28304,2370.850667,2370.876267,1,71125520,71126288,768,-0.0963343065157192
28305,2370.8786,2370.888067,1,71126358,71126642,284,-0.07516607129902002
28306,2370.8896,2370.911867,1,71126688,71127356,668,0.0163756054701061
28307,2370.9181,2370.927233,1,71127543,71127816,273,0.012151711113181059
28308,2370.9283,2370.951067,1,71127849,71128532,683,0.26399557971808585
28309,2370.9558,2371.0337,1,71128674,71131011,2337,0.47494681150943235
28310,2371.035433,2371.038533,1,71131062,71131155,93,
28311,2371.048933,2371.1398,1,71131467,71134194,2727,0.03895274111098978
28312,2371.149167,2371.178133,1,71134475,71135343,868,0.049190610687575034
28313,2371.1801,2371.189767,1,71135403,71135693,290,0.18400630406204624
28314,2371.1909,2371.222733,1,71135727,71136681,954,0.03454793661322801
28315,2371.2239,2371.251833,1,71136717,71137554,837,-0.09405756677203951
28316,2371.2594,2371.266233,1,71137782,71137986,204,0.04437136525664645
28317,2371.276633,2371.291333,1,71138298,71138739,441,0.059770699151182154
28318,2371.311333,2371.318933,1,71139339,71139567,228,-0.07069044742256722
28319,2371.340967,2371.3693,1,71140229,71141079,850,-0.015196830936030832
28320,2371.3756,2371.426133,1,71141268,71142783,1515,0.06423790822722883
28321,2371.428667,2371.443967,1,71142860,71143319,459,0.4795266108799411
28322,2371.4469,2371.464467,1,71143407,71143934,527,0.036364974719978606
28323,2371.4679,2371.538433,1,71144037,71146152,2115,0.5273908932059785
28324,2371.5399,2371.558733,1,71146197,71146761,564,0.45649438480321647
28325,2371.563767,2371.5688,1,71146913,71147064,151,0.2661720228930869
28326,2371.570267,2371.581067,1,71147108,71147432,324,0.3267876626433118
28327,2371.5872,2371.594,1,71147616,71147820,204,-0.051417398270615304
28328,2371.6038,2371.6168,1,71148114,71148504,390,0.30651388215758285
28329,2371.622733,2371.6637,1,71148681,71149911,1230,0.16031878103816954
28330,2371.671533,2371.684333,1,71150145,71150529,384,0.053737146293855925
28331,2371.690133,2371.7,1,71150703,71151000,297,-0.1379195146924601
28332,2371.702167,2371.706467,1,71151065,71151194,129,
28333,2371.7312,2371.773,1,71151936,71153190,1254,0.1264442764571719
28334,2371.7817,2371.8295,1,71153451,71154885,1434,0.22468041715975684
28335,2371.8339,2371.837133,1,71155017,71155113,96,0.42758091887297134
28336,2371.838767,2371.8482,1,71155163,71155446,283,0.18832418397150402
28337,2371.856867,2372.001067,1,71155706,71160032,4326,0.08688504946036965
28338,2372.002767,2372.009167,1,71160083,71160275,192,-0.00883747273207686
28339,2372.032633,2372.054667,1,71160978,71161640,662,0.07940742947775148
28340,2372.0558,2372.070733,1,71161674,71162121,447,-0.06847365352009802
28341,2372.081067,2372.085267,1,71162432,71162558,126,-0.20462592066627733
28342,2372.1437,2372.146967,1,71164311,71164409,98,-0.03548821614421341
28343,2372.153533,2372.159867,1,71164605,71164796,191,0.0276183003413739
28344,2372.180933,2372.185633,1,71165427,71165568,141,-0.13961797545898916
28345,2372.288667,2372.2935,1,71168660,71168805,145,-0.23845801522088225
28346,2372.304533,2372.308167,1,71169135,71169245,110,-0.346748496368926
28347,2372.312333,2372.334367,1,71169369,71170031,662,-0.08156549055540985
28348,2372.362633,2372.3675,1,71170878,71171025,147,0.0493258567234741
28349,2372.3893,2372.394233,1,71171679,71171826,147,0.8017449140669899
28350,2372.395467,2372.4224,1,71171864,71172672,808,0.24508373654509172
28351,2372.425867,2372.442,1,71172776,71173260,484,0.29037077609765827
28352,2372.5214,2372.5291,1,71175642,71175873,231,0.30897731820557417
28353,2372.5945,2372.597633,1,71177835,71177928,93,
28354,2372.5993,2372.613833,1,71177979,71178414,435,
28355,2372.626867,2372.6377,1,71178806,71179131,325,-0.08412873463405623
28356,2372.666133,2372.669567,1,71179983,71180087,104,
28357,2372.670767,2372.6793,1,71180123,71180379,256,
28358,2372.680933,2372.686367,1,71180427,71180591,164,
28359,2372.819167,2372.8252,1,71184575,71184756,181,-0.021573212094017736
28360,2372.828567,2372.8373,1,71184857,71185119,262,0.3919282405079453
28361,2372.897967,2372.9017,1,71186939,71187051,112,0.15891703048126618
28362,2372.907567,2372.913233,1,71187227,71187396,169,-0.04384966298039226
28363,2373.181467,2373.184533,1,71195444,71195535,91,0.6723736985778499
28364,2374.988733,2374.9919,1,71249661,71249757,96,0.3971740850141483
28365,2375.670433,2375.685533,1,71270112,71270565,453,0.055423232209645075
28366,2375.704967,2375.717233,1,71271149,71271516,367,0.35823655427121254
28367,2375.782967,2375.7995,1,71273489,71273985,496,0.02850670454168094
28368,2376.075733,2376.080767,1,71282271,71282423,152,-0.12186052072638905
28369,2376.120067,2376.154267,1,71283602,71284628,1026,0.04553019070343797
28370,2376.1644,2376.1723,1,71284932,71285169,237,0.02643772738893191
28371,2376.179933,2376.234767,1,71285397,71287043,1646,0.025188397097435585
28372,2376.2363,2376.2452,1,71287089,71287356,267,0.1287788442986249
28373,2376.248633,2376.2522,1,71287458,71287566,108,0.5814817732489534
28374,2376.255133,2376.263167,1,71287653,71287895,242,-0.03940594070159345
28375,2376.265467,2376.269633,1,71287964,71288088,124,-0.24367440442924448
28376,2376.274,2376.277633,1,71288220,71288328,108,
28377,2376.282467,2376.2879,1,71288474,71288637,163,0.6593498552122354
28378,2376.288933,2376.305933,1,71288667,71289177,510,0.2053042984641156
28379,2376.309,2376.3234,1,71289270,71289702,432,-0.04010935823152458
28380,2376.395733,2376.405067,1,71291871,71292152,281,-0.002205365456654841
28381,2376.406067,2376.415967,1,71292182,71292479,297,-0.06462145159746892
28382,2376.422367,2376.426567,1,71292671,71292797,126,-0.005515190981802721
28383,2376.432467,2376.4462,1,71292974,71293386,412,0.10204742305964881
28384,2376.448233,2376.4727,1,71293446,71294181,735,0.2949993875017919
28385,2376.476733,2376.482933,1,71294301,71294487,186,0.1224980717295828
28386,2376.485233,2376.4916,1,71294556,71294748,192,0.2804667742455543
28387,2376.4929,2376.5111,1,71294787,71295333,546,-0.11146595350013305
28388,2376.520767,2376.524867,1,71295623,71295746,123,0.5761927505100387
28389,2376.525967,2376.5464,1,71295779,71296392,613,0.3179829449134921
28390,2376.547533,2376.571933,1,71296425,71297157,732,0.045145860860450825
28391,2376.574933,2376.588,1,71297247,71297640,393,0.06543612452778025
28392,2376.590167,2376.608833,1,71297705,71298264,559,0.0044248651180393795
28393,2376.609933,2376.673267,1,71298297,71300198,1901,0.12229948034550388
28394,2376.674267,2376.695933,1,71300228,71300877,649,0.07885266935718732
28395,2376.7029,2376.7253,1,71301087,71301759,672,-0.08289962127289302
28396,2376.733467,2376.7374,1,71302004,71302122,118,0.8559416004666718
28397,2376.738433,2376.775333,1,71302152,71303259,1107,0.08546700381632151
28398,2376.885467,2376.924567,1,71306564,71307737,1173,0.14485691264890335
28399,2377.027067,2377.059267,1,71310812,71311778,966,0.0865839334830128
28400,2377.1568,2377.199133,1,71314704,71315973,1269,0.03315783847815508
28401,2377.279233,2377.285233,1,71318376,71318556,180,0.18247068147688703
28402,2377.3194,2377.3365,1,71319582,71320095,513,-0.012655811715363048
28403,2377.337767,2377.3439,1,71320133,71320317,184,0.09155027037247279
28404,2377.514567,2377.520567,1,71325437,71325617,180,0.6493542182942161
28405,2377.541,2377.5449,1,71326230,71326347,117,
28406,2377.5481,2377.557033,1,71326443,71326710,267,0.5640336461550637
28407,2377.5616,2377.564933,1,71326848,71326947,99,
28408,2377.572567,2377.587833,1,71327177,71327634,457,0.13802229919382455
28409,2377.598633,2377.611467,1,71327958,71328344,386,0.27229306840872447
28410,2377.6476,2377.651867,1,71329428,71329556,128,0.0005014906351978548
28411,2377.680967,2377.697167,1,71330429,71330915,486,0.2428090018695105
28412,2377.698633,2377.707033,1,71330958,71331210,252,0.32673445625465136
28413,2377.715367,2377.735267,1,71331461,71332058,597,0.625823381842621
28414,2377.815367,2377.828033,1,71334461,71334840,379,-0.04488926629322312
28415,2377.831867,2377.8613,1,71334956,71335839,883,-0.09428923633417804
28416,2377.864,2377.876767,1,71335920,71336303,383,0.1731965000291013
28417,2377.8787,2377.89,1,71336361,71336700,339,-0.003663786926082707
28418,2377.8918,2377.895133,1,71336754,71336853,99,
28419,2377.900167,2377.9038,1,71337005,71337114,109,-0.15777017441314242
28420,2377.905933,2377.919567,1,71337177,71337587,410,0.24669372566030892
28421,2377.9206,2377.960833,1,71337618,71338824,1206,0.40221089279749556
28422,2377.969433,2378.034967,1,71339082,71341049,1967,0.07963084281670345
28423,2378.0391,2378.0885,1,71341173,71342655,1482,0.13050543321245897
28424,2378.098467,2378.111167,1,71342954,71343335,381,0.6872174009616422
28425,2378.115067,2378.1228,1,71343452,71343684,232,-0.03977124181013328
28426,2378.1239,2378.172733,1,71343717,71345181,1464,0.019887535411828514
28427,2378.176067,2378.224967,1,71345282,71346749,1467,0.06320991430436806
28428,2378.314667,2378.3184,1,71349440,71349552,112,0.5875837273776697
28429,2378.349967,2378.3629,1,71350499,71350887,388,-0.022686850282913718
28430,2378.367467,2378.3765,1,71351024,71351295,271,0.26516063756761205
28431,2378.378333,2378.3844,1,71351349,71351532,183,0.02960746083926057
28432,2378.4734,2378.479633,1,71354202,71354388,186,0.17007092809604357
28433,2378.505433,2378.536567,1,71355162,71356097,935,0.11913348687452031
28434,2378.727567,2378.731167,1,71361827,71361935,108,0.24203297834219722
28435,2378.736233,2378.7403,1,71362086,71362209,123,0.24009934735308877
28436,2378.7472,2378.752067,1,71362416,71362562,146,0.36156897697040224
28437,2378.758067,2378.7677,1,71362742,71363031,289,-0.019141448032254208
28438,2378.769533,2378.7788,1,71363085,71363364,279,0.10047966134914124
28439,2378.861067,2378.866667,1,71365832,71366000,168,0.7760089075624188
28440,2378.868067,2378.872767,1,71366042,71366183,141,
28441,2378.882433,2378.889967,1,71366472,71366699,227,0.4874181334238527
28442,2379.0878,2379.105533,1,71372634,71373165,531,-0.059774372983405495
28443,2379.1896,2379.199,1,71375688,71375970,282,-0.10076034580672781
28444,2379.209667,2379.2204,1,71376290,71376612,322,-0.0037554731816344233
28445,2379.226867,2379.238567,1,71376806,71377157,351,-0.06941025820467035
28446,2379.2576,2379.260967,1,71377728,71377829,101,0.04672657621402748
28447,2379.270567,2379.275533,1,71378117,71378265,148,-0.05285334227747399
28448,2379.2768,2379.291967,1,71378304,71378759,455,0.08208227848029594
28449,2379.304,2379.308,1,71379120,71379240,120,
28450,2379.3233,2379.328867,1,71379699,71379866,167,0.5229217340246699
28451,2379.3492,2379.359133,1,71380476,71380773,297,0.11061089719089891
28452,2379.364167,2379.3814,1,71380925,71381442,517,0.1752824024087801
28453,2379.3862,2379.4012,1,71381586,71382036,450,-0.1215320745190568
28454,2379.4837,2379.492867,1,71384511,71384786,275,0.06276486780282696
28455,2379.4956,2379.505733,1,71384868,71385171,303,-0.11079429880734251
28456,2379.5072,2379.523333,1,71385216,71385699,483,-0.11468847049324296
28457,2379.524733,2379.5294,1,71385741,71385882,141,0.12095906971167456
28458,2379.537533,2379.599833,1,71386125,71387994,1869,0.18820959213786093
28459,2379.6089,2379.6796,1,71388267,71390388,2121,0.3597932071416064
28460,2379.682467,2379.6889,1,71390474,71390667,193,0.16154167836065972
28461,2379.7177,2379.742833,1,71391531,71392284,753,0.15702121689564502
28462,2379.7509,2379.81,1,71392527,71394300,1773,0.18113822279538544
28463,2379.811867,2379.877933,1,71394356,71396337,1981,0.2315363931259643
28464,2379.880367,2379.8957,1,71396411,71396871,460,-0.05839437024749086
28465,2379.8996,2379.921567,1,71396988,71397647,659,0.057481296073672736
28466,2379.927033,2379.961567,1,71397810,71398847,1037,-0.008676521984963863
28467,2379.964367,2380.0015,1,71398931,71400045,1114,0.0017339931236356055
28468,2380.121467,2380.1289,1,71403644,71403867,223,0.1284714647834651
28469,2380.13,2380.181433,1,71403900,71405442,1542,-0.015289014705402176
28470,2380.239067,2380.243467,1,71407172,71407304,132,-0.32632807969318317
28471,2380.2743,2380.313567,1,71408229,71409407,1178,0.06562125915368901
28472,2380.3692,2380.373267,1,71411076,71411198,122,-0.07021531800624793
28473,2380.408233,2380.460167,1,71412246,71413805,1559,0.01946669754049722
28474,2380.531067,2380.5364,1,71415932,71416092,160,0.49182960419015936
28475,2380.566767,2380.5859,1,71417003,71417577,574,-0.022336822060811997
28476,2380.5901,2380.6036,1,71417703,71418108,405,-0.014164640257883852
28477,2380.671133,2380.675,1,71420133,71420250,117,-0.3211719235529255
28478,2380.709933,2380.762067,1,71421297,71422862,1565,0.08424999374457319
28479,2380.853667,2380.858967,1,71425610,71425769,159,0.42685816936720544
28480,2380.880733,2380.884033,1,71426421,71426520,99,-0.25844482386595163
28481,2380.888367,2380.925133,1,71426651,71427753,1102,0.06077911740361893
28482,2381.0398,2381.058733,1,71431194,71431761,567,-0.02565263711846105
28483,2381.066333,2381.0941,1,71431989,71432823,834,0.06684682804800693
28484,2381.194433,2381.1992,1,71435832,71435976,144,-0.11227225384540745
28485,2381.233367,2381.2622,1,71437001,71437866,865,0.001984957737573542
28486,2381.5048,2381.509567,1,71445144,71445287,143,0.24314032963575957
28487,2381.523433,2381.528933,1,71445702,71445867,165,0.2964257400646659
28488,2381.573533,2381.578033,1,71447205,71447340,135,0.2781863676537141
28489,2381.5861,2381.594667,1,71447583,71447840,257,0.34113050814103885
28490,2381.603833,2381.609,1,71448114,71448270,156,0.12688757424544636
28491,2381.613533,2381.638167,1,71448405,71449145,740,-0.007652311453129155
28492,2381.653567,2381.6873,1,71449607,71450619,1012,0.20952291163728118
28493,2381.6931,2381.698067,1,71450793,71450942,149,0.5008620792999067
28494,2381.933567,2381.951933,1,71458007,71458557,550,0.0669133822306076
28495,2381.955433,2381.9606,1,71458662,71458818,156,-0.14462305811630818
28496,2381.966967,2381.9729,1,71459009,71459187,178,-0.05203299580045713
28497,2381.973967,2381.9914,1,71459219,71459742,523,0.22733288533605872
28498,2382.0045,2382.022233,1,71460135,71460666,531,0.10950450116991088
28499,2382.025967,2382.054833,1,71460779,71461644,865,0.3017696648339677
28500,2382.055833,2382.097,1,71461674,71462910,1236,0.2709578156977441
28501,2382.098233,2382.217467,1,71462946,71466524,3578,0.18929886868772508
28502,2382.2202,2382.240133,1,71466606,71467203,597,0.16904861497207155
28503,2382.2414,2382.2551,1,71467242,71467653,411,0.3587506072536057
28504,2382.257133,2382.262367,1,71467713,71467871,158,0.23658498004661133
28505,2382.264367,2382.280333,1,71467931,71468409,478,0.22668504504565326
28506,2382.2833,2382.2891,1,71468499,71468673,174,0.5883820863990563
28507,2382.3018,2382.3064,1,71469054,71469192,138,
28508,2382.314733,2382.3213,1,71469441,71469639,198,-0.07539883626003732
28509,2382.389133,2382.392233,1,71471673,71471766,93,-0.036707776241265026
28510,2382.4188,2382.456567,1,71472564,71473697,1133,0.03565691039689836
28511,2382.527833,2382.532333,1,71475834,71475969,135,0.507144388523672
28512,2382.564767,2382.5989,1,71476943,71477967,1024,0.2189733682413482
28513,2382.667067,2382.6758,1,71480012,71480274,262,0.5773009729844676
28514,2382.691,2382.6978,1,71480730,71480934,204,-0.0348830217025944
28515,2382.8278,2382.841467,1,71484834,71485244,410,0.3647626949918852
28516,2382.850433,2382.8555,1,71485512,71485665,153,0.4761631356921325
28517,2382.8693,2382.8823,1,71486079,71486469,390,-0.15002021513739153
28518,2382.971233,2383.027433,1,71489136,71490822,1686,0.1181023349901835
28519,2383.0807,2383.085533,1,71492421,71492565,144,0.36703857744856644
28520,2383.0975,2383.100633,1,71492925,71493018,93,-0.784099639239588
28521,2383.1048,2383.109,1,71493144,71493270,126,
28522,2383.2747,2383.281233,1,71498241,71498436,195,-0.08510716914818048
28523,2383.3305,2383.357833,1,71499915,71500734,819,-0.029688993914660032
28524,2383.3799,2383.422667,1,71501397,71502680,1283,0.06532317836562351
28525,2383.423667,2383.438867,1,71502710,71503166,456,0.0831402482447878
28526,2383.4399,2383.4432,1,71503197,71503296,99,0.21412885469712736
28527,2383.4747,2383.536067,1,71504241,71506082,1841,0.38986553497752696
28528,2383.543867,2383.572833,1,71506316,71507184,868,0.2428971484379625
28529,2383.589667,2383.7105,1,71507690,71511315,3625,0.3358083336905864
28530,2383.715433,2383.742733,1,71511462,71512281,819,-0.01969876546589084
28531,2383.746367,2383.751867,1,71512391,71512556,165,0.2159854572309317
28532,2383.761333,2383.801633,1,71512839,71514048,1209,0.07006602691020025
28533,2383.8213,2383.868233,1,71514639,71516046,1407,0.03566896753063879
28534,2383.8847,2383.890133,1,71516541,71516703,162,0.1980115711234881
28535,2383.910767,2383.9636,1,71517323,71518908,1585,0.01708290458258144
28536,2383.966967,2383.977467,1,71519009,71519324,315,-0.015692529501134277
28537,2384.0443,2384.0515,1,71521329,71521545,216,0.38467005752233874
28538,2384.078733,2384.100867,1,71522361,71523026,665,0.01541017992496892
28539,2384.1813,2384.190467,1,71525439,71525714,275,0.6401607233677821
28540,2384.2325,2384.237,1,71526975,71527110,135,0.40816591123079615
28541,2384.346433,2384.351633,1,71530392,71530548,156,0.4049142890737972
28542,2384.396567,2384.444,1,71531897,71533320,1423,0.04152504262894072
28543,2384.445,2384.4552,1,71533350,71533656,306,0.38017210841084165
28544,2384.460433,2384.470667,1,71533812,71534120,308,0.18574488472575554
28545,2384.4734,2384.481733,1,71534202,71534451,249,0.030264988598366068
28546,2384.4852,2384.4935,1,71534556,71534805,249,0.6030866589118161
28547,2384.494533,2384.5149,1,71534835,71535447,612,0.08853734343209652
28548,2384.515933,2384.5214,1,71535477,71535642,165,-0.1266501449099024
28549,2384.527933,2384.5404,1,71535837,71536212,375,0.11837152320523239
28550,2384.546267,2384.567,1,71536388,71537010,622,0.11165661541144417
28551,2384.568133,2384.6615,1,71537043,71539845,2802,0.27542561925462444
28552,2384.665167,2384.693333,1,71539955,71540799,844,0.245722493595074
28553,2384.6951,2384.745167,1,71540853,71542355,1502,0.1031996477088823
28554,2384.750667,2384.7946,1,71542520,71543838,1318,0.10239534452364034
28555,2384.804033,2384.831867,1,71544120,71544956,836,0.08541418945547932
28556,2384.8338,2384.837667,1,71545014,71545130,116,0.2619048608604133
28557,2384.838833,2384.849567,1,71545164,71545487,323,0.35656068299187943
28558,2384.850633,2384.8641,1,71545518,71545923,405,0.02704186679250118
28559,2384.865867,2384.889733,1,71545976,71546691,715,0.14190618347411643
28560,2384.891233,2384.8957,1,71546736,71546871,135,0.4670989933930278
28561,2384.911833,2384.916167,1,71547354,71547485,131,-0.2720282074357255
28562,2384.973867,2384.978233,1,71549216,71549346,130,-0.23500538395801351
28563,2384.991133,2385.003133,1,71549733,71550093,360,-0.07064184958496306
28564,2385.0099,2385.053367,1,71550297,71551601,1304,0.01853044871749805
28565,2385.113533,2385.1189,1,71553405,71553567,162,0.372223399531308
28566,2385.1207,2385.124,1,71553621,71553720,99,
28567,2385.125133,2385.1615,1,71553753,71554845,1092,-0.008333037086499144
28568,2385.1756,2385.194367,1,71555268,71555831,563,0.034821544655013664
28569,2385.207,2385.222267,1,71556210,71556668,458,0.402519581640545
28570,2385.3142,2385.3318,1,71559426,71559954,528,0.35127539712463135
28571,2385.455633,2385.485467,1,71563668,71564564,896,-0.02208816421949678
28572,2385.4867,2385.508867,1,71564601,71565266,665,-0.013299685517578529
28573,2385.5216,2385.5457,1,71565648,71566371,723,0.06688071844254594
28574,2385.5471,2385.5513,1,71566413,71566539,126,0.47968100806566866
28575,2385.554767,2385.563867,1,71566643,71566916,273,-0.04460848049483194
28576,2385.564867,2385.571567,1,71566946,71567147,201,-0.09409339555626922
28577,2385.588467,2385.6,1,71567654,71568000,346,-0.02639875903219543
28578,2385.6246,2385.6425,1,71568738,71569275,537,0.34688706417658477
28579,2385.7182,2385.731067,1,71571546,71571932,386,-0.02508577404913893
28580,2385.732233,2385.744167,1,71571966,71572325,359,-0.15965555815480925
28581,2385.7477,2385.754667,1,71572431,71572640,209,-0.07861813144888882
28582,2385.7569,2385.799467,1,71572707,71573984,1277,0.042944965753948044
28583,2385.800533,2385.849167,1,71574015,71575475,1460,0.07073492843881937
28584,2385.856167,2385.867033,1,71575685,71576010,325,-0.10357080950963647
28585,2385.8726,2385.879567,1,71576178,71576387,209,-0.053808991171951474
28586,2385.898967,2385.904433,1,71576969,71577132,163,0.22823595028989271
28587,2385.9453,2385.978067,1,71578359,71579342,983,-0.04460734190475125
28588,2385.979333,2385.985133,1,71579379,71579553,174,-0.14182484376080337
28589,2385.9929,2386.031833,1,71579787,71580954,1167,0.07186755196111538
28590,2386.038667,2386.047833,1,71581160,71581434,274,0.7229759402040701
28591,2386.048833,2386.133067,1,71581464,71583992,2528,0.5652226898938187
28592,2386.134433,2386.1487,1,71584032,71584461,429,0.09398160200070144
28593,2386.150567,2386.281633,1,71584517,71588448,3931,0.26953241704966646
28594,2386.283233,2386.287467,1,71588496,71588624,128,0.08198491389716098
28595,2386.288633,2386.294967,1,71588658,71588849,191,0.1496813573304198
28596,2386.2968,2386.312533,1,71588904,71589375,471,0.15574923661017562
28597,2386.317867,2386.3225,1,71589536,71589675,139,
28598,2386.328167,2386.336667,1,71589845,71590100,255,0.1376454440706159
28599,2386.442767,2386.465133,1,71593283,71593953,670,0.024971224345007915
28600,2386.4954,2386.501467,1,71594862,71595044,182,-0.13920326820728637
28601,2386.599333,2386.604767,1,71597979,71598143,164,0.1350204761234007
28602,2386.617433,2386.6232,1,71598522,71598696,174,0.5675474931434118
28603,2386.6242,2386.630833,1,71598726,71598924,198,0.22540315146983306
28604,2386.688467,2386.6947,1,71600654,71600841,187,0.011245128211350966
28605,2386.706967,2386.729467,1,71601209,71601884,675,0.18829101073148377
28606,2386.739467,2386.753067,1,71602184,71602592,408,0.4920208153899442
28607,2386.7542,2386.759033,1,71602626,71602770,144,
28608,2386.834733,2386.842167,1,71605041,71605265,224,0.3258173163672828
28609,2386.907867,2386.911467,1,71607236,71607344,108,-0.05784774835849648
28610,2386.914333,2386.9181,1,71607429,71607543,114,-0.18178487350659056
28611,2386.928,2386.9369,1,71607840,71608107,267,0.013751262978550062
28612,2386.9818,2386.9884,1,71609454,71609652,198,0.3794355424084589
28613,2387.007167,2387.010867,1,71610215,71610326,111,-0.13618606524758411
28614,2387.021933,2387.035567,1,71610657,71611067,410,0.031092603459429644
28615,2387.0413,2387.045367,1,71611239,71611361,122,-0.09890916983914572
28616,2387.0507,2387.064333,1,71611521,71611929,408,0.24850807172500528
28617,2387.065667,2387.068833,1,71611970,71612064,94,-0.07470989308311345
28618,2387.0824,2387.093767,1,71612472,71612813,341,0.11149716618151254
28619,2387.180733,2387.184533,1,71615421,71615535,114,-0.5239709108358649
28620,2387.210333,2387.2147,1,71616309,71616441,132,-0.11097296605528846
28621,2387.273833,2387.302267,1,71618214,71619068,854,0.05652697690639276
28622,2387.3372,2387.379,1,71620116,71621370,1254,0.09904898024962831
28623,2387.387967,2387.397433,1,71621639,71621922,283,0.20474799019143158
28624,2387.404267,2387.413133,1,71622128,71622393,265,0.4900814385669947
28625,2387.425833,2387.432333,1,71622774,71622969,195,0.5760105718518495
28626,2387.433533,2387.461667,1,71623005,71623850,845,0.076672365388101
28627,2387.465033,2387.524067,1,71623950,71625722,1772,0.4725736292121673
28628,2387.5269,2387.535133,1,71625807,71626053,246,0.15128982002491712
28629,2387.540733,2387.605633,1,71626221,71628168,1947,0.45353597807110085
28630,2387.607167,2387.6111,1,71628215,71628333,118,0.1143251304385459
28631,2387.619167,2387.670733,1,71628575,71630121,1546,0.07047703496096298
28632,2387.672167,2387.6842,1,71630165,71630526,361,0.09890175133390385
28633,2387.685967,2387.708767,1,71630579,71631263,684,0.04520553797220733
28634,2387.714967,2387.717967,1,71631449,71631539,90,-0.11059103290558694
28635,2387.7229,2387.737967,1,71631687,71632139,452,-0.0015241873902150608
28636,2387.744867,2387.777233,1,71632346,71633316,970,0.04704027961880704
28637,2387.780267,2387.7855,1,71633408,71633565,157,-0.21407448746753507
28638,2387.790133,2387.799867,1,71633703,71633996,293,
28639,2387.861533,2387.8682,1,71635845,71636046,201,
28640,2387.9021,2387.953133,1,71637063,71638593,1530,0.053234243329122646
28641,2387.9555,2387.971833,1,71638665,71639154,489,0.4176008170230092
28642,2388.094733,2388.1054,1,71642841,71643162,321,-0.07018462340926124
28643,2388.110167,2388.119167,1,71643305,71643575,270,0.04126896856097277
28644,2388.242267,2388.261233,1,71647268,71647836,568,-0.04315692451457659
28645,2388.262733,2388.285167,1,71647881,71648555,674,0.20898886997601934
28646,2388.365633,2388.371067,1,71650968,71651132,164,0.24247033016400163
28647,2388.406433,2388.4353,1,71652192,71653059,867,0.027041037739591177
28648,2388.829367,2388.834433,1,71664881,71665032,151,-0.026453660266626305
28649,2388.845467,2388.852467,1,71665364,71665574,210,0.39759377004023333
28650,2388.863667,2388.867833,1,71665910,71666034,124,
28651,2388.881867,2388.884867,1,71666456,71666546,90,-0.06209212361808704
28652,2388.8881,2388.897367,1,71666643,71666921,278,0.17211337826085485
28653,2388.992733,2389.006,1,71669781,71670180,399,0.4142882779535908
28654,2389.034033,2389.039567,1,71671020,71671187,167,-0.15755969638939357
28655,2389.199567,2389.203067,1,71675987,71676092,105,-0.2803304639481742
28656,2389.277067,2389.287933,1,71678312,71678637,325,-0.024707425341422683
28657,2389.300233,2389.306433,1,71679006,71679192,186,0.0930148955273879
28658,2389.308433,2389.311733,1,71679252,71679351,99,-0.11809514067605295
28659,2389.316533,2389.344167,1,71679495,71680325,830,-0.052219979953829106
28660,2389.346167,2389.372567,1,71680385,71681177,792,0.05915657371427968
28661,2389.3825,2389.387667,1,71681475,71681630,155,-0.06550623707842042
28662,2389.508233,2389.512367,1,71685246,71685371,125,0.2828131145326848
28663,2389.553833,2389.600733,1,71686614,71688021,1407,0.07740376921606183
28664,2389.6026,2389.6105,1,71688078,71688315,237,0.5395974603500355
28665,2389.614367,2389.652233,1,71688431,71689566,1135,0.18894888628182802
28666,2389.655533,2389.730333,1,71689665,71691909,2244,0.4885377396175227
28667,2389.7319,2389.750167,1,71691957,71692505,548,0.08231511060978013
28668,2389.751767,2389.764067,1,71692553,71692922,369,0.258357865119788
28669,2389.781133,2389.883067,1,71693433,71696492,3059,0.33649825402412603
28670,2389.884667,2389.888633,1,71696540,71696658,118,0.12741826527128314
28671,2389.898633,2389.923433,1,71696958,71697702,744,-0.0054698366341855735
28672,2389.927233,2389.933,1,71697816,71697990,174,0.46453588764196374
28673,2389.940067,2389.9786,1,71698202,71699358,1156,0.11466350600355835
28674,2389.980167,2389.983767,1,71699405,71699513,108,0.15960194555801074
28675,2390.073567,2390.080367,1,71702207,71702411,204,-0.10548379254486419
28676,2390.167867,2390.175533,1,71705036,71705265,229,-0.09154002904192027
28677,2390.194467,2390.2172,1,71705834,71706516,682,-0.001610510828835089
28678,2390.223767,2390.2486,1,71706713,71707458,745,-0.0373716128932704
28679,2390.249667,2390.252867,1,71707490,71707586,96,
28680,2390.2539,2390.2677,1,71707617,71708031,414,0.02130892099421603
28681,2390.349467,2390.370233,1,71710484,71711106,622,0.19476788538054807
28682,2390.385833,2390.389633,1,71711574,71711688,114,
28683,2390.391867,2390.395367,1,71711756,71711861,105,
28684,2390.509,2390.518433,1,71715270,71715552,282,0.15016835725288266
28685,2390.527033,2390.540233,1,71715810,71716206,396,0.1985658018499693
28686,2390.555467,2390.569,1,71716664,71717070,406,0.03231565565259243
28687,2390.6872,2390.691933,1,71720616,71720757,141,0.10094989889207628
28688,2390.7288,2390.762267,1,71721864,71722868,1004,-0.08849281871042956
28689,2390.7753,2390.787833,1,71723259,71723634,375,0.06852656917098478
28690,2390.8032,2390.8094,1,71724096,71724282,186,
28691,2390.813033,2390.823933,1,71724390,71724717,327,-0.034311597725223755
28692,2390.8256,2390.830667,1,71724768,71724920,152,0.025061280325437352
28693,2390.833133,2390.84,1,71724993,71725200,207,-0.22628150942674585
28694,2390.8424,2390.8724,1,71725272,71726172,900,0.2152908126813907
28695,2390.8786,2390.882133,1,71726358,71726463,105,
28696,2390.883467,2390.889033,1,71726504,71726670,166,0.10492815030152021
28697,2390.8921,2390.899967,1,71726763,71726999,236,-0.006259684272706483
28698,2390.9011,2390.910067,1,71727033,71727302,269,0.06534053653033231
28699,2390.920467,2390.967,1,71727614,71729010,1396,0.13286521865492856
28700,2390.9718,2390.982033,1,71729154,71729460,306,0.011652687801832358
28701,2390.987167,2391.0148,1,71729615,71730444,829,0.06110352437677729
28702,2391.0207,2391.070867,1,71730621,71732126,1505,0.02409923204282601
28703,2391.0726,2391.104267,1,71732178,71733128,950,-0.006063126682537334
28704,2391.105567,2391.1387,1,71733167,71734161,994,-0.014557335810903032
28705,2391.142433,2391.178333,1,71734272,71735349,1077,0.05415267164825567
28706,2391.18,2391.2017,1,71735400,71736051,651,0.09136364392670686
28707,2391.2874,2391.304267,1,71738622,71739128,506,-0.08381850706944738
28708,2391.3142,2391.350067,1,71739426,71740502,1076,0.09396687635518212
28709,2391.359633,2391.365767,1,71740788,71740973,185,0.12990951004682338
28710,2391.497167,2391.519367,1,71744915,71745581,666,0.3188234015838164
28711,2391.5326,2391.537167,1,71745978,71746115,137,-0.1521975789122836
28712,2391.6433,2391.661733,1,71749299,71749851,552,-0.06528304420388724
28713,2391.664033,2391.685067,1,71749920,71750552,632,0.0691927848201367
28714,2391.692133,2391.712267,1,71750763,71751368,605,-0.006180751316089396
28715,2391.7169,2391.721867,1,71751507,71751656,149,-0.2698121656585136
28716,2391.7247,2391.802233,1,71751741,71754066,2325,0.3510289242225652
28717,2391.8049,2391.8195,1,71754147,71754585,438,0.33104393378470093
28718,2391.822,2391.8982,1,71754660,71756946,2286,0.24344062831245727
28719,2391.8996,2391.9199,1,71756988,71757597,609,0.15008911232087974
28720,2391.9257,2391.957933,1,71757771,71758737,966,-0.009785397827032912
28721,2391.9592,2392.0189,1,71758776,71760567,1791,0.1613633029240352
28722,2392.0209,2392.031733,1,71760627,71760951,324,
28723,2392.082267,2392.1101,1,71762468,71763303,835,-0.10774165467961089
28724,2392.117367,2392.131067,1,71763521,71763932,411,-0.07597470813899426
28725,2392.214267,2392.218367,1,71766428,71766551,123,0.0015183646841880932
28726,2392.2196,2392.236267,1,71766588,71767088,500,-0.024796935018034264
28727,2392.2396,2392.2477,1,71767188,71767431,243,-0.17296711873446743
28728,2392.248833,2392.254533,1,71767464,71767635,171,-0.11106841066482097
28729,2392.2584,2392.293733,1,71767752,71768811,1059,0.08896773295493839
28730,2392.297367,2392.303967,1,71768921,71769119,198,0.4905601207279322
28731,2392.306033,2392.3212,1,71769180,71769636,456,0.08925981791895428
28732,2392.3262,2392.390467,1,71769786,71771714,1928,0.16804269941673494
28733,2392.393733,2392.431367,1,71771811,71772941,1130,-0.03319652475482232
28734,2392.433967,2392.453233,1,71773019,71773596,577,-0.0058768300066099595
28735,2392.4564,2392.462933,1,71773692,71773887,195,-0.14366190763109588
28736,2392.5285,2392.557233,1,71775855,71776716,861,0.14365231491776878
28737,2392.569833,2392.583967,1,71777094,71777519,425,0.20767139703221058
28738,2392.713933,2392.718933,1,71781417,71781567,150,0.1956561038744842
28739,2392.760133,2392.8042,1,71782803,71784126,1323,-0.013839844312380252
28740,2392.8221,2392.8407,1,71784663,71785221,558,-0.012124971145349616
28741,2392.8428,2392.848233,1,71785284,71785446,162,0.8261841265980172
28742,2392.852567,2392.866,1,71785577,71785980,403,-0.071014775982748
28743,2392.894833,2392.8985,1,71786844,71786955,111,0.38403878521020696
28744,2392.909233,2392.921467,1,71787276,71787644,368,-0.016987297171732488
28745,2392.979,2393.0005,1,71789370,71790015,645,-0.07180227812373681
28746,2393.002733,2393.014367,1,71790081,71790431,350,-0.07733131524393344
28747,2393.032733,2393.051833,1,71790981,71791554,573,0.010263007856825537
28748,2393.054,2393.0807,1,71791620,71792421,801,0.04172439359307965
28749,2393.082933,2393.086867,1,71792487,71792606,119,0.1859124030496508
28750,2393.0879,2393.097967,1,71792637,71792939,302,0.18922035598346554
28751,2393.0998,2393.104833,1,71792994,71793144,150,0.4982666377573644
28752,2393.106067,2393.1986,1,71793182,71795958,2776,0.3262515960651568
28753,2393.236133,2393.263433,1,71797083,71797902,819,0.18513863767391012
28754,2393.2721,2393.2821,1,71798163,71798463,300,-0.15721013622514637
28755,2393.288067,2393.294,1,71798642,71798820,178,0.1693261017384004
28756,2393.308833,2393.318667,1,71799264,71799560,296,-0.08947611379544627
28757,2393.332667,2393.3485,1,71799980,71800455,475,0.22401522575972782
28758,2393.350733,2393.364333,1,71800521,71800929,408,-0.035219163383973386
28759,2393.422733,2393.426433,1,71802681,71802792,111,
28760,2393.524633,2393.5946,1,71805738,71807838,2100,0.0797400283588899
28761,2393.611,2393.699433,1,71808330,71810982,2652,0.2997877273881909
28762,2393.7012,2393.711,1,71811036,71811330,294,0.1175700328601462
28763,2393.726667,2393.735867,1,71811800,71812076,276,0.19438902394154467
28764,2393.737533,2393.7407,1,71812125,71812221,96,0.023739692214170268
28765,2393.747433,2393.781133,1,71812422,71813433,1011,0.3554052500676134
28766,2393.791067,2393.877933,1,71813732,71816337,2605,0.09405458155234302
28767,2393.8811,2393.9279,1,71816433,71817837,1404,0.012417573217287205
28768,2393.996133,2394.010333,1,71819883,71820309,426,0.13240283834744154
28769,2394.024733,2394.0329,1,71820741,71820987,246,-0.0808407562664321
28770,2394.0355,2394.081833,1,71821065,71822454,1389,0.05868251582415634
28771,2394.083733,2394.0919,1,71822511,71822757,246,0.17054144528824627
28772,2394.105467,2394.108467,1,71823164,71823254,90,0.49899595215103093
28773,2394.159833,2394.1641,1,71824794,71824923,129,0.3440623966892076
28774,2394.188,2394.210133,1,71825640,71826303,663,0.016171407985902723
28775,2394.212567,2394.220467,1,71826377,71826614,237,-0.04332527421585446
28776,2394.3006,2394.305133,1,71829018,71829153,135,-0.2939844415595661
28777,2394.3339,2394.37,1,71830017,71831100,1083,0.051491142081910454
28778,2394.446,2394.4505,1,71833380,71833515,135,0.26998456688711847
28779,2394.4786,2394.511333,1,71834358,71835339,981,0.09241203141947145
28780,2394.582933,2394.589633,1,71837487,71837688,201,0.4539071118916042
28781,2394.616467,2394.658533,1,71838494,71839755,1261,0.047151573002430655
28782,2395.066933,2395.0718,1,71852007,71852154,147,0.7154298066026983
28783,2395.075367,2395.084667,1,71852261,71852540,279,0.7162593421906844
28784,2395.161933,2395.165033,1,71854857,71854950,93,0.23451569715535878
28785,2395.166933,2395.17,1,71855007,71855100,93,0.3925837906955885
28786,2395.172933,2395.1816,1,71855187,71855448,261,0.042821802496064806
28787,2395.261433,2395.278333,1,71857842,71858349,507,0.08704148497918128
28788,2395.3423,2395.3643,1,71860269,71860929,660,0.4273108857842911
28789,2395.3666,2395.3708,1,71860998,71861124,126,-0.05335983351778134
28790,2395.603667,2395.6133,1,71868110,71868399,289,0.11973646375640269
28791,2395.6567,2395.660033,1,71869701,71869800,99,
28792,2395.723267,2395.7482,1,71871698,71872446,748,0.0010728481984981053
28793,2395.752233,2395.762333,1,71872566,71872869,303,-0.0691204352006517
28794,2395.763767,2395.7736,1,71872913,71873208,295,0.35637478590630467
28795,2395.779233,2395.826267,1,71873376,71874788,1412,0.24696663130475385
28796,2395.8297,2395.835733,1,71874891,71875071,180,0.2882736515599586
28797,2395.8432,2395.850233,1,71875296,71875506,210,0.06967909614250133
28798,2395.854567,2395.8783,1,71875637,71876349,712,-0.00535921816076165
28799,2395.951067,2396.009167,1,71878532,71880275,1743,-0.03270750032254171
28800,2396.010767,2396.022067,1,71880323,71880662,339,0.369900241157965
28801,2396.023367,2396.041667,1,71880701,71881250,549,0.1167221619125328
28802,2396.046733,2396.050367,1,71881401,71881511,110,0.051023473439507076
28803,2396.0569,2396.083533,1,71881707,71882505,798,-0.10696050463419328
28804,2396.0854,2396.114633,1,71882562,71883438,876,0.20223400278760334
28805,2396.120133,2396.137833,1,71883603,71884134,531,-0.05051429269806084
28806,2396.138933,2396.142067,1,71884167,71884262,95,
28807,2396.151367,2396.156867,1,71884541,71884706,165,-0.1448858760188832
28808,2396.164267,2396.179467,1,71884928,71885384,456,0.3234836415361694
28809,2396.1832,2396.2863,1,71885496,71888589,3093,0.3675337801607822
28810,2396.291533,2396.317567,1,71888745,71889527,782,-0.004802789431344452
28811,2396.324267,2396.330133,1,71889728,71889903,175,0.3211458131890312
28812,2396.334367,2396.346467,1,71890031,71890394,363,-0.09970623643127634
28813,2396.347467,2396.372833,1,71890424,71891184,760,0.14496704999089374
28814,2396.437767,2396.445533,1,71893133,71893365,232,-0.03396755052698801
28815,2396.450567,2396.4543,1,71893517,71893629,112,0.5874091197678212
28816,2396.469,2396.489533,1,71894070,71894685,615,0.0423944892147924
28817,2396.4914,2396.495667,1,71894742,71894870,128,0.192593276057576
28818,2396.497333,2396.506467,1,71894919,71895194,275,0.4645942433620573
28819,2396.5245,2396.528267,1,71895735,71895848,113,0.3499843469200762
28820,2396.596433,2396.602567,1,71897892,71898077,185,0.3833108045296906
28821,2396.616167,2396.626767,1,71898485,71898803,318,0.08696862836359616
28822,2396.701667,2396.709,1,71901050,71901270,220,0.5165596184811313
28823,2396.7361,2396.765867,1,71902083,71902976,893,0.24092955641742067
28824,2396.768067,2396.773333,1,71903042,71903199,157,
28825,2396.7745,2396.778233,1,71903235,71903346,111,
28826,2396.8152,2396.8252,1,71904456,71904756,300,-0.12621313456413916
28827,2396.8628,2396.868333,1,71905884,71906049,165,0.39023228730807336
28828,2396.8816,2396.901333,1,71906448,71907039,591,0.22488734183521233
28829,2396.9025,2396.912967,1,71907075,71907389,314,-0.08949703375976932
28830,2397.045467,2397.0506,1,71911364,71911518,154,0.35890896340501427
28831,2397.111333,2397.148733,1,71913339,71914461,1122,0.0026343161740133778
28832,2397.158233,2397.177167,1,71914746,71915315,569,0.053621818960095366
28833,2397.178733,2397.1819,1,71915361,71915457,96,0.19710915930475129
28834,2397.198467,2397.217133,1,71915954,71916513,559,0.1933169411015721
28835,2397.225533,2397.2336,1,71916765,71917008,243,0.13105864258566488
28836,2397.246433,2397.285933,1,71917392,71918577,1185,0.48891241312463024
28837,2397.290967,2397.3062,1,71918729,71919186,457,0.19392426270635357
28838,2397.324667,2397.356033,1,71919740,71920680,940,0.13463596032296085
28839,2397.3668,2397.439,1,71921004,71923170,2166,0.027203741946148195
28840,2397.441767,2397.450133,1,71923253,71923503,250,0.4463096855777717
28841,2397.463967,2397.4893,1,71923919,71924679,760,0.07667793737159304
28842,2397.494133,2397.504433,1,71924823,71925132,309,0.09856268878076667
28843,2397.514333,2397.5364,1,71925429,71926092,663,0.03937910533001
28844,2397.543133,2397.5583,1,71926293,71926749,456,0.31199757342119433
28845,2397.567567,2397.570733,1,71927027,71927121,94,
28846,2397.577833,2397.5811,1,71927334,71927433,99,-0.02337517591010631
28847,2397.588,2397.7102,1,71927640,71931306,3666,0.3537316916273236
28848,2397.7162,2397.745667,1,71931486,71932370,884,0.03406271466805143
28849,2397.754967,2397.780467,1,71932649,71933414,765,-0.0637706774256952
28850,2397.786967,2397.810267,1,71933609,71934308,699,0.0990889669451902
28851,2397.884633,2397.8892,1,71936538,71936676,138,
28852,2397.894333,2397.900967,1,71936829,71937029,200,-0.16730693993672774
28853,2397.9026,2397.9057,1,71937078,71937171,93,
28854,2397.906733,2397.918867,1,71937201,71937566,365,-0.04942446140928139
28855,2397.921,2397.928733,1,71937630,71937861,231,-0.08018614387067742
28856,2397.934,2397.9384,1,71938020,71938152,132,-0.0743132320353997
28857,2397.9454,2397.956467,1,71938362,71938694,332,-0.12621161435587042
28858,2398.016967,2398.022067,1,71940509,71940662,153,0.7101948221599768
28859,2398.0491,2398.076167,1,71941473,71942285,812,0.07682888541279194
28860,2398.0793,2398.0984,1,71942379,71942952,573,0.14976047543497864
28861,2398.099833,2398.103967,1,71942994,71943119,125,-0.010226235374974647
28862,2398.1051,2398.1129,1,71943153,71943387,234,-0.06965351701816004
28863,2398.1199,2398.123133,1,71943597,71943693,96,
28864,2398.131033,2398.137533,1,71943930,71944125,195,0.05134057896767974
28865,2398.1711,2398.174133,1,71945133,71945223,90,0.4296141974565653
28866,2398.1862,2398.2519,1,71945586,71947557,1971,0.09153919514938427
28867,2398.254833,2398.261867,1,71947644,71947856,212,0.11146906848035161
28868,2398.271233,2398.287933,1,71948136,71948637,501,0.0724197144076008
28869,2398.292733,2398.3191,1,71948781,71949573,792,-0.02214425787000508
28870,2398.378567,2398.3935,1,71951357,71951805,448,0.32137260540825735
28871,2398.395967,2398.416667,1,71951879,71952500,621,0.22224429124044062
28872,2398.419533,2398.436067,1,71952585,71953082,497,0.40599762771255193
28873,2398.8032,2398.811767,1,71964096,71964353,257,0.7889569246627526
28874,2398.8783,2398.889133,1,71966349,71966673,324,0.22015888862376765
28875,2398.8916,2398.897433,1,71966748,71966922,174,-0.07463467072477821
28876,2398.901667,2398.907833,1,71967050,71967234,184,
28877,2398.9292,2398.936033,1,71967876,71968080,204,-0.10001953999864886
28878,2398.9388,2398.9421,1,71968164,71968263,99,
28879,2398.9438,2398.9709,1,71968314,71969127,813,0.19260242448753903
28880,2398.9757,2398.981733,1,71969271,71969451,180,-0.02435563614703461
28881,2398.989433,2399.005767,1,71969682,71970173,491,0.21006456661713682
28882,2399.007733,2399.012333,1,71970231,71970369,138,-0.0807797138927264
28883,2399.013867,2399.053767,1,71970416,71971613,1197,0.1456004858873178
28884,2399.069233,2399.111567,1,71972076,71973347,1271,0.5534504107578512
28885,2399.1198,2399.1634,1,71973594,71974902,1308,0.1886888805613318
28886,2399.166933,2399.178367,1,71975007,71975351,344,0.13476476659034373
28887,2399.1805,2399.184567,1,71975415,71975537,122,0.026695012918881083
28888,2399.190033,2399.222633,1,71975700,71976678,978,0.15144937066466413
28889,2399.2247,2399.303833,1,71976741,71979114,2373,0.1639296734093862
28890,2399.305733,2399.312033,1,71979171,71979360,189,0.7027051771259064
28891,2399.320133,2399.329033,1,71979603,71979870,267,-0.010759917231725813
28892,2399.342733,2399.354833,1,71980281,71980644,363,0.015472916238405732
28893,2399.366233,2399.375167,1,71980986,71981255,269,0.4006351625790923
28894,2399.3768,2399.4038,1,71981304,71982114,810,0.12696367707477316
28895,2399.4071,2399.425533,1,71982213,71982765,552,-0.07882870926681246
28896,2399.435167,2399.442567,1,71983055,71983277,222,-0.07186434741815123
28897,2399.4457,2399.466567,1,71983371,71983997,626,-0.12004651556074343
28898,2399.511467,2399.527933,1,71985344,71985837,493,0.05531521397855065
28899,2399.5297,2399.537433,1,71985891,71986122,231,0.2563263433368996
28900,2399.625267,2399.6311,1,71988758,71988933,175,0.008244621252422943
28901,2399.656067,2399.6615,1,71989682,71989845,163,-0.15867510103474017
28902,2399.734567,2399.745233,1,71992037,71992356,319,
28903,2399.849067,2399.858867,1,71995472,71995766,294,0.09465458954197271
28904,2399.861567,2399.864733,1,71995847,71995941,94,
28905,2400.1472,2400.1544,1,72004416,72004632,216,0.1253684728061605
28906,2400.1583,2400.162867,1,72004749,72004886,137,0.6895250218809909
28907,2400.173967,2400.1794,1,72005219,72005382,163,0.2657351789175834
28908,2400.207367,2400.211533,1,72006221,72006345,124,-0.1123615161775779
28909,2400.212633,2400.2214,1,72006378,72006642,264,0.2808836355544677
28910,2400.496533,2400.511133,1,72014895,72015333,438,-0.01326301707534679
28911,2400.628067,2400.6434,1,72018842,72019302,460,-0.04279440785617534
28912,2400.6491,2400.656333,1,72019473,72019689,216,-0.02076851081983987
28913,2400.669233,2400.716767,1,72020076,72021503,1427,0.2678184183179516
28914,2400.7303,2400.7386,1,72021909,72022158,249,0.04796366322978025
28915,2400.743367,2400.785933,1,72022301,72023577,1276,0.25737664359095014
28916,2400.7888,2400.807633,1,72023664,72024228,564,-0.05174079874060241
28917,2400.808933,2400.829633,1,72024267,72024888,621,0.25101107496339997
28918,2400.830967,2400.838767,1,72024929,72025163,234,0.48884459701631544
28919,2400.847933,2400.9254,1,72025437,72027762,2325,0.14066087372321823
28920,2400.926533,2400.944367,1,72027795,72028331,536,0.4546778929150707
28921,2400.9468,2400.9817,1,72028404,72029451,1047,0.06074780118363068
28922,2400.984567,2400.9941,1,72029537,72029823,286,0.0007965787741585301
28923,2400.9956,2401.022733,1,72029868,72030681,813,0.18541038996378947
28924,2401.024167,2401.031767,1,72030725,72030953,228,0.10259816086224678
28925,2401.1065,2401.112633,1,72033195,72033378,183,0.635708774289706
28926,2401.2209,2401.225967,1,72036627,72036779,152,
28927,2401.234867,2401.239233,1,72037046,72037176,130,0.7218616745932522
28928,2401.249067,2401.269,1,72037472,72038070,598,-0.07975878363571257
28929,2401.285233,2401.2986,1,72038556,72038958,402,0.07348819086642464
28930,2401.3064,2401.314967,1,72039192,72039449,257,-0.15344255871965617
28931,2401.3165,2401.319767,1,72039495,72039593,98,
28932,2401.3212,2401.326933,1,72039636,72039807,171,0.0603498640144225
28933,2401.339267,2401.348333,1,72040178,72040449,271,0.07325467717859815
28934,2401.3618,2401.3687,1,72040854,72041061,207,-0.07845938558492295
28935,2401.4011,2401.429233,1,72042033,72042876,843,0.19836047539507723
28936,2401.432133,2401.4818,1,72042963,72044454,1491,0.21233592524617229
28937,2401.491167,2401.494567,1,72044735,72044837,102,-0.07685655313114145
28938,2401.557733,2401.560767,1,72046731,72046823,92,
28939,2401.561833,2401.569133,1,72046854,72047073,219,0.05224422461375182
28940,2401.579967,2401.602167,1,72047399,72048065,666,0.18038449240095825
28941,2401.6064,2401.619867,1,72048192,72048596,404,-0.04856570190052958
28942,2401.660733,2401.668933,1,72049821,72050067,246,-0.09237795759037447
28943,2402.822,2402.830833,1,72084660,72084924,264,-0.014677583376454716
28944,2403.158167,2403.168033,1,72094745,72095040,295,-0.5097502218811583
28945,2403.406933,2403.417733,1,72102207,72102531,324,-0.03761211191640892
28946,2403.5487,2403.554367,1,72106461,72106631,170,0.06546404858101582
28947,2403.670933,2403.6765,1,72110127,72110295,168,-0.07907409428038666
28948,2403.683133,2403.686567,1,72110493,72110597,104,0.17569311664662096
28949,2403.691067,2403.6951,1,72110732,72110853,121,0.7396018485010686
28950,2403.728567,2403.732033,1,72111857,72111960,103,0.13851173155575505
28951,2403.787833,2403.795833,1,72113634,72113874,240,-0.008329019743662413
28952,2403.869467,2403.905267,1,72116084,72117158,1074,0.15577922741107544
28953,2403.976033,2403.999967,1,72119280,72119999,719,-0.024617814052810296
28954,2404.001633,2404.007467,1,72120048,72120224,176,0.015266844577828119
28955,2404.065933,2404.068933,1,72121977,72122067,90,
28956,2404.078433,2404.082067,1,72122352,72122462,110,
28957,2404.135833,2404.147333,1,72124074,72124419,345,0.18010240289632512
28958,2404.204967,2404.218067,1,72126149,72126542,393,0.4566370432344325
28959,2404.224033,2404.228333,1,72126720,72126849,129,-0.16061558751167726
28960,2404.2712,2404.282667,1,72128136,72128480,344,0.33562494857722724
28961,2404.290367,2404.294733,1,72128711,72128841,130,
28962,2404.342867,2404.349767,1,72130286,72130493,207,0.24038187517582787
28963,2404.3628,2404.368033,1,72130884,72131040,156,0.04381777152736995
28964,2404.42,2404.4309,1,72132600,72132927,327,0.3717895741919112
28965,2404.432933,2404.436867,1,72132987,72133106,119,0.44846505848640433
28966,2404.497367,2404.504233,1,72134921,72135126,205,0.33948154047076207
28967,2404.5662,2404.58,1,72136986,72137400,414,0.43453851637142255
28968,2404.596733,2404.6016,1,72137901,72138048,147,-0.35349713003415767
28969,2404.643367,2404.659567,1,72139301,72139787,486,0.33594135292945104
28970,2404.761367,2404.765967,1,72142841,72142979,138,0.19006546790428278
28971,2404.806433,2404.812567,1,72144192,72144377,185,0.2998520819480286
28972,2404.820367,2404.824167,1,72144611,72144725,114,0.3847196961171192
28973,2404.830433,2404.833467,1,72144912,72145004,92,
28974,2404.912567,2404.9197,1,72147377,72147591,214,0.12758031646505538
28975,2404.936033,2404.944,1,72148080,72148320,240,0.38736601802878107
28976,2405.022033,2405.0262,1,72150660,72150786,126,0.5608822149428339
28977,2405.072367,2405.077233,1,72152171,72152316,145,0.0031343343617025125
28978,2405.121667,2405.13,1,72153650,72153900,250,0.2802277105532944
28979,2405.131133,2405.138533,1,72153933,72154155,222,0.4088079996202948
28980,2405.1447,2405.1532,1,72154341,72154596,255,-0.09961892990043232
28981,2405.195867,2405.199367,1,72155876,72155981,105,
28982,2405.200933,2405.216733,1,72156027,72156501,474,0.48052418952310677
28983,2405.2282,2405.238633,1,72156846,72157158,312,0.6146276450461925
28984,2405.2741,2405.277233,1,72158223,72158316,93,
28985,2405.300633,2405.306367,1,72159018,72159191,173,-0.030548737314809362
28986,2405.323233,2405.3372,1,72159696,72160116,420,0.6473972959980234
28987,2405.3534,2405.356867,1,72160602,72160706,104,0.3616382572637765
28988,2405.362267,2405.374467,1,72160868,72161234,366,0.6558789026409702
28989,2405.3764,2405.382033,1,72161292,72161460,168,0.8413580758795289
28990,2405.386533,2405.3903,1,72161595,72161709,114,0.5765754651713768
28991,2405.393667,2405.401467,1,72161810,72162044,234,0.4041990623743589
28992,2405.403333,2405.421767,1,72162099,72162653,554,-0.10478697370682814
28993,2405.426633,2405.4602,1,72162798,72163806,1008,0.09497998987373206
28994,2405.470767,2405.474567,1,72164123,72164237,114,0.4107036275211138
28995,2405.4756,2405.485267,1,72164268,72164558,290,0.06703384831320613
28996,2405.490233,2405.4941,1,72164706,72164823,117,-0.6734890587201472
28997,2405.4991,2405.513567,1,72164973,72165407,434,-0.30065444040114647
28998,2405.705667,2405.714,1,72171170,72171420,250,-0.1184093174680973
28999,2405.715367,2405.7189,1,72171461,72171567,106,-0.03204964212553418
29000,2405.8031,2405.807567,1,72174093,72174227,134,0.5779401216980902
29001,2405.844867,2405.851633,1,72175346,72175548,202,
29002,2405.9633,2405.9701,1,72178899,72179103,204,0.5138738886003418
29003,2405.982367,2406.004167,1,72179471,72180125,654,0.43772716401646555
29004,2406.151,2406.1623,1,72184530,72184869,339,0.6061960959564161
29005,2406.181167,2406.1843,1,72185435,72185529,94,
29006,2406.186,2406.1998,1,72185580,72185994,414,0.030319711337326926
29007,2406.219567,2406.228033,1,72186587,72186840,253,-0.08432387376943513
29008,2406.563733,2406.569567,1,72196911,72197087,176,-0.19437558667347188
29009,2406.913633,2406.919033,1,72207408,72207570,162,-0.2148249592001921
29010,2406.998767,2407.001833,1,72209963,72210054,91,0.5872464778449985
29011,2407.005567,2407.0141,1,72210167,72210423,256,0.5729309825301869
29012,2407.034533,2407.053167,1,72211035,72211595,560,-0.08327860792347747
29013,2407.116333,2407.119833,1,72213489,72213594,105,-0.008632875551273117
29014,2407.1591,2407.162767,1,72214773,72214883,110,0.819657867546751
29015,2407.245233,2407.252567,1,72217356,72217577,221,0.4904601462754185
29016,2407.2563,2407.263667,1,72217689,72217910,221,-0.1697188100099509
29017,2407.266233,2407.276967,1,72217986,72218309,323,0.19876564777964684
29018,2407.6877,2407.691933,1,72230631,72230757,126,-0.037874912416858204
29019,2407.7057,2407.716867,1,72231171,72231506,335,0.19718006264779905
29020,2408.8313,2408.8363,1,72264939,72265089,150,-0.025406334418921817
29021,2408.8503,2408.858233,1,72265509,72265746,237,0.5576500479163142
29022,2408.860733,2408.890033,1,72265821,72266700,879,0.1643847657666022
29023,2408.901133,2408.909467,1,72267033,72267284,251,0.08659343236150034
29024,2408.9173,2408.929467,1,72267519,72267884,365,-0.07040545941217231
29025,2408.991567,2408.997133,1,72269747,72269913,166,-0.18701830179072138
29026,2409.032067,2409.0512,1,72270962,72271536,574,0.31692895094694273
29027,2409.074667,2409.085633,1,72272240,72272568,328,0.3382090762869903
29028,2409.0966,2409.101567,1,72272898,72273047,149,
29029,2409.190467,2409.1945,1,72275714,72275835,121,0.5360832691798554
29030,2409.255733,2409.280233,1,72277671,72278406,735,0.06155954663215816
29031,2409.281567,2409.305433,1,72278447,72279162,715,0.40946799323540056
29032,2409.3154,2409.341333,1,72279462,72280239,777,-0.09655127896812649
29033,2409.5678,2409.580633,1,72287034,72287418,384,0.1827645984677124
29034,2409.582,2409.588933,1,72287460,72287667,207,0.41236188059833995
29035,2409.590633,2409.5947,1,72287718,72287841,123,-0.22706757679257514
29036,2409.5961,2409.6061,1,72287883,72288183,300,0.5100407986530774
29037,2409.623867,2409.628233,1,72288716,72288846,130,0.26116123752368553
29038,2409.707033,2409.713,1,72291210,72291390,180,0.25812656037765136
29039,2409.719367,2409.726467,1,72291581,72291794,213,0.33767805247823784
29040,2409.7646,2409.769233,1,72292938,72293076,138,0.43003384812218676
29041,2409.7823,2409.789767,1,72293469,72293693,224,0.3550338265430349
29042,2409.792667,2409.804467,1,72293780,72294134,354,-0.24052945957269647
29043,2409.834433,2409.8408,1,72295032,72295224,192,0.27814044038539854
29044,2409.922433,2409.9362,1,72297672,72298086,414,0.30599027657836225
29045,2409.939933,2409.944433,1,72298197,72298332,135,0.08703140695006385
29046,2409.959167,2409.9629,1,72298775,72298887,112,0.17631688518486163
29047,2409.989967,2409.9931,1,72299699,72299793,94,-0.004104737209178193
29048,2410.010633,2410.017267,1,72300318,72300518,200,0.32411310245291264
29049,2410.029333,2410.047567,1,72300879,72301427,548,0.3232424935598674
29050,2410.048667,2410.053,1,72301460,72301590,130,0.24900163819195875
29051,2410.058267,2410.141333,1,72301748,72304239,2491,0.2660670649784142
29052,2410.1434,2410.179433,1,72304302,72305382,1080,0.5790045492648194
29053,2410.185667,2410.193633,1,72305570,72305808,238,0.3787635280411011
29054,2410.3409,2410.346267,1,72310227,72310388,161,0.2579532435527208
29055,2410.399133,2410.417433,1,72311973,72312522,549,-0.06005960726331534
29056,2410.437133,2410.440767,1,72313113,72313223,110,0.8293030944380338
29057,2410.504033,2410.509033,1,72315120,72315270,150,-0.09472746995218467
29058,2410.6113,2410.615567,1,72318339,72318467,128,
29059,2410.6232,2410.6283,1,72318696,72318849,153,0.058830218810764015
29060,2410.735633,2410.741567,1,72322068,72322247,179,0.13017102512328071
29061,2410.8122,2410.815567,1,72324366,72324467,101,-0.1936842664246424
29062,2410.825567,2410.831267,1,72324767,72324938,171,0.4909770981547529
29063,2410.832367,2410.837567,1,72324971,72325127,156,0.04598784655921534
29064,2411.1223,2411.129867,1,72333669,72333896,227,0.14337137260125518
29065,2411.1373,2411.1461,1,72334119,72334383,264,0.30450364637004723
29066,2411.147133,2411.150267,1,72334413,72334508,95,
29067,2411.151467,2411.166933,1,72334544,72335007,463,0.5798071672624371
29068,2411.180867,2411.205667,1,72335426,72336170,744,0.1362467483888976
29069,2411.2083,2411.2169,1,72336249,72336507,258,-0.12493118071121825
29070,2411.233667,2411.238133,1,72337010,72337143,133,0.8263935279656679
29071,2411.239233,2411.267067,1,72337176,72338012,836,-0.04930517100179773
29072,2411.273367,2411.2915,1,72338201,72338745,544,0.2246408117602463
29073,2412.466267,2412.471367,1,72373988,72374141,153,
29074,2412.482833,2412.487967,1,72374484,72374639,155,0.5180091040541643
29075,2412.4963,2412.510367,1,72374889,72375311,422,0.5669268755169142
29076,2412.516567,2412.5313,1,72375497,72375939,442,0.2654090774263011
29077,2412.532567,2412.537267,1,72375977,72376118,141,0.3516142806454536
29078,2412.551633,2412.560933,1,72376548,72376827,279,-0.10459169373304918
29079,2412.6062,2412.609533,1,72378186,72378285,99,0.001971499829477891
29080,2413.2171,2413.229967,1,72396513,72396899,386,0.11139010194490022
29081,2413.247367,2413.279533,1,72397421,72398385,964,0.6205846136852607
29082,2413.286467,2413.2976,1,72398594,72398928,334,0.13663340863658396
29083,2413.2986,2413.3033,1,72398958,72399099,141,0.299794170094287
29084,2413.319267,2413.324533,1,72399578,72399735,157,
29085,2413.365167,2413.369867,1,72400955,72401096,141,0.22473675126598433
29086,2413.3725,2413.3778,1,72401175,72401334,159,-0.11626514112104003
29087,2413.392,2413.395633,1,72401760,72401868,108,
29088,2413.404333,2413.417067,1,72402129,72402512,383,0.5441428715638633
29089,2413.429033,2413.432833,1,72402870,72402984,114,0.6249859791713895
29090,2413.437967,2413.4433,1,72403139,72403299,160,0.21428862975181986
29091,2413.451633,2413.458867,1,72403548,72403766,218,0.03843130826168803
29092,2413.4741,2413.477633,1,72404223,72404328,105,-0.07047590830139572
29093,2413.5097,2413.514233,1,72405291,72405426,135,0.2683719992582317
29094,2413.5173,2413.525767,1,72405519,72405773,254,0.3570585338345523
29095,2413.531233,2413.559667,1,72405936,72406790,854,0.4213928342706828
29096,2413.561167,2413.583433,1,72406835,72407502,667,0.054427266802869904
29097,2413.585233,2413.602833,1,72407556,72408084,528,0.13284594043124295
29098,2413.613933,2413.6211,1,72408417,72408633,216,-0.04131400908433748
29099,2413.775967,2413.781533,1,72413279,72413445,166,-0.13081758553314143
29100,2413.786167,2413.8212,1,72413585,72414636,1051,0.5065189923156633
29101,2413.8952,2413.9035,1,72416856,72417105,249,0.27797911646842993
29102,2413.9703,2413.973633,1,72419109,72419208,99,0.7672324614663512
29103,2413.9805,2413.988467,1,72419415,72419654,239,0.20439118465018796
29104,2414.0911,2414.0942,1,72422733,72422826,93,
29105,2414.219567,2414.2333,1,72426587,72426999,412,0.5362257952026744
29106,2414.686367,2414.6897,1,72440591,72440691,100,0.6978718889431008
29107,2414.999233,2415.0025,1,72449976,72450075,99,0.2305521064056316
29108,2415.069633,2415.073833,1,72452088,72452214,126,-0.0836598159472168
29109,2415.0886,2415.093433,1,72452658,72452802,144,0.14436796248398218
29110,2415.096667,2415.119167,1,72452900,72453575,675,0.426510847503211
29111,2415.1259,2415.152,1,72453777,72454560,783,0.47935168215006385
29112,2415.165733,2415.175833,1,72454971,72455274,303,0.025785643048623973
29113,2415.187533,2415.193067,1,72455625,72455792,167,0.18952003930650563
29114,2415.204733,2415.209767,1,72456141,72456293,152,-0.0526795339307707
29115,2416.183967,2416.1912,1,72485519,72485736,217,0.4482694485987277
29116,2416.339467,2416.357267,1,72490184,72490718,534,0.4814178298845058
29117,2416.3752,2416.3823,1,72491256,72491469,213,0.09343250138605537
29118,2416.419333,2416.425133,1,72492579,72492753,174,-0.1721315730549243
29119,2416.5964,2416.600433,1,72497892,72498012,120,-0.20046669545749055
29120,2416.607067,2416.632967,1,72498212,72498989,777,0.34186415281357235
29121,2416.641867,2416.659633,1,72499256,72499788,532,0.18293195136249962
29122,2416.6615,2416.673533,1,72499845,72500205,360,0.027812063326279095
29123,2416.679567,2416.7097,1,72500387,72501291,904,0.1237811738944703
29124,2416.710933,2416.727333,1,72501327,72501819,492,0.30911336374356946
29125,2416.7533,2417.010767,1,72502599,72510323,7724,0.48628205130629737
29126,2417.020967,2417.228733,1,72510629,72516861,6232,0.39457870867442246
29127,2417.2425,2417.3498,1,72517275,72520494,3219,0.5632565233125324
29128,2417.3508,2417.3577,1,72520524,72520731,207,0.6575439812437354
29129,2417.368133,2417.371267,1,72521043,72521138,95,
29130,2417.4299,2417.435767,1,72522897,72523073,176,0.6506751581220834
29131,2417.439633,2417.4491,1,72523188,72523473,285,0.02690779704608513
29132,2417.482867,2417.4883,1,72524486,72524649,163,0.3777591159983541
29133,2417.5023,2417.512667,1,72525069,72525380,311,0.28004440732505986
29134,2417.516167,2417.5225,1,72525485,72525675,190,-0.04539404263908285
29135,2417.543233,2417.5471,1,72526296,72526413,117,0.4368257393699214
29136,2418.166833,2418.176233,1,72545004,72545286,282,0.5089628116982778
29137,2420.5185,2420.525467,1,72615555,72615764,209,0.04741865877114762
29138,2420.527533,2420.542533,1,72615825,72616275,450,0.5267527311998583
29139,2420.5439,2420.5523,1,72616317,72616569,252,0.28967620082834494
29140,2420.560567,2420.5803,1,72616817,72617409,592,0.2002093019872812
29141,2420.581433,2420.5918,1,72617442,72617754,312,-0.11158482020124616
29142,2420.614833,2420.618933,1,72618444,72618567,123,0.07658291266459953
29143,2420.6233,2420.629833,1,72618699,72618894,195,0.27304216538681836
29144,2420.650333,2420.662067,1,72619509,72619862,353,0.24030783117681986
29145,2420.6631,2420.6666,1,72619893,72619998,105,
29146,2420.689933,2420.696267,1,72620697,72620888,191,0.5700344541250173
29147,2421.077467,2421.091933,1,72632324,72632757,433,0.4060249165083053
29148,2421.093267,2421.098,1,72632798,72632940,142,
29149,2421.128567,2421.134333,1,72633857,72634029,172,-0.01843120376897284
29150,2421.1697,2421.173533,1,72635091,72635205,114,0.3410230616482468
29151,2421.178267,2421.182,1,72635348,72635460,112,
29152,2421.202267,2421.2206,1,72636068,72636618,550,0.36603094532475355
29153,2421.236333,2421.252033,1,72637089,72637560,471,0.04686937825064522
29154,2421.253333,2421.2591,1,72637599,72637773,174,-0.1564740690142921
29155,2421.277433,2421.285267,1,72638322,72638558,236,0.5314887247190059
29156,2421.2903,2421.304833,1,72638709,72639144,435,0.5022557469606418
29157,2421.3061,2421.398467,1,72639183,72641954,2771,0.8327462119646367
29158,2422.238133,2422.241233,1,72667143,72667236,93,0.2839749623815506
29159,2422.242233,2422.259233,1,72667266,72667776,510,-0.08318512547454976
29160,2422.276067,2422.281267,1,72668282,72668438,156,0.14417357658794847
29161,2422.2848,2422.289067,1,72668544,72668672,128,0.10079086665750617
29162,2422.3415,2422.3545,1,72670245,72670635,390,0.4084352943934969
29163,2422.3556,2422.3819,1,72670668,72671457,789,0.38409809512702897
29164,2422.3842,2422.3878,1,72671526,72671634,108,-0.17224882003521857
29165,2422.399367,2422.420367,1,72671981,72672611,630,0.13938880594530142
29166,2422.4547,2422.4581,1,72673641,72673743,102,0.2191449417890035
29167,2422.459767,2422.513567,1,72673793,72675407,1614,0.3710238755236206
29168,2422.5256,2422.541333,1,72675768,72676239,471,0.24952244117230762
29169,2422.545567,2422.554667,1,72676367,72676640,273,-0.10206541106477486
29170,2422.5905,2422.594533,1,72677715,72677835,120,0.4390841773971231
29171,2422.595667,2422.599967,1,72677870,72677999,129,0.4540587890151048
29172,2422.601467,2422.6239,1,72678044,72678717,673,0.36499921043061595
29173,2422.626133,2422.650033,1,72678783,72679500,717,0.21478810500861445
29174,2422.670133,2422.680867,1,72680103,72680426,323,0.07109154017853285
29175,2422.684333,2422.6888,1,72680529,72680664,135,-0.0897041854956771
29176,2422.6898,2422.693,1,72680694,72680790,96,
29177,2422.746633,2422.799033,1,72682398,72683970,1572,0.32139767668269914
29178,2422.811433,2422.844133,1,72684342,72685323,981,0.24549671656318775
29179,2422.880067,2422.8849,1,72686402,72686547,145,0.7532737412196379
29180,2422.886067,2422.937933,1,72686582,72688137,1555,0.3946623118934178
29181,2422.9521,2422.961467,1,72688563,72688844,281,0.09290640975168378
29182,2422.962867,2422.973033,1,72688886,72689190,304,0.24282477755258342
29183,2422.978067,2422.989667,1,72689342,72689690,348,0.16990570508682062
29184,2423.493467,2423.5763,1,72704804,72707289,2485,0.7188163773989995
29185,2424.116067,2424.129733,1,72723482,72723891,409,0.5188365658084434
29186,2424.131667,2424.164433,1,72723950,72724932,982,0.5315118346044609
29187,2424.171267,2424.197233,1,72725138,72725916,778,0.6887350724517426
29188,2424.222667,2424.230067,1,72726680,72726902,222,0.5336229028200223
29189,2424.245933,2424.259,1,72727377,72727770,393,0.7274101856772974
29190,2424.272933,2424.294,1,72728187,72728820,633,0.3165517113993942
29191,2424.309667,2424.330633,1,72729290,72729918,628,0.12659386519786278
29192,2424.3387,2424.3464,1,72730161,72730392,231,0.07975817271819853
29193,2424.363767,2424.3716,1,72730913,72731148,235,0.6295788109187939
29194,2424.3733,2424.3867,1,72731199,72731601,402,0.2703712109838035
29195,2424.393367,2424.415267,1,72731801,72732458,657,0.37183943642334366
29196,2424.417433,2424.421767,1,72732522,72732653,131,0.07603502017803022
29197,2424.433633,2424.4535,1,72733008,72733605,597,0.1637464421442518
29198,2424.463367,2424.471433,1,72733901,72734142,241,0.03651405141931024
29199,2424.498433,2424.5534,1,72734952,72736602,1650,0.7083457937025242
29200,2424.563,2424.582467,1,72736890,72737474,584,0.5966188116670141
29201,2424.586633,2424.590833,1,72737598,72737724,126,-0.27880701165184874
29202,2424.598167,2424.640567,1,72737945,72739217,1272,0.6065736122918929
29203,2424.643533,2424.676567,1,72739305,72740297,992,0.4396392748872616
29204,2424.6971,2424.732967,1,72740913,72741989,1076,0.09476303934061876
29205,2424.736233,2424.743067,1,72742086,72742292,206,0.08951575858503764
29206,2424.7476,2424.756133,1,72742428,72742683,255,0.056326544570034436
29207,2424.759067,2424.767867,1,72742772,72743036,264,0.10996663112010276
29208,2424.772067,2424.797267,1,72743162,72743918,756,0.3933027327284363
29209,2424.802667,2424.8217,1,72744080,72744651,571,0.28770135143876796
29210,2424.841967,2424.8467,1,72745259,72745401,142,0.2619655606619268
29211,2424.8492,2424.857133,1,72745476,72745713,237,0.08463104948358084
29212,2424.860533,2424.8649,1,72745815,72745947,132,0.14679195405904552
29213,2424.866267,2424.8781,1,72745988,72746343,355,0.5422453919565889
29214,2424.906867,2424.913467,1,72747206,72747404,198,0.6764000709508081
29215,2424.9167,2424.925533,1,72747501,72747765,264,-0.11076509311748141
29216,2425.0084,2425.016667,1,72750252,72750500,248,0.6385890381594604
29217,2425.0621,2425.0951,1,72751863,72752853,990,0.5179014971103659
29218,2425.099267,2425.122433,1,72752978,72753672,694,0.4331467620748015
29219,2425.1389,2425.146433,1,72754167,72754392,225,0.3045486785321453
29220,2425.149133,2425.160367,1,72754473,72754811,338,0.12329434615791827
29221,2425.162,2425.169033,1,72754860,72755070,210,-0.07035993815823884
29222,2425.186167,2425.1893,1,72755585,72755679,94,
29223,2425.194033,2425.2966,1,72755820,72758898,3078,0.8439468927086906
29224,2425.662933,2425.669933,1,72769887,72770097,210,0.17045561010794782
29225,2425.675233,2425.682067,1,72770256,72770462,206,0.12989482339776842
29226,2425.6943,2425.757967,1,72770829,72772739,1910,0.7377577008188001
29227,2425.761667,2425.803467,1,72772850,72774104,1254,0.8523969221287387
29228,2425.832667,2425.870867,1,72774980,72776126,1146,0.7107618742515258
29229,2425.878867,2425.887167,1,72776366,72776615,249,0.6436166160211457
29230,2425.8901,2425.895033,1,72776703,72776850,147,0.6308170583285276
29231,2425.8978,2425.914267,1,72776934,72777428,494,0.706906458743062
29232,2425.938333,2425.954867,1,72778149,72778646,497,0.40860327836376636
29233,2425.967133,2425.9882,1,72779013,72779646,633,0.09380748770902532
29234,2425.9984,2426.006667,1,72779952,72780200,248,0.10311131231797012
29235,2426.023867,2426.048067,1,72780716,72781442,726,0.45943204672905613
29236,2426.055667,2426.076233,1,72781670,72782286,616,0.23592776300161872
29237,2426.087533,2426.103267,1,72782625,72783098,473,0.2979599616628378
29238,2426.104667,2426.126067,1,72783140,72783782,642,0.30439349834827634
29239,2426.146967,2426.155533,1,72784409,72784665,256,0.6513644444306477
29240,2426.158967,2426.179633,1,72784769,72785388,619,0.44100920151618245
29241,2426.1807,2426.206567,1,72785421,72786197,776,0.18586017444148395
29242,2426.222233,2426.237833,1,72786666,72787134,468,0.39850869275672335
29243,2426.246867,2426.2511,1,72787406,72787533,127,
29244,2426.257667,2426.318033,1,72787730,72789540,1810,0.8525018534936245
29245,2426.320267,2426.410433,1,72789608,72792312,2704,0.8244888511680749
29246,2426.4219,2426.469333,1,72792657,72794079,1422,0.8126312598991188
29247,2426.474267,2426.489233,1,72794228,72794676,448,0.8321929917481612
29248,2426.492033,2426.5061,1,72794760,72795183,423,0.6155767869332471
29249,2426.710633,2426.713633,1,72801318,72801408,90,0.010541711453904586
29250,2426.7464,2426.7547,1,72802392,72802641,249,0.4565459352763096
29251,2426.775367,2426.799067,1,72803261,72803972,711,0.6813430302463476
29252,2426.8028,2426.878333,1,72804084,72806349,2265,0.8107177816275979
29253,2426.883867,2426.9914,1,72806516,72809742,3226,0.836653544760348
29254,2427.007133,2427.048933,1,72810213,72811467,1254,0.8323290227509077
29255,2427.050733,2427.061567,1,72811521,72811847,326,0.899252727591472
29256,2427.0748,2427.090067,1,72812244,72812702,458,0.7040759538014345
29257,2427.0982,2427.106933,1,72812946,72813207,261,0.609431788092866
29258,2427.1206,2427.130333,1,72813618,72813909,291,0.2410553995083818
29259,2427.1843,2427.1915,1,72815529,72815745,216,0.1237444453735009
29260,2427.233967,2427.240467,1,72817019,72817214,195,0.38967574550625844
29261,2427.251033,2427.2654,1,72817530,72817962,432,0.24481667007084637
29262,2427.2704,2427.2742,1,72818112,72818226,114,0.7667246846272189
29263,2427.287367,2427.326833,1,72818621,72819804,1183,0.05558474322577974
29264,2427.335467,2427.344133,1,72820064,72820323,259,0.1606167434981622
29265,2427.358967,2427.362,1,72820769,72820860,91,
29266,2427.3656,2427.373967,1,72820968,72821219,251,0.4759398997104596
29267,2427.3786,2427.381833,1,72821358,72821454,96,0.22599842863505265
29268,2427.385033,2427.399833,1,72821550,72821994,444,0.4897675277455253
29269,2427.405367,2427.408933,1,72822161,72822267,106,0.7245969213703595
29270,2427.410333,2427.523033,1,72822309,72825690,3381,0.8416408391314365
29271,2427.859967,2427.876567,1,72835799,72836297,498,0.7899528192509412
29272,2427.882667,2427.910433,1,72836480,72837312,832,0.8019273756469519
29273,2427.9139,2427.964333,1,72837417,72838929,1512,0.7848744390536212
29274,2427.972733,2428.001267,1,72839181,72840038,857,0.7500900700080375
29275,2428.015267,2428.059333,1,72840458,72841779,1321,0.8399527230879258
29276,2428.074833,2428.1057,1,72842244,72843171,927,0.7682500404718492
29277,2428.1331,2428.1491,1,72843993,72844473,480,0.12286491272006614
29278,2428.1576,2428.165167,1,72844728,72844955,227,0.17155496177118998
29279,2428.171667,2428.180033,1,72845150,72845400,250,0.24622600862489302
29280,2428.2014,2428.206767,1,72846042,72846203,161,0.4094744456792463
29281,2428.208167,2428.253933,1,72846245,72847617,1372,0.22929857921684912
29282,2428.2696,2428.275433,1,72848088,72848262,174,-0.16779889778277005
29283,2428.2781,2428.2905,1,72848343,72848715,372,-0.01172597471220111
29284,2428.292533,2428.300667,1,72848775,72849020,245,0.06946906574138954
29285,2428.339467,2428.460833,1,72850184,72853824,3640,0.8213265696066537
29286,2428.4924,2428.496533,1,72854772,72854895,123,
29287,2428.4985,2428.5133,1,72854955,72855399,444,0.47581521046884595
29288,2428.517733,2428.5217,1,72855531,72855651,120,0.2000398952051427
29289,2428.527667,2428.5341,1,72855830,72856023,193,0.04689630786485333
29290,2428.5351,2428.547833,1,72856053,72856434,381,0.10575388749423655
29291,2428.551067,2428.563767,1,72856532,72856913,381,-0.09331253401574965
29292,2428.5791,2428.6292,1,72857373,72858876,1503,0.23161782076862872
29293,2428.637567,2428.6462,1,72859127,72859386,259,-0.12474096555498627
29294,2428.647733,2428.6716,1,72859431,72860148,717,0.32965813740519095
29295,2428.678133,2428.6892,1,72860343,72860676,333,-0.02702413929487456
29296,2428.713567,2428.7636,1,72861407,72862908,1501,0.3748928012461913
29297,2428.7729,2428.7936,1,72863187,72863808,621,0.2954351268765938
29298,2428.7991,2428.807433,1,72863973,72864222,249,0.029307417722147493
29299,2428.827933,2428.8337,1,72864837,72865011,174,0.4714190414638039
29300,2428.8377,2428.8841,1,72865131,72866523,1392,0.2513744572409197
29301,2428.893867,2429.042967,1,72866816,72871289,4473,0.8074959520192985
29302,2429.060167,2429.124033,1,72871805,72873720,1915,0.7860749556852705
29303,2429.1347,2429.142533,1,72874041,72874275,234,0.31019669571198916
29304,2429.1472,2429.1777,1,72874416,72875331,915,0.8524644967137396
29305,2429.195,2429.204367,1,72875850,72876131,281,0.07034224296650364
29306,2429.210633,2429.242233,1,72876318,72877266,948,0.11922673823716905
29307,2429.2513,2429.258067,1,72877539,72877742,203,-0.13099050040825544
29308,2429.308667,2429.3376,1,72879260,72880128,868,0.3360399841044061
29309,2429.338867,2429.384267,1,72880166,72881528,1362,0.13659745779189203
29310,2429.3853,2429.396933,1,72881559,72881907,348,0.4025611460489306
29311,2429.3988,2429.5652,1,72881964,72886956,4992,0.8261824972216418
29312,2429.573833,2429.5996,1,72887214,72887988,774,0.8276473518926719
29313,2429.601633,2429.6318,1,72888048,72888954,906,0.5918965091240189
29314,2429.6602,2429.738533,1,72889806,72892155,2349,0.8312188533409396
29315,2429.750967,2429.764067,1,72892529,72892922,393,0.7200670534519057
29316,2429.7673,2429.7783,1,72893019,72893349,330,-0.05839759509892041
29317,2429.782767,2429.785833,1,72893483,72893574,91,0.6038569100220502
29318,2429.787167,2429.7918,1,72893615,72893754,139,0.22321410286245186
29319,2429.792833,2429.796567,1,72893784,72893897,113,0.11824705143755679
29320,2429.8017,2429.809033,1,72894051,72894270,219,0.28112274607622467
29321,2429.815967,2429.8245,1,72894479,72894735,256,0.03414576851968525
29322,2429.854067,2429.8602,1,72895622,72895806,184,0.5546346371032601
29323,2429.877533,2429.900933,1,72896325,72897027,702,0.3896530200745649
29324,2429.908,2429.930567,1,72897240,72897917,677,0.04403055759554687
29325,2429.9344,2429.9417,1,72898032,72898251,219,0.22110660496017503
29326,2429.943033,2429.953867,1,72898290,72898616,326,0.33024029334657035
29327,2429.958067,2429.968033,1,72898742,72899040,298,0.07185682746282121
29328,2430.015467,2430.022833,1,72900464,72900684,220,0.25567444127785954
29329,2430.025933,2430.032067,1,72900777,72900962,185,0.4220843412895285
29330,2430.039167,2430.088867,1,72901175,72902666,1491,0.7832431173610211
29331,2430.091633,2430.137933,1,72902748,72904137,1389,0.815201744187342
29332,2430.144133,2430.178967,1,72904323,72905369,1046,0.7789036204528974
29333,2430.187967,2430.264967,1,72905639,72907949,2310,0.7118907524522936
29334,2430.276,2430.3808,1,72908280,72911424,3144,0.7053686334439287
29335,2430.3852,2430.472433,1,72911556,72914172,2616,0.7485420573669549
29336,2430.495833,2430.5065,1,72914874,72915195,321,0.22073772936586503
29337,2430.507667,2430.5117,1,72915230,72915351,121,0.053694691897050874
29338,2430.512933,2430.5181,1,72915387,72915543,156,0.21849523921374497
29339,2430.521033,2430.529367,1,72915630,72915881,251,0.10728764419341805
29340,2430.5395,2430.5467,1,72916185,72916401,216,-0.08400541109273771
29341,2430.6115,2430.635367,1,72918345,72919061,716,0.2551734401236712
29342,2430.6365,2430.640067,1,72919095,72919202,107,0.5954675043933426
29343,2430.644367,2430.659,1,72919331,72919770,439,-0.028864677457707134
29344,2430.6649,2430.678967,1,72919947,72920369,422,0.12032766143942922
29345,2430.695233,2430.748167,1,72920856,72922445,1589,0.722045135903319
29346,2430.7558,2430.838667,1,72922674,72925160,2486,0.8206892617263271
29347,2430.840233,2430.844533,1,72925206,72925335,129,-0.3125324740516373
29348,2430.880367,2430.8889,1,72926411,72926667,256,0.7144834817868362
29349,2430.8907,2430.908267,1,72926721,72927248,527,0.6064921172225884
29350,2430.9191,2431.018233,1,72927573,72930546,2973,0.8628313277590245
29351,2431.019233,2431.0829,1,72930576,72932487,1911,0.7792789066025301
29352,2431.0884,2431.1034,1,72932652,72933102,450,0.7898270524327206
29353,2431.1091,2431.120867,1,72933273,72933626,353,0.5779146576726506
29354,2431.125867,2431.1302,1,72933776,72933906,130,-0.22140065895244637
29355,2431.157133,2431.164433,1,72934713,72934932,219,0.3334098355906207
29356,2431.169367,2431.173633,1,72935081,72935208,127,-0.389587075503815
29357,2431.439033,2431.576033,1,72943170,72947280,4110,0.7613311100561717
29358,2431.5829,2431.589333,1,72947487,72947679,192,0.6710521196337951
29359,2431.5904,2431.615667,1,72947712,72948470,758,0.6316197775542463
29360,2431.620633,2431.664733,1,72948618,72949941,1323,0.6810447649484941
29361,2431.6788,2431.738867,1,72950364,72952166,1802,0.7589942355446202
29362,2431.744233,2431.789633,1,72952326,72953688,1362,0.7444961645883859
29363,2431.7928,2431.811667,1,72953784,72954350,566,0.7251918215521997
29364,2431.814133,2431.834667,1,72954423,72955040,617,0.6333467825820587
29365,2431.8392,2431.859267,1,72955176,72955778,602,0.8525778572179379
29366,2431.863567,2431.9442,1,72955907,72958326,2419,0.8016932962628871
29367,2431.9608,2431.9674,1,72958824,72959022,198,0.13461023768604377
29368,2431.973567,2431.980767,1,72959207,72959423,216,-0.0066150612149610665
29369,2431.992767,2431.997967,1,72959783,72959939,156,-0.24466979377367246
29370,2432.017767,2432.022467,1,72960533,72960674,141,0.5103569446176853
29371,2432.0391,2432.045533,1,72961173,72961365,192,0.3247209089937499
29372,2432.054967,2432.0707,1,72961649,72962121,472,0.3609062113026076
29373,2432.071967,2432.0895,1,72962159,72962685,526,-0.0019773575510929815
29374,2432.094033,2432.102767,1,72962820,72963083,263,0.17250857180377066
29375,2432.116867,2432.206767,1,72963506,72966203,2697,0.5138940814760612
29376,2432.215233,2432.339233,1,72966456,72970176,3720,0.8021651068883393
29377,2432.3435,2432.412867,1,72970305,72972386,2081,0.81168153216942
29378,2432.432333,2432.452,1,72972969,72973560,591,0.8715111879492851
29379,2432.4548,2432.567567,1,72973644,72977027,3383,0.7490333323416308
29380,2432.5847,2432.5885,1,72977541,72977655,114,
29381,2432.592033,2432.626833,1,72977760,72978804,1044,0.8423278669315442
29382,2432.6526,2432.656233,1,72979578,72979686,108,-0.13504786568091517
29383,2432.666,2432.684367,1,72979980,72980531,551,0.2844406179091005
29384,2432.690733,2432.701433,1,72980721,72981042,321,0.021919211723787656
29385,2432.766733,2432.7934,1,72983001,72983802,801,0.3742175069486615
29386,2432.801067,2432.822933,1,72984032,72984687,655,0.03163494631452322
29387,2432.824967,2432.8361,1,72984749,72985083,334,0.28374455358392364
29388,2432.8492,2432.8551,1,72985476,72985653,177,0.22226911561508633
29389,2432.9086,2433.036367,1,72987258,72991091,3833,0.7852976317512413
29390,2433.041767,2433.068967,1,72991253,72992069,816,0.7515056947799021
29391,2433.0721,2433.111033,1,72992163,72993330,1167,0.8344276999594767
29392,2433.116333,2433.1855,1,72993489,72995565,2076,0.7022370079435676
29393,2433.187667,2433.2077,1,72995630,72996231,601,0.6802928030778365
29394,2433.2156,2433.2327,1,72996468,72996981,513,0.8507505146874451
29395,2433.236833,2433.300533,1,72997104,72999015,1911,0.821873381854558
29396,2433.328267,2433.3386,1,72999848,73000158,310,0.7901292611211319
29397,2433.340867,2433.3514,1,73000226,73000542,316,0.8812624965245757
29398,2433.3562,2433.4005,1,73000686,73002015,1329,0.7715212514170815
29399,2433.401667,2433.4461,1,73002050,73003383,1333,0.6359221546222907
29400,2433.467667,2433.4816,1,73004030,73004448,418,0.2694483259820104
29401,2433.486333,2433.591967,1,73004589,73007759,3170,0.79748433641967
29402,2433.594233,2433.598933,1,73007826,73007967,141,-0.4680387009467938
29403,2433.717,2433.730433,1,73011510,73011912,402,0.49625209054565056
29404,2433.733233,2433.769067,1,73011996,73013072,1076,0.6978620586418619
29405,2433.7741,2433.822933,1,73013223,73014687,1464,0.7672430317593424
29406,2433.845367,2433.852467,1,73015361,73015574,213,0.04871889218767177
29407,2433.879733,2433.884467,1,73016391,73016534,143,-0.028325357910968418
29408,2434.090467,2434.0984,1,73022714,73022952,238,0.6945699622413067
29409,2434.099767,2434.1796,1,73022993,73025388,2395,0.7549101060025053
29410,2434.185767,2434.1942,1,73025573,73025826,253,
29411,2434.200467,2434.2335,1,73026014,73027005,991,0.7659764444996234
29412,2434.257267,2434.3424,1,73027718,73030272,2554,0.6815952221846382
29413,2434.347133,2434.4245,1,73030413,73032735,2322,0.6910428662330169
29414,2434.4282,2434.455667,1,73032846,73033670,824,0.6508825324488657
29415,2434.471267,2434.477233,1,73034138,73034316,178,0.49031442495625116
29416,2434.4865,2434.529633,1,73034595,73035888,1293,0.270068511925419
29417,2434.532767,2434.543067,1,73035983,73036292,309,-0.08820091552980984
29418,2434.581967,2434.598567,1,73037459,73037957,498,0.749026029971443
29419,2434.600767,2434.696867,1,73038023,73040906,2883,0.7816618292728426
29420,2434.7275,2434.7373,1,73041825,73042119,294,0.3867232969803668
29421,2434.7474,2434.762533,1,73042422,73042875,453,-0.07256159173635655
29422,2434.764333,2434.7684,1,73042929,73043052,123,
29423,2434.770533,2434.7737,1,73043115,73043211,96,0.3660296789657364
29424,2434.7756,2434.785633,1,73043268,73043568,300,0.2680467740738737
29425,2434.788667,2434.795533,1,73043660,73043865,205,-0.019286208380831983
29426,2434.8677,2434.874667,1,73046031,73046240,209,0.012987482550657698
29427,2434.9091,2434.9154,1,73047273,73047462,189,0.5648071605013075
29428,2434.916767,2434.920867,1,73047503,73047626,123,0.31942614614347004
29429,2434.927267,2434.954,1,73047818,73048620,802,0.7567033299005718
29430,2434.961033,2435.101133,1,73048830,73053033,4203,0.8307008369788491
29431,2435.1097,2435.195067,1,73053291,73055852,2561,0.7970662934545524
29432,2435.232567,2435.3129,1,73056977,73059387,2410,0.7561471761377621
29433,2435.8444,2435.851567,1,73075332,73075547,215,0.5967100261587749
29434,2435.878967,2435.912433,1,73076369,73077372,1003,0.6049954045753734
29435,2435.9416,2435.9579,1,73078248,73078737,489,0.591255242288418
29436,2435.9619,2435.968633,1,73078857,73079058,201,0.15169018667062642
29437,2435.974333,2436.014567,1,73079229,73080437,1208,0.5376104160835691
29438,2436.0378,2436.059767,1,73081134,73081793,659,0.5303361421497375
29439,2436.088333,2436.092133,1,73082649,73082763,114,
29440,2436.104833,2436.133967,1,73083144,73084019,875,0.06533956097242395
29441,2436.135,2436.156067,1,73084050,73084682,632,0.21147407911662297
29442,2436.167033,2436.170233,1,73085010,73085106,96,0.4406783687792688
29443,2436.178567,2436.3263,1,73085357,73089789,4432,0.8133654989246784
29444,2436.6477,2436.6873,1,73099431,73100619,1188,0.7321331411087396
29445,2436.7077,2436.812667,1,73101231,73104380,3149,0.7158028503839587
29446,2436.9204,2436.9246,1,73107612,73107738,126,0.2544082052078485
29447,2436.933533,2437.072433,1,73108005,73112172,4167,0.809814337622555
29448,2437.0914,2437.1205,1,73112742,73113615,873,0.7603285012216959
29449,2437.140233,2437.179067,1,73114206,73115372,1166,-0.01836162948631528
29450,2437.189,2437.195767,1,73115670,73115873,203,-0.10103477707630003
29451,2437.2527,2437.2578,1,73117581,73117734,153,0.7166306409397522
29452,2437.259567,2437.379933,1,73117787,73121397,3610,0.8231426171832474
29453,2437.416467,2437.422133,1,73122494,73122663,169,0.06261725851040917
29454,2437.437267,2437.440533,1,73123118,73123215,97,
29455,2437.441733,2437.4623,1,73123251,73123869,618,0.046861179165216656
29456,2437.467167,2437.4704,1,73124015,73124112,97,
29457,2437.4731,2437.480467,1,73124193,73124414,221,0.4788085919422472
29458,2437.5182,2437.522633,1,73125546,73125678,132,0.646124063353709
29459,2437.531867,2437.560267,1,73125956,73126808,852,0.11981668482460593
29460,2437.5694,2437.588667,1,73127082,73127660,578,0.02706721925206162
29461,2437.5903,2437.604967,1,73127709,73128149,440,0.2995047239958351
29462,2437.608433,2437.617033,1,73128252,73128510,258,-0.004064894159283868
29463,2437.641133,2437.6591,1,73129233,73129773,540,0.8251376882011688
29464,2437.665433,2437.6952,1,73129962,73130856,894,0.7753150633969663
29465,2437.700667,2437.750533,1,73131020,73132515,1495,0.7571786891591662
29466,2437.760133,2437.7633,1,73132803,73132899,96,0.6978308719035318
29467,2437.766333,2437.795833,1,73132989,73133874,885,0.8109608494928656
29468,2437.797333,2437.8345,1,73133919,73135035,1116,0.7487592475890231
29469,2437.839667,2437.868133,1,73135190,73136043,853,0.6476859198942874
29470,2437.870567,2437.9852,1,73136117,73139556,3439,0.7567122069134249
29471,2437.9892,2438.0261,1,73139676,73140783,1107,0.7651710425817648
29472,2438.036133,2438.0462,1,73141083,73141386,303,-0.008248680999009907
29473,2438.0475,2438.0543,1,73141425,73141629,204,-0.11895996844215727
29474,2438.0568,2438.0743,1,73141704,73142229,525,0.3003892714136432
29475,2438.076167,2438.085967,1,73142285,73142579,294,0.1034161254183619
29476,2438.116167,2438.1212,1,73143485,73143636,151,0.6321094742889587
29477,2438.123867,2438.170433,1,73143716,73145112,1396,0.21333048633819834
29478,2438.173633,2438.211133,1,73145208,73146333,1125,0.17139090554634917
29479,2438.220733,2438.224167,1,73146621,73146725,104,0.1929570267493514
29480,2438.233933,2438.488133,1,73147017,73154643,7626,0.4539305755444635
29481,2438.490167,2438.697333,1,73154705,73160919,6214,0.3425778067467706
29482,2438.729967,2438.769367,1,73161899,73163081,1182,0.27002353803674983
29483,2438.7704,2438.778167,1,73163112,73163345,233,0.5177651146385425
29484,2438.797267,2438.801867,1,73163918,73164056,138,
29485,2438.877433,2438.883133,1,73166322,73166493,171,0.10177772178396659
29486,2438.894533,2438.898333,1,73166835,73166949,114,-0.1794159025408152
29487,2438.904767,2438.908033,1,73167143,73167240,97,-0.09102659931016568
29488,2438.9092,2438.920167,1,73167276,73167605,329,0.030277094803581456
29489,2438.922633,2438.926433,1,73167678,73167792,114,0.6515073023017501
29490,2438.962167,2438.9675,1,73168865,73169025,160,-0.05785066686225744
29491,2439.125133,2439.134567,1,73173753,73174037,284,0.3449583244307841
29492,2439.136033,2439.244033,1,73174080,73177320,3240,0.8342792020513773
29493,2439.252233,2439.2622,1,73177566,73177866,300,0.7672289733149968
29494,2439.267367,2439.282567,1,73178021,73178477,456,0.5056630129750386
29495,2439.286033,2439.301533,1,73178580,73179045,465,0.0011105176927093637
29496,2439.303833,2439.3096,1,73179114,73179288,174,-0.2731583917924492
29497,2439.3112,2439.328967,1,73179336,73179869,533,0.14775501729633672
29498,2439.334,2439.347667,1,73180020,73180430,410,0.45696962984572803
29499,2439.375233,2439.3812,1,73181256,73181436,180,0.6742894167579596
29500,2439.3829,2439.407333,1,73181487,73182219,732,0.5993293220850805
29501,2439.4084,2439.4172,1,73182252,73182516,264,0.2271422804116332
29502,2439.431833,2439.462167,1,73182954,73183865,911,0.30620447423713837
29503,2439.469133,2439.475867,1,73184073,73184276,203,0.1640441538189715
29504,2439.483533,2439.597933,1,73184505,73187937,3432,0.8542464087523198
29505,2439.610233,2439.614167,1,73188306,73188425,119,0.8846681377577578
29506,2439.628667,2439.646333,1,73188860,73189389,529,0.20626050103789026
29507,2439.647567,2439.653733,1,73189427,73189611,184,0.008347839861825693
29508,2439.664633,2439.6716,1,73189938,73190148,210,-0.14891156442970907
29509,2439.722633,2439.757633,1,73191678,73192728,1050,0.39695409276594035
29510,2439.760133,2439.769167,1,73192803,73193075,272,0.5195010833247061
29511,2439.779633,2439.794467,1,73193388,73193834,446,0.09871498467274496
29512,2439.797033,2439.820167,1,73193910,73194605,695,0.3357011434973877
29513,2439.8288,2439.8325,1,73194864,73194975,111,0.32577195396473074
29514,2439.844767,2439.8502,1,73195343,73195506,163,0.08971677407830339
29515,2439.854867,2439.870933,1,73195646,73196127,481,0.6393636804315026
29516,2439.873267,2439.934533,1,73196198,73198035,1837,0.79891149133756
29517,2439.938033,2439.964367,1,73198140,73198931,791,0.8606111999125338
29518,2439.9974,2440.013667,1,73199922,73200410,488,0.3633903364873336
29519,2440.039833,2440.047167,1,73201194,73201415,221,0.2396815178085648
29520,2440.1404,2440.148967,1,73204212,73204469,257,0.5587024689128248
29521,2440.1673,2440.185367,1,73205019,73205561,542,0.4823605322688598
29522,2440.198333,2440.203733,1,73205949,73206111,162,0.12482210726854771
29523,2440.2056,2440.219833,1,73206168,73206594,426,0.1970559266855714
29524,2440.223133,2440.2357,1,73206693,73207071,378,0.40368190266597515
29525,2440.289667,2440.298433,1,73208690,73208952,262,0.7863126413092356
29526,2440.3079,2440.358567,1,73209237,73210757,1520,0.5555876447306594
29527,2440.365133,2440.372133,1,73210953,73211163,210,0.47272305298298756
29528,2440.374767,2440.3958,1,73211243,73211874,631,0.6598544974358591
29529,2440.417633,2440.428733,1,73212528,73212861,333,0.4472228590234799
29530,2440.431,2440.458033,1,73212930,73213740,810,0.5158172892670454
29531,2440.4646,2440.528233,1,73213938,73215846,1908,0.6104063389051652
29532,2440.5301,2440.539533,1,73215903,73216185,282,0.4913233137779851
29533,2440.551033,2440.5571,1,73216530,73216713,183,0.5086223660848157
29534,2440.565567,2440.576333,1,73216967,73217289,322,0.5104637638087592
29535,2440.578467,2440.5876,1,73217354,73217628,274,0.5193174481483778
29536,2440.6165,2440.6623,1,73218495,73219869,1374,0.04121240276798821
29537,2440.663433,2440.672867,1,73219902,73220186,284,0.08327291604466475
29538,2440.685233,2440.6888,1,73220556,73220664,108,0.6797699629682097
29539,2440.693767,2440.798367,1,73220813,73223951,3138,0.6781284583460371
29540,2440.803133,2440.837767,1,73224093,73225133,1040,0.6745596213559021
29541,2440.841033,2440.919967,1,73225230,73227599,2369,0.7281279272996828
29542,2441.026933,2441.030233,1,73230807,73230906,99,-0.27142959623806917
29543,2441.16,2441.171867,1,73234800,73235156,356,0.2673452703448328
29544,2441.181233,2441.196367,1,73235436,73235891,455,0.3979665723162291
29545,2441.199533,2441.203467,1,73235985,73236104,119,0.21541584946705658
29546,2441.2241,2441.235267,1,73236723,73237058,335,-0.005542387984261718
29547,2441.282567,2441.287167,1,73238477,73238615,138,-0.045887691937144405
29548,2441.315833,2441.320767,1,73239474,73239623,149,0.2277937621766703
29549,2441.331967,2441.362133,1,73239959,73240863,904,0.3621221623473218
29550,2441.3844,2441.399433,1,73241532,73241982,450,0.22118044365666426
29551,2441.401133,2441.4055,1,73242033,73242165,132,0.664913411276922
29552,2441.407367,2441.410833,1,73242221,73242324,103,0.045364973687234494
29553,2441.446433,2441.481333,1,73243392,73244439,1047,0.5419154745858851
29554,2441.483567,2441.512733,1,73244507,73245381,874,0.834996489398254
29555,2441.513933,2441.5198,1,73245417,73245594,177,0.4347917404210652
29556,2441.521067,2441.533867,1,73245632,73246016,384,0.7985987471084683
29557,2441.5428,2441.546267,1,73246284,73246388,104,0.4080747802525362
29558,2441.555967,2441.562267,1,73246679,73246868,189,0.31127817979175626
29559,2441.573067,2441.597367,1,73247192,73247921,729,0.021725389996373558
29560,2441.609233,2441.614233,1,73248276,73248426,150,0.13083979228622336
29561,2441.6314,2441.637367,1,73248942,73249121,179,0.09020041774256381
29562,2441.666767,2441.671667,1,73250003,73250150,147,0.4507884568231893
29563,2441.674533,2441.708467,1,73250235,73251254,1019,0.30655872016291785
29564,2441.7171,2441.732533,1,73251513,73251975,462,0.14166036802260867
29565,2441.748067,2441.855933,1,73252442,73255677,3235,0.8661039641638565
29566,2441.8648,2441.868667,1,73255944,73256060,116,-0.20223050938409542
29567,2441.872133,2441.875667,1,73256163,73256270,107,0.25903129858459245
29568,2441.900033,2441.904333,1,73257000,73257129,129,0.35835207661074087
29569,2441.9055,2441.911,1,73257165,73257330,165,0.3638598278445491
29570,2442.129933,2442.155367,1,73263897,73264661,764,0.7223821913163027
29571,2442.158433,2442.170567,1,73264752,73265117,365,0.7219311064558377
29572,2442.218833,2442.235167,1,73266564,73267055,491,0.705620107324705
29573,2442.260733,2442.264333,1,73267821,73267929,108,0.7606918747207035
29574,2442.2669,2442.3031,1,73268007,73269093,1086,0.7025286685169195
29575,2442.336133,2442.350167,1,73270083,73270505,422,0.7561100723563469
29576,2442.372667,2442.399133,1,73271180,73271973,793,0.7424079147301689
29577,2442.4168,2442.420333,1,73272504,73272609,105,
29578,2442.4339,2442.4373,1,73273017,73273119,102,0.16364129869121072
29579,2442.4386,2442.464767,1,73273158,73273943,785,0.09290710587585606
29580,2442.465967,2442.5009,1,73273979,73275027,1048,0.24460673731002985
29581,2442.508567,2442.513267,1,73275257,73275398,141,0.089851044941351
29582,2442.524867,2442.536367,1,73275746,73276091,345,0.5614034581732291
29583,2442.5392,2442.632933,1,73276176,73278987,2811,0.8404683922338985
29584,2442.649167,2442.657667,1,73279475,73279730,255,0.7812715459047057
29585,2442.668033,2442.679733,1,73280040,73280391,351,-0.07855920425003607
29586,2442.681033,2442.6878,1,73280430,73280634,204,-0.03382680125650282
29587,2442.689433,2442.713033,1,73280682,73281390,708,0.23357169338979375
29588,2442.7148,2442.718933,1,73281444,73281567,123,
29589,2442.720633,2442.724133,1,73281618,73281723,105,0.5355280164255608
29590,2442.868967,2442.874733,1,73286069,73286241,172,0.7528472250026134
29591,2442.876067,2443.0584,1,73286282,73291752,5470,0.7860716934299455
29592,2443.066,2443.091367,1,73291980,73292741,761,0.684618757070861
29593,2443.092633,2443.109833,1,73292778,73293294,516,-0.014162547030142768
29594,2443.1211,2443.208533,1,73293633,73296255,2622,0.8083457565566201
29595,2443.2099,2443.245367,1,73296297,73297361,1064,0.8302056026428416
29596,2443.2751,2443.2787,1,73298253,73298361,108,
29597,2443.298933,2443.302567,1,73298967,73299077,110,
29598,2443.460067,2443.6197,1,73303802,73308591,4789,0.8333067673105911
29599,2443.623167,2443.671533,1,73308695,73310145,1450,0.766604414240494
29600,2443.694033,2443.7296,1,73310820,73311888,1068,0.849532642627993
29601,2443.783167,2443.7873,1,73313495,73313619,124,0.16809002355786498
29602,2443.9337,2443.9368,1,73318011,73318104,93,0.3882481614312008
29603,2443.950733,2444.0882,1,73318521,73322646,4125,0.7948506891674783
29604,2444.089433,2444.103433,1,73322682,73323102,420,0.6287883753549491
29605,2444.105033,2444.187133,1,73323150,73325613,2463,0.770206625467442
29606,2444.2284,2444.2349,1,73326852,73327047,195,-0.012451373601187008
29607,2444.400767,2444.407033,1,73332023,73332210,187,0.4223162101962679
29608,2444.410267,2444.624933,1,73332308,73338747,6439,0.7947878672143563
29609,2444.6439,2444.6493,1,73339317,73339479,162,0.19829938416275497
29610,2444.6546,2444.661267,1,73339638,73339838,200,0.39228914089680034
29611,2444.6651,2444.680133,1,73339953,73340403,450,0.19797478804046936
29612,2444.883833,2445.019033,1,73346514,73350570,4056,0.78873494387936
29613,2445.042867,2445.0544,1,73351286,73351632,346,0.29352100103583667
29614,2445.252167,2445.412333,1,73357565,73362369,4804,0.7840147896312737
29615,2445.4268,2445.506833,1,73362804,73365204,2400,0.7825286751425867
29616,2445.640933,2445.6462,1,73369227,73369386,159,0.16510390638373434
29617,2445.647367,2445.653233,1,73369421,73369596,175,-0.31764280207220486
29618,2445.733267,2445.749533,1,73371998,73372485,487,0.7392329161653503
29619,2445.750733,2445.794867,1,73372521,73373846,1325,0.7077031135104767
29620,2445.795867,2445.837533,1,73373876,73375125,1249,0.7697627515693583
29621,2445.866733,2445.877133,1,73376001,73376313,312,0.2226670059152124
29622,2445.878733,2445.884133,1,73376361,73376523,162,-0.21099848255716933
29623,2445.8875,2445.890933,1,73376625,73376727,102,
29624,2445.893733,2445.8973,1,73376811,73376919,108,0.008387327408789162
29625,2445.899167,2445.9044,1,73376975,73377132,157,-0.07144580642768017
29626,2446.0279,2446.035133,1,73380837,73381053,216,0.14812052974022835
29627,2446.037067,2446.185433,1,73381112,73385562,4450,0.840341160454346
29628,2446.1866,2446.205367,1,73385598,73386161,563,0.8253109567132586
29629,2446.244833,2446.248133,1,73387344,73387443,99,-0.3837499882731734
29630,2446.253867,2446.2595,1,73387616,73387785,169,0.04403922823372484
29631,2446.4328,2446.436667,1,73392984,73393100,116,-0.12371616525938192
29632,2446.475,2446.623167,1,73394250,73398695,4445,0.8118943603090717
29633,2446.625333,2446.6946,1,73398759,73400838,2079,0.8102313787122297
29634,2446.729567,2446.7372,1,73401887,73402116,229,0.006413500159082376
29635,2446.888867,2447.0629,1,73406666,73411887,5221,0.7905514515837144
29636,2447.297,2447.312533,1,73418910,73419375,465,0.2576429659113396
29637,2447.3155,2447.414033,1,73419465,73422420,2955,0.730631877203153
29638,2447.649967,2447.768233,1,73429499,73433046,3547,0.7765459022981368
29639,2448.028067,2448.1056,1,73440842,73443168,2326,0.8074972173650717
29640,2448.1082,2448.1807,1,73443246,73445421,2175,0.7040618716938455
29641,2448.3889,2448.3977,1,73451667,73451931,264,0.40169258777234956
29642,2448.45,2448.464367,1,73453500,73453931,431,0.6670124075294
29643,2448.465833,2448.502533,1,73453974,73455075,1101,0.6976737451470149
29644,2448.504033,2448.550133,1,73455120,73456503,1383,0.7454841188850546
29645,2448.989433,2448.992533,1,73469682,73469775,93,0.28232754131225857
29646,2449.004467,2449.013567,1,73470134,73470407,273,0.600806533393673
29647,2449.015833,2449.0446,1,73470474,73471338,864,0.548545312160256
29648,2449.0494,2449.069933,1,73471482,73472097,615,0.41189389942066396
29649,2449.0751,2449.097833,1,73472253,73472934,681,0.810866820101195
29650,2449.8164,2449.848333,1,73494492,73495449,957,0.6564926297906362
29651,2449.903767,2449.922267,1,73497113,73497668,555,0.7037052945089557
29652,2449.9611,2450.006833,1,73498833,73500204,1371,0.7253325285405483
29653,2450.0271,2450.032667,1,73500813,73500980,167,0.8189421447515594
29654,2450.033733,2450.043633,1,73501011,73501308,297,0.7922148120565811
29655,2450.064267,2450.077533,1,73501928,73502325,397,0.7935556678827497
29656,2450.0839,2450.102433,1,73502517,73503072,555,0.7544560315393294
29657,2450.373567,2450.380467,1,73511207,73511414,207,0.46626150428168606
29658,2450.3903,2450.449967,1,73511709,73513499,1790,0.7987032445837964
29659,2450.451233,2450.4999,1,73513536,73514997,1461,0.8617049590901196
29660,2450.966233,2450.9742,1,73528986,73529226,240,0.6375288688632552
29661,2450.976767,2451.005633,1,73529303,73530168,865,0.5570825423527379
29662,2451.010733,2451.050267,1,73530321,73531508,1187,0.5301634806312195
29663,2451.069767,2451.1023,1,73532093,73533069,976,0.6506478409022384
29664,2451.118967,2451.122767,1,73533569,73533683,114,0.4784313651303516
29665,2451.124,2451.1334,1,73533720,73534002,282,0.5047148811549067
29666,2451.134533,2451.1588,1,73534035,73534764,729,0.6003451299881417
29667,2451.171033,2451.178033,1,73535130,73535340,210,0.5674090130751577
29668,2451.201733,2451.2063,1,73536051,73536189,138,
29669,2451.217033,2451.264667,1,73536510,73537940,1430,0.126245320603074
29670,2451.268067,2451.277633,1,73538042,73538328,286,-0.02038454792821059
29671,2451.296233,2451.432967,1,73538886,73542989,4103,0.7948447683439723
29672,2451.458,2451.5558,1,73543740,73546674,2934,0.7634043199223537
29673,2451.601967,2451.6068,1,73548059,73548204,145,-0.22334045822675705
29674,2451.8312,2451.8397,1,73554936,73555191,255,0.45130406801786715
29675,2451.8457,2451.849067,1,73555371,73555472,101,
29676,2451.853533,2451.861467,1,73555605,73555844,239,-0.09398381208429356
29677,2451.864433,2451.898867,1,73555932,73556966,1034,0.6639383166928101
29678,2451.900067,2451.958333,1,73557002,73558749,1747,0.6157656550953533
29679,2452.388667,2452.4174,1,73571660,73572522,862,0.6692609085502051
29680,2452.455133,2452.468067,1,73573653,73574042,389,0.8137905514344096
29681,2452.486533,2452.498967,1,73574595,73574969,374,0.7939763273212573
29682,2452.500567,2452.507,1,73575017,73575210,193,-0.013740143046624234
29683,2452.508067,2452.5113,1,73575242,73575339,97,0.7037502603266806
29684,2452.541433,2452.546733,1,73576242,73576401,159,0.6516903883753146
29685,2452.5617,2452.576367,1,73576851,73577291,440,0.2621483891326165
29686,2452.578967,2452.5883,1,73577369,73577649,280,0.20613876145598722
29687,2452.643533,2452.648133,1,73579305,73579443,138,0.40914558795653516
29688,2452.6741,2452.685667,1,73580223,73580570,347,0.09681446394961757
29689,2452.686867,2452.691667,1,73580606,73580750,144,-0.33791162318755197
29690,2452.738867,2452.996167,1,73582166,73589885,7719,0.7746015247034358
29691,2453.021333,2453.026633,1,73590639,73590798,159,
29692,2453.119133,2453.126967,1,73593573,73593809,236,0.4004908185330314
29693,2453.137133,2453.164967,1,73594113,73594949,836,0.4318430764617595
29694,2453.178333,2453.1976,1,73595349,73595928,579,0.29142143890825456
29695,2453.220833,2453.225733,1,73596624,73596771,147,0.7105037911765608
29696,2453.231667,2453.246433,1,73596950,73597392,442,0.7973277312225028
29697,2453.2476,2453.346267,1,73597428,73600388,2960,0.8295663347883394
29698,2453.3488,2453.411133,1,73600464,73602333,1869,0.8030895946163054
29699,2453.4302,2453.5154,1,73602906,73605462,2556,0.8348276018199121
29700,2453.721633,2453.734433,1,73611648,73612032,384,0.46785463194778015
29701,2453.735533,2453.9389,1,73612065,73618167,6102,0.7892423605079805
29702,2453.962133,2453.970733,1,73618863,73619121,258,0.009647258267836228
29703,2454.244667,2454.36,1,73627340,73630800,3460,0.8080982141083285
29704,2454.7562,2454.766433,1,73642686,73642992,306,0.7247503889839448
29705,2454.7691,2454.7924,1,73643073,73643772,699,0.6134633011553886
29706,2454.831667,2454.8351,1,73644950,73645053,103,-0.05868762748778169
29707,2454.838733,2454.8555,1,73645161,73645665,504,0.7417415325426859
29708,2455.057467,2455.116567,1,73651724,73653497,1773,0.7876939435601504
29709,2455.122833,2455.127733,1,73653684,73653831,147,0.43403351396732154
29710,2455.128933,2455.139,1,73653867,73654170,303,0.5737210285153347
29711,2455.153033,2455.177433,1,73654590,73655322,732,0.7252459440256175
29712,2455.562,2455.568967,1,73666860,73667069,209,0.7102304737074235
29713,2455.580067,2455.588867,1,73667402,73667666,264,0.7273873399350768
29714,2455.601033,2455.606267,1,73668030,73668188,158,0.2115101525089315
29715,2455.635567,2455.664467,1,73669067,73669934,867,0.8306362401396733
29716,2455.700167,2455.7053,1,73671005,73671159,154,0.35141915830586273
29717,2455.7393,2455.7531,1,73672179,73672593,414,0.5499540195470304
29718,2455.791033,2455.796133,1,73673730,73673883,153,0.41375549465400796
29719,2455.802867,2455.8198,1,73674086,73674594,508,0.5297143079012824
29720,2455.839867,2455.854833,1,73675196,73675644,448,0.5603817376917315
29721,2455.8567,2455.867767,1,73675701,73676033,332,0.8061914157311796
29722,2455.9049,2455.9125,1,73677147,73677375,228,0.6207425278319636
29723,2455.9149,2455.9247,1,73677447,73677741,294,0.5645721809136272
29724,2455.948633,2455.954133,1,73678458,73678623,165,0.530393231584117
29725,2455.9614,2455.970733,1,73678842,73679121,279,0.617865990139652
29726,2456.3946,2456.399467,1,73691838,73691984,146,-0.09322261364824959
29727,2456.4218,2456.435967,1,73692654,73693079,425,0.559583278841405
29728,2456.4387,2456.4488,1,73693161,73693464,303,0.6685537471730019
29729,2456.451433,2456.5422,1,73693542,73696266,2724,0.8331442996391307
29730,2456.559667,2456.5641,1,73696790,73696923,133,0.6966194795937185
29731,2456.583267,2456.593867,1,73697498,73697816,318,-0.0017004801109723774
29732,2456.598,2456.6049,1,73697940,73698147,207,0.2938144053963847
29733,2456.605933,2456.6092,1,73698177,73698276,99,
29734,2456.6182,2456.624867,1,73698546,73698746,200,-0.14514033120843808
29735,2456.878133,2456.901733,1,73706343,73707051,708,0.724636191978919
29736,2456.9276,2456.935633,1,73707828,73708068,240,0.720393859390597
29737,2456.9537,2456.966433,1,73708611,73708992,381,0.7982266098257936
29738,2456.970233,2456.976967,1,73709106,73709309,203,0.6322607569432565
29739,2456.981367,2456.993867,1,73709441,73709816,375,0.6557699396344987
29740,2457.014233,2457.043467,1,73710426,73711304,878,0.8201081658113243
29741,2457.047067,2457.091267,1,73711412,73712738,1326,0.7451512150334388
29742,2457.0952,2457.1557,1,73712856,73714671,1815,0.792932806019397
29743,2457.161467,2457.224367,1,73714844,73716731,1887,0.7389151313228797
29744,2457.226967,2457.301967,1,73716809,73719059,2250,0.7443337190222006
29745,2457.8312,2457.9241,1,73734936,73737723,2787,0.8064312829818131
29746,2458.414533,2458.417967,1,73752435,73752539,104,-0.1719959517411225
29747,2458.424333,2458.4312,1,73752729,73752936,207,0.6459648562575251
29748,2458.4328,2458.5198,1,73752984,73755594,2610,0.7956152661251928
29749,2458.521633,2458.532833,1,73755648,73755984,336,0.037990610250418576
29750,2458.8915,2458.896633,1,73766745,73766898,153,0.5637464372187003
29751,2458.8994,2459.059367,1,73766982,73771781,4799,0.8167926326787457
29752,2459.078533,2459.143567,1,73772355,73774307,1952,0.768611653811187
29753,2459.241167,2459.269933,1,73777235,73778097,862,0.6742471100615518
29754,2459.282933,2459.373967,1,73778487,73781219,2732,0.8459910157857714
29755,2459.9696,2459.974867,1,73799088,73799246,158,0.4813660151268699
29756,2459.983933,2459.9973,1,73799517,73799919,402,0.6755029788067451
29757,2460.034167,2460.058333,1,73801025,73801749,724,0.9128386926894381
29758,2460.111533,2460.144167,1,73803345,73804325,980,0.897106901263173
29759,2460.1567,2460.2353,1,73804701,73807059,2358,0.6861107742110927
29760,2460.245767,2460.2668,1,73807373,73808004,631,0.7377984135742993
29761,2460.271,2460.3004,1,73808130,73809012,882,0.7802375416662082
29762,2460.6722,2460.679,1,73820166,73820370,204,0.5002220029063241
29763,2460.693333,2460.873867,1,73820799,73826216,5417,0.8165744242088339
29764,2460.893367,2460.9641,1,73826801,73828923,2122,0.7350742897372329
29765,2460.965833,2460.9691,1,73828974,73829073,99,0.5193533927779297
29766,2460.9716,2461.092567,1,73829148,73832777,3629,0.7976788796023931
29767,2461.5283,2461.545,1,73845849,73846350,501,0.6885349492334867
29768,2461.546133,2461.685867,1,73846383,73850576,4193,0.7978661875257393
29769,2461.691533,2461.7673,1,73850745,73853019,2274,0.8391707435424334
29770,2461.772533,2461.8545,1,73853175,73855635,2460,0.7440645063121695
29771,2461.858467,2461.9243,1,73855754,73857729,1975,0.7610883257230793
29772,2461.944967,2461.972133,1,73858349,73859163,814,0.7065683632756079
29773,2461.985933,2462.012767,1,73859577,73860383,806,0.8116725599503745
29774,2462.485433,2462.499667,1,73874562,73874990,428,0.7180203262382312
29775,2462.5016,2462.6594,1,73875048,73879782,4734,0.8242245285215063
29776,2462.664533,2462.6923,1,73879935,73880769,834,0.7420104498886456
29777,2462.6951,2462.731467,1,73880853,73881944,1091,0.7216148793319921
29778,2462.749233,2462.8124,1,73882476,73884372,1896,0.8310136784950827
29779,2462.8157,2462.824,1,73884471,73884720,249,0.8215099485826849
29780,2462.834333,2462.8624,1,73885029,73885872,843,0.7630698907383326
29781,2462.867867,2462.942867,1,73886036,73888286,2250,0.7349403305448169
29782,2462.9444,2462.948867,1,73888332,73888466,134,0.9608252448996514
29783,2463.079367,2463.102367,1,73892381,73893071,690,0.5781854850666062
29784,2463.1148,2463.195467,1,73893444,73895864,2420,0.8216211681625896
29785,2463.208133,2463.294767,1,73896243,73898843,2600,0.8480548105438142
29786,2463.615333,2463.627667,1,73908459,73908830,371,0.2766292622014462
29787,2463.8481,2463.8777,1,73915443,73916331,888,0.6388183486934825
29788,2463.879,2463.8842,1,73916370,73916526,156,0.5595251212875698
29789,2463.906967,2463.920667,1,73917209,73917620,411,0.7040772101955904
29790,2463.928,2463.952767,1,73917840,73918583,743,0.7281570599372276
29791,2464.405267,2464.414767,1,73932158,73932443,285,0.6694336423350524
29792,2464.418033,2464.421667,1,73932540,73932650,110,0.5650344286687424
29793,2464.429333,2464.438667,1,73932879,73933160,281,0.5121167202831146
29794,2464.463633,2464.478167,1,73933908,73934345,437,0.6464692097414552
29795,2464.512533,2464.515533,1,73935375,73935465,90,0.7784678581110483
29796,2464.534133,2464.544633,1,73936023,73936338,315,0.5754514153960039
29797,2465.015267,2465.020567,1,73950458,73950617,159,0.4943359898195595
29798,2465.031433,2465.0361,1,73950942,73951083,141,0.4615143558144335
29799,2465.0382,2465.0923,1,73951146,73952769,1623,0.7856589157674698
29800,2465.097133,2465.132867,1,73952913,73953986,1073,0.845376288411438
29801,2465.1359,2465.222,1,73954077,73956660,2583,0.8066135824889891
29802,2465.2322,2465.263233,1,73956966,73957896,930,0.732717769704871
29803,2465.678767,2465.679667,1,73970363,73970390,27,
29804,2465.698867,2465.7022,1,73970966,73971066,100,
29805,2465.703567,2465.8457,1,73971107,73975371,4264,0.702685788461049
29806,2465.853167,2465.859433,1,73975595,73975782,187,-0.27732519347278756
29807,2465.863233,2466.0249,1,73975896,73980747,4851,0.8222785679948347
29808,2466.028833,2466.047433,1,73980864,73981422,558,0.6954926341035833
29809,2466.0485,2466.100633,1,73981455,73983018,1563,0.7114622638788524
29810,2466.1118,2466.131867,1,73983354,73983956,602,0.7158444229977794
29811,2466.1403,2466.158133,1,73984209,73984743,534,0.7439203190435281
29812,2466.603133,2466.608933,1,73998093,73998267,174,0.8739864219245373
29813,2466.6126,2466.7873,1,73998378,74003619,5241,0.758970122410346
29814,2466.789467,2466.8149,1,74003684,74004447,763,0.7887726768155254
29815,2466.818,2466.8487,1,74004540,74005461,921,0.7228593987829571
29816,2466.849933,2466.856067,1,74005497,74005682,185,0.6269255168797097
29817,2466.876567,2466.946933,1,74006297,74008407,2110,0.7331929848653276
29818,2466.9527,2466.960467,1,74008581,74008814,233,0.6222341660230616
29819,2466.962133,2466.991,1,74008863,74009730,867,0.7074749881301851
29820,2468.687367,2468.7114,1,74060621,74061342,721,0.8553465072952725
29821,2468.815133,2468.827033,1,74064453,74064810,357,0.5284033175707794
29822,2468.8293,2468.832733,1,74064879,74064981,102,0.42264022206651136
29823,2468.876333,2468.881667,1,74066289,74066450,161,0.6494856678812791
29824,2468.885533,2468.893967,1,74066565,74066819,254,0.5798066453561919
29825,2469.6186,2469.623367,1,74088558,74088701,143,0.29834126030618063
29826,2469.626467,2469.6977,1,74088794,74090931,2137,0.7723204311353092
29827,2469.7015,2469.7443,1,74091045,74092329,1284,0.8737802907229578
29828,2470.2387,2470.244067,1,74107161,74107322,161,0.3563309057027074
29829,2470.310867,2470.476633,1,74109326,74114298,4972,0.8297383836686985
29830,2470.6694,2470.672767,1,74120082,74120183,101,
29831,2473.048067,2473.059167,1,74191442,74191775,333,-0.06015227533081701
29832,2473.195167,2473.439333,1,74195855,74203179,7324,0.385782988561181
29833,2473.4445,2473.6644,1,74203335,74209932,6597,0.49975835920379136
29834,2473.6792,2473.774133,1,74210376,74213223,2847,0.16681930308605544
29835,2473.803,2473.807,1,74214090,74214210,120,0.45632567273292884
29836,2473.891267,2473.8991,1,74216738,74216973,235,0.27271730794475363
29837,2473.9023,2473.9536,1,74217069,74218608,1539,0.4175760464559271
29838,2473.974267,2473.977433,1,74219228,74219322,94,-0.04574023915966608
29839,2473.9801,2473.983333,1,74219403,74219499,96,
29840,2473.984567,2473.9879,1,74219537,74219637,100,0.23382177828473383
29841,2474.1936,2474.198133,1,74225808,74225943,135,0.47729255076672367
29842,2476.018533,2476.025567,1,74280555,74280767,212,0.435372667104537
29843,2476.0278,2476.0752,1,74280834,74282256,1422,0.8400448409488976
29844,2476.076333,2476.122333,1,74282289,74283669,1380,0.8380588055589959
29845,2476.301933,2476.305133,1,74289057,74289153,96,
29846,2476.352367,2476.359833,1,74290571,74290794,223,0.17993412958925198
29847,2476.751233,2476.7585,1,74302536,74302755,219,0.11944983662990363
29848,2476.777533,2476.7823,1,74303325,74303469,144,0.6631303156326567
29849,2476.783567,2476.804867,1,74303507,74304146,639,0.4019899715638434
29850,2476.814767,2476.8243,1,74304443,74304729,286,0.271492632805026
29851,2477.127033,2477.144367,1,74313810,74314331,521,0.8465367654144498
29852,2477.145867,2477.2377,1,74314376,74317131,2755,0.8316865102562787
29853,2477.557367,2477.729067,1,74326721,74331872,5151,0.8159476238010187
29854,2477.735367,2477.744867,1,74332061,74332346,285,0.07041239057734135
29855,2477.7663,2477.771467,1,74332989,74333144,155,-0.1160166893779799
29856,2477.787167,2477.791133,1,74333615,74333733,118,-0.2347774317558489
29857,2477.855367,2477.8674,1,74335661,74336022,361,0.5266855809736478
29858,2477.872167,2477.8796,1,74336165,74336388,223,0.06406130890507995
29859,2477.883567,2477.905,1,74336507,74337150,643,0.19425026691903485
29860,2477.9096,2477.953767,1,74337288,74338613,1325,0.11332103211389119
29861,2477.959133,2477.979633,1,74338773,74339388,615,-0.07352527518532996
29862,2477.9944,2478.004433,1,74339832,74340132,300,0.5174274562640594
29863,2478.007767,2478.0127,1,74340233,74340381,148,-0.00553680311382075
29864,2478.014167,2478.0238,1,74340425,74340714,289,0.5001386704862433
29865,2478.0264,2478.0455,1,74340792,74341365,573,0.5953756401038642
29866,2478.051833,2478.0744,1,74341554,74342232,678,0.5854161753399593
29867,2478.083167,2478.122567,1,74342495,74343677,1182,0.6440334402956351
29868,2478.124867,2478.166633,1,74343746,74344998,1252,0.37441362916660037
29869,2478.172833,2478.197033,1,74345184,74345910,726,0.6469063311426156
29870,2478.1981,2478.2169,1,74345943,74346507,564,0.35667154268127443
29871,2478.224033,2478.228,1,74346720,74346840,120,0.1371832122649639
29872,2478.231067,2478.2397,1,74346932,74347191,259,-0.2351283549116053
29873,2478.2514,2478.326367,1,74347542,74349791,2249,0.1477213808581072
29874,2478.332167,2478.3489,1,74349965,74350467,502,0.0769690385188706
29875,2478.350733,2478.357833,1,74350521,74350734,213,0.22033387880577412
29876,2478.367833,2478.389233,1,74351034,74351676,642,0.3021778626593456
29877,2478.408633,2478.413533,1,74352258,74352405,147,0.41469200075258
29878,2478.428467,2478.8543,1,74352854,74365629,12775,0.48178826763614413
29879,2478.8557,2478.8671,1,74365671,74366013,342,0.3136738024572245
29880,2478.868667,2478.895533,1,74366060,74366865,805,-0.04910708790176917
29881,2478.906467,2478.9121,1,74367194,74367363,169,-0.007258604217896005
29882,2478.923267,2478.932233,1,74367698,74367966,268,0.1790751948418523
29883,2478.934333,2478.941867,1,74368029,74368256,227,0.42316390521808694
29884,2478.949367,2478.9979,1,74368481,74369937,1456,0.36608754328469845
29885,2479.0093,2479.024067,1,74370279,74370722,443,0.12350726300378054
29886,2479.0255,2479.0401,1,74370765,74371203,438,-0.021549833780741344
29887,2479.207267,2479.2134,1,74376218,74376402,184,0.15557727830894585
29888,2479.230267,2479.313433,1,74376908,74379402,2494,0.8341227310499116
29889,2479.3508,2479.361467,1,74380524,74380844,320,0.09232765106145113
29890,2479.362567,2479.3693,1,74380877,74381079,202,-0.026457477991871814
29891,2479.3716,2479.381467,1,74381148,74381444,296,0.42087663634124944
29892,2479.4104,2479.4106,1,74382312,74382318,6,
29893,2479.434633,2479.440167,1,74383038,74383205,167,0.29668181872818244
29894,2479.457033,2479.470033,1,74383710,74384100,390,0.2872987704732955
29895,2479.4726,2479.480867,1,74384178,74384426,248,0.1537199868859487
29896,2479.4858,2479.520967,1,74384574,74385629,1055,0.1436412481862609
29897,2479.5229,2479.533533,1,74385687,74386005,318,0.017745468165172883
29898,2479.563833,2479.567133,1,74386914,74387013,99,
29899,2479.5729,2479.582967,1,74387187,74387489,302,0.18621811092401702
29900,2479.596133,2479.601267,1,74387883,74388038,155,0.19823584306781686
29901,2479.604533,2479.7213,1,74388135,74391639,3504,0.7789936051092284
29902,2479.759333,2479.762933,1,74392779,74392887,108,0.11137373979170281
29903,2479.7735,2479.7837,1,74393205,74393511,306,0.13396045810718407
29904,2479.8192,2479.825833,1,74394576,74394774,198,-0.17067704256136848
29905,2479.8539,2479.860467,1,74395617,74395814,197,0.714105583920884
29906,2479.868133,2479.8983,1,74396043,74396949,906,0.2977589680291379
29907,2479.8993,2479.903533,1,74396979,74397105,126,
29908,2479.909567,2479.9197,1,74397287,74397591,304,0.06192821464260555
29909,2479.920733,2479.924333,1,74397621,74397729,108,0.12569873802080433
29910,2479.9287,2479.938733,1,74397861,74398161,300,0.041667933688199654
29911,2479.942933,2479.949633,1,74398287,74398488,201,
29912,2479.991467,2479.997033,1,74399744,74399910,166,0.6627408115158507
29913,2479.998633,2480.008033,1,74399958,74400240,282,0.6858003513909946
29914,2480.016333,2480.0436,1,74400489,74401308,819,0.7660722727282828
29915,2480.047367,2480.1026,1,74401421,74403078,1657,0.766422620914301
29916,2480.1037,2480.183,1,74403111,74405490,2379,0.6657436513203796
29917,2480.201667,2480.213967,1,74406050,74406419,369,0.6515421510841493
29918,2480.227867,2480.233433,1,74406836,74407002,166,0.05336812569037902
29919,2480.2484,2480.2688,1,74407452,74408064,612,0.24373153656751118
29920,2480.2698,2480.274667,1,74408094,74408240,146,0.09459440562368188
29921,2480.2758,2480.283233,1,74408274,74408496,222,-0.037885661188717265
29922,2480.3444,2480.350133,1,74410332,74410503,171,0.7057273241245414
29923,2480.3669,2480.3895,1,74411007,74411685,678,0.5369831422417568
29924,2480.401767,2480.4122,1,74412053,74412366,313,0.4332179708958734
29925,2480.4187,2480.425467,1,74412561,74412764,203,0.2751692421916593
29926,2480.428667,2480.436367,1,74412860,74413091,231,0.04767151597479485
29927,2480.491033,2480.614467,1,74414730,74418434,3704,0.7858692013800233
29928,2480.9503,2481.078267,1,74428509,74432348,3839,0.6228640245836797
29929,2481.0852,2481.162533,1,74432556,74434875,2319,0.6502873750638861
29930,2481.169733,2481.179633,1,74435091,74435388,297,0.4746996993755693
29931,2481.1849,2481.193467,1,74435547,74435804,257,0.6202129659665876
29932,2481.201367,2481.219367,1,74436041,74436581,540,0.6647419339202045
29933,2481.2381,2481.242333,1,74437143,74437269,126,0.48365171739475066
29934,2481.246133,2481.2753,1,74437383,74438259,876,0.06060360452489283
29935,2481.276367,2481.3095,1,74438291,74439285,994,0.25482446757314825
29936,2481.3312,2481.339933,1,74439936,74440197,261,0.5639759198838656
29937,2481.341,2481.483867,1,74440230,74444516,4286,0.808493838694882
29938,2481.4954,2481.516,1,74444862,74445480,618,0.7721403555732275
29939,2481.524433,2481.549933,1,74445732,74446497,765,0.754698400335182
29940,2481.5518,2481.554967,1,74446554,74446649,95,0.591126911038532
29941,2481.560633,2481.575267,1,74446818,74447258,440,0.49725821204017157
29942,2481.6254,2481.632433,1,74448762,74448972,210,-0.3355934364583302
29943,2481.638833,2481.643367,1,74449164,74449301,137,0.144006906989154
29944,2481.659833,2481.6718,1,74449794,74450154,360,0.3235123919799255
29945,2481.758,2481.879667,1,74452740,74456390,3650,0.8506632121041349
29946,2481.922267,2481.928367,1,74457668,74457851,183,0.30755012824365957
29947,2481.93,2481.936967,1,74457900,74458109,209,0.7306946234972019
29948,2481.939767,2481.953667,1,74458193,74458610,417,0.14095787879861707
29949,2482.210667,2482.216967,1,74466320,74466509,189,0.5059664930283272
29950,2482.2284,2482.246033,1,74466852,74467380,528,0.2892169744631999
29951,2482.269567,2482.275733,1,74468087,74468271,184,0.1770864693421071
29952,2482.335,2482.340167,1,74470050,74470205,155,0.11621065350762982
29953,2482.343667,2482.383967,1,74470310,74471519,1209,0.3006754533069253
29954,2482.408133,2482.412233,1,74472243,74472366,123,
29955,2482.414233,2482.4207,1,74472426,74472621,195,-0.08210494086974103
29956,2482.475333,2482.5321,1,74474259,74475963,1704,0.5492634616017171
29957,2482.5354,2482.5681,1,74476062,74477043,981,0.7861842646243801
29958,2482.581133,2482.620333,1,74477433,74478609,1176,0.8191849649282953
29959,2482.627233,2482.701867,1,74478816,74481056,2240,0.803782906558178
29960,2482.703033,2482.733133,1,74481090,74481993,903,0.7507055137055005
29961,2482.741167,2482.757,1,74482235,74482710,475,0.5875397627828118
29962,2482.7834,2482.800033,1,74483502,74484000,498,0.12175933376238393
29963,2482.806867,2482.817167,1,74484206,74484515,309,0.03850266841754287
29964,2482.848167,2482.898033,1,74485445,74486940,1495,0.3925468590483797
29965,2482.904033,2482.938233,1,74487120,74488146,1026,0.1257945739163548
29966,2482.947667,2482.9548,1,74488430,74488644,214,0.25867691622770245
29967,2482.961233,2482.964833,1,74488836,74488944,108,0.6714425234082189
29968,2482.968967,2483.0963,1,74489069,74492889,3820,0.853769551595127
29969,2483.4002,2483.409333,1,74502006,74502279,273,0.7408266256574759
29970,2483.410533,2483.425267,1,74502315,74502758,443,0.6897529495524175
29971,2483.427033,2483.438,1,74502810,74503140,330,0.805981572442524
29972,2483.4667,2483.474267,1,74504001,74504228,227,0.6156511670897802
29973,2483.498567,2483.5091,1,74504957,74505273,316,0.8319745502244462
29974,2483.526333,2483.5369,1,74505789,74506107,318,0.6634113615449907
29975,2483.560733,2483.579433,1,74506821,74507382,561,0.2580274000901182
29976,2483.583967,2483.6438,1,74507519,74509314,1795,0.10280624481094863
29977,2483.661267,2483.674133,1,74509838,74510223,385,0.5911051835201437
29978,2483.675567,2483.773933,1,74510267,74513217,2950,0.7917980951296847
29979,2483.807333,2483.824167,1,74514219,74514725,506,0.39596961530168734
29980,2483.841633,2483.853067,1,74515248,74515592,344,0.1643193413802854
29981,2483.857533,2483.861,1,74515725,74515830,105,0.3252021835221264
29982,2483.8779,2483.8867,1,74516337,74516601,264,-0.0810593293577433
29983,2483.919833,2483.930467,1,74517594,74517914,320,0.5853497778098432
29984,2483.9358,2483.991267,1,74518074,74519738,1664,0.1470288453804012
29985,2483.992333,2484.014833,1,74519769,74520444,675,0.24313085410884408
29986,2484.027467,2484.1814,1,74520824,74525442,4618,0.8288878055917522
29987,2484.183267,2484.237033,1,74525498,74527110,1612,0.8298479127043302
29988,2484.244567,2484.254767,1,74527337,74527643,306,0.6211331338908691
29989,2484.258333,2484.291433,1,74527749,74528742,993,0.7335794671228548
29990,2484.3209,2484.325567,1,74529627,74529767,140,0.32581881734878776
29991,2484.333333,2484.367233,1,74529999,74531016,1017,0.06470022483906582
29992,2484.375067,2484.383767,1,74531252,74531513,261,0.002241605499455734
29993,2484.415233,2484.458,1,74532456,74533740,1284,0.22740803248300162
29994,2484.4624,2484.525067,1,74533872,74535752,1880,0.0778298410092509
29995,2484.526633,2484.531333,1,74535798,74535939,141,0.5140085982739917
29996,2484.535333,2484.5409,1,74536059,74536227,168,0.25908599645377867
29997,2484.541967,2484.556867,1,74536259,74536706,447,0.22643855777094024
29998,2484.562733,2484.636567,1,74536881,74539097,2216,0.4727648387106433
29999,2484.6441,2484.666833,1,74539323,74540004,681,0.42755750015888805
30000,2484.668,2484.672533,1,74540040,74540175,135,-0.4828567481399906
30001,2484.677667,2484.681733,1,74540330,74540451,121,-0.16270659623588188
30002,2484.683,2484.711433,1,74540490,74541342,852,0.6644669108242774
30003,2484.719767,2484.7486,1,74541593,74542458,865,0.6819448633279137
30004,2484.759367,2484.895033,1,74542781,74546850,4069,0.5925872228554514
30005,2484.896733,2484.9139,1,74546901,74547417,516,0.11353059355647084
30006,2484.915033,2484.926667,1,74547450,74547800,350,-0.09342207824658562
30007,2484.936467,2484.960433,1,74548094,74548812,718,0.22656151530318588
30008,2484.964533,2484.986133,1,74548935,74549583,648,0.25620337498860846
30009,2484.994667,2485.002633,1,74549840,74550078,238,0.3105870088054772
30010,2485.0046,2485.012033,1,74550138,74550360,222,-0.006379694759354413
30011,2485.0231,2485.026333,1,74550693,74550789,96,
30012,2485.0382,2485.433567,1,74551146,74563007,11861,0.4050372019369356
30013,2485.524933,2485.5357,1,74565747,74566071,324,0.2662895114659601
30014,2485.538167,2485.541567,1,74566145,74566247,102,0.7843702583133856
30015,2485.659033,2485.6678,1,74569770,74570034,264,0.31700954211568116
30016,2485.677567,2485.7776,1,74570327,74573328,3001,0.8335695799147795
30017,2485.792033,2485.799533,1,74573760,74573985,225,0.7202824855105641
30018,2485.819933,2485.857867,1,74574597,74575736,1139,0.02298409676273425
30019,2485.866967,2485.878567,1,74576009,74576357,348,0.1630519442929545
30020,2485.891933,2485.8969,1,74576757,74576907,150,0.6636021150094886
30021,2485.902367,2485.946033,1,74577071,74578380,1309,0.17451421220206453
30022,2485.948267,2485.9801,1,74578448,74579403,955,0.11137218874764088
30023,2486.004933,2486.1252,1,74580147,74583756,3609,0.8018440824986081
30024,2486.1285,2486.132267,1,74583855,74583968,113,0.27765182824787515
30025,2486.148533,2486.152233,1,74584455,74584566,111,0.1565104729729815
30026,2486.1629,2486.167933,1,74584887,74585037,150,0.6830527835202527
30027,2486.179367,2486.184633,1,74585381,74585538,157,-0.08410251593579501
30028,2486.2795,2486.282567,1,74588385,74588477,92,0.07061817907553165
30029,2486.287633,2486.293,1,74588628,74588790,162,0.5173906440177131
30030,2486.556733,2486.5714,1,74596701,74597142,441,0.6986948513410703
30031,2486.6063,2486.614367,1,74598189,74598431,242,0.8283882518672172
30032,2486.615633,2486.6193,1,74598468,74598579,111,0.13464824302021952
30033,2486.628,2486.680833,1,74598840,74600424,1584,0.7352170751841146
30034,2486.690933,2486.7471,1,74600727,74602413,1686,0.740208730789335
30035,2486.748633,2486.7753,1,74602458,74603259,801,0.8588613799682843
30036,2486.778867,2486.782167,1,74603366,74603465,99,0.6099496530959333
30037,2486.793233,2486.806,1,74603796,74604180,384,0.7054504650990737
30038,2486.839667,2486.856333,1,74605190,74605689,499,0.19663638626895572
30039,2486.8591,2486.871233,1,74605773,74606136,363,0.3341859747675353
30040,2486.882667,2486.8912,1,74606480,74606736,256,0.061554436525071275
30041,2486.9123,2486.915767,1,74607369,74607473,104,0.588380423753072
30042,2486.9248,2486.929333,1,74607744,74607879,135,0.44724864477861964
30043,2486.948233,2486.991133,1,74608446,74609733,1287,0.6291622914895462
30044,2486.997733,2487.006233,1,74609931,74610186,255,0.2014109251660613
30045,2487.0079,2487.0182,1,74610237,74610546,309,0.4352817577449051
30046,2487.025467,2487.033233,1,74610764,74610996,232,0.6424456139007843
30047,2487.1535,2487.1653,1,74614605,74614959,354,0.39958797940170104
30048,2487.1736,2487.1818,1,74615208,74615454,246,-0.0519498886591536
30049,2487.1889,2487.1939,1,74615667,74615817,150,
30050,2487.1949,2487.1983,1,74615847,74615949,102,
30051,2487.201633,2487.210733,1,74616048,74616321,273,0.5075987021792527
30052,2487.212067,2487.2413,1,74616362,74617239,877,0.8885602914012296
30053,2487.244533,2487.2637,1,74617335,74617911,576,0.5390798607314284
30054,2487.273833,2487.298767,1,74618214,74618963,749,0.7362070830918558
30055,2487.4443,2487.452633,1,74623329,74623578,249,-0.13731745498841796
30056,2487.4605,2487.542933,1,74623815,74626287,2472,0.5027227363353659
30057,2487.5463,2487.551433,1,74626389,74626542,153,0.4528852027536206
30058,2487.555533,2487.560367,1,74626665,74626811,146,0.05790126322307767
30059,2487.6162,2487.670333,1,74628486,74630109,1623,0.7787292296772953
30060,2487.6714,2487.728267,1,74630142,74631848,1706,0.73364294496938
30061,2487.733067,2487.736767,1,74631992,74632103,111,-0.07047588828740721
30062,2487.759333,2487.7654,1,74632779,74632962,183,-0.25532826990006874
30063,2487.795767,2487.800267,1,74633873,74634008,135,-0.006693306366280227
30064,2487.844667,2487.8504,1,74635340,74635512,172,-0.04259071585945536
30065,2487.878433,2487.945933,1,74636352,74638377,2025,0.4624752964900547
30066,2487.968533,2487.982067,1,74639055,74639462,407,0.18772802986460463
30067,2488.063267,2488.179,1,74641898,74645370,3472,0.7189416510423198
30068,2488.2184,2488.225367,1,74646552,74646761,209,0.350454828109464
30069,2488.2329,2488.236633,1,74646987,74647098,111,
30070,2488.2564,2488.2723,1,74647692,74648169,477,0.5126939138452111
30071,2488.275767,2488.280733,1,74648273,74648421,148,0.4377895222035606
30072,2488.291333,2488.352,1,74648739,74650560,1821,0.5705749858899953
30073,2488.3896,2488.394433,1,74651688,74651832,144,0.4294367543267687
30074,2488.398133,2488.4035,1,74651943,74652105,162,-0.1348060230547179
30075,2488.4059,2488.409767,1,74652177,74652293,116,0.6984391682015483
30076,2488.411067,2488.567333,1,74652332,74657019,4687,0.8090479409333332
30077,2488.6785,2488.792033,1,74660355,74663760,3405,0.5630019849196342
30078,2489.141567,2489.149567,1,74674247,74674487,240,0.1892363227855712
30079,2489.158167,2489.161233,1,74674745,74674836,91,0.3421396297745148
30080,2489.173933,2489.178433,1,74675217,74675352,135,0.5792977214299667
30081,2489.2049,2489.216833,1,74676147,74676504,357,0.30911481787071665
30082,2489.2204,2489.230467,1,74676612,74676914,302,0.5593429476976671
30083,2489.232,2489.2397,1,74676960,74677191,231,0.6178727720059879
30084,2489.261267,2489.2667,1,74677838,74678001,163,0.6277298392358296
30085,2489.268433,2489.273467,1,74678052,74678204,152,0.43180571149624886
30086,2489.3179,2489.322233,1,74679537,74679666,129,0.42760844684021804
30087,2489.333067,2489.341967,1,74679992,74680259,267,0.483953093682944
30088,2489.3706,2489.3809,1,74681118,74681427,309,0.5482437235252682
30089,2489.3893,2489.3949,1,74681679,74681847,168,0.39206411656236634
30090,2489.434967,2489.438433,1,74683049,74683152,103,0.40857982516958674
30091,2489.441633,2489.453267,1,74683248,74683598,350,0.40772514090715695
30092,2489.488367,2489.495967,1,74684651,74684879,228,0.5216864178312691
30093,2489.5037,2489.5115,1,74685111,74685345,234,0.5466107093028948
30094,2489.520033,2489.53,1,74685600,74685900,300,0.5071523324519854
30095,2489.5591,2489.563633,1,74686773,74686908,135,0.5644116344032771
30096,2489.627733,2489.707467,1,74688831,74691224,2393,0.7005321957375538
30097,2489.7109,2489.744167,1,74691327,74692325,998,0.743624846282092
30098,2489.756567,2489.7657,1,74692697,74692971,274,0.42762791717736826
30099,2489.780833,2489.7859,1,74693424,74693577,153,-0.0387890148232806
30100,2489.7957,2489.801733,1,74693871,74694051,180,-0.03167470838665183
30101,2489.8036,2489.811033,1,74694108,74694330,222,0.07255576887119818
30102,2489.8207,2489.825567,1,74694621,74694767,146,-0.5960055191010709
30103,2489.8676,2489.871367,1,74696028,74696141,113,0.6162053305179647
30104,2489.883333,2489.897167,1,74696499,74696915,416,0.2082671456112125
30105,2489.898333,2489.9572,1,74696949,74698716,1767,0.11419014253524815
30106,2489.993233,2489.999067,1,74699796,74699972,176,0.06973232885568738
30107,2490.0133,2490.379667,1,74700399,74711390,10991,0.3689500503175782
30108,2490.380733,2490.524333,1,74711421,74715729,4308,0.29510132954068763
30109,2490.526567,2490.5747,1,74715797,74717241,1444,0.23230602148447843
30110,2490.582367,2490.667067,1,74717471,74720012,2541,0.2633256124702704
30111,2490.6751,2490.698967,1,74720253,74720969,716,0.21336697451251688
30112,2490.7,2490.729767,1,74721000,74721893,893,0.12469165374774076
30113,2490.7376,2490.903167,1,74722128,74727095,4967,0.7774330862790046
30114,2490.905667,2490.910533,1,74727170,74727315,145,0.26159300166803684
30115,2490.9118,2490.919167,1,74727354,74727575,221,0.00670062170873482
30116,2490.9223,2490.944833,1,74727669,74728344,675,0.7369715548640685
30117,2491.2415,2491.276667,1,74737245,74738300,1055,0.6912809882480705
30118,2491.2808,2491.285433,1,74738424,74738562,138,0.171175409304302
30119,2491.2907,2491.298967,1,74738721,74738969,248,-0.0715608593778101
30120,2491.301,2491.314867,1,74739030,74739446,416,0.5745241996826544
30121,2491.321967,2491.335333,1,74739659,74740059,400,0.449735064155742
30122,2491.373267,2491.404067,1,74741198,74742122,924,0.5760993243905043
30123,2491.418,2491.4351,1,74742540,74743053,513,0.4782333513931539
30124,2491.4851,2491.490333,1,74744553,74744709,156,0.6588772861997915
30125,2491.492233,2491.5009,1,74744766,74745027,261,0.5730095041030049
30126,2491.526033,2491.5373,1,74745780,74746119,339,0.5085160622175664
30127,2491.544033,2491.5518,1,74746320,74746554,234,0.49999368019759216
30128,2491.576433,2491.582533,1,74747292,74747475,183,0.11155411404021892
30129,2491.5905,2491.6117,1,74747715,74748351,636,0.04543698464726625
30130,2491.613167,2491.645433,1,74748395,74749362,967,0.21088475089458025
30131,2491.665633,2491.6803,1,74749968,74750409,441,0.34504680007319005
30132,2491.6831,2491.717633,1,74750493,74751528,1035,0.7533286954674372
30133,2491.7276,2491.765667,1,74751828,74752970,1142,0.733126495240176
30134,2491.7733,2491.7802,1,74753199,74753406,207,0.41156721447941913
30135,2491.7834,2491.786467,1,74753502,74753594,92,
30136,2491.803,2491.816867,1,74754090,74754506,416,-0.07061953085346616
30137,2491.8241,2491.830267,1,74754723,74754908,185,0.42654169622397686
30138,2491.831467,2491.835333,1,74754944,74755059,115,-0.11996804022884038
30139,2491.836533,2491.8435,1,74755095,74755305,210,0.2512132447069723
30140,2492.471167,2492.5239,1,74774135,74775717,1582,0.5459707517695395
30141,2492.5252,2492.530933,1,74775756,74775927,171,-0.15937899745857684
30142,2492.537633,2492.542033,1,74776128,74776260,132,-0.0404197853709378
30143,2492.562467,2492.5667,1,74776874,74777001,127,-0.15152869244221553
30144,2492.7938,2492.796967,1,74783814,74783909,95,0.44984675539684565
30145,2492.819267,2492.824067,1,74784578,74784722,144,0.5348696582794084
30146,2492.833867,2492.8532,1,74785016,74785596,580,0.6908147571457771
30147,2492.861867,2492.871433,1,74785856,74786142,286,0.40302276069685433
30148,2492.918233,2492.9365,1,74787546,74788095,549,0.7039024213522573
30149,2492.9584,2493.016167,1,74788752,74790485,1733,0.7370810347819056
30150,2493.032267,2493.035367,1,74790968,74791061,93,0.7879794270670253
30151,2493.043033,2493.065433,1,74791290,74791962,672,0.7907404640276915
30152,2493.070033,2493.073967,1,74792100,74792219,119,-0.11092554707241349
30153,2493.0765,2493.0822,1,74792295,74792466,171,0.26104780252047394
30154,2493.0911,2493.114167,1,74792733,74793425,692,-0.09714783839178227
30155,2493.115567,2493.1496,1,74793467,74794488,1021,0.17219453726671205
30156,2493.164233,2493.170633,1,74794926,74795118,192,0.8620622682549598
30157,2493.172467,2493.3198,1,74795174,74799594,4420,0.7455775126382337
30158,2493.325167,2493.41,1,74799755,74802300,2545,0.7526084663425062
30159,2493.504667,2493.5701,1,74805140,74807103,1963,0.6794120835006716
30160,2493.5711,2493.577967,1,74807133,74807339,206,-0.1411368447234058
30161,2493.5908,2493.594733,1,74807724,74807841,117,0.7822124461784765
30162,2493.596367,2493.602867,1,74807891,74808086,195,-0.0594541423106528
30163,2493.835667,2493.8639,1,74815070,74815917,847,0.5810052106129223
30164,2493.877367,2493.931767,1,74816321,74817953,1632,0.7829873836743165
30165,2493.940533,2494.012633,1,74818215,74820378,2163,0.5682552051759797
30166,2494.0201,2494.042433,1,74820603,74821272,669,0.6680859212740186
30167,2494.0435,2494.094633,1,74821305,74822838,1533,0.6678945635432325
30168,2494.103567,2494.154167,1,74823107,74824625,1518,0.7198619950177803
30169,2494.1664,2494.216067,1,74824992,74826482,1490,0.14326799813420207
30170,2494.217167,2494.230467,1,74826515,74826914,399,-0.007685219791918623
30171,2494.2317,2494.439,1,74826951,74833170,6219,0.7617535813072223
30172,2494.471233,2494.4755,1,74834136,74834265,129,0.15488647318611742
30173,2494.500767,2494.5956,1,74835023,74837868,2845,0.6659283643180761
30174,2494.599033,2494.604133,1,74837970,74838123,153,0.20712595449704424
30175,2494.614167,2494.618433,1,74838425,74838552,127,0.6408786968277611
30176,2494.850167,2494.8726,1,74845505,74846178,673,0.7085708644122768
30177,2494.8821,2494.885267,1,74846463,74846558,95,0.6539624305765025
30178,2494.886767,2494.909133,1,74846603,74847273,670,0.7700342102918232
30179,2494.922033,2494.977267,1,74847660,74849318,1658,0.773796163158861
30180,2494.9858,2495.0365,1,74849574,74851095,1521,0.7901167368806256
30181,2495.037533,2495.084733,1,74851125,74852541,1416,0.7383008994257839
30182,2495.088267,2495.091267,1,74852648,74852738,90,-0.09703635460160337
30183,2495.1091,2495.1985,1,74853273,74855955,2682,0.7663168764727719
30184,2495.2021,2495.365667,1,74856063,74860970,4907,0.4070353851138529
30185,2495.367267,2495.376333,1,74861018,74861289,271,0.4288494013176643
30186,2495.4074,2495.411567,1,74862222,74862347,125,0.8505775404058431
30187,2495.438,2495.4422,1,74863140,74863266,126,0.3399674504163363
30188,2495.444533,2495.448167,1,74863335,74863445,110,0.36845592352533557
30189,2495.4492,2495.4524,1,74863476,74863572,96,0.6987756919304124
30190,2495.542867,2495.549733,1,74866286,74866491,205,0.5048975459205418
30191,2495.770933,2495.779233,1,74873127,74873376,249,0.33679078604243134
30192,2495.8005,2495.841467,1,74874015,74875244,1229,0.7834435621782444
30193,2495.848367,2495.902767,1,74875451,74877083,1632,0.7571133169740785
30194,2495.911133,2495.941833,1,74877333,74878254,921,0.6978127359724784
30195,2495.942867,2495.9862,1,74878286,74879586,1300,0.7188497826552536
30196,2495.987467,2496.035333,1,74879624,74881059,1435,0.7341827624000766
30197,2496.039867,2496.056767,1,74881196,74881703,507,0.6620567565904693
30198,2496.062967,2496.085367,1,74881889,74882561,672,0.5144097545782114
30199,2496.088833,2496.1029,1,74882664,74883087,423,0.8456837150574552
30200,2496.104133,2496.107833,1,74883123,74883234,111,0.7549585843180148
30201,2496.112733,2496.182033,1,74883381,74885460,2079,0.7209483182337375
30202,2496.2089,2496.218533,1,74886267,74886555,288,0.8210753675669629
30203,2496.2278,2496.232,1,74886834,74886960,126,0.8852638976982085
30204,2496.2377,2496.245633,1,74887131,74887368,237,0.33595490326035743
30205,2496.247267,2496.297767,1,74887418,74888933,1515,0.7531259110577276
30206,2496.301,2496.323533,1,74889030,74889705,675,0.742435551073706
30207,2496.325367,2496.434,1,74889761,74893020,3259,0.4258736193200886
30208,2496.4534,2496.4651,1,74893602,74893953,351,0.12488265699696084
30209,2496.4685,2496.475067,1,74894055,74894252,197,0.6226946085026733
30210,2496.4761,2496.4904,1,74894283,74894712,429,0.5362103272800982
30211,2496.6727,2496.6797,1,74900181,74900391,210,0.6788967287128046
30212,2496.681033,2496.724567,1,74900430,74901737,1307,0.20146954209838086
30213,2496.7362,2496.7405,1,74902086,74902215,129,0.8449269150881842
30214,2496.761433,2496.799667,1,74902842,74903990,1148,0.7377245023484523
30215,2496.829833,2496.8755,1,74904894,74906265,1371,0.6946790887886931
30216,2496.896333,2496.973933,1,74906889,74909217,2328,0.745512470323266
30217,2496.976133,2496.999167,1,74909283,74909975,692,0.5159526284696629
30218,2497.0005,2497.0088,1,74910015,74910264,249,0.6310349675791617
30219,2497.0104,2497.067,1,74910312,74912010,1698,0.8319106664125218
30220,2497.0732,2497.0872,1,74912196,74912616,420,0.6501044591815873
30221,2497.096133,2497.103833,1,74912883,74913114,231,0.49873269239345175
30222,2497.108267,2497.111633,1,74913248,74913348,100,0.12943558004468206
30223,2497.144567,2497.154733,1,74914337,74914641,304,-0.05775660297510878
30224,2497.255667,2497.329033,1,74917670,74919870,2200,0.3308285071486265
30225,2497.330333,2497.338567,1,74919909,74920157,248,-0.026059779821611766
30226,2497.348233,2497.354033,1,74920446,74920620,174,0.5908812174913235
30227,2497.3594,2497.367833,1,74920782,74921034,252,-0.12250296385596951
30228,2497.651633,2497.6565,1,74929548,74929695,147,0.7735145284372612
30229,2497.6794,2497.718333,1,74930382,74931549,1167,0.6980959005865472
30230,2497.754867,2497.771867,1,74932646,74933156,510,0.7382620418405056
30231,2497.7907,2497.834133,1,74933721,74935023,1302,0.2887617808550791
30232,2497.856333,2497.883267,1,74935689,74936498,809,0.4889497955454547
30233,2497.894267,2497.898833,1,74936828,74936964,136,0.8290615722172912
30234,2497.901533,2497.906333,1,74937045,74937189,144,-0.3456450034737859
30235,2497.911167,2497.9608,1,74937335,74938824,1489,0.16669041166981569
30236,2497.9815,2498.127033,1,74939445,74943810,4365,0.7457971373687926
30237,2498.144633,2498.1615,1,74944338,74944845,507,0.6978288128540044
30238,2498.1679,2498.2735,1,74945037,74948205,3168,0.7471136794763725
30239,2498.278,2498.2978,1,74948340,74948934,594,-0.015337887855490564
30240,2498.395933,2498.448867,1,74951877,74953466,1589,0.5226000070478724
30241,2498.472833,2498.482,1,74954184,74954460,276,0.08757713807229256
30242,2498.488833,2498.495233,1,74954664,74954856,192,0.5260019585970528
30243,2498.5361,2498.549933,1,74956083,74956497,414,0.6235907312482389
30244,2498.551467,2498.640433,1,74956544,74959212,2668,0.7798341366551761
30245,2498.659567,2498.669,1,74959787,74960070,283,-0.11340103065959853
30246,2498.6804,2498.688,1,74960412,74960640,228,-0.11216723823943069
30247,2498.693767,2498.7038,1,74960813,74961114,301,0.1676205598961661
30248,2498.7339,2498.768133,1,74962017,74963043,1026,0.5958122403119023
30249,2498.7774,2498.783233,1,74963322,74963496,174,0.26843083169960685
30250,2498.799233,2498.803467,1,74963976,74964104,128,0.13774527827422897
30251,2498.807967,2498.8142,1,74964239,74964426,187,-0.07380495518074319
30252,2498.843733,2498.8484,1,74965311,74965452,141,0.34745565132180156
30253,2498.849767,2499.002733,1,74965493,74970081,4588,0.7903352106855832
30254,2499.004067,2499.019133,1,74970122,74970573,451,0.872099326191032
30255,2499.027067,2499.100467,1,74970812,74973014,2202,0.7515628274327911
30256,2499.119933,2499.214833,1,74973597,74976444,2847,0.7432964149353032
30257,2499.222133,2499.2259,1,74976663,74976777,114,-0.2537745122385924
30258,2499.2379,2499.278533,1,74977137,74978355,1218,0.5542998674371185
30259,2499.2843,2499.296767,1,74978529,74978903,374,0.21277555598418613
30260,2499.315067,2499.321867,1,74979452,74979656,204,-0.18464727745470946
30261,2499.331767,2499.336033,1,74979953,74980080,127,
30262,2499.347,2499.3573,1,74980410,74980719,309,0.7675586960437384
30263,2499.360067,2499.4332,1,74980802,74982996,2194,0.6961679802005767
30264,2499.4499,2499.486367,1,74983497,74984591,1094,0.7745458970508661
30265,2499.500367,2499.5264,1,74985011,74985792,781,0.5542238902721789
30266,2499.528233,2499.564233,1,74985846,74986926,1080,0.767017691469553
30267,2499.585967,2499.589833,1,74987579,74987694,115,0.6931551535962416
30268,2499.591733,2499.664733,1,74987751,74989941,2190,0.6896551838722379
30269,2499.668267,2499.691267,1,74990048,74990738,690,0.6137162021813913
30270,2499.6943,2499.7913,1,74990829,74993739,2910,0.7601016752348501
30271,2499.794267,2499.802067,1,74993828,74994062,234,0.7767008794297091
30272,2499.805233,2499.810067,1,74994156,74994302,146,0.6745894398418243
30273,2499.8111,2499.8889,1,74994333,74996667,2334,0.7999521634363466
30274,2499.8923,2499.895533,1,74996769,74996865,96,0.04165287309636122
30275,2499.897167,2499.904633,1,74996915,74997138,223,0.3048069559365019
30276,2499.920967,2499.972767,1,74997629,74999183,1554,0.696335039359184
30277,2499.982667,2500.008333,1,74999480,75000249,769,0.8029116092365807
30278,2500.0116,2500.016533,1,75000348,75000495,147,0.1666657396508923
30279,2500.039967,2500.093167,1,75001199,75002795,1596,0.6989668435015773
30280,2500.094867,2500.1259,1,75002846,75003777,931,0.7628803021299486
30281,2500.1297,2500.133867,1,75003891,75004016,125,0.3759086449510337
30282,2500.137567,2500.142033,1,75004127,75004260,133,0.6527964932894627
30283,2500.159267,2500.179233,1,75004778,75005376,598,0.6594001836551918
30284,2500.181167,2500.2124,1,75005435,75006372,937,0.6744051230719986
30285,2500.227233,2500.246933,1,75006816,75007407,591,0.7290773284073391
30286,2500.2526,2500.264367,1,75007578,75007931,353,0.12202587745889514
30287,2500.282033,2500.301367,1,75008460,75009041,581,0.7230454594016811
30288,2500.303067,2500.319633,1,75009092,75009588,496,0.8286002581999429
30289,2500.321633,2500.3351,1,75009648,75010053,405,0.7636947159256116
30290,2500.3613,2500.371567,1,75010839,75011147,308,0.7774567597055835
30291,2500.3767,2500.3803,1,75011301,75011409,108,-0.025924525130472775
30292,2500.3873,2500.392367,1,75011619,75011771,152,0.6765441633986331
30293,2500.4064,2500.460967,1,75012192,75013829,1637,0.7305612810148309
30294,2500.4705,2500.494567,1,75014115,75014837,722,0.8459918707649703
30295,2500.499,2500.5145,1,75014970,75015435,465,0.25256469253624275
30296,2500.5257,2500.5871,1,75015771,75017613,1842,0.695136339602509
30297,2500.608433,2500.618133,1,75018252,75018543,291,0.7564465401748626
30298,2500.623433,2500.628567,1,75018702,75018857,155,0.1497227470836294
30299,2500.6312,2500.638867,1,75018936,75019166,230,0.4394775525522591
30300,2500.653367,2500.688467,1,75019601,75020654,1053,0.709832123782262
30301,2500.6912,2500.7081,1,75020736,75021243,507,0.8030478858439108
30302,2500.718733,2500.744133,1,75021561,75022323,762,0.8194770841638701
30303,2500.748433,2500.763133,1,75022452,75022893,441,0.339961932540846
30304,2500.7787,2500.8546,1,75023361,75025638,2277,0.8065611672496014
30305,2500.856733,2500.8694,1,75025701,75026082,381,0.850837141261101
30306,2500.872767,2500.8974,1,75026183,75026922,739,0.6805573806346655
30307,2500.8997,2500.977467,1,75026991,75029324,2333,0.7769835313972345
30308,2500.979267,2500.993233,1,75029378,75029796,418,0.851009713783621
30309,2500.995867,2501.022267,1,75029876,75030668,792,0.7457085629150987
30310,2501.0244,2501.119133,1,75030732,75033573,2841,0.7892304127981614
30311,2501.121833,2501.148233,1,75033654,75034446,792,0.5509416776608912
30312,2501.1516,2501.248033,1,75034548,75037440,2892,0.7931213870786226
30313,2501.251467,2501.255467,1,75037544,75037664,120,0.24037348134123673
30314,2501.2567,2501.2777,1,75037701,75038331,630,0.31864641770657776
30315,2501.280367,2501.3775,1,75038411,75041325,2914,0.7712781621660412
30316,2501.378967,2501.402367,1,75041369,75042071,702,0.701774416799586
30317,2501.4083,2501.489767,1,75042249,75044693,2444,0.7333132064073635
30318,2501.4941,2501.505933,1,75044823,75045177,354,0.7451346029586583
30319,2501.519967,2501.5356,1,75045599,75046068,469,0.7243822788624636
30320,2501.539633,2501.6081,1,75046188,75048243,2055,0.7116883311344124
30321,2501.615767,2501.628333,1,75048473,75048849,376,0.548471914879983
30322,2501.638133,2501.648433,1,75049143,75049452,309,0.7541905112698835
30323,2502.191867,2502.266333,1,75065756,75067989,2233,0.439889844104157
30324,2502.276133,2502.285967,1,75068283,75068579,296,0.43699338091266643
30325,2502.2945,2502.303867,1,75068835,75069116,281,0.37080875957939874
30326,2502.313933,2502.320233,1,75069417,75069606,189,-0.10601045629912573
30327,2502.633333,2502.640867,1,75078999,75079226,227,0.6349708518964703
30328,2502.657867,2502.6756,1,75079736,75080268,532,0.745145215547399
30329,2502.700067,2502.7484,1,75081002,75082452,1450,0.7950119625541143
30330,2502.7702,2502.8081,1,75083106,75084243,1137,0.48345046629746624
30331,2502.819467,2502.828567,1,75084584,75084857,273,0.7133557767668163
30332,2502.833667,2502.9103,1,75085010,75087309,2299,0.6494739999519241
30333,2502.921467,2502.942233,1,75087644,75088266,622,0.78020910209908
30334,2502.9507,2502.967167,1,75088521,75089015,494,0.7215363719134976
30335,2502.979633,2503.053233,1,75089388,75091596,2208,0.6672562060344077
30336,2503.056,2503.059433,1,75091680,75091782,102,
30337,2503.083167,2503.1015,1,75092495,75093045,550,0.010315980903384578
30338,2503.103967,2503.270733,1,75093119,75098121,5002,0.805950541902359
30339,2503.295433,2503.308933,1,75098862,75099267,405,0.6282507190095514
30340,2503.311867,2503.330467,1,75099356,75099914,558,0.11016650604041452
30341,2503.3326,2503.343933,1,75099978,75100317,339,0.08227631315092764
30342,2503.345667,2503.372767,1,75100370,75101183,813,0.26054939167015617
30343,2503.387933,2503.396,1,75101637,75101880,243,0.5050831429803533
30344,2503.397967,2503.435433,1,75101939,75103062,1123,0.2694447765672286
30345,2503.4408,2503.458833,1,75103224,75103764,540,0.01896026771700672
30346,2503.4618,2503.4809,1,75103854,75104427,573,0.25018848069991123
30347,2503.4993,2503.730967,1,75104979,75111929,6950,0.5575509967240327
30348,2503.732033,2503.7638,1,75111960,75112914,954,0.40507372767316246
30349,2503.7669,2503.8429,1,75113007,75115287,2280,0.5518740790674975
30350,2503.848667,2503.856167,1,75115460,75115685,225,0.07217893288838118
30351,2503.862567,2503.870233,1,75115877,75116106,229,0.3612223410024413
30352,2503.8826,2503.886467,1,75116478,75116594,116,0.47448760579127797
30353,2503.888233,2503.952667,1,75116646,75118580,1934,0.347248141055412
30354,2503.954233,2504.001933,1,75118626,75120057,1431,0.32357244864258666
30355,2504.0038,2504.039,1,75120114,75121170,1056,0.2918981823570392
30356,2504.054233,2504.0749,1,75121626,75122247,621,0.0049222387808882506
30357,2504.078567,2504.089367,1,75122357,75122681,324,0.22490752195971342
30358,2504.0908,2504.094167,1,75122724,75122825,101,0.5312021228219015
30359,2504.0958,2504.110467,1,75122874,75123314,440,0.4142915697984817
30360,2504.1215,2504.127067,1,75123645,75123812,167,0.17299735571481192
30361,2504.138433,2504.2143,1,75124152,75126429,2277,0.7999355779654317
30362,2504.2167,2504.3337,1,75126501,75130011,3510,0.7773377994667702
30363,2504.3801,2504.387533,1,75131403,75131625,222,0.5418775399220075
30364,2504.392,2504.397233,1,75131760,75131916,156,-0.06733283201896319
30365,2504.462533,2504.541633,1,75133875,75136248,2373,0.5719066078004
30366,2504.807433,2504.814533,1,75144222,75144435,213,0.534197982188776
30367,2504.836367,2504.841667,1,75145091,75145250,159,0.7345894867156924
30368,2504.844,2504.848167,1,75145320,75145445,125,0.6701854658089544
30369,2504.8708,2504.891233,1,75146124,75146736,612,0.6916128228864995
30370,2504.927633,2504.932433,1,75147828,75147972,144,0.4490935353316746
30371,2504.9388,2504.952133,1,75148164,75148563,399,0.5553534492038076
30372,2505.0037,2505.010367,1,75150111,75150311,200,0.6152383271597937
30373,2505.013633,2505.0261,1,75150408,75150783,375,0.5585558200360794
30374,2505.059067,2505.0703,1,75151772,75152109,337,0.4716289475243612
30375,2505.1761,2505.256967,1,75155283,75157709,2426,0.6733271625076618
30376,2505.2618,2505.288033,1,75157854,75158640,786,0.7983968409904098
30377,2506.363167,2506.3742,1,75190895,75191226,331,0.6706387394078586
30378,2506.384133,2506.395733,1,75191523,75191871,348,0.6123960625094925
30379,2506.4251,2506.445433,1,75192753,75193362,609,0.6593123946578062
30380,2506.448467,2506.451667,1,75193454,75193550,96,-0.057278801702412174
30381,2506.541267,2506.562267,1,75196238,75196868,630,0.17985579643144975
30382,2506.571233,2506.641333,1,75197136,75199239,2103,0.6747147795080755
30383,2506.654067,2506.662767,1,75199622,75199883,261,0.28886926136413216
30384,2506.665,2506.670033,1,75199950,75200100,150,0.44003468536535295
30385,2506.681733,2506.684933,1,75200451,75200547,96,
30386,2506.687733,2506.765367,1,75200631,75202961,2330,0.7895895281612635
30387,2506.767067,2506.772067,1,75203012,75203162,150,-0.32849358568616344
30388,2506.7731,2506.776333,1,75203193,75203289,96,0.10534606993860014
30389,2506.778333,2506.781767,1,75203349,75203453,104,0.18643621627086315
30390,2506.783933,2506.787667,1,75203517,75203630,113,-0.02945544673725626
30391,2507.1525,2507.155733,1,75214575,75214671,96,0.6748976983686445
30392,2507.159033,2507.162967,1,75214770,75214889,119,0.40017238311979053
30393,2507.179533,2507.190633,1,75215385,75215718,333,0.7986692045628194
30394,2507.222333,2507.2462,1,75216669,75217386,717,0.9094135958982582
30395,2507.319367,2507.3292,1,75219581,75219876,295,0.6939541075946635
30396,2507.332967,2507.337133,1,75219989,75220113,124,0.27554123846482625
30397,2507.365,2507.3686,1,75220950,75221058,108,0.5394250788237513
30398,2507.3707,2507.387,1,75221121,75221610,489,0.6146227221502668
30399,2507.393067,2507.412333,1,75221792,75222369,577,0.0752925530311603
30400,2507.447267,2507.461067,1,75223418,75223832,414,0.7269736838891542
30401,2507.4858,2507.500033,1,75224574,75225000,426,0.6578449383387084
30402,2507.5013,2507.515933,1,75225039,75225477,438,0.6311129789229183
30403,2507.9722,2507.979167,1,75239166,75239375,209,0.7416415272591073
30404,2508.002,2508.043967,1,75240060,75241319,1259,0.8726788451999405
30405,2508.0493,2508.0949,1,75241479,75242847,1368,0.7884863294574384
30406,2508.1085,2508.176667,1,75243255,75245300,2045,0.7656409522143706
30407,2508.201833,2508.290467,1,75246054,75248714,2660,0.7478891140150732
30408,2508.291467,2508.3188,1,75248744,75249564,820,0.5949567569915654
30409,2508.320967,2508.3426,1,75249629,75250278,649,0.6200433922755378
30410,2508.3477,2508.3717,1,75250431,75251151,720,0.6184741624067596
30411,2508.373833,2508.426433,1,75251214,75252792,1578,0.7714399689384014
30412,2508.440833,2508.445233,1,75253224,75253356,132,0.6408291939027941
30413,2508.453333,2508.477667,1,75253599,75254330,731,0.7042526806866569
30414,2508.6566,2508.858567,1,75259698,75265757,6059,0.8155321051402952
30415,2508.885633,2508.8987,1,75266568,75266961,393,0.4707549529206671
30416,2509.104467,2509.108333,1,75273134,75273249,115,0.6936796424442584
30417,2509.115333,2509.129733,1,75273459,75273891,432,-0.04769216153774364
30418,2509.131767,2509.1688,1,75273953,75275064,1111,0.8453014686110704
30419,2509.176633,2509.187967,1,75275298,75275639,341,0.6249266305099748
30420,2509.189033,2509.216267,1,75275670,75276488,818,0.8641877841020296
30421,2509.373,2509.378533,1,75281190,75281355,165,0.6332553063674076
30422,2509.4072,2509.519167,1,75282216,75285575,3359,0.8327837502936745
30423,2509.5399,2509.632133,1,75286197,75288963,2766,0.7948342032366513
30424,2509.653867,2509.657767,1,75289616,75289733,117,0.529846868725007
30425,2509.964967,2509.9696,1,75298949,75299088,139,0.670148011133908
30426,2509.971467,2509.983267,1,75299144,75299498,354,0.6213999770885045
30427,2510.0055,2510.013167,1,75300165,75300395,230,0.7132672687154534
30428,2510.042667,2510.0581,1,75301280,75301743,463,0.861839730438181
30429,2510.066933,2510.070033,1,75302007,75302100,93,0.48816199360258183
30430,2510.073033,2510.101333,1,75302190,75303039,849,0.6094524815551507
30431,2510.103733,2510.1244,1,75303111,75303732,621,0.7901930044808386
30432,2510.131333,2510.1705,1,75303939,75305115,1176,0.6248212340266387
30433,2510.180767,2510.2307,1,75305423,75306921,1498,0.6597042238951332
30434,2510.2321,2510.2538,1,75306963,75307614,651,0.6132618505624282
30435,2510.270433,2510.280933,1,75308112,75308427,315,0.6689106270484961
30436,2510.2852,2510.297033,1,75308556,75308910,354,0.46634168758127104
30437,2510.304067,2510.310233,1,75309122,75309306,184,0.7723022898745323
30438,2510.318933,2510.3898,1,75309567,75311694,2127,0.6906287426402085
30439,2510.409467,2510.413667,1,75312284,75312410,126,0.6345729382332481
30440,2510.445567,2510.450267,1,75313367,75313508,141,
30441,2510.4513,2510.455167,1,75313539,75313655,116,0.17560800324281223
30442,2510.4592,2510.462867,1,75313776,75313886,110,0.8777851530423374
30443,2510.509467,2510.524267,1,75315284,75315728,444,0.3358132519528074
30444,2510.5363,2510.631833,1,75316089,75318954,2865,0.7795907105347928
30445,2510.6497,2510.731067,1,75319491,75321932,2441,0.8268696866119012
30446,2511.0851,2511.0901,1,75332553,75332703,150,0.4164062155434289
30447,2511.093367,2511.366333,1,75332801,75340989,8188,0.7432874500859371
30448,2511.370333,2511.3791,1,75341109,75341373,264,0.32521390249514387
30449,2511.678,2511.688633,1,75350340,75350658,318,0.7315613259206618
30450,2511.691567,2511.807033,1,75350747,75354210,3463,0.7578470602692665
30451,2511.812367,2511.817933,1,75354371,75354537,166,0.6488897646726387
30452,2511.819267,2511.882033,1,75354578,75356460,1882,0.7539257833292307
30453,2511.890167,2511.929467,1,75356705,75357884,1179,0.7682114821161168
30454,2511.931933,2511.968167,1,75357957,75359045,1088,0.8156531619229639
30455,2511.978133,2511.984833,1,75359343,75359544,201,0.5976450695646888
30456,2511.994967,2512.0127,1,75359849,75360381,532,0.8896841760115313
30457,2512.053833,2512.063867,1,75361614,75361916,302,0.1267900972780234
30458,2512.065767,2512.073133,1,75361973,75362193,220,0.05715847542122176
30459,2512.076367,2512.086733,1,75362291,75362601,310,-0.15034158446090423
30460,2512.207867,2512.221833,1,75366236,75366654,418,0.2554902885204315
30461,2512.222933,2512.4333,1,75366687,75372999,6312,0.7341809950466875
30462,2512.467233,2512.472467,1,75374016,75374174,158,
30463,2512.702833,2512.8147,1,75381084,75384441,3357,0.7798643846448415
30464,2513.151233,2513.248067,1,75394536,75397442,2906,0.7506313484223046
30465,2513.250267,2513.323133,1,75397508,75399693,2185,0.8484018333800636
30466,2513.324367,2513.328633,1,75399731,75399858,127,0.21976220370652308
30467,2513.330533,2513.350867,1,75399915,75400526,611,0.6402759600536716
30468,2513.353033,2513.416233,1,75400590,75402486,1896,0.8618064511212395
30469,2513.797433,2513.798467,1,75413922,75413954,32,
30470,2513.807433,2513.8161,1,75414222,75414483,261,0.6052773742292861
30471,2513.8205,2513.8976,1,75414615,75416928,2313,0.815078349227449
30472,2513.9006,2514.0203,1,75417018,75420609,3591,0.7952836367259568
30473,2514.0236,2514.089433,1,75420708,75422682,1974,0.7905016634225115
30474,2514.112267,2514.1412,1,75423368,75424236,868,0.669545768595037
30475,2514.155867,2514.178633,1,75424676,75425358,682,0.7987161005988422
30476,2514.638867,2514.645367,1,75439166,75439361,195,0.693854884362045
30477,2514.6747,2514.7284,1,75440241,75441852,1611,0.6180983237041564
30478,2514.767167,2514.784267,1,75443015,75443528,513,0.7195249079878209
30479,2514.786033,2514.790233,1,75443580,75443706,126,0.5876601282676517
30480,2514.7928,2514.7986,1,75443784,75443958,174,0.4510843324386684
30481,2514.817867,2514.834967,1,75444536,75445049,513,0.8007814212283806
30482,2514.847867,2514.8625,1,75445436,75445875,439,0.5676419681205315
30483,2514.864667,2514.868733,1,75445940,75446061,121,0.7357447628293158
30484,2514.872067,2514.881433,1,75446162,75446442,280,0.5879736889089232
30485,2514.888967,2514.895933,1,75446669,75446877,208,0.7323780757319481
30486,2514.897333,2514.932233,1,75446919,75447966,1047,0.7440540329871368
30487,2514.934967,2514.973133,1,75448049,75449193,1144,0.6382305034840686
30488,2515.091833,2515.099333,1,75452754,75452979,225,0.057686162108997796
30489,2515.101733,2515.213867,1,75453051,75456416,3365,0.8284470538826365
30490,2515.315567,2515.3191,1,75459467,75459573,106,
30491,2515.396633,2515.4001,1,75461898,75462003,105,0.1144949261881941
30492,2515.4436,2515.4496,1,75463308,75463488,180,0.5528045785253556
30493,2515.4513,2515.473433,1,75463539,75464202,663,0.6907492650840348
30494,2515.474433,2515.624833,1,75464232,75468744,4512,0.8032510498947635
30495,2515.939767,2515.942833,1,75478193,75478284,91,0.4937109319566729
30496,2515.950067,2516.0607,1,75478502,75481821,3319,0.812477878908673
30497,2516.073067,2516.0859,1,75482192,75482577,385,0.5156722892107843
30498,2516.088633,2516.150833,1,75482658,75484524,1866,0.04810249392786484
30499,2516.212167,2516.2167,1,75486365,75486501,136,0.46686001463844323
30500,2516.218233,2516.224733,1,75486546,75486741,195,0.5781535176107846
30501,2516.233333,2516.270033,1,75486999,75488100,1101,0.5863291568640439
30502,2516.280667,2516.296033,1,75488420,75488880,460,0.1015343070537493
30503,2516.297467,2516.390467,1,75488924,75491714,2790,0.735908494401763
30504,2516.391933,2516.3996,1,75491757,75491988,231,0.4525508328502544
30505,2516.409333,2516.516967,1,75492279,75495509,3230,0.7805451656456107
30506,2516.521067,2516.5738,1,75495632,75497214,1582,0.7339113771816841
30507,2516.632433,2516.6593,1,75498972,75499779,807,0.6594082727269565
30508,2516.6747,2516.6913,1,75500241,75500739,498,0.6194849401449104
30509,2516.6935,2516.7574,1,75500805,75502722,1917,0.807535403854082
30510,2516.7728,2516.779933,1,75503184,75503397,213,0.3061458497141765
30511,2516.9989,2517.068533,1,75509967,75512055,2088,0.8063462942246243
30512,2517.071633,2517.132033,1,75512148,75513960,1812,0.793311516180787
30513,2517.447533,2517.4529,1,75523425,75523587,162,0.5128821353937791
30514,2517.461733,2517.4709,1,75523851,75524127,276,0.7295289323637462
30515,2517.483167,2517.611567,1,75524495,75528347,3852,0.7647798132901652
30516,2517.623633,2517.691067,1,75528708,75530732,2024,0.8142711472061662
30517,2517.766333,2517.785333,1,75532989,75533559,570,0.6870875191308917
30518,2517.805233,2517.8852,1,75534156,75536556,2400,0.7850973318185094
30519,2517.895433,2517.9006,1,75536862,75537018,156,-0.06945337423805635
30520,2517.9016,2517.9088,1,75537048,75537264,216,0.5836824709676145
30521,2518.246933,2518.258933,1,75547407,75547767,360,0.151722594198903
30522,2518.259967,2518.2751,1,75547799,75548253,454,0.7909112309590471
30523,2518.279367,2518.373867,1,75548381,75551216,2835,0.8013877095268015
30524,2518.618333,2518.634067,1,75558549,75559022,473,0.8352397387752181
30525,2518.635233,2518.6785,1,75559056,75560355,1299,0.6954896868467447
30526,2518.6808,2518.729467,1,75560424,75561884,1460,0.7803965460017614
30527,2518.746767,2518.853467,1,75562403,75565604,3201,0.7642402815729502
30528,2518.8564,2518.909867,1,75565692,75567296,1604,0.7191466560113641
30529,2518.9221,2518.9367,1,75567663,75568101,438,0.7930840614392365
30530,2518.9414,2518.9559,1,75568242,75568677,435,0.6293959179710026
30531,2519.002867,2519.025767,1,75570086,75570773,687,0.5521133351748486
30532,2519.040633,2519.161067,1,75571218,75574832,3614,0.7074550435819773
30533,2519.1655,2519.1729,1,75574965,75575187,222,0.6916197935986068
30534,2519.176733,2519.2211,1,75575301,75576633,1332,0.6834257847987407
30535,2519.2339,2519.248867,1,75577017,75577466,449,0.6700761363863239
30536,2519.253633,2519.265667,1,75577608,75577970,362,0.5236344129462507
30537,2519.651667,2519.658733,1,75589550,75589761,211,0.1867216125359318
30538,2519.747033,2519.802633,1,75592410,75594078,1668,0.7780378110186235
30539,2519.804733,2519.8552,1,75594141,75595656,1515,0.8316979152857776
30540,2519.8979,2519.913067,1,75596937,75597392,455,0.1859237726558703
30541,2519.9143,2519.920867,1,75597429,75597626,197,-0.029203428827138576
30542,2520.162567,2520.187167,1,75604877,75605615,738,0.7030612125313119
30543,2520.1883,2520.362767,1,75605649,75610883,5234,0.6739312985726996
30544,2520.373533,2520.389367,1,75611205,75611681,476,0.20787868801497478
30545,2520.446033,2520.527733,1,75613380,75615831,2451,0.7261148881112758
30546,2520.7439,2520.7573,1,75622317,75622719,402,0.16846120430848732
30547,2520.763133,2520.866167,1,75622893,75625985,3092,0.8550055853044299
30548,2520.920267,2520.933,1,75627608,75627990,382,0.4986609981663793
30549,2520.934267,2520.937633,1,75628028,75628128,100,0.7623916838312674
30550,2521.139733,2521.238867,1,75634191,75637166,2975,0.7726470157485447
30551,2521.240033,2521.296133,1,75637200,75638883,1683,0.7785472086294503
30552,2521.3074,2521.371233,1,75639222,75641136,1914,0.8076658426645218
30553,2521.3733,2521.387367,1,75641199,75641621,422,0.023879156584927678
30554,2521.5006,2521.605367,1,75645018,75648161,3143,0.2528554753023782
30555,2521.606433,2521.614133,1,75648192,75648423,231,0.012633203618023366
30556,2521.626667,2521.749467,1,75648800,75652484,3684,0.8506385544408204
30557,2521.7968,2521.811933,1,75653904,75654357,453,0.4683057286448486
30558,2521.813267,2521.8208,1,75654398,75654624,226,0.24639062705719114
30559,2521.878833,2521.8832,1,75656364,75656496,132,0.28070065841297576
30560,2521.884233,2521.888967,1,75656526,75656669,143,-0.15668520892079543
30561,2521.890167,2521.9333,1,75656705,75657999,1294,0.38695164527411813
30562,2521.9432,2521.9617,1,75658296,75658851,555,-0.059491460317993
30563,2521.963533,2521.988967,1,75658905,75659669,764,0.169945641411931
30564,2522.029567,2522.0745,1,75660887,75662235,1348,0.7923682723258503
30565,2522.075767,2522.090733,1,75662273,75662721,448,0.8016956326151592
30566,2522.094967,2522.1659,1,75662849,75664977,2128,0.7873096732972764
30567,2522.168567,2522.2284,1,75665057,75666852,1795,0.8023619571641449
30568,2522.251267,2522.3388,1,75667538,75670164,2626,0.8007397288279864
30569,2522.346833,2522.357567,1,75670404,75670727,323,0.4859478574149652
30570,2522.375833,2522.382167,1,75671274,75671465,191,0.062633843644302
30571,2522.386767,2522.3967,1,75671603,75671901,298,0.28896363546957776
30572,2522.397933,2522.401,1,75671937,75672030,93,0.7110913589966386
30573,2522.402133,2522.4056,1,75672063,75672168,105,
30574,2522.408233,2522.411967,1,75672246,75672359,113,
30575,2522.415533,2522.504067,1,75672465,75675122,2657,0.8144986641176101
30576,2522.5151,2522.520567,1,75675453,75675617,164,0.05286537128079113
30577,2522.531333,2522.5344,1,75675939,75676032,93,0.018995296961714956
30578,2522.660933,2522.774433,1,75679827,75683232,3405,0.16663058739918774
30579,2522.7757,2522.7788,1,75683271,75683364,93,
30580,2522.7844,2522.818833,1,75683532,75684564,1032,0.5505914958581322
30581,2522.819867,2522.942367,1,75684596,75688271,3675,0.7529453604727548
30582,2522.9606,2522.9671,1,75688818,75689013,195,0.561487791329019
30583,2522.968167,2522.975467,1,75689045,75689264,219,0.5356821973072666
30584,2522.982433,2522.988667,1,75689472,75689660,188,0.6070954911209115
30585,2522.9932,2523.023567,1,75689796,75690707,911,-0.025524925477976454
30586,2523.0618,2523.087267,1,75691854,75692618,764,0.5729894689797149
30587,2523.0981,2523.202467,1,75692943,75696074,3131,0.8144048322461953
30588,2523.213267,2523.216433,1,75696398,75696492,94,-0.2752456605369633
30589,2523.511833,2523.5169,1,75705354,75705507,153,0.6309500412045959
30590,2523.520967,2523.5375,1,75705629,75706125,496,0.7823195947028748
30591,2523.540033,2523.679733,1,75706200,75710391,4191,0.7691008771617295
30592,2523.6809,2523.691767,1,75710427,75710753,326,0.6179657095283689
30593,2523.694733,2523.742667,1,75710841,75712280,1439,0.7159847073730616
30594,2523.755467,2523.764667,1,75712664,75712940,276,0.5991278031259842
30595,2523.812367,2523.817467,1,75714371,75714524,153,-0.10884201403647341
30596,2523.821233,2523.878867,1,75714636,75716366,1730,0.09882886575971457
30597,2523.911733,2523.918933,1,75717351,75717567,216,0.47096351578458634
30598,2523.925567,2524.016733,1,75717767,75720501,2734,0.13793822903617745
30599,2524.018467,2524.045667,1,75720554,75721370,816,0.11534889985775865
30600,2524.062533,2524.069033,1,75721875,75722070,195,0.11603751621609236
30601,2524.071133,2524.112333,1,75722133,75723369,1236,0.340409701703056
30602,2524.1175,2524.171933,1,75723525,75725157,1632,0.19315322808363278
30603,2524.175233,2524.1788,1,75725256,75725364,108,
30604,2524.220567,2524.252033,1,75726617,75727560,943,0.11834912407064795
30605,2524.265367,2524.2722,1,75727961,75728166,205,0.1390677317713989
30606,2524.3089,2524.3236,1,75729267,75729708,441,0.7094556778661587
30607,2524.492833,2524.495967,1,75734784,75734879,95,0.40009991464410083
30608,2524.5013,2524.512533,1,75735039,75735375,336,0.43473231275398283
30609,2524.533533,2524.542,1,75736005,75736260,255,0.25450763991495645
30610,2524.5485,2524.5515,1,75736455,75736545,90,0.820910111691359
30611,2524.5753,2524.58,1,75737259,75737400,141,0.3090410659243958
30612,2524.585367,2524.597533,1,75737561,75737925,364,0.560939551178724
30613,2524.66,2524.679967,1,75739800,75740399,599,0.2738681329343288
30614,2524.681333,2524.7054,1,75740439,75741162,723,0.8674410426568163
30615,2524.7068,2524.831367,1,75741204,75744941,3737,0.14209227791640971
30616,2524.838067,2524.8429,1,75745142,75745287,145,0.16622269685246574
30617,2524.845033,2524.873367,1,75745350,75746201,851,0.2651366016035397
30618,2524.875733,2524.902767,1,75746271,75747083,812,0.05310666084138146
30619,2524.914867,2524.940367,1,75747446,75748211,765,0.058558843490274175
30620,2524.9647,2525.034367,1,75748941,75751031,2090,0.25006316952783636
30621,2525.066133,2525.1825,1,75751983,75755475,3492,0.5960962959872258
30622,2525.1889,2525.237333,1,75755667,75757119,1452,0.8159141957550651
30623,2525.245533,2525.290533,1,75757365,75758715,1350,0.8554168215135568
30624,2525.3083,2525.312767,1,75759249,75759383,134,-0.22071248244977787
30625,2525.324333,2525.327333,1,75759729,75759819,90,
30626,2525.3397,2525.343567,1,75760191,75760307,116,0.014762023051196924
30627,2525.351567,2525.355867,1,75760547,75760676,129,0.06059790914482576
30628,2525.3668,2525.371067,1,75761004,75761132,128,-0.047029092403579664
30629,2525.706667,2525.734433,1,75771200,75772032,832,0.6035453407138729
30630,2525.741033,2525.793167,1,75772230,75773795,1565,0.6757362926672762
30631,2525.8096,2525.8394,1,75774288,75775182,894,0.6021431811261068
30632,2525.860767,2525.865267,1,75775823,75775958,135,0.6035150749018551
30633,2525.866667,2525.8754,1,75776000,75776262,262,0.43007125440475075
30634,2525.882367,2525.905467,1,75776471,75777164,693,0.5275817925784082
30635,2525.916667,2525.924,1,75777500,75777720,220,0.5327653261406577
30636,2525.9497,2525.9795,1,75778491,75779385,894,0.0315167409730909
30637,2525.9805,2526.009767,1,75779415,75780293,878,0.10755424293756476
30638,2526.018833,2526.021867,1,75780564,75780656,92,0.4916297730049093
30639,2526.030833,2526.0943,1,75780924,75782829,1905,0.7683674275378359
30640,2526.095633,2526.3174,1,75782868,75789522,6654,0.7760598233299363
30641,2526.325533,2526.329467,1,75789765,75789884,119,0.29071810032721657
30642,2526.344133,2526.350533,1,75790323,75790515,192,0.17153553392357124
30643,2526.3993,2526.422433,1,75791979,75792672,693,0.66801307639771
30644,2526.425067,2526.479367,1,75792752,75794381,1629,0.7544838073627838
30645,2526.516833,2526.520067,1,75795504,75795602,98,
30646,2526.523433,2526.527233,1,75795702,75795816,114,
30647,2526.6499,2526.6529,1,75799497,75799587,90,0.4206824627953106
30648,2526.660233,2526.760567,1,75799806,75802817,3011,0.7418989588646344
30649,2526.763167,2526.8241,1,75802895,75804723,1828,0.8063879054256089
30650,2526.859867,2526.867867,1,75805796,75806036,240,0.44268624653028604
30651,2526.882067,2526.8987,1,75806462,75806961,499,-0.06408122348855504
30652,2526.9131,2526.9285,1,75807393,75807855,462,0.4238405569237023
30653,2526.983867,2526.989,1,75809516,75809670,154,-0.181922113862597
30654,2526.9917,2527.0014,1,75809751,75810042,291,0.1877711697887218
30655,2527.0077,2527.0152,1,75810231,75810456,225,0.6011898933951292
30656,2527.0163,2527.082733,1,75810489,75812481,1992,0.605945679092311
30657,2527.092533,2527.103133,1,75812775,75813093,318,0.1170220274236825
30658,2527.214133,2527.218033,1,75816423,75816540,117,0.3298348201067632
30659,2527.243633,2527.2903,1,75817308,75818709,1401,0.5038835951951127
30660,2527.291867,2527.313867,1,75818756,75819416,660,0.48948708543019753
30661,2527.315467,2527.318633,1,75819464,75819558,94,-0.39398790856862953
30662,2527.3295,2527.3493,1,75819885,75820479,594,0.597530067172119
30663,2527.375333,2527.403867,1,75821259,75822116,857,0.7351752639231584
30664,2527.416767,2527.4713,1,75822503,75824139,1636,0.4611029366156397
30665,2527.478433,2527.4903,1,75824352,75824709,357,0.510578646656498
30666,2527.500067,2527.572533,1,75825002,75827175,2173,0.7654641676528305
30667,2527.627033,2527.631333,1,75828810,75828939,129,0.10539831064857577
30668,2527.6415,2527.6617,1,75829245,75829851,606,0.07929355079905151
30669,2527.663967,2527.67,1,75829919,75830100,181,-0.245238993955456
30670,2527.7041,2527.712267,1,75831123,75831368,245,0.6097077607080099
30671,2527.713967,2527.724533,1,75831419,75831735,316,0.39889286703540106
30672,2527.726733,2527.7479,1,75831801,75832437,636,0.15859789321252502
30673,2527.7561,2527.7797,1,75832683,75833391,708,-0.013793591963803427
30674,2527.7869,2527.802133,1,75833607,75834063,456,0.26600659864662
30675,2527.8336,2527.837367,1,75835008,75835121,113,0.039199979533220276
30676,2527.8414,2527.963,1,75835242,75838890,3648,0.7420249327338623
30677,2527.979,2527.999967,1,75839370,75839999,629,0.4540253660130384
30678,2528.0091,2528.029467,1,75840273,75840884,611,-0.032956154429610446
30679,2528.030733,2528.0505,1,75840921,75841515,594,0.2605421056457637
30680,2528.057667,2528.066233,1,75841730,75841986,256,0.0434501317844121
30681,2528.1088,2528.133967,1,75843264,75844019,755,0.3281417544680922
30682,2528.145233,2528.1571,1,75844356,75844713,357,-0.05941762587596773
30683,2528.158933,2528.176667,1,75844767,75845300,533,0.030393780639066253
30684,2528.185367,2528.4904,1,75845561,75854712,9151,0.534093886540399
30685,2528.4962,2528.541167,1,75854886,75856235,1349,0.4756841941143777
30686,2528.554067,2528.5596,1,75856622,75856788,166,-0.11920235745236872
30687,2528.5858,2528.5909,1,75857574,75857727,153,-0.031467297482392666
30688,2528.5925,2528.596633,1,75857775,75857898,123,-0.14839039815115293
30689,2528.6019,2528.606133,1,75858057,75858183,126,-0.08510099537756399
30690,2528.6083,2528.620933,1,75858249,75858627,378,0.15390531756044315
30691,2528.631433,2528.640033,1,75858942,75859200,258,0.22953587804376302
30692,2528.754667,2528.758167,1,75862640,75862745,105,0.2239353720152321
30693,2528.763933,2528.774467,1,75862917,75863234,317,0.7193585493382298
30694,2528.776233,2528.8319,1,75863286,75864957,1671,0.6809665090546894
30695,2528.8492,2528.864033,1,75865476,75865920,444,0.7090774031269979
30696,2528.8984,2528.907867,1,75866952,75867236,284,0.406479899692904
30697,2528.909067,2528.912367,1,75867272,75867371,99,
30698,2528.919633,2528.950467,1,75867588,75868514,926,0.06715839349677075
30699,2528.9554,2528.969267,1,75868662,75869078,416,0.0908572463682749
30700,2528.9735,2528.987833,1,75869205,75869634,429,0.00015988146979187357
30701,2529.005633,2529.014067,1,75870168,75870422,254,0.1835811006595433
30702,2529.024033,2529.110733,1,75870720,75873321,2601,0.060832253276454584
30703,2529.129467,2529.2514,1,75873884,75877542,3658,0.7322506196224002
30704,2529.277967,2529.2887,1,75878339,75878661,322,0.5051195486874192
30705,2529.2948,2529.3012,1,75878844,75879036,192,0.7312993792162704
30706,2529.3095,2529.359267,1,75879285,75880778,1493,-0.029955560445371163
30707,2529.400233,2529.404267,1,75882006,75882128,122,0.06311216127489001
30708,2529.405667,2529.411067,1,75882170,75882332,162,0.10243285841085675
30709,2529.4259,2529.438933,1,75882777,75883167,390,0.695431070388292
30710,2529.445067,2529.4562,1,75883352,75883686,334,0.03201940366312496
30711,2529.468967,2529.472167,1,75884069,75884165,96,
30712,2529.490933,2529.500467,1,75884727,75885014,287,0.7616666364256315
30713,2529.5083,2529.651567,1,75885249,75889547,4298,0.7682036528087258
30714,2529.653933,2529.6591,1,75889617,75889773,156,-0.3670931021596746
30715,2529.665367,2529.728133,1,75889961,75891843,1882,0.7266732998164763
30716,2529.735833,2529.755967,1,75892074,75892679,605,0.7942024891532653
30717,2530.182367,2530.187,1,75905471,75905610,139,0.495342487499834
30718,2530.206833,2530.2144,1,75906204,75906432,228,0.7616980290867739
30719,2530.247667,2530.2653,1,75907430,75907959,529,0.6020199530988891
30720,2530.299033,2530.3061,1,75908970,75909183,213,0.2197418517538511
30721,2530.310967,2530.3475,1,75909329,75910425,1096,0.6202203788109716
30722,2530.386933,2530.394733,1,75911607,75911841,234,0.6378050645720892
30723,2530.443967,2530.4496,1,75913319,75913488,169,0.3323767873447457
30724,2530.5215,2530.527133,1,75915645,75915813,168,0.4443642634904054
30725,2530.532867,2530.545633,1,75915986,75916368,382,0.7136115446494021
30726,2530.546967,2530.642567,1,75916409,75919277,2868,0.6345462119958333
30727,2530.648933,2530.793067,1,75919467,75923792,4325,0.6846172020648023
30728,2532.810633,2532.816967,1,75984318,75984509,191,0.6581855107023852
30729,2532.8374,2532.8514,1,75985122,75985542,420,0.6273105634203703
30730,2532.873233,2532.894067,1,75986196,75986822,626,0.6698979746390704
30731,2532.9375,2532.9744,1,75988125,75989232,1107,0.6984891106036326
30732,2532.999867,2533.021467,1,75989996,75990644,648,0.7515359418832753
30733,2533.0418,2533.0528,1,75991254,75991584,330,0.6858109298281005
30734,2533.056367,2533.0727,1,75991691,75992181,490,0.6438589743205309
30735,2533.205267,2533.5308,1,75996158,76005924,9766,0.10913299755956178
30736,2533.558267,2533.5778,1,76006748,76007334,586,0.05342044947210219
30737,2533.584567,2533.6133,1,76007537,76008399,862,0.08445710080061694
30738,2533.616067,2533.629067,1,76008482,76008872,390,0.12400311152029925
30739,2533.6335,2533.6383,1,76009005,76009149,144,0.14902355152923866
30740,2533.6436,2533.656033,1,76009308,76009680,372,0.7873435240794812
30741,2533.6579,2533.743933,1,76009737,76012317,2580,0.6348430501750637
30742,2533.7564,2533.7629,1,76012692,76012887,195,-0.05052899826271059
30743,2533.773933,2533.787333,1,76013217,76013619,402,-0.000560482627943806
30744,2533.7894,2533.825533,1,76013682,76014765,1083,0.20372466192418062
30745,2534.012667,2534.1001,1,76020380,76023003,2623,0.7521818115226617
30746,2534.101867,2534.234567,1,76023056,76027037,3981,0.8099418231858477
30747,2534.241433,2534.2459,1,76027242,76027377,135,0.21285128008555623
30748,2534.2684,2534.2744,1,76028052,76028232,180,-0.0749583624700364
30749,2534.276,2534.282133,1,76028280,76028463,183,0.4359517673695032
30750,2534.604667,2534.623567,1,76038140,76038707,567,0.5993651433687626
30751,2534.660067,2534.669567,1,76039802,76040087,285,0.5545004317142785
30752,2534.6754,2534.696233,1,76040262,76040886,624,0.7304576512073471
30753,2534.834833,2534.882433,1,76045044,76046472,1428,0.742135951881813
30754,2534.8858,2535.001533,1,76046574,76050045,3471,0.7815537805491308
30755,2535.011933,2535.0371,1,76050357,76051113,756,0.8455614898200023
30756,2535.056567,2535.0677,1,76051697,76052031,334,0.5022217864599868
30757,2535.081933,2535.112467,1,76052457,76053374,917,-0.04707416138028526
30758,2535.1167,2535.125433,1,76053501,76053762,261,0.16365839769403942
30759,2535.154367,2535.205233,1,76054631,76056156,1525,0.304962048510957
30760,2535.212167,2535.230367,1,76056365,76056911,546,0.06901809506013806
30761,2535.2324,2535.2571,1,76056972,76057713,741,0.30997404455531546
30762,2535.264033,2535.2704,1,76057920,76058112,192,0.5476756046539316
30763,2535.271733,2535.433233,1,76058151,76062996,4845,0.8024575045464569
30764,2535.454733,2535.4601,1,76063641,76063803,162,0.2632884080790525
30765,2535.469833,2535.476433,1,76064094,76064292,198,0.3860644299952256
30766,2535.483333,2535.488067,1,76064499,76064642,143,0.09291287818497855
30767,2535.489433,2535.495767,1,76064682,76064873,191,0.5372524244530551
30768,2535.506667,2535.638133,1,76065200,76069143,3943,0.7477436803223799
30769,2535.643567,2535.651,1,76069307,76069530,223,0.5908868788803868
30770,2535.652233,2535.6561,1,76069566,76069683,117,
30771,2535.841767,2535.8532,1,76075253,76075596,343,0.371525417713401
30772,2535.929533,2535.934067,1,76077885,76078022,137,0.5546898554569908
30773,2535.937033,2535.979133,1,76078110,76079373,1263,0.7556376997851414
30774,2536.009133,2536.093267,1,76080273,76082798,2525,0.7074480513579418
30775,2536.101333,2536.161267,1,76083039,76084838,1799,0.7064304037232261
30776,2536.1808,2536.211067,1,76085424,76086332,908,0.7191361901245841
30777,2536.2259,2536.276,1,76086777,76088280,1503,0.6846550221911895
30778,2536.289,2536.325433,1,76088670,76089762,1092,0.7695018573433994
30779,2536.342933,2536.3684,1,76090287,76091052,765,0.8215262284086248
30780,2536.3757,2536.384433,1,76091271,76091532,261,0.008160436310483852
30781,2536.386767,2536.4464,1,76091603,76093392,1789,0.19980040593482812
30782,2536.464133,2536.481733,1,76093923,76094451,528,0.66064893465033
30783,2536.484767,2536.526967,1,76094543,76095809,1266,0.8161898716985029
30784,2536.528767,2536.570333,1,76095863,76097109,1246,0.8162136665977807
30785,2536.600133,2536.612933,1,76098003,76098387,384,-0.007278852477775926
30786,2536.614733,2536.6244,1,76098441,76098732,291,-0.08417456351900111
30787,2536.6309,2536.7135,1,76098927,76101405,2478,0.7835094150048072
30788,2536.714933,2536.7563,1,76101447,76102689,1242,0.8299791812836992
30789,2536.777367,2536.919733,1,76103321,76107591,4270,0.7191004466431375
30790,2536.930933,2536.936233,1,76107927,76108086,159,-0.08091179813736267
30791,2536.938267,2536.946733,1,76108148,76108401,253,0.02905301550827375
30792,2536.954033,2536.9576,1,76108620,76108728,108,
30793,2537.229367,2537.234267,1,76116881,76117028,147,0.6452334425825327
30794,2537.236967,2537.279533,1,76117109,76118385,1276,0.6332963123315171
30795,2537.302367,2537.316,1,76119071,76119480,409,0.7078320186850213
30796,2537.326367,2537.330767,1,76119791,76119923,132,0.7191779892311941
30797,2537.3327,2537.3396,1,76119981,76120188,207,0.5408611906603774
30798,2537.351333,2537.354833,1,76120539,76120644,105,0.10480739993715937
30799,2537.360567,2537.382733,1,76120817,76121481,664,0.7469923102426311
30800,2537.389233,2537.4944,1,76121676,76124832,3156,0.7584560773666298
30801,2537.496133,2537.5241,1,76124883,76125723,840,0.7694822539070367
30802,2537.5294,2537.595433,1,76125882,76127862,1980,0.6465528464092933
30803,2537.6079,2537.6458,1,76128237,76129374,1137,0.6837912433141691
30804,2537.668533,2537.677633,1,76130055,76130328,273,-0.05086109455688113
30805,2537.680867,2537.699133,1,76130426,76130973,547,0.05485832260737761
30806,2537.7009,2537.716533,1,76131027,76131495,468,0.21654122821703234
30807,2537.725867,2537.736833,1,76131776,76132104,328,0.4471065633700487
30808,2537.738333,2537.899633,1,76132149,76136988,4839,0.8111256439269088
30809,2537.901867,2538.001567,1,76137056,76140047,2991,0.7908698799209556
30810,2538.008467,2538.0124,1,76140254,76140372,118,0.3352170324815611
30811,2538.0151,2538.019733,1,76140453,76140591,138,0.060553961604007486
30812,2538.0469,2538.049933,1,76141407,76141497,90,0.10349136308766066
30813,2538.1321,2538.1567,1,76143963,76144701,738,0.5178471757159598
30814,2538.1578,2538.2179,1,76144734,76146537,1803,0.7286707103079576
30815,2538.219233,2538.245833,1,76146576,76147374,798,0.7825816831329059
30816,2538.305433,2538.310167,1,76149162,76149305,143,-0.039535237334372024
30817,2538.313267,2538.317133,1,76149398,76149513,115,0.14537353622083887
30818,2538.3227,2538.327433,1,76149681,76149822,141,0.18058768931992603
30819,2538.328633,2538.3322,1,76149858,76149966,108,0.24481868821540675
30820,2538.3647,2538.433767,1,76150941,76153013,2072,0.7688511536921011
30821,2538.435867,2538.529767,1,76153076,76155893,2817,0.7902928035126353
30822,2538.5315,2538.5458,1,76155945,76156374,429,0.3876279657291254
30823,2538.563533,2538.613933,1,76156905,76158417,1512,0.08058267049181636
30824,2538.615133,2538.6291,1,76158453,76158873,420,0.06146238076359281
30825,2538.637367,2538.736967,1,76159121,76162109,2988,0.6752264462195009
30826,2538.743567,2538.7471,1,76162307,76162413,106,
30827,2538.7481,2538.7514,1,76162443,76162542,99,0.7514224185866741
30828,2538.753,2538.764367,1,76162590,76162931,341,0.019034447351769086
30829,2538.7721,2539.0475,1,76163163,76171425,8262,0.32652574720427313
30830,2539.054333,2539.0601,1,76171629,76171803,174,0.740761146424393
30831,2539.061433,2539.095633,1,76171842,76172868,1026,0.7914431091481237
30832,2539.124167,2539.164067,1,76173725,76174922,1197,0.08218085627867311
30833,2539.183533,2539.259833,1,76175505,76177794,2289,0.8040675193953434
30834,2539.261133,2539.306067,1,76177833,76179182,1349,0.8523285956984832
30835,2539.3199,2539.333933,1,76179597,76180017,420,-0.03853275939815492
30836,2539.3353,2539.35,1,76180059,76180500,441,-0.07336456810063789
30837,2539.361133,2539.3682,1,76180833,76181046,213,0.5370664378250609
30838,2539.369667,2539.374633,1,76181090,76181238,148,
30839,2539.398,2539.4147,1,76181940,76182441,501,0.75971034600462
30840,2539.4174,2539.512667,1,76182522,76185380,2858,0.7672592186096528
30841,2539.525833,2539.5573,1,76185774,76186719,945,0.03374801784641966
30842,2539.580667,2539.7457,1,76187420,76192371,4951,0.8366167500438757
30843,2539.765567,2539.7946,1,76192967,76193838,871,-0.04243377920474143
30844,2539.795933,2539.801333,1,76193877,76194039,162,0.19221237734293273
30845,2539.813167,2539.822433,1,76194395,76194672,277,0.6012609615975485
30846,2539.939867,2539.947867,1,76198196,76198436,240,0.5141440054287946
30847,2539.9509,2539.962133,1,76198527,76198863,336,0.5137005472504591
30848,2539.9639,2540.006033,1,76198917,76200180,1263,0.7703581944169715
30849,2540.010433,2540.064233,1,76200312,76201926,1614,0.8009170117687171
30850,2540.0722,2540.1045,1,76202166,76203135,969,0.7995754451288066
30851,2540.1097,2540.1642,1,76203291,76204926,1635,0.7818033709279573
30852,2540.174067,2540.2112,1,76205222,76206336,1114,0.6532254481029612
30853,2540.2131,2540.220667,1,76206393,76206620,227,-0.3694699249635254
30854,2540.234867,2540.278567,1,76207046,76208357,1311,0.054288369638132015
30855,2540.293267,2540.2966,1,76208798,76208898,100,0.6867149304247483
30856,2540.301333,2540.430867,1,76209039,76212926,3887,0.7633645941032243
30857,2540.4428,2540.550967,1,76213284,76216529,3245,0.8012304285277753
30858,2540.6471,2540.6531,1,76219413,76219593,180,-0.06367307053552365
30859,2540.664767,2540.685933,1,76219943,76220577,634,0.8036685013671042
30860,2540.6946,2540.7042,1,76220838,76221126,288,0.2612318827633804
30861,2540.7103,2540.715733,1,76221309,76221471,162,0.7908246162417858
30862,2540.721067,2540.848467,1,76221632,76225454,3822,0.759659674251176
30863,2540.852367,2540.934033,1,76225571,76228020,2449,0.7695027670359457
30864,2540.936467,2540.941167,1,76228094,76228235,141,0.5213984292875272
30865,2540.943667,2540.966467,1,76228310,76228994,684,0.0013159567269573928
30866,2540.967467,2541.0015,1,76229024,76230045,1021,0.09072278009237986
30867,2541.0274,2541.0432,1,76230822,76231296,474,0.8555893145065608
30868,2541.0452,2541.137967,1,76231356,76234139,2783,0.7847551575063187
30869,2541.154,2541.187967,1,76234620,76235639,1019,-0.010525807923302597
30870,2541.195833,2541.205367,1,76235874,76236161,287,0.11765497022136925
30871,2541.206667,2541.3219,1,76236200,76239657,3457,0.8723660805196365
30872,2541.326333,2541.335033,1,76239789,76240050,261,0.23351168302489067
30873,2541.3491,2541.364,1,76240473,76240920,447,0.07295903270212639
30874,2541.3651,2541.375733,1,76240953,76241271,318,0.18625349267938693
30875,2541.377833,2541.401767,1,76241334,76242053,719,0.07381069356120752
30876,2541.408567,2541.416667,1,76242257,76242500,243,-0.10086233617494356
30877,2541.4235,2541.479867,1,76242705,76244396,1691,0.7993713130900515
30878,2541.4917,2541.537233,1,76244751,76246116,1365,0.7671639981702811
30879,2541.5546,2541.593033,1,76246638,76247790,1152,0.025797928564413215
30880,2541.598333,2541.615467,1,76247949,76248464,515,0.5647050659110121
30881,2541.618067,2541.724367,1,76248542,76251731,3189,0.8163354535125925
30882,2541.7292,2541.771833,1,76251876,76253154,1278,0.7999455005407863
30883,2541.775167,2541.782667,1,76253255,76253480,225,0.3050979439024798
30884,2541.803433,2541.8075,1,76254102,76254225,123,
30885,2541.808867,2541.8287,1,76254266,76254861,595,0.07858713122794887
30886,2541.830633,2541.843867,1,76254918,76255316,398,0.07562686948293727
30887,2541.8507,2541.862933,1,76255521,76255887,366,0.23757078186756417
30888,2541.880967,2541.887567,1,76256429,76256627,198,0.7398126770714052
30889,2541.8921,2541.9204,1,76256763,76257612,849,0.8016730438119033
30890,2541.924067,2542.0045,1,76257722,76260135,2413,0.8189700300607552
30891,2542.018533,2542.113433,1,76260555,76263402,2847,0.794015646494763
30892,2542.127333,2542.155833,1,76263819,76264674,855,0.5476938681761508
30893,2542.166933,2542.1746,1,76265007,76265238,231,
30894,2542.176,2542.1868,1,76265280,76265604,324,0.03897657357003354
30895,2542.188033,2542.191633,1,76265640,76265748,108,0.4388887233578802
30896,2542.2052,2542.3273,1,76266156,76269819,3663,0.7845961369489853
30897,2542.328533,2542.4264,1,76269855,76272792,2937,0.7994918965070956
30898,2542.4362,2542.465233,1,76273086,76273956,870,-0.005122693833908646
30899,2542.468767,2542.479667,1,76274063,76274390,327,0.3296072090981622
30900,2542.485733,2542.493067,1,76274571,76274792,221,0.044905371561441386
30901,2542.5208,2542.720367,1,76275624,76281611,5987,0.8257678685448504
30902,2542.760533,2542.7798,1,76282815,76283394,579,0.029938616620952114
30903,2542.789067,2542.796433,1,76283672,76283892,220,0.182932125050053
30904,2542.808867,2542.8126,1,76284266,76284378,112,-0.006892760524914025
30905,2542.830433,2542.839267,1,76284912,76285178,266,0.2184228149629398
30906,2542.8408,2543.002433,1,76285224,76290072,4848,0.7899748151747106
30907,2543.009367,2543.042867,1,76290281,76291286,1005,0.037300205102542616
30908,2543.044533,2543.054467,1,76291335,76291634,299,0.22735094303108502
30909,2543.060167,2543.0644,1,76291805,76291932,127,-0.214589046105838
30910,2543.076067,2543.104433,1,76292282,76293132,850,0.6069438437470721
30911,2543.1055,2543.2416,1,76293165,76297248,4083,0.8094564936448692
30912,2543.253133,2543.271633,1,76297593,76298148,555,0.7041805876287771
30913,2543.275133,2543.31,1,76298253,76299300,1047,0.6105532549746724
30914,2543.331433,2543.401067,1,76299942,76302032,2090,0.8037500321092077
30915,2543.4176,2543.444633,1,76302528,76303338,810,0.764210717561563
30916,2543.449433,2543.4948,1,76303482,76304844,1362,0.7582549723464314
30917,2543.495833,2543.537767,1,76304874,76306133,1259,0.7841670755637392
30918,2543.547333,2543.563667,1,76306419,76306910,491,-0.0743782909477005
30919,2543.565267,2543.578967,1,76306958,76307369,411,0.24149098160258653
30920,2543.580467,2543.594533,1,76307414,76307835,421,0.2601166146002876
30921,2543.6213,2543.638133,1,76308639,76309143,504,0.7381914815726528
30922,2543.639967,2543.7296,1,76309199,76311888,2689,0.7510044252983508
30923,2543.749567,2543.752867,1,76312487,76312586,99,
30924,2543.763233,2543.773767,1,76312896,76313213,317,-0.09367850644055514
30925,2543.7758,2543.784433,1,76313274,76313532,258,0.5456050560325613
30926,2543.788,2543.902867,1,76313640,76317086,3446,0.8460932720560338
30927,2544.1209,2544.1412,1,76323627,76324236,609,0.7426961908729721
30928,2544.143567,2544.263533,1,76324307,76327905,3598,0.7773902571409678
30929,2544.298267,2544.3086,1,76328948,76329258,310,0.7463299316714589
30930,2544.3157,2544.3382,1,76329471,76330146,675,0.7072372485242507
30931,2544.3399,2544.4423,1,76330197,76333269,3072,0.8297772694590462
30932,2544.4458,2544.510033,1,76333374,76335300,1926,0.8226462492047848
30933,2544.5163,2544.5508,1,76335489,76336524,1035,0.7641927073618445
30934,2544.568567,2544.576633,1,76337057,76337298,241,0.7573000850277307
30935,2544.582133,2544.615,1,76337463,76338450,987,0.7708879376395826
30936,2544.637833,2544.6952,1,76339134,76340856,1722,0.74242817695292
30937,2544.696833,2544.83,1,76340904,76344900,3996,0.774352490089865
30938,2544.832167,2544.857433,1,76344965,76345722,757,0.859345772366804
30939,2544.858467,2544.925033,1,76345754,76347750,1996,0.8394669943050237
30940,2544.934633,2544.950833,1,76348038,76348524,486,0.7386675764368752
30941,2545.704133,2545.713533,1,76371123,76371405,282,0.25143091119674477
30942,2551.262967,2551.267633,1,76537889,76538028,139,0.3142295488045963
30943,2555.971,2555.977067,1,76679130,76679312,182,0.4302747918673825
30944,2557.9548,2557.9584,1,76738644,76738752,108,0.2643997173234709
30945,2558.046233,2558.053967,1,76741386,76741619,233,0.47904062065155306
30946,2558.0571,2558.060333,1,76741713,76741809,96,0.24796338814118732
30947,2559.4459,2559.452467,1,76783377,76783574,197,0.2775227503714077
30948,2559.824967,2559.828467,1,76794749,76794854,105,
30949,2559.8298,2559.833167,1,76794894,76794995,101,0.5104734420781099
30950,2559.9021,2559.907433,1,76797063,76797222,159,0.14322277349119528
30951,2560.128367,2560.131567,1,76803851,76803947,96,0.1295155425669304
30952,2560.143933,2560.154033,1,76804317,76804620,303,0.2594397395191883
30953,2560.159133,2560.1659,1,76804773,76804977,204,0.14753490497665248
30954,2560.167967,2560.224867,1,76805039,76806746,1707,0.1941772209328961
30955,2560.257067,2560.276667,1,76807712,76808300,588,0.18053612615829912
30956,2560.285267,2560.307667,1,76808558,76809230,672,-0.10852191293233691
30957,2560.311467,2560.322233,1,76809344,76809666,322,-0.012266759856252807
30958,2560.329767,2560.3424,1,76809893,76810272,379,-0.07378918536502088
30959,2560.378933,2560.390267,1,76811367,76811708,341,-0.16204774889336448
30960,2562.278367,2562.311367,1,76868351,76869341,990,0.32878236245048303
30961,2562.495667,2562.499267,1,76874870,76874978,108,-0.11193091022800597
30962,2562.542033,2562.567333,1,76876260,76877019,759,-0.019906015084246286
30963,2562.568533,2562.576367,1,76877055,76877291,236,0.11085042512200693
30964,2562.644,2562.726067,1,76879320,76881782,2462,0.6465966967796969
30965,2562.731933,2562.759867,1,76881957,76882796,839,0.17262844671634725
30966,2563.020533,2563.027967,1,76890615,76890839,224,0.0924000918565762
30967,2563.029467,2563.034333,1,76890884,76891029,145,0.5567094556530884
30968,2563.055233,2563.067633,1,76891656,76892028,372,0.23214427509009025
30969,2563.075867,2563.1051,1,76892276,76893153,877,0.30985114770613764
30970,2563.109167,2563.134333,1,76893275,76894029,754,0.2778638912834378
30971,2563.271267,2563.2751,1,76898138,76898253,115,0.006191348636819677
30972,2563.314,2563.321667,1,76899420,76899650,230,-0.02163325475208643
30973,2563.3272,2563.3339,1,76899816,76900017,201,0.3246538836147639
30974,2563.3349,2563.337933,1,76900047,76900137,90,
30975,2563.3412,2563.3505,1,76900236,76900515,279,0.14335553668253437
30976,2563.355533,2563.365267,1,76900665,76900958,293,0.18122650130546786
30977,2563.716233,2563.7199,1,76911486,76911597,111,0.5905802913335705
30978,2563.7219,2563.724933,1,76911657,76911747,90,0.4107677393053231
30979,2564.5549,2564.586933,1,76936647,76937607,960,0.6844980993608248
30980,2564.6223,2564.625933,1,76938669,76938777,108,0.23475223430855885
30981,2564.628533,2564.640733,1,76938855,76939221,366,0.6363077768371125
30982,2564.6649,2564.669933,1,76939947,76940097,150,0.604281630434502
30983,2564.675867,2564.6874,1,76940276,76940622,346,0.570664180850059
30984,2565.357733,2565.361467,1,76960731,76960844,113,0.43709525187957904
30985,2565.3741,2565.3852,1,76961223,76961556,333,0.532250414539547
30986,2565.429367,2565.4431,1,76962881,76963293,412,0.7049433810509323
30987,2565.454467,2565.460633,1,76963634,76963818,184,0.8020921898176376
30988,2565.492133,2565.516067,1,76964763,76965482,719,0.6349579542578057
30989,2565.599733,2565.607633,1,76967991,76968228,237,0.7721551207442194
30990,2565.613333,2565.616567,1,76968399,76968497,98,0.4526403821295853
30991,2565.6495,2565.666733,1,76969485,76970001,516,0.6079329943973502
30992,2565.679233,2565.691133,1,76970376,76970733,357,0.05978846972602579
30993,2565.731067,2565.740967,1,76971932,76972229,297,0.5768925321568016
30994,2565.767233,2565.775667,1,76973016,76973270,254,0.3925902994620849
30995,2565.7775,2565.7865,1,76973325,76973595,270,0.4850337601857298
30996,2565.9462,2565.9493,1,76978386,76978479,93,-0.39675846103858936
30997,2565.950467,2565.965,1,76978514,76978950,436,0.524166023498832
30998,2565.984233,2565.9902,1,76979526,76979706,180,-0.052440308375431975
30999,2566.182033,2566.186867,1,76985460,76985606,146,0.2605205897655492
31000,2566.542267,2566.546433,1,76996268,76996392,124,0.6550272127303779
31001,2566.586,2566.6191,1,76997580,76998573,993,0.6952099860212262
31002,2566.6627,2566.6673,1,76999881,77000019,138,0.47138461976258356
31003,2566.6812,2566.691433,1,77000436,77000742,306,0.5691418598213072
31004,2566.714633,2566.720633,1,77001438,77001618,180,0.6578482368017258
31005,2566.722033,2566.759033,1,77001660,77002770,1110,0.6810728819220914
31006,2566.792,2566.800567,1,77003760,77004017,257,0.7331723760026158
31007,2566.823567,2566.832433,1,77004707,77004972,265,0.7114175628332412
31008,2566.840567,2566.855033,1,77005217,77005650,433,0.6877555387089385
31009,2567.381,2567.395433,1,77021430,77021862,432,0.6450440264627821
31010,2567.396867,2567.414967,1,77021906,77022449,543,0.35720870384995457
31011,2567.427567,2567.447667,1,77022827,77023430,603,0.768384496310699
31012,2567.457,2567.4737,1,77023710,77024211,501,0.6149156018300697
31013,2567.474767,2567.517867,1,77024243,77025536,1293,0.6734231002581299
31014,2567.527267,2567.532267,1,77025818,77025968,150,0.728468433591969
31015,2567.536933,2567.5489,1,77026107,77026467,360,0.7010890382160995
31016,2567.550433,2567.5592,1,77026512,77026776,264,0.6452376310139536
31017,2567.607833,2567.621533,1,77028234,77028645,411,0.43431220805922494
31018,2567.629233,2567.657433,1,77028876,77029722,846,0.0035693159075140934
31019,2567.6608,2567.690267,1,77029824,77030708,884,0.09867338191575181
31020,2567.692633,2567.702633,1,77030778,77031078,300,0.03076058341494308
31021,2567.746267,2567.764867,1,77032388,77032946,558,0.3778007454385939
31022,2567.766133,2567.8641,1,77032983,77035923,2940,0.5831426404961849
31023,2568.118533,2568.128367,1,77043555,77043851,296,0.41073330235777505
31024,2568.139333,2568.156633,1,77044179,77044698,519,0.7552933245504087
31025,2568.1584,2568.206133,1,77044752,77046183,1431,0.8138378796276204
31026,2568.2199,2568.259967,1,77046597,77047799,1202,0.7906975222358914
31027,2568.707433,2568.7159,1,77061222,77061477,255,0.6389061563023828
31028,2568.723533,2568.7292,1,77061705,77061876,171,0.6040439577295328
31029,2568.772033,2568.794967,1,77063160,77063849,689,0.8559384213905014
31030,2568.8095,2568.8168,1,77064285,77064504,219,0.49460798431440217
31031,2568.8191,2568.884567,1,77064573,77066537,1964,0.7671081114138515
31032,2568.8891,2568.9654,1,77066673,77068962,2289,0.7453574044995033
31033,2568.975967,2568.997733,1,77069279,77069931,652,0.6703860876633412
31034,2569.0033,2569.024367,1,77070099,77070731,632,0.7533709787700188
31035,2569.031933,2569.0439,1,77070957,77071317,360,0.48294692909077164
31036,2569.074533,2569.0787,1,77072235,77072361,126,-0.04109106156655419
31037,2569.080933,2569.0942,1,77072427,77072826,399,0.23515617179416545
31038,2569.3752,2569.378867,1,77081256,77081366,110,0.6720384915752396
31039,2569.403,2569.427467,1,77082090,77082824,734,0.7110174413699352
31040,2569.451533,2569.458167,1,77083545,77083745,200,0.8232228919095139
31041,2569.4641,2569.467667,1,77083923,77084030,107,0.7530784726063205
31042,2569.469733,2569.488133,1,77084091,77084643,552,0.7013382505204465
31043,2569.4967,2569.517833,1,77084901,77085534,633,0.6733862252426146
31044,2569.5231,2569.546,1,77085693,77086380,687,0.7259079570430687
31045,2569.556467,2569.5598,1,77086694,77086794,100,0.18755307679164507
31046,2569.5643,2569.683767,1,77086929,77090513,3584,0.7615182144259944
31047,2569.697667,2569.720033,1,77090930,77091600,670,0.6928024126828963
31048,2569.721033,2569.743067,1,77091630,77092292,662,0.8012645795589943
31049,2569.7482,2569.755067,1,77092446,77092652,206,0.46820979292808973
31050,2569.757867,2569.761167,1,77092736,77092835,99,0.5444495061485056
31051,2569.775267,2569.7791,1,77093258,77093373,115,
31052,2569.783233,2569.788733,1,77093496,77093661,165,-0.04861489088631309
31053,2569.789967,2569.793933,1,77093699,77093817,118,0.00132091424595523
31054,2569.8014,2569.8084,1,77094042,77094252,210,0.2754441088622096
31055,2570.163767,2570.1691,1,77104913,77105073,160,0.6365718861910298
31056,2570.173067,2570.1855,1,77105192,77105565,373,0.23123199626412308
31057,2570.202033,2570.2079,1,77106060,77106237,177,0.7366247941847756
31058,2570.212967,2570.2245,1,77106389,77106735,346,0.7915937009806481
31059,2570.2396,2570.251,1,77107188,77107530,342,0.7833155110588176
31060,2570.2999,2570.3242,1,77108997,77109726,729,0.755086971781356
31061,2570.3309,2570.334067,1,77109927,77110022,95,0.045055604301517505
31062,2570.338067,2570.396567,1,77110142,77111897,1755,0.768341764753653
31063,2570.416633,2570.4462,1,77112498,77113386,888,0.761914124065945
31064,2570.4705,2570.4834,1,77114115,77114502,387,0.5000081321874269
31065,2570.494467,2570.503467,1,77114834,77115104,270,0.2647872135867222
31066,2570.507733,2570.513267,1,77115231,77115398,167,0.016056303259097016
31067,2570.875967,2570.879367,1,77126279,77126381,102,-0.015546546215935021
31068,2570.893,2570.903067,1,77126790,77127092,302,0.7928477756194358
31069,2570.9233,2570.9441,1,77127699,77128323,624,0.7450756682733817
31070,2570.949767,2570.9665,1,77128493,77128995,502,0.882881212876907
31071,2570.972867,2571.008467,1,77129186,77130254,1068,0.7554743597859986
31072,2571.0163,2571.0442,1,77130489,77131326,837,0.6392272118848242
31073,2571.054433,2571.188233,1,77131632,77135646,4014,0.7871234697590792
31074,2571.193667,2571.278833,1,77135810,77138364,2554,0.7496655810935524
31075,2571.282967,2571.345167,1,77138489,77140355,1866,0.7180740931437798
31076,2571.369967,2571.378267,1,77141099,77141348,249,0.5628611429385957
31077,2571.403267,2571.4137,1,77142098,77142411,313,0.14330569623539754
31078,2571.4147,2571.423367,1,77142441,77142701,260,0.1283588830854938
31079,2571.425033,2571.433633,1,77142750,77143008,258,0.47558174782825524
31080,2571.481467,2571.486633,1,77144444,77144598,154,0.08034230588683956
31081,2571.498133,2571.501833,1,77144943,77145054,111,
31082,2571.503367,2571.519,1,77145101,77145570,469,0.3631129848268936
31083,2571.5206,2571.616033,1,77145618,77148480,2862,0.56304331232869
31084,2571.9015,2571.9116,1,77157045,77157348,303,0.6082516067713997
31085,2571.914333,2571.923733,1,77157429,77157711,282,0.6335359305317809
31086,2571.935033,2571.938833,1,77158050,77158164,114,
31087,2571.951167,2571.967367,1,77158535,77159021,486,0.7145595074437117
31088,2571.974833,2572.026233,1,77159244,77160786,1542,0.8185215969099484
31089,2572.0346,2572.0641,1,77161038,77161923,885,0.7854699648323611
31090,2572.077033,2572.146967,1,77162310,77164409,2099,0.7832225757617413
31091,2572.148133,2572.160867,1,77164443,77164826,383,0.4842155477407495
31092,2572.1634,2572.168533,1,77164902,77165055,153,0.8559296292280132
31093,2572.1855,2572.277367,1,77165565,77168321,2756,0.7424299504375563
31094,2572.281167,2572.304033,1,77168435,77169120,685,0.7491862933478656
31095,2572.305433,2572.354833,1,77169162,77170644,1482,0.7345880994534303
31096,2572.357133,2572.397467,1,77170713,77171924,1211,0.8216921552442956
31097,2572.398867,2572.412667,1,77171966,77172380,414,0.8225097025883628
31098,2572.425067,2572.445167,1,77172752,77173355,603,0.7306391274919778
31099,2572.448167,2572.458333,1,77173445,77173749,304,0.6031854365005916
31100,2572.4771,2572.480867,1,77174313,77174426,113,
31101,2572.5423,2572.5458,1,77176269,77176374,105,
31102,2572.897867,2572.930667,1,77186936,77187920,984,0.4820250501053782
31103,2572.943267,2572.954067,1,77188298,77188622,324,0.6523104666660127
31104,2572.9658,2573.078333,1,77188974,77192349,3375,0.8047751133565575
31105,2573.082267,2573.124933,1,77192468,77193747,1279,0.7508597178141017
31106,2573.2547,2573.272633,1,77197641,77198178,537,0.3937995225330559
31107,2573.276033,2573.321167,1,77198280,77199635,1355,0.06165391384198402
31108,2573.323233,2573.3414,1,77199696,77200242,546,0.19922617525626016
31109,2573.387867,2573.5934,1,77201636,77207802,6166,0.8270745054232035
31110,2574.134,2574.146967,1,77224020,77224409,389,0.6812278128340764
31111,2574.151367,2574.1648,1,77224541,77224944,403,0.44626677613332405
31112,2574.235767,2574.242067,1,77227073,77227262,189,0.3059983405867188
31113,2574.4388,2574.5204,1,77233164,77235612,2448,0.7889060206216076
31114,2574.531067,2574.539833,1,77235932,77236194,262,0.8145943909165623
31115,2574.5412,2574.640067,1,77236236,77239202,2966,0.800580385882322
31116,2574.6441,2574.6644,1,77239323,77239932,609,0.8566049121046535
31117,2575.023,2575.044,1,77250690,77251320,630,0.5848660280320283
31118,2575.045567,2575.054133,1,77251367,77251623,256,0.6919244102375666
31119,2575.395733,2575.433,1,77261871,77262990,1119,0.7393956991222549
31120,2575.4387,2575.450933,1,77263161,77263527,366,0.5967391602066875
31121,2575.453,2575.465933,1,77263590,77263977,387,0.9189238266325744
31122,2575.4749,2575.525667,1,77264247,77265770,1523,0.7291625231295791
31123,2575.8402,2575.870633,1,77275206,77276118,912,0.7213974299972358
31124,2576.2064,2576.2254,1,77286192,77286762,570,0.7987023100179139
31125,2576.231633,2576.270667,1,77286948,77288120,1172,0.8733131016469947
31126,2576.272767,2576.2885,1,77288183,77288655,472,0.7260319387618149
31127,2576.2947,2576.402767,1,77288841,77292083,3242,0.7168743044599704
31128,2576.409433,2576.429267,1,77292282,77292878,596,0.8365509502489407
31129,2576.906767,2576.909933,1,77307203,77307297,94,0.29043575753792794
31130,2576.9153,2576.919833,1,77307459,77307594,135,0.6867936345459845
31131,2576.9334,2576.9447,1,77308002,77308341,339,0.7353514558063023
31132,2577.350667,2577.410567,1,77320520,77322317,1797,0.7986096075708403
31133,2577.413667,2577.423733,1,77322410,77322711,301,0.48729368731006667
31134,2577.424733,2577.435667,1,77322741,77323070,329,0.8041287735876425
31135,2577.4423,2577.4633,1,77323269,77323899,630,0.7483076834228825
31136,2580.0894,2580.095767,1,77402682,77402873,191,0.5772533475926437
31137,2580.150367,2580.157467,1,77404511,77404724,213,0.46534731548036595
31138,2580.6794,2580.685467,1,77420382,77420564,182,0.34435092475468876
31139,2580.6898,2580.694467,1,77420694,77420834,140,0.31405084942648653
31140,2580.702733,2580.722767,1,77421081,77421683,602,0.4621125606352302
31141,2580.748067,2580.760033,1,77422442,77422800,358,0.5664552383923732
31142,2580.8208,2580.8301,1,77424624,77424903,279,0.7252947236702223
31143,2580.969833,2580.9821,1,77429094,77429463,369,0.5663324314829458
31144,2580.988467,2580.997167,1,77429654,77429915,261,0.5573882539318994
31145,2581.501533,2581.531767,1,77445045,77445953,908,0.6375370993183955
31146,2581.532767,2581.538667,1,77445983,77446160,177,0.4503225116815037
31147,2581.550833,2581.577567,1,77446524,77447327,803,0.4316668754539321
31148,2581.5819,2581.603,1,77447457,77448090,633,0.5957098245946424
31149,2581.627567,2581.6846,1,77448827,77450538,1711,0.569226008343291
31150,2581.7004,2581.705,1,77451012,77451150,138,0.6877921526745421
31151,2581.706967,2581.736933,1,77451209,77452107,898,0.609658999938466
31152,2581.757233,2581.7727,1,77452716,77453181,465,0.6412999671308164
31153,2581.7772,2581.7985,1,77453316,77453955,639,0.8452245675262575
31154,2581.8214,2581.845867,1,77454642,77455376,734,0.6435323536137799
31155,2581.854767,2581.869767,1,77455643,77456093,450,0.7777425307464334
31156,2581.8781,2581.9032,1,77456343,77457096,753,0.7734694251353602
31157,2582.055767,2582.072567,1,77461673,77462177,504,0.5423199759559366
31158,2582.076833,2582.082933,1,77462304,77462487,183,0.2610611772520542
31159,2582.1235,2582.139667,1,77463705,77464190,485,0.6255227790117438
31160,2582.502733,2582.509033,1,77475081,77475270,189,0.3670849164445921
31161,2582.5128,2582.672867,1,77475384,77480186,4802,0.8358690112711684
31162,2582.686367,2582.7192,1,77480591,77481576,985,0.6381882142048447
31163,2582.721533,2582.795933,1,77481645,77483877,2232,0.8098558543269716
31164,2582.799533,2582.877633,1,77483985,77486328,2343,0.7640284381902712
31165,2582.8802,2582.905733,1,77486406,77487171,765,0.6853233556947653
31166,2582.9074,2582.984767,1,77487222,77489543,2321,0.7852295754435051
31167,2582.990633,2583.000833,1,77489718,77490024,306,0.7210739174460058
31168,2583.4338,2583.5877,1,77503014,77507631,4617,0.7598408474200984
31169,2583.5901,2583.627833,1,77507703,77508834,1131,0.7547741538061236
31170,2583.6348,2583.679733,1,77509044,77510391,1347,0.7068303066454126
31171,2583.684933,2583.7103,1,77510547,77511309,762,0.6908940023619823
31172,2583.7118,2583.7636,1,77511354,77512908,1554,0.6312095846463355
31173,2583.7677,2583.813433,1,77513031,77514402,1371,0.5495884301752837
31174,2583.821267,2583.849467,1,77514638,77515484,846,0.7195707507953759
31175,2583.8806,2583.8867,1,77516418,77516601,183,0.4930769814969952
31176,2583.889867,2583.909233,1,77516696,77517276,580,0.6219952386945221
31177,2583.929833,2583.972833,1,77517894,77519184,1290,0.5361699240585384
31178,2583.995067,2584.000733,1,77519852,77520021,169,0.7615282943652281
31179,2584.003267,2584.027933,1,77520098,77520837,739,0.8014556731708685
31180,2584.034067,2584.0467,1,77521022,77521401,379,0.7569930732088211
31181,2584.0554,2584.071767,1,77521662,77522153,491,0.7018432689974705
31182,2584.463467,2584.466533,1,77533904,77533995,91,0.05697270639669755
31183,2584.5356,2584.539567,1,77536068,77536187,119,0.7058589497501039
31184,2584.5421,2584.694533,1,77536263,77540835,4572,0.8260733356281231
31185,2584.695667,2584.713867,1,77540870,77541416,546,0.7520423628721226
31186,2584.726467,2584.7358,1,77541794,77542074,280,0.7706530348478756
31187,2584.742833,2584.8184,1,77542284,77544552,2268,0.8062388744781332
31188,2584.832833,2584.850933,1,77544984,77545527,543,0.8185016132782352
31189,2585.239133,2585.267167,1,77557173,77558015,842,0.7176080699282191
31190,2585.301967,2585.313233,1,77559059,77559396,337,0.6732404072805596
31191,2585.3228,2585.3418,1,77559684,77560254,570,0.7247044981566618
31192,2585.6889,2585.714733,1,77570667,77571441,774,0.4762100005242946
31193,2585.716033,2585.7201,1,77571480,77571603,123,0.6926229486038902
31194,2585.744633,2585.821733,1,77572338,77574651,2313,0.7539563775482706
31195,2585.840433,2585.843433,1,77575212,77575302,90,-0.12344220386057965
31196,2586.584133,2586.590467,1,77597523,77597714,191,0.24603066961558404
31197,2586.599633,2586.701067,1,77597988,77601032,3044,0.8248814387149755
31198,2586.7115,2586.715133,1,77601345,77601453,108,0.0393170757736513
31199,2587.0781,2587.083933,1,77612343,77612517,174,0.5344155936400234
31200,2587.085067,2587.090667,1,77612552,77612720,168,0.5174612203580938
31201,2587.102267,2587.112567,1,77613068,77613377,309,0.759195452313446
31202,2587.150333,2587.163233,1,77614509,77614896,387,0.8849434039028411
31203,2587.24,2587.247533,1,77617200,77617425,225,0.6704958597771367
31204,2587.2849,2587.302667,1,77618547,77619080,533,0.6024839617963201
31205,2587.364233,2587.377767,1,77620926,77621333,407,0.8165722445723442
31206,2587.4034,2587.415433,1,77622102,77622462,360,0.6281478367623906
31207,2587.419533,2587.428933,1,77622585,77622867,282,0.6442510890896594
31208,2587.584467,2587.731233,1,77627534,77631936,4402,0.7994409913637911
31209,2587.775967,2587.816733,1,77633279,77634501,1222,0.8096660970225309
31210,2587.823,2587.876867,1,77634690,77636306,1616,0.7820726834856674
31211,2588.302067,2588.328833,1,77649062,77649864,802,0.6153854573741881
31212,2588.335833,2588.3964,1,77650074,77651892,1818,0.7162515443512442
31213,2588.4057,2588.436533,1,77652171,77653095,924,0.6556485476452274
31214,2588.4548,2588.4919,1,77653644,77654757,1113,0.5293926112769402
31215,2588.5077,2588.5144,1,77655231,77655432,201,0.580922552118869
31216,2588.5685,2588.601233,1,77657055,77658036,981,0.16528077785578754
31217,2588.6321,2588.705267,1,77658963,77661158,2195,0.6787277894231835
31218,2588.735967,2588.827633,1,77662079,77664828,2749,0.6242445235853239
31219,2588.8417,2588.882267,1,77665251,77666468,1217,0.686433019278593
31220,2588.883267,2588.894167,1,77666498,77666825,327,0.6707571128162829
31221,2588.909433,2588.914433,1,77667282,77667432,150,0.7362192741123462
31222,2588.9241,2588.936633,1,77667723,77668098,375,0.6125999609886763
31223,2588.938967,2588.943567,1,77668169,77668307,138,0.609948992436368
31224,2588.989067,2589.002467,1,77669672,77670074,402,0.6924658081924167
31225,2589.016367,2589.0197,1,77670491,77670591,100,0.8055883395856805
31226,2589.021567,2589.1371,1,77670647,77674113,3466,0.708974458454355
31227,2589.1387,2589.146367,1,77674161,77674391,230,0.6973818507541284
31228,2589.150533,2589.1908,1,77674515,77675724,1209,0.721115022491648
31229,2589.2068,2589.2223,1,77676204,77676669,465,0.7329445167622984
31230,2589.225333,2589.245667,1,77676759,77677370,611,0.7095998054713721
31231,2589.583433,2589.586667,1,77687502,77687600,98,-0.14832680209345364
31232,2589.5932,2589.806433,1,77687796,77694192,6396,0.7717082866153225
31233,2590.167667,2590.1725,1,77705030,77705175,145,0.5915662231879518
31234,2590.175833,2590.186567,1,77705274,77705597,323,0.705875828939424
31235,2590.238367,2590.292967,1,77707151,77708789,1638,0.8112877336504146
31236,2590.300433,2590.3257,1,77709012,77709771,759,0.6592246441526232
31237,2590.334033,2590.416267,1,77710020,77712488,2468,0.7458028221080523
31238,2590.419833,2590.4423,1,77712594,77713269,675,0.656224355941954
31239,2590.4433,2590.463067,1,77713299,77713892,593,0.5805148737061269
31240,2590.467333,2590.489933,1,77714019,77714697,678,0.6966713998357685
31241,2590.491933,2590.566033,1,77714757,77716980,2223,0.8181050902929322
31242,2590.593733,2590.6138,1,77717811,77718414,603,0.7212793303879467
31243,2590.621667,2590.6277,1,77718650,77718831,181,0.3646465397037306
31244,2590.628767,2590.6941,1,77718863,77720823,1960,0.7425703481658684
31245,2590.697967,2590.7087,1,77720939,77721261,322,0.6329691689897948
31246,2590.709867,2590.761067,1,77721296,77722832,1536,0.7846867427754569
31247,2590.762267,2590.781333,1,77722868,77723439,571,0.5553040935949822
31248,2590.7988,2590.804233,1,77723964,77724126,162,0.2195944771285132
31249,2590.805267,2590.812533,1,77724158,77724375,217,0.5575616484331445
31250,2591.3599,2591.392333,1,77740797,77741769,972,0.524097703036582
31251,2591.453067,2591.4604,1,77743592,77743812,220,0.5400226774877404
31252,2591.564467,2591.576167,1,77746934,77747285,351,0.5456633532664897
31253,2591.629267,2591.639467,1,77748878,77749184,306,0.6389816721250762
31254,2591.8222,2591.9397,1,77754666,77758191,3525,0.766306391417203
31255,2591.9663,2592.143633,1,77758989,77764308,5319,0.7562579513887413
31256,2592.147733,2592.166867,1,77764431,77765006,575,0.807375843650194
31257,2592.1683,2592.181633,1,77765049,77765448,399,0.6160918987277063
31258,2592.596633,2592.6011,1,77777898,77778033,135,0.7347394048426015
31259,2592.604133,2592.6131,1,77778123,77778393,270,0.6652578490147455
31260,2592.616133,2592.7001,1,77778483,77781003,2520,0.7250112543041562
31261,2592.701433,2592.7571,1,77781042,77782713,1671,0.6271582217419982
31262,2592.768133,2592.7737,1,77783043,77783211,168,0.5340276181734337
31263,2592.778067,2592.794333,1,77783342,77783829,487,0.6631853887764712
31264,2592.795367,2592.806833,1,77783861,77784204,343,0.5701076079349547
31265,2592.8581,2592.876833,1,77785743,77786304,561,0.08535709083419267
31266,2592.878033,2592.885567,1,77786340,77786567,227,0.15164068641947118
31267,2592.952233,2592.957533,1,77788566,77788725,159,0.575720464452694
31268,2593.001133,2593.008167,1,77790033,77790245,212,-0.06034894681930937
31269,2593.216,2593.219533,1,77796480,77796585,105,0.07217068053020939
31270,2593.2278,2593.373767,1,77796834,77801213,4379,0.850529266775752
31271,2593.395733,2593.438733,1,77801871,77803161,1290,0.5619803357604721
31272,2593.445567,2593.525867,1,77803367,77805776,2409,0.8224475410223767
31273,2593.534533,2593.537767,1,77806035,77806133,98,-0.14666009523781867
31274,2593.539167,2593.542533,1,77806175,77806275,100,0.003191284260428204
31275,2593.9644,2593.970267,1,77818932,77819108,176,0.6067308403778513
31276,2593.977833,2593.9866,1,77819334,77819598,264,0.883097261920181
31277,2594.012333,2594.0161,1,77820369,77820483,114,0.8821321721430408
31278,2594.034033,2594.046267,1,77821020,77821388,368,0.8536370968277762
31279,2594.0923,2594.1073,1,77822769,77823219,450,0.8446186752497965
31280,2594.108967,2594.116067,1,77823269,77823482,213,0.5998222253773878
31281,2594.124533,2594.2518,1,77823735,77827554,3819,0.8000833271719714
31282,2594.258033,2594.330633,1,77827740,77829918,2178,0.8060344798651775
31283,2594.3403,2594.362667,1,77830209,77830880,671,0.7393702304743923
31284,2594.375767,2594.3834,1,77831273,77831502,229,0.7439002656352172
31285,2594.820533,2594.995867,1,77844615,77849876,5261,0.8279353092889904
31286,2595.0416,2595.047533,1,77851248,77851425,177,0.8605947638141981
31287,2595.0504,2595.122967,1,77851512,77853689,2177,0.7981745198846153
31288,2595.1246,2595.131467,1,77853738,77853944,206,0.6362782421065382
31289,2595.135467,2595.150433,1,77854064,77854512,448,0.7980556400655047
31290,2595.1536,2595.202933,1,77854608,77856087,1479,0.7443549688977119
31291,2595.206733,2595.3033,1,77856201,77859099,2898,0.7430472099109244
31292,2595.306467,2595.309767,1,77859194,77859293,99,-0.22573106224240044
31293,2595.332,2595.337733,1,77859960,77860131,171,0.4166262941454974
31294,2595.752167,2595.762867,1,77872565,77872886,321,0.24331153963559748
31295,2595.767733,2595.925267,1,77873031,77877758,4727,0.7299293394260749
31296,2595.929267,2596.0033,1,77877878,77880099,2221,0.7908915567760302
31297,2596.0094,2596.0372,1,77880282,77881116,834,0.6337659463728187
31298,2596.038467,2596.092633,1,77881154,77882778,1624,0.7892573482915789
31299,2596.0981,2596.1117,1,77882943,77883351,408,0.7306069050554351
31300,2596.114367,2596.218933,1,77883431,77886567,3136,0.7688974397949038
31301,2596.547633,2596.6054,1,77896428,77898162,1734,0.7553109365157182
31302,2596.608933,2596.618067,1,77898267,77898542,275,-0.32787161513753693
31303,2596.620067,2596.631433,1,77898602,77898942,340,0.27944597301779733
31304,2596.9894,2597.086167,1,77909682,77912585,2903,0.7824524875052316
31305,2597.0874,2597.091,1,77912622,77912730,108,0.05768588261576063
31306,2597.093333,2597.096733,1,77912799,77912901,102,0.07775844992947813
31307,2597.533067,2597.5481,1,77925992,77926443,451,0.5064339681025152
31308,2597.550867,2597.5599,1,77926526,77926797,271,0.07860004290243747
31309,2597.569833,2597.661833,1,77927094,77929854,2760,0.8102362166452941
31310,2598.1308,2598.136867,1,77943924,77944106,182,0.6243510010725125
31311,2598.1663,2598.194667,1,77944989,77945840,851,0.44877990830520936
31312,2598.2326,2598.249167,1,77946978,77947475,497,0.5903130882959072
31313,2598.250767,2598.255333,1,77947523,77947659,136,0.33437746776974053
31314,2598.265067,2598.275967,1,77947952,77948279,327,0.5849871540837197
31315,2598.276967,2598.3055,1,77948309,77949165,856,0.5280313948340768
31316,2598.332,2598.339333,1,77949960,77950179,219,0.4163772856937488
31317,2598.341133,2598.345767,1,77950233,77950373,140,0.3690041168009692
31318,2598.506,2598.5806,1,77955180,77957418,2238,0.7413583959830898
31319,2598.5818,2598.6295,1,77957454,77958885,1431,0.7280309150938427
31320,2598.665367,2598.770267,1,77959961,77963108,3147,0.7737669444026214
31321,2598.783333,2598.810733,1,77963499,77964321,822,0.6654465239642073
31322,2598.812233,2598.863633,1,77964366,77965908,1542,0.7025870195651893
31323,2598.87,2598.902133,1,77966100,77967063,963,0.8111903234250611
31324,2598.9085,2598.964967,1,77967255,77968949,1694,0.7845290167228193
31325,2598.9692,2598.991967,1,77969076,77969759,683,0.5658909628951427
31326,2598.993567,2599.0447,1,77969807,77971341,1534,0.6576090229109964
31327,2599.057333,2599.060967,1,77971719,77971829,110,0.5156060661735583
31328,2599.069667,2599.08,1,77972090,77972400,310,0.7353969811732829
31329,2599.086733,2599.098667,1,77972601,77972960,359,0.5910023350301196
31330,2599.453733,2599.5727,1,77983611,77987181,3570,0.8168272672864318
31331,2599.863467,2599.8711,1,77995904,77996133,229,0.55443446903916
31332,2599.872433,2599.883167,1,77996172,77996495,323,0.6916505628793064
31333,2599.884733,2599.9773,1,77996541,77999319,2778,0.6487525641190088
31334,2599.986033,2599.995733,1,77999580,77999871,291,0.6810291804309785
31335,2600.000567,2600.141033,1,78000017,78004230,4213,0.6464379933045413
31336,2600.660967,2600.728233,1,78019829,78021846,2017,0.7230388953780462
31337,2600.733067,2600.869167,1,78021992,78026075,4083,0.7625269285521773
31338,2600.870767,2600.8744,1,78026123,78026232,109,-0.2829989965380769
31339,2600.8756,2600.878767,1,78026268,78026363,95,0.7272894099834015
31340,2600.894433,2600.986733,1,78026832,78029601,2769,0.8061844364639684
31341,2600.994633,2601.0154,1,78029838,78030462,624,0.6240385167186014
31342,2601.016433,2601.099867,1,78030492,78032996,2504,0.6500234087986894
31343,2601.653433,2601.764233,1,78049602,78052926,3324,0.8244975655503296
31344,2602.389967,2602.411,1,78071699,78072330,631,0.7696207255149013
31345,2602.521933,2602.534433,1,78075657,78076032,375,0.5151323621609933
31346,2602.595233,2602.600467,1,78077856,78078014,158,0.43804807670850354
31347,2602.606467,2602.614333,1,78078194,78078429,235,0.7077327295502187
31348,2602.619267,2602.623333,1,78078578,78078699,121,0.4432604038682085
31349,2604.169633,2604.177167,1,78125088,78125315,227,0.05609664968846755
31350,2604.184167,2604.2369,1,78125525,78127107,1582,0.18388950948349678
31351,2604.2494,2604.309433,1,78127482,78129282,1800,0.27362036483825675
31352,2604.3239,2604.336867,1,78129717,78130106,389,0.1983368943172378
31353,2604.3383,2604.3465,1,78130149,78130395,246,-0.14948687716186979
31354,2604.360467,2604.364867,1,78130814,78130946,132,0.3546678687566624
31355,2605.1739,2605.182767,1,78155217,78155483,266,0.36259844120840024
31356,2608.610567,2608.615133,1,78258317,78258453,136,0.09821607834804347
31357,2608.619633,2608.664,1,78258588,78259920,1332,0.5807857697018414
31358,2608.668967,2608.7164,1,78260069,78261492,1423,0.5847451459654722
31359,2617.268933,2617.273767,1,78518067,78518213,146,-0.25792588635499014
31360,2617.285633,2617.288767,1,78518568,78518663,95,
31361,2617.511533,2617.5203,1,78525345,78525609,264,0.43956706909034654
31362,2617.599767,2617.603233,1,78527993,78528096,103,0.8777213612738434
31363,2639.395,2639.407,1,79181850,79182210,360,0.6379663243900993
31364,2639.6625,2639.678867,1,79189875,79190366,491,0.6851560059107678
31365,2639.7082,2639.717567,1,79191246,79191527,281,0.6753548445744305
31366,2639.721467,2639.77,1,79191644,79193100,1456,0.6332970123292524
31367,2639.785133,2639.7883,1,79193553,79193649,96,0.594454999981259
31368,2639.791,2639.797533,1,79193730,79193925,195,0.7010175043608383
31369,2639.799467,2639.823733,1,79193984,79194711,727,0.6931097889398473
31370,2639.8385,2639.859833,1,79195155,79195794,639,0.5263892832365863
31371,2639.869267,2639.872567,1,79196078,79196177,99,0.35970768847311907
31372,2639.875533,2639.885733,1,79196265,79196571,306,0.8861929914738615
31373,2639.906933,2639.911567,1,79197207,79197347,140,0.6210696198067435
31374,2639.912833,2639.926867,1,79197384,79197806,422,0.6925431400228594
31375,2639.944067,2639.955033,1,79198322,79198650,328,0.7467220144171564
31376,2639.960667,2639.982933,1,79198820,79199487,667,0.5596660895346975
31377,2640.085867,2640.101467,1,79202576,79203044,468,0.2748992751580136
31378,2640.107933,2640.188467,1,79203237,79205654,2417,0.4031176154162087
31379,2640.513033,2640.517167,1,79215390,79215515,125,0.6578755424969343
31380,2640.531467,2640.6753,1,79215944,79220259,4315,0.7769282914026434
31381,2640.694833,2640.722333,1,79220844,79221669,825,0.8363336721025161
31382,2640.725733,2640.834,1,79221771,79225020,3249,0.7506310401561717
31383,2641.475267,2641.480333,1,79244258,79244409,151,0.684666933181869
31384,2641.5106,2641.576033,1,79245318,79247280,1962,0.7081047670254079
31385,2641.6106,2641.629567,1,79248318,79248887,569,0.7630613026223968
31386,2641.637367,2641.6425,1,79249121,79249275,154,0.6648379749261859
31387,2641.694233,2641.7182,1,79250826,79251546,720,0.6283440836947269
31388,2641.7348,2641.740367,1,79252044,79252211,167,0.5515166446283508
31389,2641.7437,2641.7533,1,79252311,79252599,288,0.5782266214357035
31390,2641.7557,2641.7774,1,79252671,79253322,651,0.5830923355892677
31391,2641.796367,2641.833267,1,79253891,79254998,1107,0.6245294608396968
31392,2641.866667,2641.873167,1,79256000,79256195,195,0.5897702588843889
31393,2641.8746,2641.8846,1,79256238,79256538,300,0.6097619957110136
31394,2641.921433,2641.936,1,79257642,79258080,438,0.6351277886481125
31395,2642.674667,2642.6845,1,79280240,79280535,295,0.6840966463902395
31396,2642.7141,2642.732233,1,79281423,79281966,543,0.6849976888585705
31397,2642.742967,2642.749167,1,79282289,79282475,186,0.6278852103933756
31398,2642.758233,2642.764067,1,79282746,79282922,176,0.39288720289006435
31399,2642.767267,2642.792467,1,79283018,79283774,756,0.5551137955331966
31400,2642.8013,2642.816833,1,79284039,79284504,465,0.5035459621558217
31401,2642.819767,2642.825233,1,79284593,79284756,163,0.5093844034804215
31402,2642.827433,2642.8333,1,79284822,79284999,177,0.46091661292451164
31403,2642.8465,2642.888033,1,79285395,79286640,1245,0.6502026896748043
31404,2642.892633,2642.9142,1,79286778,79287426,648,0.5992576041714156
31405,2642.918333,2642.926333,1,79287549,79287789,240,0.5818609264179823
31406,2643.4274,2643.5547,1,79302822,79306641,3819,0.6824379097806134
31407,2643.577767,2643.617467,1,79307333,79308524,1191,0.6055810690183138
31408,2643.624033,2643.633367,1,79308720,79309001,281,0.5250373998313134
31409,2643.636233,2643.6398,1,79309086,79309194,108,0.6396609967664433
31410,2643.641567,2643.659533,1,79309247,79309785,538,0.5241608020682811
31411,2643.892367,2643.896033,1,79316771,79316880,109,0.6050819583324526
31412,2643.901333,2643.9286,1,79317039,79317858,819,0.794160174658069
31413,2643.9298,2643.9342,1,79317894,79318026,132,-0.046501988802459045
31414,2646.320567,2646.325567,1,79389617,79389767,150,0.7257836605129805
31415,2646.767033,2646.917733,1,79403010,79407531,4521,0.33815312276255166
31416,2646.920767,2646.946133,1,79407623,79408383,760,0.22717672554673596
31417,2647.097967,2647.107433,1,79412939,79413222,283,0.3211937201257758
31418,2647.113967,2647.1364,1,79413419,79414092,673,-0.04887235671304449
31419,2647.157833,2647.177233,1,79414734,79415316,582,-0.09130945026434387
31420,2647.187967,2647.2222,1,79415639,79416666,1027,0.19355320826679862
31421,2647.236233,2647.255833,1,79417086,79417674,588,-0.1186843509274881
31422,2647.270333,2647.2971,1,79418109,79418913,804,-0.02554737232465785
31423,2647.311333,2647.343533,1,79419339,79420305,966,-0.07326700343158372
31424,2647.356967,2647.3755,1,79420709,79421265,556,-0.02017427796868128
31425,2647.395333,2647.4174,1,79421859,79422522,663,-0.05789788462642504
31426,2647.435,2647.457367,1,79423050,79423721,671,0.04355783474482305
31427,2647.476633,2647.497533,1,79424298,79424925,627,-0.035654507181293496
31428,2647.514233,2647.538033,1,79425426,79426140,714,0.06997025483781488
31429,2647.555133,2647.5788,1,79426653,79427364,711,0.08679552228696338
31430,2647.598733,2647.620733,1,79427961,79428621,660,-0.07004222157830721
31431,2647.639867,2647.659633,1,79429196,79429788,592,-0.04301064080139113
31432,2647.678767,2647.703267,1,79430363,79431098,735,0.1625393091522371
31433,2647.7229,2647.7469,1,79431687,79432407,720,0.10410405890637156
31434,2647.765133,2647.783633,1,79432953,79433508,555,0.04035524308869655
31435,2647.804567,2647.81,1,79434137,79434300,163,0.4835697927048798
31436,2647.8114,2647.828633,1,79434342,79434858,516,0.08361445610133754
31437,2647.847867,2647.871967,1,79435436,79436159,723,0.1742570745416613
31438,2647.888533,2647.915133,1,79436655,79437453,798,0.1387768331754293
31439,2647.934567,2647.958767,1,79438037,79438763,726,0.11662522259537304
31440,2647.9609,2647.964267,1,79438827,79438928,101,
31441,2647.974,2647.997933,1,79439220,79439937,717,0.017974800600210006
31442,2648.018467,2648.039767,1,79440554,79441193,639,0.11868815873232619
31443,2648.059833,2648.081633,1,79441794,79442448,654,0.08618298033113637
31444,2648.1035,2648.126433,1,79443105,79443792,687,0.15919531789220787
31445,2648.1474,2648.168467,1,79444422,79445054,632,0.0777494810401759
31446,2648.183267,2648.2204,1,79445498,79446612,1114,-0.12151529229591818
31447,2648.229633,2648.264533,1,79446888,79447935,1047,0.2540252602666623
31448,2648.279533,2648.300767,1,79448385,79449023,638,-0.09998606949135558
31449,2648.3227,2648.343133,1,79449681,79450293,612,-0.054993937728789105
31450,2648.364667,2648.387533,1,79450940,79451625,685,0.12223710277032351
31451,2648.4071,2648.433667,1,79452213,79453010,797,0.05299493780836543
31452,2648.4517,2648.474167,1,79453551,79454225,674,0.13549178012822863
31453,2648.495367,2648.517633,1,79454861,79455528,667,0.11875128120448476
31454,2648.536933,2648.567433,1,79456107,79457022,915,0.14843080304810555
31455,2648.587267,2648.608433,1,79457618,79458252,634,0.08155610159618243
31456,2648.627333,2648.6508,1,79458819,79459524,705,-0.01364977072143005
31457,2648.670567,2648.696867,1,79460117,79460906,789,0.10441002406797317
31458,2648.7066,2648.7099,1,79461198,79461297,99,0.17635454044654353
31459,2648.7244,2648.7461,1,79461732,79462383,651,-0.13214606701173628
31460,2648.761933,2648.785633,1,79462857,79463568,711,0.19941905859143616
31461,2648.807267,2648.830667,1,79464218,79464920,702,0.26934121761270424
31462,2648.855567,2648.859,1,79465667,79465770,103,0.5857668228766709
31463,2648.870067,2648.883767,1,79466102,79466513,411,0.516671693922357
31464,2648.901033,2648.923233,1,79467030,79467696,666,0.18065824451998985
31465,2648.945933,2648.9703,1,79468377,79469109,732,0.02858697341405976
31466,2648.9929,2649.018733,1,79469787,79470561,774,-0.031004965684170896
31467,2649.039,2649.067667,1,79471170,79472030,860,-0.027882255976251567
31468,2649.085433,2649.111733,1,79472562,79473351,789,-0.08153896676107851
31469,2649.1292,2649.152633,1,79473876,79474578,702,0.07996702796074043
31470,2649.1775,2649.202067,1,79475325,79476062,737,0.11207163952125841
31471,2649.2221,2649.2504,1,79476663,79477512,849,0.0437069578848518
31472,2649.269467,2649.2953,1,79478084,79478859,775,0.06733459451985402
31473,2649.3152,2649.3379,1,79479456,79480137,681,0.056737764969308144
31474,2649.348567,2649.3541,1,79480457,79480623,166,0.7664208481318767
31475,2649.3594,2649.386033,1,79480782,79481580,798,0.060736178877314084
31476,2649.405767,2649.430767,1,79482173,79482923,750,-0.04462896887190889
31477,2649.4547,2649.4772,1,79483641,79484316,675,-0.06110213232573834
31478,2649.495267,2649.504367,1,79484858,79485131,273,0.27865744556960653
31479,2649.5055,2649.525,1,79485165,79485750,585,0.08487756858065387
31480,2649.553333,2649.5809,1,79486599,79487427,828,-0.10176935923718665
31481,2649.6049,2649.626067,1,79488147,79488782,635,-0.09899087608705809
31482,2649.652833,2649.675,1,79489584,79490250,666,-0.0358901144618185
31483,2650.299833,2650.347967,1,79508994,79510439,1445,0.3360446509071194
31484,2650.528667,2650.549133,1,79515860,79516473,613,-0.04794518316510591
31485,2650.6564,2650.6857,1,79519692,79520571,879,0.11928285108183848
31486,2650.841667,2650.847933,1,79525250,79525437,187,-0.10428855186954487
31487,2650.850633,2650.8621,1,79525518,79525863,345,0.005627923829616216
31488,2651.214567,2651.220867,1,79536437,79536626,189,0.32443303160544806
31489,2651.2585,2651.262633,1,79537755,79537878,123,0.734005343878212
31490,2651.536833,2651.554833,1,79546104,79546644,540,0.21527563841647995
31491,2651.5638,2651.6739,1,79546914,79550217,3303,0.834284145169699
31492,2651.683133,2651.702,1,79550493,79551060,567,0.5085314571153422
31493,2651.704233,2651.767133,1,79551126,79553013,1887,0.0009351722219950815
31494,2651.769133,2651.776,1,79553073,79553280,207,0.28454508887178387
31495,2651.777067,2651.7829,1,79553312,79553487,175,0.4839726437120123
31496,2651.787367,2651.800533,1,79553621,79554015,394,0.5682433119914548
31497,2651.801533,2651.850667,1,79554045,79555520,1475,0.04824432535664599
31498,2651.8597,2651.865933,1,79555791,79555977,186,0.015632783640774847
31499,2651.866967,2651.8789,1,79556009,79556367,358,0.6707178447846642
31500,2651.882167,2651.886433,1,79556465,79556592,127,
31501,2651.9271,2651.9377,1,79557813,79558131,318,0.43057645604254
31502,2651.9398,2651.968667,1,79558194,79559060,866,0.09472990239475218
31503,2651.969833,2651.9781,1,79559094,79559343,249,0.05141761034810708
31504,2651.994567,2651.999867,1,79559837,79559996,159,0.018315671876450907
31505,2652.007,2652.016067,1,79560210,79560482,272,0.35883001548935656
31506,2652.018067,2652.0286,1,79560542,79560858,316,0.17133139254055466
31507,2652.5311,2652.546133,1,79575933,79576383,450,0.33444877713571475
31508,2652.5506,2652.558433,1,79576518,79576752,234,0.20755862887181303
31509,2652.5668,2652.685133,1,79577004,79580553,3549,0.16334648607431998
31510,2652.6863,2652.696233,1,79580589,79580886,297,0.2307586754737588
31511,2652.7002,2652.7077,1,79581006,79581231,225,-0.2122254811079661
31512,2652.713133,2652.716667,1,79581393,79581500,107,-0.14030578021935658
31513,2653.172733,2653.182067,1,79595181,79595462,281,0.6130705562305713
31514,2653.183333,2653.231967,1,79595499,79596959,1460,0.5051457859086299
31515,2653.2348,2653.238033,1,79597044,79597140,96,
31516,2653.439967,2653.446367,1,79603199,79603391,192,0.6941192604320836
31517,2653.455633,2653.464433,1,79603668,79603932,264,0.5386740207670321
31518,2653.466,2653.470633,1,79603980,79604118,138,0.494190705217881
31519,2653.472233,2653.548233,1,79604166,79606446,2280,0.02473431412917212
31520,2653.5495,2653.558067,1,79606485,79606742,257,0.11739874236314542
31521,2653.579567,2653.6854,1,79607387,79610562,3175,0.7729046328546608
31522,2653.6869,2653.690467,1,79610607,79610714,107,0.45471068781436996
31523,2653.715133,2653.722033,1,79611453,79611660,207,-0.0734884712394516
31524,2653.723867,2653.728533,1,79611716,79611855,139,0.665440937555588
31525,2653.735433,2653.739267,1,79612062,79612178,116,0.6256597708034914
31526,2653.7404,2653.745967,1,79612212,79612379,167,0.17711626786304877
31527,2653.876033,2653.879967,1,79616280,79616399,119,0.3680583329783205
31528,2654.192867,2654.198,1,79625786,79625940,154,0.25904614618515753
31529,2654.202867,2654.349133,1,79626086,79630473,4387,0.8040836438644523
31530,2654.3769,2654.3972,1,79631307,79631916,609,0.7952013675093628
31531,2654.404167,2654.501333,1,79632125,79635039,2914,0.8402953971121508
31532,2654.505733,2654.509333,1,79635171,79635279,108,0.35557647269435233
31533,2654.5106,2654.5179,1,79635318,79635537,219,-0.1812934742884745
31534,2654.5202,2654.526233,1,79635606,79635786,180,-0.10876639589190662
31535,2654.851533,2654.877267,1,79645545,79646318,773,0.5578445274855773
31536,2654.881567,2654.960067,1,79646447,79648802,2355,0.7599772074878571
31537,2654.9628,2654.991233,1,79648884,79649736,852,0.6514847596388794
31538,2655.0224,2655.0287,1,79650672,79650861,189,0.6492929092547551
31539,2655.030633,2655.035167,1,79650918,79651055,137,0.49826797976662346
31540,2655.037567,2655.089967,1,79651127,79652699,1572,0.3937919643354775
31541,2655.091433,2655.105667,1,79652742,79653170,428,0.03255650618993671
31542,2655.157667,2655.161667,1,79654730,79654850,120,0.35389870672147955
31543,2655.165767,2655.180267,1,79654973,79655408,435,0.46311068332383415
31544,2655.182267,2655.186,1,79655468,79655580,112,0.1661203407817224
31545,2655.187333,2655.2672,1,79655619,79658016,2397,0.05741863338829682
31546,2655.345467,2655.348733,1,79660364,79660461,97,
31547,2655.3618,2655.470667,1,79660854,79664120,3266,0.8119468220081855
31548,2655.8876,2655.8938,1,79676628,79676814,186,0.8181496300949997
31549,2655.933667,2655.9613,1,79678010,79678839,829,0.6385215771124049
31550,2655.997833,2656.003033,1,79679934,79680090,156,0.4432526478999492
31551,2656.012867,2656.027333,1,79680386,79680819,433,0.5613492019208087
31552,2656.050167,2656.066667,1,79681505,79682000,495,0.4653135100684334
31553,2656.1203,2656.126733,1,79683609,79683801,192,0.6350490495999619
31554,2656.1289,2656.137833,1,79683867,79684134,267,0.6380873198647858
31555,2656.227267,2656.230733,1,79686818,79686921,103,-0.11812979990982968
31556,2656.238233,2656.2496,1,79687146,79687488,342,0.14786080733258714
31557,2656.251933,2656.2728,1,79687557,79688184,627,0.18615993651542875
31558,2656.2853,2656.334667,1,79688559,79690040,1481,0.7803693489389684
31559,2656.3368,2656.386067,1,79690104,79691582,1478,0.8699735270989591
31560,2656.396567,2656.462067,1,79691897,79693862,1965,0.7844266462744137
31561,2656.4725,2656.5381,1,79694175,79696143,1968,0.7910002370511152
31562,2656.877867,2656.957133,1,79706336,79708713,2377,0.7509622300921899
31563,2656.958567,2657.153567,1,79708757,79714607,5850,0.7858725709475418
31564,2657.1561,2657.159467,1,79714683,79714784,101,-0.3353846563195044
31565,2657.3783,2657.3819,1,79721349,79721457,108,-0.1734694129603955
31566,2657.383567,2657.4565,1,79721507,79723695,2188,0.5798401755857083
31567,2657.458867,2657.473167,1,79723766,79724195,429,0.011597448674617247
31568,2657.479333,2657.484067,1,79724379,79724522,143,0.453315299136095
31569,2657.6244,2657.690067,1,79728732,79730702,1970,0.723334552653709
31570,2657.697933,2657.720667,1,79730937,79731620,683,0.7440381013223211
31571,2657.747667,2657.7761,1,79732430,79733283,853,0.7336272735970714
31572,2657.792567,2657.806033,1,79733777,79734180,403,0.20419456421375637
31573,2657.808333,2657.850567,1,79734249,79735517,1268,0.45260236339361437
31574,2657.858933,2657.865967,1,79735767,79735979,212,0.15431354377253292
31575,2657.8733,2657.895367,1,79736199,79736861,662,0.43911891484689114
31576,2657.923333,2657.969567,1,79737699,79739087,1388,0.23580256801337182
31577,2657.970667,2657.978933,1,79739120,79739367,247,0.15508721364558734
31578,2657.981967,2657.995133,1,79739459,79739853,394,-0.12234870865510086
31579,2658.031133,2658.0398,1,79740933,79741194,261,0.6234111731674055
31580,2658.066633,2658.138433,1,79741998,79744152,2154,0.49900580537451084
31581,2658.139867,2658.352133,1,79744196,79750563,6367,0.4732885587132797
31582,2658.354467,2658.435667,1,79750634,79753070,2436,0.5911572237078894
31583,2658.4368,2658.6702,1,79753104,79760106,7002,0.44977903340943787
31584,2658.682867,2658.693,1,79760486,79760790,304,-0.007472377458128875
31585,2658.694567,2658.698367,1,79760837,79760951,114,-0.19539542375841243
31586,2658.721333,2658.728267,1,79761639,79761848,209,0.07616417625680523
31587,2658.7297,2658.733367,1,79761891,79762001,110,0.4406120523477629
31588,2658.8951,2658.9018,1,79766853,79767054,201,0.6140966105397564
31589,2658.915767,2658.966733,1,79767473,79769001,1528,0.8102876479572321
31590,2658.968633,2659.004467,1,79769058,79770134,1076,0.6760795559070354
31591,2659.017533,2659.1156,1,79770525,79773468,2943,0.7352214639864875
31592,2659.133967,2659.150867,1,79774019,79774526,507,0.5274982243615565
31593,2659.160433,2659.169333,1,79774812,79775079,267,0.1403062609903423
31594,2659.178933,2659.195533,1,79775367,79775865,498,-0.023271564197566427
31595,2659.204567,2659.209733,1,79776137,79776291,154,0.5468930512397815
31596,2659.2228,2659.242733,1,79776684,79777281,597,0.6260094066638956
31597,2659.2585,2659.34,1,79777755,79780200,2445,0.7461425874781191
31598,2659.344233,2659.349667,1,79780326,79780490,164,0.4505333495111515
31599,2659.403367,2659.417667,1,79782101,79782530,429,0.20615917276682597
31600,2659.452467,2659.455967,1,79783574,79783679,105,0.5956243050035944
31601,2659.467533,2659.475933,1,79784025,79784277,252,0.3346842979512554
31602,2659.477067,2659.521767,1,79784312,79785653,1341,0.048206833039934976
31603,2659.5231,2659.555,1,79785693,79786650,957,0.07684696885072717
31604,2659.570833,2659.6729,1,79787124,79790187,3063,0.7840079750101515
31605,2659.677567,2659.687433,1,79790327,79790622,295,0.5653401621016021
31606,2659.694933,2659.713433,1,79790847,79791402,555,0.5376722435003717
31607,2659.7209,2659.734167,1,79791627,79792025,398,-0.06614928991509283
31608,2659.743433,2659.748233,1,79792302,79792446,144,-0.053710296963658005
31609,2659.7534,2659.765867,1,79792602,79792976,374,0.3584693263594279
31610,2659.948167,2660.0548,1,79798445,79801644,3199,0.46524613565468764
31611,2660.114233,2660.121433,1,79803426,79803642,216,-0.10920059571274728
31612,2660.133433,2660.136767,1,79804002,79804103,101,-0.11670908413048586
31613,2660.195033,2660.2065,1,79805850,79806195,345,0.8224823514935519
31614,2660.2076,2660.2359,1,79806228,79807077,849,0.8022544918375735
31615,2660.240167,2660.264533,1,79807205,79807935,730,0.4222795215922765
31616,2660.270233,2660.296267,1,79808106,79808888,782,0.7698331708837063
31617,2660.326067,2660.354333,1,79809782,79810629,847,0.7143601312172547
31618,2660.369533,2660.3823,1,79811085,79811469,384,0.3357533726954891
31619,2660.384133,2660.426667,1,79811523,79812800,1277,0.4206703962154657
31620,2660.4363,2660.44,1,79813089,79813200,111,0.29558279433155654
31621,2660.4509,2660.471867,1,79813527,79814156,629,0.3831928761468872
31622,2660.4956,2660.499733,1,79814868,79814991,123,-0.2717648047610301
31623,2660.501767,2660.5413,1,79815053,79816239,1186,0.20564333752435052
31624,2660.5439,2660.569467,1,79816317,79817084,767,-0.07322131277954166
31625,2660.591733,2660.6077,1,79817751,79818231,480,0.8024395417769754
31626,2660.608733,2660.650767,1,79818261,79819523,1262,0.8008593327965232
31627,2660.652733,2660.6915,1,79819581,79820745,1164,0.7037925539557641
31628,2660.6972,2660.706433,1,79820916,79821192,276,0.32286896893791744
31629,2660.7075,2660.712333,1,79821225,79821369,144,
31630,2660.7233,2660.732933,1,79821699,79821987,288,-0.07985914957455721
31631,2660.739267,2660.7459,1,79822178,79822377,199,0.14032794216418734
31632,2661.0729,2661.0792,1,79832187,79832376,189,0.6255778070242518
31633,2661.0816,2661.095667,1,79832448,79832870,422,0.551201572151159
31634,2661.1048,2661.107833,1,79833144,79833234,90,0.8055365310403105
31635,2661.111833,2661.121267,1,79833354,79833638,284,0.7122097145835126
31636,2661.1293,2661.146133,1,79833879,79834383,504,0.6975290386614491
31637,2661.1801,2661.192633,1,79835403,79835778,375,0.6120413762723634
31638,2661.197767,2661.213233,1,79835933,79836396,463,0.4945799225757655
31639,2661.2244,2661.2307,1,79836732,79836921,189,-0.1406413667671703
31640,2661.2412,2661.255633,1,79837236,79837668,432,0.6133340188177695
31641,2661.2582,2661.265067,1,79837746,79837952,206,0.26983180437702653
31642,2661.299367,2661.3046,1,79838981,79839138,157,0.4439585452705
31643,2661.311267,2661.3234,1,79839338,79839702,364,0.5586589394867353
31644,2661.345,2661.358667,1,79840350,79840760,410,0.5362739108464424
31645,2661.3637,2661.367467,1,79840911,79841024,113,
31646,2661.404367,2661.421967,1,79842131,79842659,528,0.5757715811150398
31647,2661.4433,2661.4525,1,79843299,79843575,276,0.611568632337325
31648,2661.459567,2661.4671,1,79843787,79844013,226,0.4908539556163443
31649,2661.584567,2661.601333,1,79847537,79848039,502,0.8062057025772177
31650,2661.6031,2661.6947,1,79848093,79850841,2748,0.7209911478983121
31651,2661.717433,2661.7348,1,79851522,79852044,522,0.4398858280518402
31652,2661.7361,2661.7646,1,79852083,79852938,855,0.037959339192378
31653,2661.766433,2661.775167,1,79852992,79853255,263,0.17310279866870823
31654,2661.7797,2661.800967,1,79853391,79854029,638,0.1595455746477932
31655,2661.8227,2661.828367,1,79854681,79854851,170,0.5251883309747996
31656,2661.838967,2661.89,1,79855169,79856700,1531,0.11510505300539357
31657,2661.892767,2661.9168,1,79856783,79857504,721,0.2907826588238395
31658,2661.931433,2662.0998,1,79857942,79862994,5052,0.5514768137769792
31659,2662.101867,2662.233067,1,79863056,79866992,3936,0.3086725813189066
31660,2662.257033,2662.4399,1,79867710,79873197,5487,0.5187050102788866
31661,2662.442667,2662.471633,1,79873280,79874148,868,0.37292503059409804
31662,2662.4733,2662.552133,1,79874199,79876563,2364,0.4691053352184478
31663,2662.553133,2662.5567,1,79876593,79876701,108,-0.07227865250904303
31664,2662.562033,2662.570333,1,79876860,79877109,249,0.015976951711047252
31665,2662.572067,2662.5751,1,79877162,79877253,91,
31666,2662.5765,2662.583133,1,79877295,79877493,198,0.3962560271599646
31667,2662.589133,2662.595033,1,79877673,79877850,177,0.006654500852100186
31668,2662.6017,2662.744667,1,79878051,79882340,4289,0.7496008448591381
31669,2663.186767,2663.222833,1,79895603,79896684,1081,0.5855249025785262
31670,2663.229633,2663.232767,1,79896888,79896983,95,
31671,2663.2434,2663.258467,1,79897302,79897754,452,0.5056238692711762
31672,2663.279567,2663.288367,1,79898387,79898651,264,0.8050517673117034
31673,2663.305833,2663.336833,1,79899174,79900104,930,0.5991332618909045
31674,2663.385867,2663.4032,1,79901576,79902096,520,0.7011279503092864
31675,2663.429267,2663.435633,1,79902878,79903068,190,0.7504441000828269
31676,2663.440033,2663.4612,1,79903200,79903836,636,0.6922259246167917
31677,2663.4709,2663.481433,1,79904127,79904442,315,-0.07213304993114816
31678,2663.4873,2663.4997,1,79904619,79904991,372,0.4272545485704819
31679,2663.511,2663.554533,1,79905330,79906635,1305,-0.036428192846207436
31680,2663.571133,2663.584633,1,79907133,79907538,405,0.6152744360184176
31681,2663.5867,2663.677667,1,79907601,79910330,2729,0.7443216767477187
31682,2663.689367,2663.699233,1,79910681,79910976,295,0.42596705582839123
31683,2663.702233,2663.705333,1,79911066,79911159,93,
31684,2663.7114,2663.7477,1,79911342,79912431,1089,-0.02870690337911691
31685,2663.7588,2663.762067,1,79912764,79912862,98,-0.18921948956460408
31686,2663.800133,2663.804667,1,79914003,79914140,137,0.25860501700818117
31687,2663.809767,2663.830067,1,79914293,79914902,609,0.20910965380325944
31688,2663.8318,2663.890433,1,79914954,79916712,1758,0.05784580467268939
31689,2663.8917,2663.8984,1,79916751,79916952,201,0.5840122754473652
31690,2663.8996,2664.099933,1,79916988,79922997,6009,0.7303851461114109
31691,2664.105033,2664.1089,1,79923150,79923267,117,-0.20916465039548598
31692,2664.1292,2664.2016,1,79923876,79926048,2172,0.7544190896915417
31693,2664.2201,2664.224867,1,79926603,79926746,143,0.26186262704914504
31694,2664.2859,2664.2891,1,79928577,79928673,96,0.07197661969434875
31695,2664.295833,2664.360433,1,79928874,79930812,1938,0.41374766851429334
31696,2664.613267,2664.618767,1,79938398,79938563,165,0.560788982643608
31697,2664.619767,2664.644433,1,79938593,79939332,739,0.6929353994069616
31698,2664.645533,2664.6508,1,79939365,79939524,159,0.4494619953199033
31699,2664.669267,2664.6854,1,79940078,79940562,484,0.927694430944799
31700,2664.687633,2664.694833,1,79940628,79940844,216,0.37843520236707384
31701,2664.696133,2664.754433,1,79940883,79942632,1749,0.6661670404213219
31702,2664.762033,2664.844533,1,79942860,79945335,2475,0.7874992117572807
31703,2664.8557,2664.881267,1,79945671,79946438,767,0.7620317315066777
31704,2664.891433,2664.8956,1,79946742,79946868,126,
31705,2664.9005,2664.905267,1,79947015,79947158,143,0.040719271253118514
31706,2664.9078,2664.915633,1,79947234,79947468,234,-0.07725377874433462
31707,2664.941167,2664.9634,1,79948235,79948902,667,0.436521203261721
31708,2664.974867,2665.0916,1,79949246,79952748,3502,0.7528540995906573
31709,2665.0967,2665.194167,1,79952901,79955825,2924,0.7365494828931092
31710,2665.199533,2665.237433,1,79955985,79957122,1137,-0.0023266129871025816
31711,2665.2419,2665.2684,1,79957257,79958052,795,0.09335290402858933
31712,2665.281733,2665.2881,1,79958451,79958643,192,0.06437072770400029
31713,2665.292367,2665.298967,1,79958771,79958969,198,0.7647078078207951
31714,2665.300067,2665.464833,1,79959002,79963944,4942,0.7052510920171758
31715,2665.481633,2665.5109,1,79964448,79965327,879,0.8088296239434671
31716,2665.533233,2665.543433,1,79965996,79966302,306,-0.08693173787283916
31717,2665.546433,2665.591567,1,79966392,79967747,1355,0.11794856826560729
31718,2665.6228,2665.672533,1,79968684,79970175,1491,0.646884257413141
31719,2665.681467,2665.725167,1,79970444,79971755,1311,0.7769704226496278
31720,2665.742967,2665.763633,1,79972289,79972908,619,0.012276833386778027
31721,2665.7648,2665.779667,1,79972944,79973390,446,0.034317798458890124
31722,2665.8316,2665.847067,1,79974948,79975412,464,0.2977205817691695
31723,2665.848967,2665.8584,1,79975469,79975752,283,0.42432660864302907
31724,2665.859533,2665.8905,1,79975785,79976715,930,0.09951867954635271
31725,2665.8929,2665.901567,1,79976787,79977047,260,0.1354633629873661
31726,2665.9035,2665.9171,1,79977105,79977513,408,0.23983148647059696
31727,2665.931,2665.938867,1,79977930,79978166,236,0.657088444036384
31728,2665.946633,2665.957,1,79978398,79978710,312,0.6792384362689071
31729,2665.9584,2666.048567,1,79978752,79981457,2705,0.6638082968378861
31730,2666.0591,2666.0683,1,79981773,79982049,276,0.7085793178979758
31731,2666.069667,2666.184167,1,79982090,79985525,3435,0.540529002730122
31732,2666.187367,2666.205467,1,79985621,79986164,543,0.3882282908890061
31733,2666.229067,2666.2391,1,79986872,79987173,301,0.35746604293018014
31734,2666.259967,2666.272033,1,79987799,79988160,361,0.015301661872731942
31735,2666.280467,2666.310633,1,79988414,79989318,904,0.448403193171142
31736,2666.312133,2666.316333,1,79989363,79989489,126,0.21162396764804575
31737,2666.322633,2666.388433,1,79989678,79991652,1974,0.4296135344247621
31738,2666.3899,2666.458133,1,79991697,79993743,2046,0.4904067683272912
31739,2666.467333,2666.482533,1,79994019,79994475,456,0.6791317601213385
31740,2666.484467,2666.627767,1,79994534,79998833,4299,0.6917157514685331
31741,2666.642533,2666.6456,1,79999275,79999368,93,-0.09139918257133553
31742,2666.6472,2666.651067,1,79999416,79999532,116,0.020646141346888216
31743,2666.6696,2666.6737,1,80000088,80000211,123,0.03300629178206698
31744,2666.680767,2666.685133,1,80000423,80000553,130,0.19928076021170069
31745,2666.713667,2666.7248,1,80001410,80001744,334,0.539951051959344
31746,2666.750033,2666.762167,1,80002500,80002865,365,-0.07479663017359926
31747,2666.7698,2666.773133,1,80003094,80003193,99,
31748,2666.7781,2666.781633,1,80003343,80003448,105,
31749,2666.832867,2666.843033,1,80004986,80005290,304,0.44072312247461154
31750,2666.849633,2666.8551,1,80005488,80005653,165,0.33806339796434803
31751,2666.866067,2666.886533,1,80005982,80006595,613,-0.04949808911697101
31752,2666.887833,2666.902367,1,80006634,80007071,437,0.05524962423249682
31753,2666.907433,2666.910633,1,80007222,80007318,96,
31754,2666.912167,2666.9159,1,80007365,80007477,112,-0.24056714823445052
31755,2666.922433,2666.925833,1,80007672,80007774,102,0.29155432814663934
31756,2666.9843,2667.0113,1,80009529,80010339,810,0.7487603070193977
31757,2667.0303,2667.041133,1,80010909,80011233,324,0.5442385620478044
31758,2667.068367,2667.115167,1,80012051,80013455,1404,0.7345860523656988
31759,2667.118233,2667.136467,1,80013546,80014094,548,0.5872584151774722
31760,2667.1447,2667.189267,1,80014341,80015678,1337,0.783939210862077
31761,2667.191,2667.2204,1,80015730,80016612,882,0.8511680077436117
31762,2667.2249,2667.250967,1,80016747,80017529,782,0.669390646141961
31763,2667.252,2667.2951,1,80017560,80018853,1293,0.6529313856746072
31764,2667.303667,2667.3089,1,80019110,80019267,157,0.5013750678550091
31765,2667.317067,2667.3269,1,80019512,80019807,295,0.8359123836875123
31766,2667.328033,2667.342467,1,80019840,80020274,434,0.6302612876147852
31767,2667.366333,2667.390933,1,80020989,80021727,738,0.10544937806071981
31768,2667.392767,2667.409933,1,80021783,80022297,514,0.21521997044432897
31769,2667.410967,2667.419333,1,80022329,80022579,250,0.16902697679276618
31770,2667.429833,2667.433867,1,80022894,80023016,122,0.40869686450831316
31771,2667.442033,2667.6024,1,80023260,80028072,4812,0.7573691468552375
31772,2667.608667,2667.636633,1,80028260,80029098,838,0.8604457115234228
31773,2667.644567,2667.682767,1,80029337,80030483,1146,0.7687217697898888
31774,2667.690833,2667.7658,1,80030724,80032974,2250,0.7791657185320128
31775,2667.768567,2667.776233,1,80033057,80033286,229,-0.45733281806432907
31776,2667.789867,2667.815033,1,80033696,80034450,754,0.7651191976133203
31777,2667.819533,2667.8721,1,80034585,80036163,1578,0.7238892312857444
31778,2667.873933,2667.919633,1,80036217,80037588,1371,0.783891303307786
31779,2667.920767,2668.006933,1,80037623,80040207,2584,0.8156552372365978
31780,2668.008533,2668.018133,1,80040255,80040543,288,0.4382767238324417
31781,2668.0192,2668.030133,1,80040576,80040903,327,0.7135247368843605
31782,2668.032767,2668.095733,1,80040983,80042871,1888,0.7812784660630232
31783,2668.099433,2668.1148,1,80042982,80043444,462,0.7012625575948764
31784,2668.121633,2668.1338,1,80043648,80044014,366,0.6067056007102504
31785,2668.190467,2668.1943,1,80045714,80045829,115,0.06714858205714914
31786,2668.212533,2668.2187,1,80046375,80046561,186,0.5429152842845223
31787,2668.230267,2668.235233,1,80046908,80047056,148,0.5580956561999301
31788,2668.2476,2668.252967,1,80047428,80047589,161,
31789,2668.3462,2668.402067,1,80050386,80052062,1676,0.5635436348323378
31790,2668.4074,2668.4241,1,80052222,80052723,501,0.2675841952166976
31791,2668.425533,2668.4288,1,80052765,80052864,99,-0.339431708045045
31792,2668.433033,2668.4361,1,80052990,80053083,93,0.47461548525391156
31793,2668.571833,2668.738833,1,80057154,80062164,5010,0.7912929119557762
31794,2668.7424,2668.765533,1,80062272,80062965,693,0.7843374529971213
31795,2668.7713,2668.809,1,80063139,80064270,1131,0.7098799163780648
31796,2668.829233,2668.887167,1,80064876,80066615,1739,0.8155788275270962
31797,2668.915533,2668.944567,1,80067465,80068337,872,0.702134449829134
31798,2668.9485,2668.9987,1,80068455,80069961,1506,0.6737938237781282
31799,2669.0019,2669.0207,1,80070057,80070621,564,0.7786002041404897
31800,2669.022367,2669.027167,1,80070671,80070815,144,-0.1126699796597825
31801,2669.0283,2669.048067,1,80070849,80071442,593,0.6509674280770987
31802,2669.0512,2669.110933,1,80071536,80073327,1791,0.7409151630687952
31803,2669.112167,2669.134833,1,80073365,80074044,679,0.807013358482326
31804,2669.137,2669.148333,1,80074110,80074449,339,0.49360254134726
31805,2669.1657,2669.2187,1,80074971,80076561,1590,0.7324931781137055
31806,2669.2336,2669.260167,1,80077008,80077805,797,0.8043492984803071
31807,2669.261267,2669.2684,1,80077838,80078052,214,0.05430529230050274
31808,2669.2839,2669.3537,1,80078517,80080611,2094,0.7821148506939399
31809,2669.361933,2669.372167,1,80080857,80081165,308,0.6705927933372812
31810,2669.3758,2669.381467,1,80081274,80081444,170,0.3865047055784856
31811,2669.3825,2669.4016,1,80081475,80082048,573,0.6556501041421943
31812,2669.4044,2669.481933,1,80082132,80084457,2325,0.8137987414775865
31813,2669.4851,2669.495633,1,80084553,80084868,315,0.7515370551839943
31814,2669.4994,2669.523533,1,80084982,80085705,723,0.5115148779473451
31815,2669.527033,2669.6189,1,80085810,80088567,2757,0.814892928843178
31816,2669.6203,2669.647167,1,80088609,80089415,806,0.5338643778044063
31817,2669.651433,2669.705067,1,80089542,80091152,1610,0.7707225153313295
31818,2669.712633,2669.7157,1,80091378,80091471,93,0.5151385353661295
31819,2669.718933,2669.738867,1,80091567,80092166,599,0.7086730135520575
31820,2669.742467,2669.748067,1,80092274,80092442,168,0.7445036895292496
31821,2669.753467,2669.7578,1,80092604,80092734,130,-0.1908038538954694
31822,2669.774667,2669.808967,1,80093240,80094269,1029,0.7059788855000793
31823,2669.812833,2669.8299,1,80094384,80094897,513,0.8050205144018051
31824,2669.853333,2669.8611,1,80095599,80095833,234,0.6332714057154991
31825,2669.865733,2669.871167,1,80095971,80096135,164,0.2226906247136721
31826,2669.895933,2669.934333,1,80096877,80098029,1152,0.7364952783638083
31827,2669.936767,2669.950267,1,80098103,80098508,405,0.6985772366420675
31828,2669.968,2669.9833,1,80099040,80099499,459,0.7953001778646849
31829,2669.9914,2669.9992,1,80099742,80099976,234,0.2529090440515316
31830,2670.019067,2670.0566,1,80100572,80101698,1126,0.6955615778869294
31831,2670.058967,2670.074167,1,80101769,80102225,456,0.7195541104221764
31832,2670.085967,2670.110333,1,80102579,80103309,730,0.7832615904975997
31833,2670.1157,2670.119067,1,80103471,80103572,101,0.23151633674767208
31834,2670.1217,2670.133833,1,80103651,80104014,363,0.5398497531397113
31835,2670.145667,2670.201533,1,80104370,80106045,1675,0.7678919385095034
31836,2670.217733,2670.2378,1,80106531,80107134,603,0.6965687067862097
31837,2670.2414,2670.247567,1,80107242,80107427,185,0.03051512708687524
31838,2670.250367,2670.255733,1,80107511,80107671,160,0.3682470980548085
31839,2670.273467,2670.3487,1,80108204,80110461,2257,0.8000150215842756
31840,2670.3501,2670.3545,1,80110503,80110635,132,0.44779643980608846
31841,2670.359367,2670.369633,1,80110781,80111088,307,0.7933690317251327
31842,2670.373033,2670.399,1,80111190,80111970,780,0.6918858940420111
31843,2670.401433,2670.498367,1,80112042,80114951,2909,0.8157140481265298
31844,2670.501533,2670.531833,1,80115045,80115954,909,0.7461298800499994
31845,2670.558433,2670.567233,1,80116752,80117016,264,0.3101447474160774
31846,2670.576833,2670.652933,1,80117304,80119587,2283,0.6799671767373184
31847,2670.690067,2670.6931,1,80120702,80120793,91,
31848,2670.9471,2670.957033,1,80128413,80128710,297,0.7139659448174844
31849,2670.961433,2670.972433,1,80128842,80129172,330,0.5968111502592958
31850,2671.012267,2671.0219,1,80130368,80130657,289,0.5205490552170661
31851,2671.125,2671.310067,1,80133750,80139302,5552,0.8579257175990687
31852,2671.334833,2671.351067,1,80140044,80140532,488,0.756808676895783
31853,2671.3537,2671.421133,1,80140611,80142633,2022,0.7928397485692362
31854,2671.439167,2671.466367,1,80143175,80143991,816,0.7323032169536443
31855,2671.470067,2671.5077,1,80144102,80145231,1129,0.7350171385088626
31856,2671.509733,2671.5235,1,80145291,80145705,414,0.8013648192623333
31857,2671.526367,2671.547033,1,80145791,80146410,619,0.8736375681553992
31858,2671.548667,2671.572867,1,80146460,80147186,726,0.3823714641338474
31859,2671.575,2671.6766,1,80147250,80150298,3048,0.7829581705868046
31860,2671.6822,2671.689767,1,80150466,80150693,227,0.8290929783440272
31861,2671.693333,2671.788233,1,80150799,80153646,2847,0.835633507313098
31862,2671.790367,2671.805867,1,80153711,80154176,465,0.5503660854674692
31863,2671.8216,2671.876967,1,80154648,80156309,1661,0.8165214001890732
31864,2671.8997,2671.911133,1,80156991,80157333,342,0.5016412617673618
31865,2671.915767,2671.9211,1,80157473,80157633,160,0.43030199920681345
31866,2671.9471,2672.001967,1,80158413,80160059,1646,0.82754588527472
31867,2672.018133,2672.0363,1,80160543,80161089,546,0.6640108538704009
31868,2672.041133,2672.0452,1,80161233,80161356,123,0.3924096396244079
31869,2672.070833,2672.126467,1,80162124,80163794,1670,0.8434249284601469
31870,2672.1333,2672.138567,1,80163999,80164157,158,0.43177870302921145
31871,2672.142833,2672.1637,1,80164284,80164911,627,0.7574280932489533
31872,2672.1658,2672.174333,1,80164974,80165229,255,0.5205018905364288
31873,2672.1773,2672.182633,1,80165319,80165478,159,0.31956139028823055
31874,2672.1985,2672.2548,1,80165955,80167644,1689,0.8368009274459611
31875,2672.256967,2672.267733,1,80167709,80168031,322,0.336613569822279
31876,2672.272533,2672.2924,1,80168175,80168772,597,0.7657129623299131
31877,2672.295567,2672.2997,1,80168867,80168991,124,0.30656786713097833
31878,2672.301567,2672.3151,1,80169047,80169453,406,0.6428926011221245
31879,2672.326733,2672.421933,1,80169801,80172657,2856,0.781849446908443
31880,2672.4258,2672.448067,1,80172774,80173442,668,0.5408751677624475
31881,2672.449967,2672.516533,1,80173499,80175495,1996,0.8489531894325422
31882,2672.521867,2672.6438,1,80175656,80179314,3658,0.5444313417164842
31883,2672.645467,2672.6807,1,80179364,80180421,1057,0.8309330536772452
31884,2672.6851,2672.6981,1,80180553,80180943,390,0.5167400300810047
31885,2672.7156,2672.797,1,80181468,80183910,2442,0.747708576613803
31886,2672.806267,2672.821667,1,80184188,80184650,462,0.6395030820046912
31887,2672.8244,2672.828033,1,80184732,80184840,108,0.5950771994164455
31888,2672.831267,2672.918067,1,80184938,80187542,2604,0.7334636125494666
31889,2672.929167,2672.950467,1,80187875,80188514,639,0.5087978106743208
31890,2672.9541,2673.045233,1,80188623,80191356,2733,0.7558770792835191
31891,2673.0483,2673.1248,1,80191449,80193744,2295,0.7067859065273456
31892,2673.133333,2673.1484,1,80193999,80194452,453,0.7925112268733886
31893,2673.150867,2673.175067,1,80194526,80195252,726,0.7879968429926213
31894,2673.184667,2673.194967,1,80195540,80195849,309,-0.1361222747704146
31895,2673.207167,2673.214567,1,80196215,80196437,222,0.05308715051927109
31896,2673.226667,2673.3096,1,80196800,80199288,2488,0.5642247451662273
31897,2673.345267,2673.365733,1,80200358,80200971,613,-0.06950338354909608
31898,2673.367033,2673.3715,1,80201010,80201145,135,0.46090477965481697
31899,2673.409367,2673.423467,1,80202281,80202704,423,0.837994995645721
31900,2673.4272,2673.525867,1,80202816,80205776,2960,0.8165972166025208
31901,2673.540667,2673.556733,1,80206220,80206701,481,0.47606843725788023
31902,2673.560933,2673.570167,1,80206827,80207105,278,-0.0923592834736308
31903,2673.5828,2673.589633,1,80207484,80207688,204,0.42323731312943397
31904,2673.700233,2673.704133,1,80211006,80211123,117,0.20517548847177464
31905,2673.7155,2673.748733,1,80211465,80212461,996,0.6319690571371186
31906,2673.753533,2673.769267,1,80212605,80213078,473,0.21199652554999732
31907,2673.771433,2673.786867,1,80213142,80213606,464,0.7369553722428247
31908,2673.7935,2673.829167,1,80213805,80214875,1070,0.6151297394650508
31909,2673.846833,2673.8664,1,80215404,80215992,588,0.7979413763900739
31910,2673.8675,2673.882567,1,80216025,80216477,452,0.6941096938117829
31911,2673.892667,2673.9535,1,80216780,80218605,1825,0.7296535329934426
31912,2673.979333,2674.077333,1,80219379,80222319,2940,0.1684714849353497
31913,2674.083267,2674.252533,1,80222498,80227575,5077,0.7963801984732344
31914,2674.255433,2674.2814,1,80227662,80228442,780,0.8228220616765525
31915,2674.282733,2674.3815,1,80228481,80231445,2964,0.7674459423854013
31916,2674.396767,2674.4,1,80231903,80232000,97,0.03290995918605524
31917,2674.489667,2674.5044,1,80234690,80235132,442,0.672331759375013
31918,2674.505867,2674.550333,1,80235176,80236509,1333,0.7984352188538013
31919,2674.553067,2674.5977,1,80236592,80237931,1339,0.8070207318222026
31920,2674.602167,2674.608133,1,80238065,80238243,178,0.8563071624991452
31921,2674.6101,2674.6667,1,80238303,80240001,1698,0.05086480341910444
31922,2674.694433,2674.814567,1,80240832,80244437,3605,0.8008297707983554
31923,2674.8165,2674.862533,1,80244495,80245875,1380,0.8077690352275004
31924,2674.864167,2674.8808,1,80245925,80246424,499,0.8213920679921086
31925,2674.888567,2674.967967,1,80246657,80249039,2382,0.7857148892555637
31926,2674.9837,2675.039833,1,80249511,80251194,1683,0.13841652995306
31927,2675.050733,2675.2119,1,80251521,80256357,4836,0.8328871242912247
31928,2675.230167,2675.263033,1,80256905,80257890,985,-0.04972787553276075
31929,2675.265333,2675.280733,1,80257959,80258421,462,0.3229540071688289
31930,2675.283533,2675.288533,1,80258505,80258655,150,0.6860983067100405
31931,2675.300167,2675.305033,1,80259005,80259150,145,-0.03220713409790502
31932,2675.307233,2675.355033,1,80259216,80260650,1434,0.783324626484595
31933,2675.367,2675.4129,1,80261010,80262387,1377,0.7129651627684456
31934,2675.426067,2675.461967,1,80262782,80263859,1077,-0.059669596271708286
31935,2675.465633,2675.485567,1,80263968,80264567,599,0.058672600105225875
31936,2675.5098,2675.587233,1,80265294,80267616,2322,0.7718403689155563
31937,2675.5901,2675.727167,1,80267703,80271815,4112,0.7869794243881716
31938,2675.736267,2675.7843,1,80272088,80273529,1441,0.700593767206707
31939,2675.7854,2675.790633,1,80273562,80273718,156,0.10591122442796753
31940,2675.794,2675.819533,1,80273820,80274585,765,-0.0034488120162291455
31941,2675.823267,2675.850367,1,80274698,80275511,813,0.3283180451002721
31942,2675.851967,2675.862367,1,80275559,80275871,312,0.04227527089497955
31943,2675.865033,2675.8704,1,80275950,80276112,162,0.4741427511768622
31944,2675.8908,2675.8948,1,80276724,80276844,120,0.35441116391768795
31945,2675.8984,2676.094633,1,80276952,80282838,5886,0.7803248999239499
31946,2676.116133,2676.1896,1,80283483,80285688,2205,0.8254806197526353
31947,2676.198733,2676.2022,1,80285961,80286066,105,0.8856710293588488
31948,2676.206333,2676.2395,1,80286189,80287185,996,0.799524340481521
31949,2676.265433,2676.311867,1,80287962,80289356,1394,-0.021319265427972817
31950,2676.313,2676.4426,1,80289390,80293278,3888,0.8335774285469814
31951,2676.459633,2676.501633,1,80293788,80295048,1260,0.04187821490038094
31952,2676.506467,2676.5097,1,80295194,80295291,97,
31953,2676.5108,2676.516633,1,80295324,80295498,174,-0.1414150105510757
31954,2676.537133,2676.5517,1,80296113,80296551,438,0.8736192570444364
31955,2676.554467,2676.666533,1,80296634,80299995,3361,0.8114080629298299
31956,2676.688633,2676.702933,1,80300658,80301087,429,0.3648698409574234
31957,2676.7041,2676.7717,1,80301123,80303151,2028,0.094739190020109
31958,2676.7879,2676.962567,1,80303637,80308877,5240,0.8365861466377652
31959,2676.964233,2677.004,1,80308926,80310120,1194,0.8296862183077451
31960,2677.008367,2677.031833,1,80310251,80310954,703,0.7056213807242474
31961,2677.034333,2677.0874,1,80311029,80312622,1593,0.7890493714670516
31962,2677.096467,2677.124333,1,80312894,80313729,835,0.772892661017697
31963,2677.125733,2677.148667,1,80313771,80314460,689,0.7609072957463546
31964,2677.1618,2677.214433,1,80314854,80316432,1578,0.08293602247220096
31965,2677.2387,2677.3781,1,80317161,80321343,4182,0.7477330148717997
31966,2677.384333,2677.454133,1,80321529,80323623,2094,0.7318688526988273
31967,2677.456,2677.4898,1,80323680,80324694,1014,0.8470081292141911
31968,2677.491233,2677.504167,1,80324736,80325125,389,0.6743757109969631
31969,2677.506933,2677.518967,1,80325207,80325569,362,0.639192316644384
31970,2677.529333,2677.599233,1,80325879,80327976,2097,0.7926063871125699
31971,2677.6012,2677.606033,1,80328036,80328180,144,-0.2413753246723187
31972,2677.6078,2677.7083,1,80328234,80331249,3015,0.7891474303792707
31973,2677.7309,2677.7781,1,80331927,80333343,1416,0.028840293498515038
31974,2677.802967,2677.931067,1,80334089,80337932,3843,0.780361964651885
31975,2677.946867,2678.049367,1,80338406,80341481,3075,0.6553212752163728
31976,2678.060567,2678.064233,1,80341817,80341926,109,0.37130311515369796
31977,2678.068933,2678.0746,1,80342067,80342238,171,0.016073324855980554
31978,2678.0996,2678.105433,1,80342988,80343162,174,0.4679489971479213
31979,2678.159867,2678.177467,1,80344796,80345324,528,0.815268516329956
31980,2678.179067,2678.213367,1,80345372,80346401,1029,0.7835079848787226
31981,2678.219733,2678.278767,1,80346591,80348363,1772,0.6424784761472879
31982,2678.290467,2678.3098,1,80348714,80349294,580,0.019327966596980387
31983,2678.311333,2678.3462,1,80349339,80350386,1047,0.06996235780353977
31984,2678.36,2678.516767,1,80350800,80355503,4703,0.8079080859026303
31985,2678.525267,2678.536967,1,80355758,80356109,351,0.7089216823730391
31986,2678.540833,2678.6064,1,80356224,80358192,1968,0.7117506884915792
31987,2678.609033,2678.614233,1,80358270,80358426,156,0.7289040360225001
31988,2678.741233,2678.752267,1,80362236,80362568,332,0.30068922574375473
31989,2678.753333,2678.781933,1,80362599,80363457,858,0.6519263321698602
31990,2678.828833,2678.835533,1,80364864,80365065,201,0.001841386630074648
31991,2678.938767,2678.994133,1,80368163,80369823,1660,0.7451437459105792
31992,2679.000533,2679.050633,1,80370015,80371518,1503,0.7314160281550782
31993,2679.0532,2679.061033,1,80371596,80371830,234,0.5705609882001763
31994,2679.0647,2679.0852,1,80371941,80372556,615,0.0420273461843611
31995,2679.086833,2679.099567,1,80372604,80372987,383,0.16006467337425556
31996,2679.102233,2679.114067,1,80373066,80373422,356,0.07402073442707635
31997,2679.1173,2679.1319,1,80373519,80373957,438,0.30242114886244137
31998,2679.174967,2679.180967,1,80375249,80375429,180,0.5335529975936633
31999,2679.1842,2679.248033,1,80375526,80377440,1914,0.791322417713518
32000,2679.251067,2679.310267,1,80377532,80379308,1776,0.6807420774171302
32001,2679.314533,2679.395333,1,80379435,80381859,2424,0.7368532387143869
32002,2679.437167,2679.455067,1,80383115,80383652,537,0.03787732453363112
32003,2679.4569,2679.467333,1,80383707,80384019,312,-0.05158609265885006
32004,2679.470533,2679.4755,1,80384115,80384265,150,-0.17559557254099936
32005,2679.477067,2679.481667,1,80384312,80384450,138,0.4968328422926355
32006,2679.5478,2679.599067,1,80386434,80387972,1538,0.4452055893826804
32007,2679.6124,2679.629333,1,80388372,80388879,507,0.36757993549951623
32008,2679.685667,2679.6977,1,80390570,80390931,361,0.5005049020286151
32009,2679.6997,2679.7878,1,80390991,80393634,2643,0.6118856034653654
32010,2679.7941,2679.815133,1,80393823,80394453,630,0.6330293833677354
32011,2679.825,2679.928533,1,80394750,80397855,3105,0.7246574115406562
32012,2679.935033,2679.957167,1,80398050,80398715,665,0.6547699303716606
32013,2679.9582,2680.0292,1,80398746,80400876,2130,0.7120488551017045
32014,2680.034267,2680.060967,1,80401028,80401829,801,0.7426597224003556
32015,2680.071733,2680.0766,1,80402151,80402298,147,0.5706682361814646
32016,2680.0884,2680.101833,1,80402652,80403054,402,-0.07723060168505352
32017,2680.104667,2680.109,1,80403140,80403270,130,-0.014326242043532375
32018,2680.1368,2680.201533,1,80404104,80406045,1941,0.6126952806211877
32019,2680.2038,2680.209633,1,80406114,80406288,174,0.6708741989323413
32020,2680.212667,2680.2264,1,80406380,80406792,412,0.6339226043338662
32021,2680.228333,2680.387567,1,80406849,80411627,4778,0.7449713265626322
32022,2680.388633,2680.3954,1,80411658,80411862,204,0.7652171877522126
32023,2680.398667,2680.4147,1,80411960,80412441,481,0.9201684421938106
32024,2680.417233,2680.471433,1,80412516,80414142,1626,0.7355079912464275
32025,2680.478,2680.518067,1,80414340,80415542,1202,0.7648944573978782
32026,2680.525767,2680.546867,1,80415773,80416406,633,-0.011742852965541546
32027,2680.5479,2680.551333,1,80416437,80416539,102,0.14660727855678202
32028,2680.557867,2680.563033,1,80416736,80416890,154,0.038709091330256414
32029,2680.5752,2680.5794,1,80417256,80417382,126,0.7191742712649191
32030,2680.5822,2680.598633,1,80417466,80417958,492,0.019623268260170162
32031,2680.599667,2680.623733,1,80417990,80418711,721,0.6454693685244124
32032,2680.699733,2680.703333,1,80420991,80421099,108,
32033,2680.7117,2680.727033,1,80421351,80421810,459,0.6205362441744509
32034,2680.728367,2680.774567,1,80421851,80423237,1386,0.7806762647935898
32035,2680.775933,2680.8383,1,80423277,80425149,1872,0.8095729929775866
32036,2680.8401,2680.8498,1,80425203,80425494,291,0.2053071133595822
32037,2680.880167,2680.893367,1,80426405,80426801,396,0.17237857826170352
32038,2680.908133,2680.943333,1,80427243,80428299,1056,0.5513577993589229
32039,2680.944367,2680.964767,1,80428331,80428943,612,0.367366722805484
32040,2680.9673,2681.118567,1,80429019,80433557,4538,0.828975805339465
32041,2681.133967,2681.1907,1,80434019,80435721,1702,0.8014060398828752
32042,2681.191733,2681.224867,1,80435751,80436746,995,0.6433430209050612
32043,2681.247033,2681.260967,1,80437410,80437829,419,-0.00882655783918155
32044,2681.2665,2681.271033,1,80437995,80438130,135,-0.08360317999070196
32045,2681.287333,2681.293267,1,80438619,80438798,179,-0.03182242950381946
32046,2681.300933,2681.387967,1,80439027,80441639,2612,0.43972361155067685
32047,2681.4542,2681.612,1,80443626,80448360,4734,0.7996455308075923
32048,2681.625733,2681.633967,1,80448771,80449019,248,-0.1628818488132766
32049,2681.6419,2681.6538,1,80449257,80449614,357,0.002811719485416971
32050,2681.703767,2681.708167,1,80451113,80451245,132,0.24033768205439535
32051,2681.714667,2681.719267,1,80451440,80451578,138,0.0450087470019861
32052,2681.728833,2681.7336,1,80451864,80452008,144,-0.03720124551160038
32053,2681.7346,2681.755667,1,80452038,80452670,632,0.7957253056728674
32054,2681.7671,2681.782767,1,80453013,80453483,470,0.050162717754795465
32055,2681.8402,2681.850667,1,80455206,80455520,314,0.20569680166044824
32056,2681.857267,2681.870667,1,80455718,80456120,402,0.7822567044373253
32057,2681.8721,2681.9022,1,80456163,80457066,903,0.871205649733394
32058,2681.9043,2681.9301,1,80457129,80457903,774,0.8167982390442683
32059,2681.932267,2681.935633,1,80457968,80458068,100,0.658968873272454
32060,2681.944467,2681.964167,1,80458334,80458925,591,0.8006137655376029
32061,2682.055333,2682.0674,1,80461659,80462022,363,0.18659371149770987
32062,2682.072833,2682.093667,1,80462184,80462810,626,-0.04651389127210848
32063,2682.095,2682.112233,1,80462850,80463366,516,0.0013677596524226175
32064,2682.127267,2682.236933,1,80463818,80467107,3289,0.7867409975317621
32065,2682.2731,2682.322333,1,80468193,80469669,1476,0.13720911198998456
32066,2682.326367,2682.340933,1,80469791,80470227,436,0.06861867167980716
32067,2682.345333,2682.353033,1,80470359,80470590,231,-0.048033103268709874
32068,2682.4604,2682.521267,1,80473812,80475638,1826,0.2878641768628596
32069,2682.547733,2682.551933,1,80476431,80476557,126,-0.1545883690325007
32070,2682.5541,2682.5653,1,80476623,80476959,336,0.09310240687334881
32071,2682.566767,2682.5905,1,80477003,80477715,712,0.13060727672133193
32072,2682.615633,2682.619733,1,80478468,80478591,123,0.23939348085628948
32073,2682.628333,2682.732733,1,80478849,80481981,3132,0.7041789739806417
32074,2682.753167,2682.7596,1,80482595,80482788,193,0.12582660474807844
32075,2682.780967,2682.827633,1,80483429,80484828,1399,0.16011138975477573
32076,2682.8305,2682.8411,1,80484915,80485233,318,0.15676112681080642
32077,2682.848433,2682.859,1,80485452,80485770,318,0.30994999521504435
32078,2682.9027,2682.9107,1,80487081,80487321,240,-0.10000038334736808
32079,2682.9462,2682.9968,1,80488386,80489904,1518,0.6088507901187514
32080,2682.9983,2683.050567,1,80489949,80491517,1568,0.7344331569735373
32081,2683.0627,2683.074767,1,80491881,80492243,362,0.38672647943171007
32082,2683.083033,2683.087433,1,80492490,80492622,132,0.5274267223939747
32083,2683.096433,2683.128067,1,80492892,80493842,950,0.020463940429597982
32084,2683.131433,2683.147367,1,80493942,80494421,479,0.19057094455695633
32085,2683.1484,2683.156067,1,80494452,80494682,230,-0.048417814927864296
32086,2683.2012,2683.224967,1,80496036,80496749,713,0.4633904986791331
32087,2683.239967,2683.2801,1,80497199,80498403,1204,0.34070409125002254
32088,2683.3154,2683.323267,1,80499462,80499698,236,-0.09107869683133084
32089,2683.33,2683.343367,1,80499900,80500301,401,0.10718899889726023
32090,2683.3457,2683.351167,1,80500371,80500535,164,-0.043682586691434606
32091,2683.408167,2683.4583,1,80502245,80503749,1504,0.7427026152768268
32092,2683.4627,2683.4688,1,80503881,80504064,183,-0.28688008719250885
32093,2683.4703,2683.474667,1,80504109,80504240,131,-0.08527599352295366
32094,2683.478267,2683.505667,1,80504348,80505170,822,0.5686083853291284
32095,2683.512267,2683.516567,1,80505368,80505497,129,-0.1256788984228429
32096,2683.528533,2683.540067,1,80505855,80506202,347,0.32957597387587356
32097,2683.551167,2683.555467,1,80506535,80506664,129,0.7369920176656176
32098,2683.564633,2683.616833,1,80506938,80508504,1566,-0.047841023436859156
32099,2683.646767,2683.650867,1,80509403,80509526,123,0.3484985971339779
32100,2683.652633,2683.6572,1,80509578,80509716,138,0.10837057690034929
32101,2683.675533,2683.682367,1,80510265,80510471,206,0.626863250921813
32102,2683.6858,2683.7029,1,80510574,80511087,513,0.437755139770155
32103,2683.709833,2683.7183,1,80511294,80511549,255,-0.06985463343009882
32104,2683.733533,2683.7432,1,80512005,80512296,291,-0.11205881868975227
32105,2683.7552,2683.8426,1,80512656,80515278,2622,0.6338159639360835
32106,2683.845867,2683.876733,1,80515376,80516301,925,0.6130228030214474
32107,2683.931667,2684.006967,1,80517950,80520209,2259,0.5044528486388018
32108,2684.008167,2684.011433,1,80520245,80520342,97,0.43820988955773416
32109,2684.015633,2684.038,1,80520468,80521140,672,0.2515490105746341
32110,2684.354233,2684.418033,1,80530626,80532540,1914,0.5866232165638522
32111,2684.432733,2684.449833,1,80532981,80533494,513,0.5626291831248867
32112,2684.493233,2684.504133,1,80534796,80535123,327,0.4896975141095746
32113,2684.518,2684.5564,1,80535540,80536692,1152,0.04077922529425847
32114,2684.557933,2684.569933,1,80536737,80537097,360,0.4001466799355412
32115,2684.605167,2684.649633,1,80538155,80539488,1333,0.5433437005615407
32116,2684.913767,2684.9317,1,80547413,80547951,538,0.40585171449471497
32117,2684.932967,2684.9958,1,80547989,80549874,1885,0.6570670907441613
32118,2685.001133,2685.025267,1,80550033,80550758,725,0.7714838856220717
32119,2685.1242,2685.162233,1,80553726,80554866,1140,0.6492811809400719
32120,2685.198133,2685.2021,1,80555943,80556063,120,0.6077921278522925
32121,2685.2792,2685.2992,1,80558376,80558976,600,0.5775618383067298
32122,2685.3004,2685.395667,1,80559012,80561870,2858,0.562202601101378
32123,2685.447933,2685.451433,1,80563437,80563542,105,-0.22398369989600386
32124,2685.470533,2685.4882,1,80564115,80564646,531,-0.016240595875058862
32125,2685.779533,2685.785533,1,80573385,80573565,180,0.5930179803883645
32126,2685.786833,2685.864633,1,80573604,80575938,2334,0.5136154236118496
32127,2685.8809,2685.9074,1,80576427,80577222,795,0.6176472232379263
32128,2685.929267,2685.9443,1,80577878,80578329,451,0.5113723594425607
32129,2685.946433,2685.9682,1,80578392,80579046,654,0.5807119520302787
32130,2685.9815,2685.988267,1,80579445,80579648,203,0.5173005313401545
32131,2686.010833,2686.078333,1,80580324,80582349,2025,0.43279220642221994
32132,2686.102733,2686.2196,1,80583081,80586588,3507,0.6565613239039114
32133,2686.273,2686.282167,1,80588190,80588465,275,0.2985682463858174
32134,2686.285133,2686.288767,1,80588553,80588663,110,0.016141593917794794
32135,2686.290033,2686.295167,1,80588700,80588855,155,-0.24562608038017572
32136,2686.3205,2686.4914,1,80589615,80594742,5127,0.7631701341690149
32137,2686.500233,2686.541,1,80595006,80596230,1224,0.6471566336546362
32138,2686.569733,2686.591033,1,80597091,80597730,639,0.7271071932987786
32139,2686.688833,2686.692133,1,80600664,80600763,99,-0.22173152835198642
32140,2686.7136,2686.7181,1,80601408,80601543,135,0.22953775791068165
32141,2686.843033,2686.8699,1,80605290,80606097,807,0.564747274874718
32142,2687.0478,2687.051267,1,80611434,80611538,104,-0.012159663624461315
32143,2687.061433,2687.073767,1,80611842,80612213,371,0.5308103390261208
32144,2687.074967,2687.078267,1,80612249,80612348,99,
32145,2687.2022,2687.2106,1,80616066,80616318,252,0.15945917801027837
32146,2687.2233,2687.2452,1,80616699,80617356,657,0.4405841396396163
32147,2687.281733,2687.2858,1,80618451,80618574,123,0.22142466379279394
32148,2687.364533,2687.3678,1,80620935,80621034,99,0.4105510679863198
32149,2687.369833,2687.374433,1,80621094,80621232,138,
32150,2687.3782,2687.3818,1,80621346,80621454,108,-0.38428154702615436
32151,2687.3965,2687.409567,1,80621895,80622287,392,0.38419097049677936
32152,2687.426233,2687.430567,1,80622786,80622917,131,0.5265941896371656
32153,2687.431733,2687.436267,1,80622951,80623088,137,
32154,2687.439033,2687.5293,1,80623170,80625879,2709,0.77171517657311
32155,2687.552833,2687.566133,1,80626584,80626983,399,0.5531490940861256
32156,2687.567133,2687.571333,1,80627013,80627139,126,0.12682043897441886
32157,2687.579867,2687.585067,1,80627396,80627552,156,-0.061902582091750244
32158,2687.586467,2687.623433,1,80627594,80628702,1108,0.6017318508630615
32159,2687.771267,2687.807633,1,80633138,80634228,1090,0.605555109259667
32160,2687.8351,2687.84,1,80635053,80635200,147,0.02052921424669426
32161,2687.8515,2687.854533,1,80635545,80635635,90,-0.0016298889667301295
32162,2687.8621,2687.867233,1,80635863,80636016,153,0.1376374678369985
32163,2687.962533,2687.9952,1,80638875,80639856,981,0.4455568385244027
32164,2688.064533,2688.077367,1,80641935,80642321,386,0.6942865117710186
32165,2688.079367,2688.082433,1,80642381,80642472,91,
32166,2688.206767,2688.211733,1,80646203,80646351,148,
32167,2688.219333,2688.2331,1,80646579,80646993,414,0.28595795166991794
32168,2688.245,2688.254233,1,80647350,80647626,276,0.35026570707527904
32169,2688.2772,2688.3204,1,80648316,80649612,1296,0.026817295456628372
32170,2688.3218,2688.324833,1,80649654,80649744,90,-0.27815405830650247
32171,2688.340067,2688.3689,1,80650202,80651067,865,0.13127534659670229
32172,2688.375133,2688.3823,1,80651253,80651469,216,0.3216634580066132
32173,2688.456733,2688.4621,1,80653701,80653863,162,-0.06659529337008943
32174,2688.463633,2688.472433,1,80653908,80654172,264,0.1343462396793611
32175,2688.479267,2688.5032,1,80654378,80655096,718,0.2155285062205495
32176,2688.508867,2688.520233,1,80655266,80655606,340,0.38856313575903006
32177,2688.521467,2688.5282,1,80655644,80655846,202,0.26230566759589063
32178,2688.536667,2688.5483,1,80656100,80656449,349,0.27442170098812274
32179,2688.553167,2688.564933,1,80656595,80656947,352,0.1569409581492069
32180,2688.571233,2688.606567,1,80657136,80658197,1061,0.1491349818506918
32181,2688.6105,2688.6342,1,80658315,80659026,711,0.04862665102370736
32182,2688.635533,2688.662133,1,80659065,80659863,798,-0.04526933832881338
32183,2688.682267,2688.6896,1,80660468,80660688,220,0.41156436687397785
32184,2688.734233,2688.7379,1,80662026,80662137,111,0.3022995492443937
32185,2688.739233,2688.745867,1,80662176,80662376,200,0.49211823340079885
32186,2688.750567,2688.754267,1,80662517,80662628,111,0.4435193138854159
32187,2688.7588,2688.819967,1,80662764,80664599,1835,0.08449131502145128
32188,2688.832333,2688.840333,1,80664969,80665209,240,0.30075476540110535
32189,2688.8418,2688.932133,1,80665254,80667963,2709,0.04731773741643307
32190,2688.933767,2688.938733,1,80668013,80668161,148,0.031001841989416086
32191,2688.9407,2688.981633,1,80668221,80669448,1227,0.09089907023797444
32192,2688.9863,2688.993933,1,80669589,80669817,228,-0.025640688635850135
32193,2688.998233,2689.0368,1,80669946,80671104,1158,0.04017001343296404
32194,2689.045533,2689.050933,1,80671365,80671527,162,0.0028832833056503878
32195,2689.141033,2689.144267,1,80674230,80674328,98,0.6792725695316197
32196,2689.154367,2689.2044,1,80674631,80676132,1501,0.013386405918925533
32197,2689.222767,2689.234667,1,80676683,80677040,357,0.06344356529457225
32198,2689.2373,2689.2562,1,80677119,80677686,567,-0.023646542931309456
32199,2689.261167,2689.2681,1,80677835,80678043,208,-0.08464911893393044
32200,2689.2944,2689.317567,1,80678832,80679527,695,0.15440630436268313
32201,2689.344633,2689.347833,1,80680338,80680434,96,0.1977656040812134
32202,2689.3539,2689.359767,1,80680617,80680793,176,0.09180358749176872
32203,2689.360833,2689.366667,1,80680824,80681000,176,-0.16487767211598844
32204,2689.3682,2689.388267,1,80681046,80681648,602,0.43724834445546995
32205,2689.389467,2689.4021,1,80681684,80682063,379,0.42112538359799484
32206,2689.4085,2689.428733,1,80682255,80682861,606,0.06578747403227511
32207,2689.4472,2689.454667,1,80683416,80683640,224,0.29668068429669214
32208,2689.5395,2689.545167,1,80686185,80686355,170,0.48635781517457627
32209,2689.5757,2689.638567,1,80687271,80689157,1886,0.10253026033684963
32210,2689.973967,2689.977433,1,80699219,80699322,103,
32211,2690.235367,2690.2466,1,80707061,80707398,337,0.21933319185272318
32212,2690.248,2690.260267,1,80707440,80707808,368,0.15904448994587025
32213,2690.296567,2690.3066,1,80708897,80709198,301,0.31742382611613074
32214,2690.3093,2690.3153,1,80709279,80709459,180,0.6321989500001389
32215,2690.321333,2690.325467,1,80709639,80709764,125,-0.04114441883051728
32216,2690.327067,2690.336233,1,80709812,80710086,274,0.2857415815862869
32217,2690.4111,2690.4238,1,80712333,80712714,381,0.37095409736798024
32218,2690.436933,2690.479767,1,80713107,80714393,1286,0.600042467195938
32219,2690.4808,2690.4856,1,80714424,80714568,144,0.25148574081161806
32220,2690.486867,2690.498233,1,80714606,80714946,340,0.7427132338892065
32221,2690.499333,2690.502333,1,80714979,80715069,90,0.9134352474132731
32222,2690.510133,2690.5255,1,80715303,80715765,462,0.7131381953719137
32223,2690.7448,2690.7833,1,80722344,80723499,1155,0.6543442845317406
32224,2690.8481,2690.855333,1,80725443,80725659,216,-0.00543764913959512
32225,2690.8571,2690.868533,1,80725713,80726055,342,0.3672393094639459
32226,2690.870233,2690.8741,1,80726106,80726223,117,0.4017541611537915
32227,2690.9544,2690.9677,1,80728632,80729031,399,0.6420666111230855
32228,2691.0879,2691.0909,1,80732637,80732727,90,-0.12379154119640272
32229,2691.1051,2691.131667,1,80733153,80733950,797,0.1302210084094226
32230,2691.166333,2691.174133,1,80734989,80735223,234,0.011784911981280911
32231,2691.1787,2691.264033,1,80735361,80737920,2559,-0.009829446423824325
32232,2691.2922,2691.333667,1,80738766,80740010,1244,-0.03318313603729986
32233,2691.341933,2691.3451,1,80740257,80740353,96,
32234,2691.470133,2691.535167,1,80744103,80746055,1952,0.08902653213409946
32235,2691.6189,2691.6243,1,80748567,80748729,162,-0.21062127616140675
32236,2691.641933,2691.654467,1,80749257,80749634,377,0.2254944425099875
32237,2691.660767,2691.717,1,80749823,80751510,1687,0.015516565418765517
32238,2691.882567,2691.8912,1,80756477,80756736,259,-0.007510627212149024
32239,2691.895033,2691.907133,1,80756850,80757213,363,0.0691184523291108
32240,2691.9265,2691.9319,1,80757795,80757957,162,0.23108085439440793
32241,2691.939733,2691.952367,1,80758191,80758571,380,0.03973248215926208
32242,2691.9756,2691.980333,1,80759268,80759409,141,-0.0872794777474975
32243,2691.982167,2692.015867,1,80759465,80760476,1011,0.056952430689420054
32244,2692.018667,2692.0331,1,80760560,80760993,433,0.15229067661399392
32245,2692.034767,2692.071833,1,80761043,80762154,1111,0.22344529565622842
32246,2692.074267,2692.077267,1,80762228,80762318,90,0.7399272944238302
32247,2692.080733,2692.104933,1,80762421,80763147,726,0.17132562384280234
32248,2692.116,2692.1227,1,80763480,80763681,201,0.03603232913967282
32249,2692.252533,2692.296133,1,80767575,80768883,1308,0.19640231404122274
32250,2692.2975,2692.301867,1,80768925,80769056,131,0.6940844075295606
32251,2692.311167,2692.315933,1,80769335,80769477,142,0.2755766039470783
32252,2692.445333,2692.4484,1,80773359,80773452,93,-0.19218357620012885
32253,2692.470567,2692.474067,1,80774117,80774222,105,-0.16251780092249785
32254,2692.581033,2692.590133,1,80777430,80777703,273,0.6618631452661274
32255,2692.601333,2692.611633,1,80778039,80778348,309,0.06142869394903068
32256,2692.637267,2692.644433,1,80779118,80779332,214,-0.2837868571980441
32257,2692.6456,2692.649567,1,80779368,80779487,119,-0.2850056192608823
32258,2692.655033,2692.664433,1,80779650,80779932,282,0.7761387124688809
32259,2692.6907,2692.695533,1,80780721,80780865,144,0.23990367028114734
32260,2693.277033,2693.2812,1,80798310,80798436,126,
32261,2693.9144,2693.9255,1,80817432,80817765,333,0.1232596774557598
32262,2693.980733,2693.996,1,80819421,80819880,459,0.187018147947984
32263,2694.6813,2694.685933,1,80840439,80840577,138,-0.08036981537813291
32264,2695.5478,2695.550867,1,80866434,80866526,92,0.08699431557063876
32265,2695.623867,2695.6316,1,80868716,80868948,232,0.6676141952039369
32266,2695.647333,2695.652,1,80869419,80869560,141,0.8078756166042889
32267,2695.6834,2695.698533,1,80870502,80870955,453,0.6293919625637481
32268,2695.804833,2695.8109,1,80874144,80874327,183,0.6664474540948806
32269,2695.863667,2695.868067,1,80875910,80876042,132,0.597956083194858
32270,2695.871267,2695.8764,1,80876138,80876292,154,0.567394281266376
32271,2695.969833,2695.987167,1,80879094,80879615,521,0.49891243514098604
32272,2695.988667,2696.0015,1,80879660,80880045,385,0.6283207807447666
32273,2696.021833,2696.032733,1,80880654,80880981,327,0.5003260419689308
32274,2696.034033,2696.037733,1,80881020,80881131,111,-0.17072984005256048
32275,2696.0466,2696.0522,1,80881398,80881566,168,
32276,2696.9792,2696.988867,1,80909376,80909666,290,0.6378225172111364
32277,2696.997667,2697.006033,1,80909930,80910180,250,0.4227417064552556
32278,2697.0074,2697.0202,1,80910222,80910606,384,0.13796979948635005
32279,2697.0423,2697.055133,1,80911269,80911653,384,0.2616671253119394
32280,2697.075767,2697.080633,1,80912273,80912418,145,0.631592319658207
32281,2697.243333,2697.246767,1,80917299,80917403,104,0.5823033823141671
32282,2697.250433,2697.2621,1,80917512,80917863,351,0.7180318259579266
32283,2697.308267,2697.3146,1,80919248,80919438,190,0.6845289316986821
32284,2697.379467,2697.3831,1,80921384,80921493,109,0.7279503927277288
32285,2697.6899,2697.6943,1,80930697,80930829,132,0.3707397695050651
32286,2697.7004,2697.733733,1,80931012,80932011,999,0.5410067074205448
32287,2697.7349,2697.7717,1,80932047,80933151,1104,0.48465266322467193
32288,2697.777467,2697.8218,1,80933324,80934654,1330,0.46561982653442713
32289,2697.8302,2697.847267,1,80934906,80935418,512,0.5334371021203459
32290,2697.8537,2697.8568,1,80935611,80935704,93,0.6129973930638887
32291,2697.8625,2697.9148,1,80935875,80937444,1569,0.5343185997666512
32292,2697.929133,2697.943367,1,80937873,80938301,428,0.5240351558316889
32293,2697.952967,2697.957067,1,80938589,80938712,123,0.3331984506794908
32294,2697.963233,2698.0143,1,80938896,80940429,1533,0.5425644351186845
32295,2698.026967,2698.033233,1,80940809,80940996,187,0.6082412797898985
32296,2698.041633,2698.0543,1,80941248,80941629,381,0.5384614804035849
32297,2698.056533,2698.065267,1,80941695,80941958,263,0.4526952816870472
32298,2698.107,2698.1188,1,80943210,80943564,354,0.5439855426832909
32299,2698.124067,2698.1713,1,80943722,80945139,1417,0.5548323543202963
32300,2698.174567,2698.204967,1,80945237,80946149,912,0.39849870592958425
32301,2698.230967,2698.237367,1,80946929,80947121,192,-0.08518827982137363
32302,2698.262033,2698.269033,1,80947860,80948070,210,0.1918155820457723
32303,2698.280567,2698.304933,1,80948417,80949147,730,0.2948695814845158
32304,2698.315533,2698.341833,1,80949465,80950254,789,0.04727125970102985
32305,2698.375233,2698.3843,1,80951256,80951529,273,0.3645491354276455
32306,2698.400267,2698.404967,1,80952008,80952149,141,-0.28326885094911003
32307,2698.4538,2698.463733,1,80953614,80953911,297,0.7038746223323841
32308,2698.4684,2698.4782,1,80954052,80954346,294,0.06908645710592386
32309,2698.479533,2698.504133,1,80954385,80955123,738,0.2739238571304359
32310,2698.523433,2698.542767,1,80955702,80956283,581,0.10770409373455536
32311,2698.584433,2698.588433,1,80957532,80957652,120,0.7437275485865305
32312,2698.592533,2698.6133,1,80957775,80958399,624,0.646405109013496
32313,2698.6148,2698.642933,1,80958444,80959287,843,0.5276788040887217
32314,2698.660767,2698.675733,1,80959823,80960271,448,0.6523848522432174
32315,2698.6853,2698.699833,1,80960559,80960994,435,0.26404760778430053
32316,2698.7091,2698.729467,1,80961273,80961884,611,0.5666984040290419
32317,2698.756633,2698.771333,1,80962698,80963139,441,0.6621902819834196
32318,2698.773367,2698.787567,1,80963201,80963627,426,0.5379135066570923
32319,2698.790433,2698.797367,1,80963712,80963921,209,0.5304789529209913
32320,2698.8071,2698.8657,1,80964213,80965971,1758,0.5452754638873384
32321,2698.8836,2698.886967,1,80966508,80966609,101,-0.33197160668525233
32322,2698.896833,2698.901267,1,80966904,80967038,134,0.327642767443797
32323,2698.910167,2698.934933,1,80967305,80968047,742,0.5615123376983187
32324,2698.966767,2698.978967,1,80969003,80969369,366,0.5082457222156852
32325,2698.982667,2699.015333,1,80969480,80970459,979,0.1090417490468032
32326,2699.018133,2699.040133,1,80970543,80971203,660,-0.047177511025593415
32327,2699.053067,2699.063067,1,80971592,80971892,300,0.6810276972689585
32328,2699.069133,2699.102433,1,80972073,80973072,999,0.24941607128438895
32329,2699.115867,2699.142233,1,80973476,80974266,790,0.08367825965576368
32330,2699.143467,2699.150333,1,80974304,80974509,205,0.09935405576932921
32331,2699.151433,2699.156567,1,80974542,80974697,155,0.39867779675858883
32332,2699.193567,2699.3322,1,80975807,80979966,4159,0.7364703101768804
32333,2699.3482,2699.3518,1,80980446,80980554,108,0.6714326307558454
32334,2699.353133,2699.3635,1,80980593,80980905,312,0.4426496429525112
32335,2699.368033,2699.393567,1,80981040,80981807,767,0.7150806031161431
32336,2699.3946,2699.430767,1,80981838,80982923,1085,0.6703581160908076
32337,2699.463533,2699.471967,1,80983905,80984159,254,0.3074961055136583
32338,2699.484767,2699.5191,1,80984543,80985573,1030,0.023286984390069407
32339,2699.522567,2699.532267,1,80985677,80985968,291,-0.005835986213957002
32340,2699.533267,2699.536267,1,80985998,80986088,90,
32341,2699.5516,2699.575467,1,80986548,80987264,716,0.5661349911411486
32342,2699.578833,2699.612533,1,80987364,80988375,1011,0.3530425248477559
32343,2699.622533,2699.659067,1,80988675,80989772,1097,0.2653724247101457
32344,2699.669533,2699.674133,1,80990085,80990223,138,0.7014837583511917
32345,2699.686733,2699.691267,1,80990601,80990738,137,0.665202428099719
32346,2699.692633,2699.699867,1,80990778,80990996,218,0.5319721161452903
32347,2699.702833,2699.706133,1,80991084,80991183,99,0.7870701032132535
32348,2699.707367,2699.744133,1,80991221,80992323,1102,0.11745539632351946
32349,2699.754,2699.796033,1,80992620,80993880,1260,0.015001569106663205
32350,2699.833533,2699.839967,1,80995005,80995199,194,0.1134054899064228
32351,2699.843833,2699.847733,1,80995314,80995431,117,0.29610094364504175
32352,2699.855967,2699.871667,1,80995679,80996150,471,0.30608423846658633
32353,2699.886,2699.920767,1,80996580,80997623,1043,0.6769922743910927
32354,2699.975733,2699.995,1,80999271,80999850,579,0.6513298523702201
32355,2699.996133,2700.000433,1,80999883,81000012,129,0.6600674658950492
32356,2700.007933,2700.013,1,81000237,81000390,153,0.528563198844658
32357,2700.02,2700.028833,1,81000600,81000864,264,0.14939599972317974
32358,2700.046033,2700.0692,1,81001380,81002076,696,0.8775360052300695
32359,2700.087933,2700.1001,1,81002637,81003003,366,0.5820386697517232
32360,2700.105867,2700.132733,1,81003176,81003981,805,0.8203436290475921
32361,2700.1341,2700.144233,1,81004023,81004326,303,0.7728683607558064
32362,2700.158767,2700.172067,1,81004763,81005162,399,0.6144479531318179
32363,2700.178033,2700.190333,1,81005340,81005709,369,0.6425196314479467
32364,2700.248867,2700.261267,1,81007466,81007838,372,0.01908693118571799
32365,2700.2643,2700.282233,1,81007929,81008466,537,0.09837470225557472
32366,2700.3202,2700.328933,1,81009606,81009867,261,0.04383181694002182
32367,2700.351667,2700.3847,1,81010550,81011541,991,0.3974298331240343
32368,2700.407633,2700.412667,1,81012228,81012380,152,0.2554428309845092
32369,2700.4151,2700.426267,1,81012453,81012788,335,0.5131080785307123
32370,2700.4274,2700.440767,1,81012822,81013223,401,0.12336975708915651
32371,2700.491733,2700.4967,1,81014751,81014901,150,0.5619295323433214
32372,2700.5013,2700.508733,1,81015039,81015261,222,0.1794561860969819
32373,2700.510133,2700.516433,1,81015303,81015492,189,0.536485934908071
32374,2700.527333,2700.535,1,81015819,81016050,231,0.45228481455313424
32375,2700.542,2700.5603,1,81016260,81016809,549,0.7382998900731251
32376,2700.568167,2700.586933,1,81017045,81017607,562,0.7449325088302214
32377,2700.5994,2700.611967,1,81017982,81018359,377,0.6288224638756167
32378,2700.652533,2700.667133,1,81019575,81020013,438,0.6366384405695464
32379,2700.6752,2700.688333,1,81020256,81020649,393,0.6343875537781175
32380,2700.7204,2700.7649,1,81021612,81022947,1335,0.8485543360006783
32381,2700.797533,2700.8081,1,81023925,81024243,318,0.7509659392770629
32382,2700.8287,2700.8837,1,81024861,81026511,1650,0.6233147565221235
32383,2700.899867,2700.920933,1,81026996,81027627,631,0.6653932622683357
32384,2700.938933,2700.993833,1,81028167,81029814,1647,0.5479894848272058
32385,2701.0101,2701.032033,1,81030303,81030960,657,0.6933401609904903
32386,2701.052,2701.094333,1,81031560,81032829,1269,0.681659685818453
32387,2701.104933,2701.1092,1,81033147,81033276,129,0.403967291524774
32388,2701.117633,2701.130133,1,81033528,81033903,375,0.5989421710145734
32389,2701.1315,2701.141233,1,81033945,81034236,291,0.5006699553697854
32390,2701.198967,2701.2327,1,81035969,81036981,1012,-0.04578981458818238
32391,2701.282433,2701.2865,1,81038472,81038595,123,0.6021967950725724
32392,2701.294933,2701.298267,1,81038847,81038948,101,
32393,2701.315533,2701.327167,1,81039465,81039815,350,0.3768166570624769
32394,2701.3306,2701.334567,1,81039918,81040037,119,0.7423344134091687
32395,2701.418433,2701.4302,1,81042552,81042906,354,0.5418948215301251
32396,2701.593333,2701.6112,1,81047799,81048336,537,0.7451663074988515
32397,2701.616333,2701.6597,1,81048489,81049791,1302,0.7723400928543276
32398,2701.6609,2701.666333,1,81049827,81049989,162,0.4552010366043121
32399,2701.667833,2701.677067,1,81050034,81050312,278,0.5573258027101984
32400,2701.689333,2701.718367,1,81050679,81051551,872,0.6861105211683572
32401,2701.721333,2701.749033,1,81051639,81052470,831,0.6531225616528846
32402,2701.7523,2701.777733,1,81052569,81053331,762,0.5554962137399492
32403,2701.782633,2701.8048,1,81053478,81054144,666,0.7179634705803072
32404,2701.810833,2701.822133,1,81054324,81054663,339,0.4805710800536568
32405,2701.823867,2701.834267,1,81054716,81055028,312,0.48709600248132606
32406,2701.843667,2701.862633,1,81055310,81055878,568,0.6519103494993275
32407,2701.864567,2701.907667,1,81055937,81057230,1293,0.6535894475492452
32408,2702.2565,2702.263867,1,81067695,81067916,221,0.6721119717211294
32409,2702.265633,2702.275133,1,81067968,81068253,285,0.6696592418003762
32410,2702.284467,2702.309,1,81068534,81069270,736,0.758739082508147
32411,2702.3203,2702.331833,1,81069609,81069954,345,0.6458404039997786
32412,2702.3377,2702.342767,1,81070131,81070283,152,0.5759255177479446
32413,2702.347833,2702.363933,1,81070434,81070917,483,0.6769761725484552
32414,2702.368167,2702.412067,1,81071045,81072362,1317,0.7591909422578114
32415,2702.4392,2702.446,1,81073176,81073380,204,0.23408264145137575
32416,2702.460733,2702.473533,1,81073821,81074205,384,-0.0956008100366536
32417,2702.4759,2702.4935,1,81074277,81074805,528,0.2165643349808485
32418,2702.4945,2702.502933,1,81074835,81075087,252,-0.09162806138719931
32419,2702.528367,2702.5437,1,81075851,81076311,460,0.2413618825831698
32420,2702.544867,2702.551933,1,81076346,81076557,211,0.5091651586245176
32421,2702.560433,2702.645833,1,81076812,81079374,2562,0.125677419474322
32422,2702.691233,2702.742667,1,81080736,81082280,1544,0.7537404710683301
32423,2702.7447,2702.8111,1,81082341,81084333,1992,0.7990427377095582
32424,2702.843767,2702.8544,1,81085313,81085632,319,0.29660641090341766
32425,2702.863767,2702.868833,1,81085913,81086064,151,-0.10839765157186161
32426,2702.870933,2702.876133,1,81086127,81086283,156,-0.09117160678016038
32427,2702.877233,2702.888067,1,81086316,81086642,326,0.2771753468310012
32428,2702.8891,2702.892967,1,81086673,81086789,116,
32429,2702.894967,2702.906667,1,81086849,81087200,351,0.09976222232431932
32430,2703.377633,2703.3863,1,81101328,81101589,261,0.67735826647792
32431,2703.4576,2703.471933,1,81103728,81104157,429,0.8683770261470849
32432,2703.473067,2703.4849,1,81104192,81104547,355,0.8341713401082014
32433,2703.517367,2703.541333,1,81105521,81106239,718,0.8047443286741152
32434,2703.542367,2703.644133,1,81106271,81109323,3052,0.7468472465851433
32435,2703.654067,2703.706967,1,81109622,81111209,1587,0.660636347571595
32436,2703.7281,2703.758,1,81111843,81112740,897,0.7393663198971216
32437,2703.7722,2703.7917,1,81113166,81113751,585,0.6442788722180451
32438,2703.7927,2703.8141,1,81113781,81114423,642,0.652384587311634
32439,2703.842367,2703.869833,1,81115271,81116094,823,0.7540856596715665
32440,2703.879967,2703.8926,1,81116399,81116778,379,0.7640473729445791
32441,2703.8998,2703.916,1,81116994,81117480,486,0.6926080496227025
32442,2703.921467,2703.929033,1,81117644,81117870,226,0.4256010173435953
32443,2703.940433,2703.945333,1,81118212,81118359,147,0.05634626785072143
32444,2703.947367,2703.998133,1,81118421,81119943,1522,0.12761742220467243
32445,2703.9995,2704.004267,1,81119985,81120128,143,-0.0640948237664435
32446,2704.089267,2704.2086,1,81122678,81126258,3580,0.8402774541065537
32447,2704.212767,2704.293133,1,81126383,81128793,2410,0.7728125416048742
32448,2704.2949,2704.318833,1,81128847,81129564,717,0.7166837150494293
32449,2704.324633,2704.338433,1,81129738,81130152,414,0.6998630460418571
32450,2704.3448,2704.3571,1,81130344,81130713,369,0.6219480223263787
32451,2704.626667,2704.654067,1,81138800,81139622,822,0.6681983500148644
32452,2704.658333,2704.750433,1,81139749,81142512,2763,0.7935316695347556
32453,2704.765967,2704.770767,1,81142979,81143123,144,0.15775617687758955
32454,2704.824167,2704.9047,1,81144725,81147141,2416,0.6916952288602025
32455,2705.1688,2705.1762,1,81155064,81155286,222,0.488808573530829
32456,2705.1777,2705.181067,1,81155331,81155432,101,0.6154055301535987
32457,2705.1925,2705.228933,1,81155775,81156867,1092,0.5507741403406087
32458,2705.231133,2705.257833,1,81156933,81157734,801,0.12682243018478176
32459,2705.260033,2705.2925,1,81157800,81158775,975,0.5051719883025654
32460,2705.305667,2705.3127,1,81159170,81159381,211,0.5838435376886262
32461,2705.317767,2705.364133,1,81159533,81160923,1390,0.7298461166519812
32462,2705.3777,2705.393,1,81161331,81161790,459,0.7042861104443955
32463,2705.402067,2705.409867,1,81162062,81162296,234,0.46174848510373334
32464,2705.421567,2705.4251,1,81162647,81162753,106,0.07769966786274182
32465,2705.436467,2705.458633,1,81163094,81163758,664,-0.053833633397885175
32466,2705.4624,2705.4791,1,81163872,81164373,501,0.21094197649631094
32467,2705.480267,2705.484033,1,81164408,81164520,112,
32468,2705.486633,2705.494533,1,81164598,81164835,237,0.24643863317632617
32469,2705.528133,2705.5581,1,81165843,81166743,900,0.6713559186802001
32470,2705.559267,2705.5721,1,81166778,81167163,385,0.21809839042599086
32471,2705.579833,2705.665167,1,81167394,81169955,2561,0.7440225292500648
32472,2705.6723,2705.7055,1,81170169,81171165,996,0.5244708026827763
32473,2705.7212,2705.795867,1,81171636,81173876,2240,0.7118400329484803
32474,2705.8167,2705.825567,1,81174501,81174767,266,0.2618575334104321
32475,2705.829167,2705.8748,1,81174875,81176244,1369,0.788367881059853
32476,2705.876,2705.884633,1,81176280,81176538,258,-0.24555994810197965
32477,2705.885967,2705.900533,1,81176579,81177015,436,0.6232282659178648
32478,2705.903733,2705.918733,1,81177111,81177561,450,0.5281923113723253
32479,2705.960667,2705.965733,1,81178820,81178971,151,0.4036232606447524
32480,2705.9744,2706.022333,1,81179232,81180669,1437,0.05139773902980413
32481,2706.031633,2706.131433,1,81180948,81183942,2994,0.8428529892330102
32482,2706.153467,2706.1998,1,81184604,81185994,1390,0.7467784053507625
32483,2706.204,2706.2455,1,81186120,81187365,1245,0.6815152291692592
32484,2706.250867,2706.262133,1,81187526,81187863,337,0.6280257648012999
32485,2706.729767,2706.739633,1,81201893,81202188,295,0.7576544758272366
32486,2706.744933,2706.7564,1,81202347,81202692,345,0.594430257345834
32487,2706.758033,2706.7678,1,81202740,81203034,294,0.694267983956547
32488,2706.791433,2706.8019,1,81203742,81204057,315,0.7169475833031371
32489,2706.827367,2706.8373,1,81204821,81205119,298,0.8299219028726734
32490,2706.854367,2706.8637,1,81205631,81205911,280,0.37544142403707825
32491,2706.886333,2706.9018,1,81206589,81207054,465,0.30656280504208955
32492,2706.914367,2706.958833,1,81207431,81208764,1333,0.0667137235896772
32493,2706.964333,2706.968067,1,81208929,81209042,113,
32494,2706.969667,2706.974667,1,81209090,81209240,150,-0.020513346338739066
32495,2706.9837,2706.9927,1,81209511,81209781,270,0.6231744062677098
32496,2707.0027,2707.008767,1,81210081,81210263,182,0.49734276277668965
32497,2707.019567,2707.035533,1,81210587,81211065,478,0.6042929691747267
32498,2707.0366,2707.139633,1,81211098,81214188,3090,0.8153688457020866
32499,2707.147,2707.155367,1,81214410,81214661,251,0.21656790543449894
32500,2707.182633,2707.201967,1,81215478,81216059,581,-0.01467885900097145
32501,2707.203067,2707.2209,1,81216092,81216627,535,0.08861381300014191
32502,2707.251533,2707.258767,1,81217545,81217763,218,0.4484366130374865
32503,2707.263467,2707.2865,1,81217904,81218595,691,0.4128700746525552
32504,2707.289,2707.2998,1,81218670,81218994,324,0.5799942695993957
32505,2707.3081,2707.3249,1,81219243,81219747,504,-0.03986580767603779
32506,2707.330033,2707.338867,1,81219900,81220166,266,0.29981956476674443
32507,2707.340933,2707.5078,1,81220227,81225234,5007,0.8476636042037597
32508,2707.719767,2707.7414,1,81231593,81232242,649,0.7070114321130602
32509,2707.746933,2707.759533,1,81232407,81232785,378,0.6976805589518469
32510,2707.809467,2707.821267,1,81234284,81234638,354,0.6371015688094152
32511,2707.8485,2707.892833,1,81235455,81236784,1329,0.6828109200241571
32512,2707.9184,2707.934233,1,81237552,81238026,474,0.771488753882004
32513,2707.957867,2707.972133,1,81238736,81239163,427,0.7194399295923316
32514,2707.973567,2707.988867,1,81239207,81239666,459,0.5388390746930612
32515,2707.9934,2708.003,1,81239802,81240090,288,0.2014188993298417
32516,2708.014167,2708.0858,1,81240425,81242574,2149,0.19954220824064764
32517,2708.095433,2708.110867,1,81242862,81243326,464,0.5544534865746876
32518,2708.1139,2708.155867,1,81243417,81244676,1259,0.8201390301334031
32519,2708.157133,2708.205633,1,81244713,81246168,1455,0.834292692312801
32520,2708.2526,2708.2588,1,81247578,81247764,186,0.005035227114379893
32521,2708.2693,2708.281733,1,81248079,81248451,372,-0.11699014317802779
32522,2708.3178,2708.3761,1,81249534,81251283,1749,0.7512868507348994
32523,2708.377767,2708.454,1,81251333,81253620,2287,0.7998804149304345
32524,2708.455967,2708.492533,1,81253679,81254775,1096,0.6717740740697061
32525,2708.534833,2708.544167,1,81256044,81256325,281,0.7623413362190828
32526,2708.5502,2708.569633,1,81256506,81257088,582,0.11758169926476557
32527,2708.575067,2708.578867,1,81257252,81257366,114,-0.021466767556759744
32528,2708.580167,2708.587,1,81257405,81257610,205,-0.22632594891343508
32529,2708.7307,2708.7557,1,81261921,81262671,750,0.7188852335335162
32530,2708.764167,2708.8022,1,81262925,81264066,1141,0.7902242249712792
32531,2708.8048,2708.864633,1,81264144,81265938,1794,0.7924323569457383
32532,2708.875567,2708.904433,1,81266267,81267132,865,0.7942341034977692
32533,2708.905933,2708.9344,1,81267177,81268032,855,0.8348555121594591
32534,2708.9448,2708.9838,1,81268344,81269514,1170,0.7185182765559028
32535,2708.985267,2708.990233,1,81269558,81269706,148,0.7438793133607144
32536,2708.998367,2709.025567,1,81269951,81270767,816,0.8030478934296537
32537,2709.060467,2709.083333,1,81271814,81272499,685,-0.021878362700610627
32538,2709.084433,2709.087567,1,81272532,81272627,95,-0.25367675583411503
32539,2709.101633,2709.1086,1,81273048,81273258,210,0.3156357759333683
32540,2709.186267,2709.191667,1,81275588,81275750,162,0.5327149442997905
32541,2709.2428,2709.249167,1,81277284,81277475,191,0.411228576034764
32542,2709.3197,2709.322967,1,81279591,81279689,98,
32543,2709.355667,2709.3592,1,81280670,81280776,106,-0.4764898227083513
32544,2709.9032,2709.9227,1,81297096,81297681,585,0.41445604634974703
32545,2709.9245,2709.927733,1,81297735,81297831,96,0.017582819624387163
32546,2709.9843,2709.9961,1,81299529,81299883,354,0.5128391727492734
32547,2710.458667,2710.461767,1,81313760,81313853,93,0.5729194437224704
32548,2710.607933,2710.619967,1,81318237,81318599,362,0.9174255080018241
32549,2710.711733,2710.7222,1,81321351,81321666,315,0.7219442834373304
32550,2710.724,2710.7275,1,81321720,81321825,105,-0.05547311866289473
32551,2710.775633,2710.781433,1,81323268,81323442,174,0.555473777220177
32552,2710.785833,2710.790367,1,81323574,81323711,137,0.6565504457316745
32553,2711.102867,2711.109933,1,81333086,81333297,211,0.19709137779624364
32554,2711.115667,2711.276733,1,81333470,81338301,4831,0.8203364871323257
32555,2711.319467,2711.397233,1,81339584,81341916,2332,0.8012159583789711
32556,2711.424367,2711.449967,1,81342731,81343499,768,0.7254531020742637
32557,2711.4545,2711.528367,1,81343635,81345851,2216,0.7119477945439083
32558,2711.5397,2711.548267,1,81346191,81346448,257,0.10254004330055298
32559,2711.9094,2711.9213,1,81357282,81357639,357,0.5202262328802711
32560,2711.927767,2711.987033,1,81357833,81359610,1777,0.5574117162473918
32561,2711.9966,2712.087967,1,81359898,81362639,2741,0.6931022962471869
32562,2712.098867,2712.107667,1,81362966,81363230,264,-0.1448437486049779
32563,2712.1257,2712.169933,1,81363771,81365097,1326,0.6129997210158505
32564,2712.5323,2712.537233,1,81375969,81376116,147,0.6625574472201753
32565,2712.539233,2712.5448,1,81376176,81376344,168,0.4839611662963613
32566,2712.559067,2712.585667,1,81376772,81377570,798,0.7370033655001017
32567,2712.602767,2712.616233,1,81378083,81378486,403,0.7704051239745905
32568,2712.6298,2712.635167,1,81378894,81379055,161,0.5968017742681639
32569,2712.6636,2712.6972,1,81379908,81380916,1008,0.8412803838660362
32570,2712.775967,2712.781933,1,81383279,81383457,178,0.7160146517966485
32571,2712.789033,2712.7931,1,81383670,81383793,123,0.42363332069544724
32572,2712.8232,2712.8275,1,81384696,81384825,129,0.7176944559184998
32573,2712.8298,2712.8441,1,81384894,81385323,429,0.5881938751884751
32574,2712.859667,2712.8667,1,81385790,81386001,211,0.7875932860722968
32575,2712.900933,2712.906067,1,81387027,81387182,155,0.09764377156643682
32576,2712.908933,2712.917433,1,81387267,81387522,255,0.590394932364028
32577,2712.950867,2712.9659,1,81388526,81388977,451,0.6148703753795879
32578,2713.079033,2713.0931,1,81392370,81392793,423,0.5168702643269735
32579,2713.094133,2713.146367,1,81392823,81394391,1568,0.6835902490762825
32580,2713.1479,2713.207067,1,81394437,81396212,1775,0.7053820115015627
32581,2713.208267,2713.235633,1,81396248,81397068,820,0.7675681348552743
32582,2713.243,2713.2462,1,81397290,81397386,96,0.09089717791310367
32583,2713.279133,2713.35,1,81398373,81400500,2127,0.7203829306369093
32584,2713.354133,2713.370767,1,81400623,81401123,500,0.6024326703920518
32585,2713.372033,2713.388733,1,81401160,81401661,501,0.7038294649679521
32586,2713.6686,2713.6724,1,81410058,81410172,114,
32587,2713.675333,2713.812133,1,81410259,81414363,4104,0.7767167677480803
32588,2713.8308,2713.8352,1,81414924,81415056,132,-0.020532092244860287
32589,2714.182,2714.195533,1,81425460,81425865,405,0.6917975795094294
32590,2714.212567,2714.2176,1,81426377,81426528,151,0.5850156114158289
32591,2714.257633,2714.268333,1,81427728,81428049,321,0.7174514261770664
32592,2714.320067,2714.3324,1,81429602,81429972,370,0.6143041864596064
32593,2714.397233,2714.407267,1,81431916,81432218,302,0.6403047105085926
32594,2714.434833,2714.442867,1,81433044,81433286,242,0.5996772504710014
32595,2714.448233,2714.460667,1,81433446,81433820,374,0.6573660650155201
32596,2714.8884,2714.895367,1,81446652,81446861,209,0.568754350762993
32597,2714.907633,2714.9138,1,81447228,81447414,186,0.8347091368323427
32598,2714.914867,2715.053233,1,81447446,81451596,4150,0.8384394450550757
32599,2715.0579,2715.106567,1,81451737,81453197,1460,0.825334726678895
32600,2715.1186,2715.134833,1,81453558,81454044,486,0.7109062450056328
32601,2715.139533,2715.150833,1,81454185,81454524,339,0.5568269375896728
32602,2715.440733,2715.4463,1,81463221,81463389,168,0.6970512907573827
32603,2715.456333,2715.603667,1,81463689,81468110,4421,0.8206048905065624
32604,2715.625233,2715.724667,1,81468756,81471740,2984,0.722670002316663
32605,2715.726733,2715.7324,1,81471801,81471972,171,-0.1155560275745848
32606,2715.8204,2715.9116,1,81474612,81477348,2736,0.767563470753221
32607,2716.338867,2716.4061,1,81490166,81492183,2017,0.7358284298325497
32608,2716.4072,2716.4156,1,81492216,81492468,252,0.3644785445887522
32609,2716.779467,2716.786967,1,81503384,81503609,225,0.593908350317378
32610,2716.787967,2716.885533,1,81503639,81506565,2926,0.8160015719709518
32611,2716.889633,2716.894767,1,81506688,81506843,155,-0.070821976990954
32612,2717.220233,2717.248333,1,81516606,81517449,843,0.750814757130819
32613,2717.2495,2717.253833,1,81517485,81517614,129,0.35506775899136495
32614,2717.2568,2717.345267,1,81517704,81520358,2654,0.8227409967097045
32615,2717.721567,2717.779333,1,81531647,81533379,1732,0.8186776206123214
32616,2717.783167,2717.7983,1,81533495,81533949,454,0.023934466627593742
32617,2717.799933,2717.8061,1,81533997,81534183,186,-0.13796605584799693
32618,2718.0824,2718.247467,1,81542472,81547424,4952,0.8225017114031938
32619,2718.2519,2718.255333,1,81547557,81547659,102,0.44602924881216416
32620,2718.257533,2718.261033,1,81547725,81547830,105,0.28836872364022437
32621,2718.338233,2718.342,1,81550146,81550260,114,0.7464144034362512
32622,2718.3434,2718.427267,1,81550302,81552818,2516,0.8206603483534451
32623,2718.4427,2718.4463,1,81553281,81553389,108,-0.12321107456477584
32624,2718.4487,2718.454,1,81553461,81553620,159,-0.14507850799529373
32625,2718.731967,2718.7391,1,81561959,81562173,214,0.49082036982343674
32626,2718.751933,2718.767233,1,81562557,81563016,459,0.536999182639749
32627,2718.770133,2718.777467,1,81563103,81563324,221,0.6772470327281008
32628,2718.7975,2718.8075,1,81563925,81564225,300,0.48104162870435985
32629,2718.820167,2718.8506,1,81564605,81565518,913,0.703926841722008
32630,2718.8645,2718.928233,1,81565935,81567846,1911,0.8020861644047982
32631,2718.9344,2718.998067,1,81568032,81569942,1910,0.6858990386035567
32632,2719.008667,2719.0374,1,81570260,81571122,862,0.6552253680696541
32633,2719.055567,2719.095,1,81571667,81572850,1183,0.800904626610313
32634,2719.1096,2719.116433,1,81573288,81573492,204,0.7279239367252074
32635,2719.4454,2719.452633,1,81583362,81583578,216,0.6091839099218356
32636,2719.455433,2719.471133,1,81583662,81584133,471,0.8905941019243939
32637,2719.472533,2719.513033,1,81584175,81585390,1215,0.7819427070139613
32638,2719.5146,2719.658133,1,81585438,81589743,4305,0.8301035642271292
32639,2719.6596,2719.6686,1,81589788,81590058,270,0.5017398328027024
32640,2719.692367,2719.833633,1,81590771,81595008,4237,0.7211055745522607
32641,2719.860033,2719.889733,1,81595800,81596691,891,0.7093223535166245
32642,2719.900667,2719.905333,1,81597020,81597159,139,0.40931855175421594
32643,2719.923,2719.926367,1,81597690,81597791,101,
32644,2720.316433,2720.323233,1,81609492,81609696,204,0.6794955338749017
32645,2720.3323,2720.5086,1,81609969,81615258,5289,0.8007951569967257
32646,2720.530933,2720.546,1,81615927,81616380,453,0.796350573561216
32647,2720.547633,2720.553967,1,81616428,81616619,191,0.5819790003107781
32648,2720.561667,2720.6619,1,81616850,81619857,3007,0.6866695452083322
32649,2720.663367,2720.7171,1,81619901,81621513,1612,0.8123479439636673
32650,2720.7424,2720.749833,1,81622272,81622494,222,0.06536526898544007
32651,2720.751133,2720.754533,1,81622533,81622635,102,
32652,2720.7576,2720.762167,1,81622728,81622865,137,0.2165555215173455
32653,2721.255233,2721.2654,1,81637656,81637962,306,0.34070576300559396
32654,2721.283133,2721.312933,1,81638493,81639387,894,0.8585806629384761
32655,2721.328667,2721.344567,1,81639860,81640337,477,0.9341944845766764
32656,2721.3568,2721.430167,1,81640704,81642905,2201,0.6256266432769226
32657,2721.4422,2721.465667,1,81643266,81643970,704,0.7080884670862849
32658,2721.467433,2721.505633,1,81644022,81645168,1146,0.6182112899143222
32659,2721.544867,2721.548767,1,81646346,81646463,117,0.4667225301959774
32660,2721.556967,2721.571533,1,81646709,81647145,436,0.5122366254893002
32661,2721.5936,2721.608467,1,81647808,81648254,446,0.5531727172920963
32662,2721.612333,2721.627967,1,81648369,81648839,470,0.37490291014990845
32663,2721.645833,2721.6494,1,81649374,81649482,108,-0.18233357297170738
32664,2721.660567,2721.678667,1,81649817,81650360,543,0.5942569343133854
32665,2721.6981,2721.706567,1,81650943,81651197,254,0.6564367241652284
32666,2721.716167,2721.7361,1,81651485,81652083,598,0.7685664067476946
32667,2722.0377,2722.352367,1,81661131,81670571,9440,0.7446806921060841
32668,2722.3585,2722.362267,1,81670755,81670868,113,-0.05636634439053606
32669,2722.700433,2722.704633,1,81681012,81681138,126,0.5203446384499508
32670,2722.7063,2722.771333,1,81681189,81683139,1950,0.8145600810901169
32671,2722.775767,2722.852667,1,81683273,81685580,2307,0.7423013823953373
32672,2722.8697,2723.091567,1,81686091,81692747,6656,0.7571171849203391
32673,2723.116767,2723.120633,1,81693503,81693618,115,-0.02635968712646662
32674,2723.138133,2723.159267,1,81694143,81694778,635,0.6083060389524831
32675,2723.166133,2723.1912,1,81694983,81695736,753,0.6614029530768785
32676,2723.1951,2723.199333,1,81695853,81695979,126,0.43120781988938417
32677,2723.2013,2723.205167,1,81696039,81696155,116,0.537339418503609
32678,2723.223067,2723.247833,1,81696692,81697434,742,0.7656766338139683
32679,2723.2542,2723.347333,1,81697626,81700419,2793,0.6664790903992016
32680,2723.640633,2723.6439,1,81709218,81709317,99,0.006617200989518842
32681,2723.648533,2723.663633,1,81709455,81709908,453,0.5887035128696959
32682,2723.664667,2723.7663,1,81709940,81712989,3049,0.8236573170325651
32683,2723.7916,2723.8893,1,81713748,81716679,2931,0.8057453046446358
32684,2723.900333,2723.9071,1,81717009,81717213,204,0.8018949824722607
32685,2723.918433,2723.922967,1,81717552,81717689,137,0.4852295091973656
32686,2723.9815,2724.094933,1,81719445,81722847,3402,0.8065619825316064
32687,2724.585233,2724.5994,1,81737556,81737982,426,0.7054143875534827
32688,2724.6008,2724.620433,1,81738024,81738612,588,0.6734838343055862
32689,2724.653033,2724.665633,1,81739590,81739968,378,0.5866781714965895
32690,2724.717533,2724.722833,1,81741525,81741684,159,0.5216195742104608
32691,2724.868433,2724.873567,1,81746052,81746207,155,0.766151717010656
32692,2724.877067,2724.8919,1,81746312,81746757,445,0.712859352054691
32693,2724.935867,2724.944333,1,81748076,81748329,253,0.6658923062970309
32694,2724.9955,2725.040633,1,81749865,81751218,1353,0.095048005819125
32695,2725.0457,2725.099767,1,81751371,81752993,1622,0.6909848530216
32696,2725.100867,2725.1469,1,81753026,81754407,1381,0.6734466616188564
32697,2725.1586,2725.187033,1,81754758,81755610,852,0.6476184114878701
32698,2725.192733,2725.195767,1,81755781,81755873,92,-0.48516433233355616
32699,2725.196833,2725.218967,1,81755904,81756569,665,0.7185678502933376
32700,2725.237167,2725.269967,1,81757115,81758099,984,0.7376759387933226
32701,2725.272533,2725.291333,1,81758175,81758739,564,0.8198023105496417
32702,2725.3186,2725.3278,1,81759558,81759834,276,0.6635984353987616
32703,2725.3389,2725.351867,1,81760167,81760556,389,-0.047739841989264106
32704,2725.353467,2725.3582,1,81760604,81760746,142,-0.08098776095242143
32705,2725.657033,2725.769667,1,81769710,81773090,3380,0.8213194103277158
32706,2725.780167,2725.7855,1,81773405,81773565,160,-0.19807440385890943
32707,2725.794933,2725.843233,1,81773847,81775296,1449,0.5342516624742076
32708,2725.844667,2725.921467,1,81775340,81777644,2304,0.8285099815039232
32709,2725.932333,2725.935667,1,81777969,81778070,101,-0.11130418163434659
32710,2725.938033,2725.943167,1,81778140,81778295,155,-0.11386551962888528
32711,2725.957267,2725.9657,1,81778718,81778971,253,-0.2955724781134348
32712,2726.2084,2726.380633,1,81786252,81791418,5166,0.8572161657363361
32713,2726.385833,2726.465067,1,81791574,81793952,2378,0.8179537720498954
32714,2726.480967,2726.503767,1,81794429,81795113,684,0.7213695061714817
32715,2726.5342,2726.5497,1,81796026,81796491,465,0.043213892138590795
32716,2726.551333,2726.559767,1,81796539,81796793,254,0.37659436451644973
32717,2726.566333,2726.5703,1,81796989,81797109,120,
32718,2726.792467,2726.857367,1,81803774,81805721,1947,0.8112742163034874
32719,2726.860667,2726.9228,1,81805820,81807684,1864,0.800199243917139
32720,2726.930033,2726.980267,1,81807900,81809408,1508,0.8124631774177312
32721,2726.984133,2727.0267,1,81809523,81810801,1278,0.7288800394166752
32722,2727.027833,2727.037033,1,81810834,81811110,276,0.6073552214455151
32723,2727.0506,2727.1432,1,81811518,81814296,2778,0.8065917700940017
32724,2727.147067,2727.216633,1,81814412,81816498,2086,0.7243341076388503
32725,2727.2191,2727.303667,1,81816573,81819110,2537,0.7807081964096
32726,2727.317433,2727.3205,1,81819522,81819615,93,0.07468171403527063
32727,2727.3217,2727.325633,1,81819651,81819768,117,0.051066148982868736
32728,2727.600333,2727.680167,1,81828009,81830405,2396,0.7897558248072747
32729,2727.6864,2727.700167,1,81830592,81831005,413,0.5537094134407974
32730,2727.704333,2727.754567,1,81831129,81832637,1508,0.8063450415138987
32731,2727.774133,2727.7964,1,81833223,81833892,669,0.5369639529267782
32732,2727.807367,2727.8344,1,81834221,81835032,811,-0.04493891247572152
32733,2727.840567,2727.844767,1,81835217,81835343,126,
32734,2727.861067,2727.974933,1,81835832,81839247,3415,0.7942282659137442
32735,2727.999433,2728.004567,1,81839982,81840137,155,0.2605409119543336
32736,2728.006433,2728.010633,1,81840192,81840318,126,0.42772449887970493
32737,2728.2199,2728.222933,1,81846597,81846687,90,0.16673222862255754
32738,2728.228833,2728.354533,1,81846864,81850635,3771,0.8540406664600148
32739,2728.3721,2728.554567,1,81851163,81856637,5474,0.7407373693220372
32740,2728.574967,2728.578667,1,81857249,81857360,111,
32741,2729.233667,2729.238567,1,81877010,81877157,147,0.5764250441024957
32742,2729.718633,2729.7488,1,81891558,81892464,906,0.5550066440823541
32743,2729.7944,2729.803967,1,81893832,81894119,287,0.6896283504289161
32744,2729.952833,2729.9647,1,81898584,81898941,357,0.7033111915891296
32745,2729.968767,2729.9762,1,81899063,81899286,223,0.6035915311278792
32746,2730.025333,2730.0335,1,81900759,81901005,246,0.6965189329771508
32747,2730.172267,2730.310767,1,81905168,81909323,4155,0.7983638697832007
32748,2730.646633,2730.679867,1,81919398,81920396,998,0.7630579656944746
32749,2730.7063,2730.737133,1,81921189,81922113,924,0.7425655794350631
32750,2730.743033,2730.755633,1,81922290,81922668,378,0.8340321904222501
32751,2730.765933,2730.8045,1,81922977,81924135,1158,0.6845786867228899
32752,2730.821733,2730.869433,1,81924651,81926082,1431,0.7888908810898241
32753,2730.871633,2730.883267,1,81926148,81926498,350,0.8914874820173636
32754,2730.886733,2730.892467,1,81926601,81926774,173,0.5681364218441941
32755,2730.8936,2730.939633,1,81926808,81928188,1380,0.7330295248595706
32756,2730.949133,2730.963833,1,81928473,81928914,441,0.7851987552779643
32757,2730.965167,2730.989,1,81928955,81929670,715,0.7040095776214145
32758,2731.0027,2731.060867,1,81930081,81931826,1745,0.7354941868270385
32759,2731.0754,2731.1171,1,81932262,81933513,1251,0.789969497840779
32760,2731.1314,2731.159767,1,81933942,81934793,851,0.7914953459240303
32761,2731.1706,2731.234767,1,81935118,81937043,1925,0.6314706957930968
32762,2731.2716,2731.386433,1,81938148,81941592,3444,0.6799823156100646
32763,2731.390533,2731.395367,1,81941715,81941861,146,-0.19291853972748446
32764,2731.399,2731.4031,1,81941970,81942093,123,0.3124186066755082
32765,2731.405433,2731.409533,1,81942162,81942285,123,-0.03892916463133488
32766,2731.425333,2731.436367,1,81942759,81943091,332,0.08688231543793483
32767,2731.437833,2731.455533,1,81943134,81943665,531,0.14735737883015437
32768,2731.4569,2731.542833,1,81943707,81946284,2577,0.2065266157019225
32769,2731.543833,2731.547567,1,81946314,81946427,113,
32770,2731.624633,2731.6321,1,81948738,81948963,225,0.762088588033434
32771,2731.635867,2731.683033,1,81949076,81950490,1414,0.8130663781441739
32772,2731.6849,2731.732633,1,81950547,81951978,1431,0.8101360639132466
32773,2731.735567,2731.738967,1,81952067,81952169,102,0.7935571261114962
32774,2731.740733,2731.802967,1,81952221,81954089,1868,0.8130914747240449
32775,2731.8065,2731.8383,1,81954195,81955149,954,0.7403367395659151
32776,2731.853333,2731.886433,1,81955599,81956592,993,0.7732528504413723
32777,2731.8879,2731.891833,1,81956637,81956754,117,0.08206499824752339
32778,2731.9017,2731.9082,1,81957051,81957246,195,0.3265515927959025
32779,2731.9202,2731.931733,1,81957606,81957951,345,-0.07662694791892768
32780,2731.932767,2731.9642,1,81957983,81958926,943,0.1453366937097418
32781,2732.046867,2732.051533,1,81961406,81961545,139,0.7259935234606119
32782,2732.060833,2732.214067,1,81961824,81966422,4598,0.8556023256052578
32783,2732.248767,2732.2911,1,81967463,81968733,1270,0.7545306986931763
32784,2732.292167,2732.3568,1,81968765,81970704,1939,0.8024735325516903
32785,2732.387967,2732.3922,1,81971639,81971766,127,-0.08476000621155635
32786,2732.474567,2732.5919,1,81974237,81977757,3520,0.8282746744194558
32787,2732.6194,2732.6238,1,81978582,81978714,132,0.08328503547512973
32788,2732.633067,2732.6596,1,81978992,81979788,796,0.3374712414385368
32789,2732.6853,2732.800933,1,81980559,81984027,3468,0.7666320302718956
32790,2732.802167,2732.813533,1,81984065,81984405,340,0.6428303859436105
32791,2732.814533,2732.856867,1,81984435,81985706,1271,0.7472202398949679
32792,2732.872167,2732.966867,1,81986165,81989006,2841,0.8038621091685918
32793,2732.9712,2732.986133,1,81989136,81989583,447,0.6505259391185655
32794,2732.995467,2733.0164,1,81989864,81990492,628,0.6744585300272826
32795,2733.022167,2733.041233,1,81990665,81991236,571,0.7846531505791713
32796,2733.044367,2733.143267,1,81991331,81994298,2967,0.8008563148774748
32797,2733.148233,2733.1682,1,81994446,81995046,600,0.13393723372647415
32798,2733.180933,2733.200033,1,81995427,81996000,573,0.023135530949271725
32799,2733.2039,2733.224,1,81996117,81996720,603,0.07021374430416942
32800,2733.2252,2733.233433,1,81996756,81997002,246,0.43613084522943063
32801,2733.2701,2733.2868,1,81998103,81998604,501,0.8652937479560822
32802,2733.288133,2733.401,1,81998643,82002030,3387,0.7967308726412478
32803,2733.402033,2733.408667,1,82002060,82002260,200,0.6980587955395716
32804,2733.412467,2733.506167,1,82002374,82005185,2811,0.8026374264632214
32805,2733.509067,2733.563267,1,82005272,82006898,1626,0.796821231905192
32806,2733.662533,2733.6678,1,82009875,82010034,159,0.3143720789766487
32807,2733.674533,2733.728467,1,82010235,82011854,1619,0.5305622130031576
32808,2733.733133,2733.951467,1,82011993,82018544,6551,0.7595760151462698
32809,2733.961567,2734.006033,1,82018847,82020180,1333,0.08854928657137023
32810,2734.041067,2734.151167,1,82021232,82024535,3303,0.762294803162048
32811,2734.844433,2734.860167,1,82045332,82045805,473,0.7170726583575121
32812,2734.873433,2734.8801,1,82046202,82046403,201,0.7844378035524124
32813,2734.912,2734.9294,1,82047360,82047882,522,0.663130331056356
32814,2735.028,2735.074733,1,82050840,82052241,1401,0.7621842632795406
32815,2735.085167,2735.147133,1,82052555,82054413,1858,0.7924432638011583
32816,2735.573167,2735.5798,1,82067195,82067394,199,0.727356252124728
32817,2735.601533,2735.637667,1,82068045,82069130,1085,0.7547391693164913
32818,2735.6579,2735.661233,1,82069737,82069836,99,-0.31069726921617846
32819,2735.671267,2735.688,1,82070138,82070640,502,0.6515369621145355
32820,2735.689567,2735.6972,1,82070687,82070916,229,0.08810233134257457
32821,2735.704433,2735.7505,1,82071132,82072515,1383,0.5587779589361543
32822,2735.774033,2735.7845,1,82073220,82073535,315,0.49475486415536807
32823,2735.785833,2735.794667,1,82073574,82073840,266,0.44965330896419503
32824,2735.843267,2735.8804,1,82075298,82076412,1114,-0.018471849867592274
32825,2735.890767,2735.894433,1,82076723,82076832,109,0.7387576727448428
32826,2735.900033,2736.031533,1,82077000,82080945,3945,0.7940035780249631
32827,2736.039233,2736.0465,1,82081176,82081395,219,0.6480950244780054
32828,2736.060533,2736.133433,1,82081815,82084002,2187,0.8204511684147053
32829,2736.1429,2736.161,1,82084287,82084830,543,0.8517274059461521
32830,2736.5015,2736.5958,1,82095045,82097874,2829,0.8432903213300241
32831,2736.597667,2736.616467,1,82097930,82098494,564,0.8701408327780722
32832,2736.618333,2736.6735,1,82098549,82100205,1656,0.7878168252990649
32833,2736.681233,2736.7484,1,82100436,82102452,2016,0.7965341958971804
32834,2736.75,2736.753133,1,82102500,82102593,93,-0.1730588335649202
32835,2736.755033,2736.777867,1,82102650,82103336,686,0.8527938151738067
32836,2736.795633,2736.905567,1,82103868,82107167,3299,0.7586710193128288
32837,2736.915733,2736.9212,1,82107471,82107636,165,-0.13993825670686152
32838,2737.244333,2737.341267,1,82117329,82120238,2909,0.7747892722215138
32839,2737.346433,2737.3949,1,82120392,82121847,1455,0.7401624708396004
32840,2737.405733,2737.456467,1,82122171,82123694,1523,0.6982665950267918
32841,2737.480233,2737.512367,1,82124406,82125371,965,0.6946485202478102
32842,2737.526167,2737.572133,1,82125785,82127163,1378,0.6250789937378722
32843,2737.590233,2737.607033,1,82127706,82128210,504,0.7763235309665154
32844,2737.624667,2737.638467,1,82128740,82129154,414,0.7701467088638855
32845,2737.646433,2737.6665,1,82129392,82129995,603,0.7582218394049641
32846,2737.678733,2737.722467,1,82130361,82131674,1313,0.11575945334282427
32847,2737.7549,2737.8638,1,82132647,82135914,3267,0.8077885820783451
32848,2737.870767,2737.878767,1,82136123,82136363,240,-0.18750807921403823
32849,2737.880033,2737.889433,1,82136400,82136682,282,-0.08855167933853086
32850,2737.890567,2737.9176,1,82136717,82137528,811,0.033283748000416925
32851,2737.9336,2737.9368,1,82138008,82138104,96,-0.03692028632796507
32852,2737.939467,2738.017567,1,82138184,82140527,2343,0.821282658834228
32853,2738.021567,2738.058367,1,82140647,82141751,1104,0.8644630786210291
32854,2738.0794,2738.142367,1,82142382,82144271,1889,0.8128675949706351
32855,2738.1535,2738.200367,1,82144605,82146011,1406,0.7718288660875595
32856,2738.233767,2738.240233,1,82147013,82147206,193,0.6213038612289165
32857,2738.767233,2738.771733,1,82163016,82163151,135,0.49402704961527716
32858,2738.8702,2738.873867,1,82166106,82166216,110,0.6924979908398039
32859,2738.889267,2738.903333,1,82166678,82167099,421,0.5697905201807885
32860,2738.9165,2738.9423,1,82167495,82168269,774,0.649982333413031
32861,2738.9664,2738.9742,1,82168992,82169226,234,0.5038286360904332
32862,2738.994533,2739.0089,1,82169835,82170267,432,0.38536816092969334
32863,2739.010767,2739.017667,1,82170323,82170530,207,0.8199244254290896
32864,2739.0553,2739.059133,1,82171659,82171773,114,0.3059330050763525
32865,2739.069067,2739.082733,1,82172072,82172481,409,0.5804499073411027
32866,2739.104733,2739.1207,1,82173141,82173621,480,0.5458536713439541
32867,2739.171533,2739.1907,1,82175145,82175721,576,0.6081449001515005
32868,2739.214133,2739.2259,1,82176423,82176777,354,0.6578598238790239
32869,2739.2312,2739.237,1,82176936,82177110,174,0.6500364432304367
32870,2739.3815,2739.406033,1,82181445,82182180,735,0.837724994428573
32871,2739.408333,2739.4183,1,82182249,82182549,300,0.7810809301092372
32872,2739.4193,2739.478467,1,82182579,82184354,1775,0.7353208138083445
32873,2739.482267,2739.506033,1,82184468,82185180,712,0.8028383817451981
32874,2739.8791,2739.884233,1,82196373,82196526,153,0.782297047474826
32875,2739.885733,2739.937767,1,82196571,82198133,1562,0.7045827034259889
32876,2739.951933,2739.985467,1,82198557,82199564,1007,0.75192169731064
32877,2739.988833,2739.997167,1,82199664,82199915,251,0.4620907837987847
32878,2740.0052,2740.015433,1,82200156,82200462,306,0.625267367656025
32879,2740.046067,2740.0634,1,82201382,82201902,520,0.5426825828554022
32880,2740.064733,2740.089,1,82201941,82202670,729,0.592622359277744
32881,2740.099633,2740.157733,1,82202988,82204731,1743,0.6953911781827387
32882,2740.1683,2740.1762,1,82205049,82205286,237,0.6948382087773035
32883,2740.189133,2740.195067,1,82205673,82205852,179,0.6628008633410409
32884,2740.202967,2740.227067,1,82206089,82206812,723,0.547749976989943
32885,2740.250933,2740.257733,1,82207527,82207731,204,0.6661370217043137
32886,2740.260833,2740.271267,1,82207824,82208138,314,-0.052747590659376925
32887,2740.2739,2740.314133,1,82208217,82209423,1206,0.003848334840482891
32888,2740.315367,2740.319733,1,82209461,82209591,130,
32889,2740.3342,2740.338233,1,82210026,82210146,120,0.5222995387505843
32890,2740.3429,2740.4632,1,82210287,82213896,3609,0.8199995059249294
32891,2740.4921,2740.5909,1,82214763,82217727,2964,0.7713013137762759
32892,2741.082333,2741.0939,1,82232469,82232817,348,0.7105487184134859
32893,2741.0992,2741.1326,1,82232976,82233978,1002,0.7568356369384904
32894,2741.143233,2741.1632,1,82234296,82234896,600,0.8914090537785626
32895,2741.182467,2741.19,1,82235474,82235700,226,0.5667264990277651
32896,2741.1922,2741.239867,1,82235766,82237196,1430,0.4933806285797485
32897,2741.2476,2741.259,1,82237428,82237770,342,0.9471850421806376
32898,2741.2616,2741.339,1,82237848,82240170,2322,0.6321629746903064
32899,2741.353433,2741.3796,1,82240602,82241388,786,0.7596683678275116
32900,2741.381,2741.407267,1,82241430,82242218,788,0.7569392201807459
32901,2741.4177,2741.469933,1,82242531,82244097,1566,0.11083194211183835
32902,2741.485,2741.489267,1,82244550,82244678,128,0.7341386136540786
32903,2741.492667,2741.7464,1,82244780,82252392,7612,0.7433009858800481
32904,2742.0962,2742.123133,1,82262886,82263693,807,0.6700240211858206
32905,2742.1247,2742.1398,1,82263741,82264194,453,0.6063329413729819
32906,2742.151,2742.172033,1,82264530,82265160,630,0.704680788082077
32907,2742.173033,2742.197067,1,82265190,82265912,722,0.7363787167122623
32908,2742.2438,2742.253267,1,82267314,82267598,284,0.6333039820348401
32909,2742.2731,2742.298033,1,82268193,82268940,747,0.045580992223232614
32910,2742.301033,2742.3088,1,82269030,82269264,234,0.174398619576003
32911,2742.3131,2742.323867,1,82269393,82269716,323,0.002118640176084411
32912,2742.335433,2742.361,1,82270062,82270830,768,0.7019988037978906
32913,2742.400967,2742.424767,1,82272029,82272743,714,0.6372039334110087
32914,2742.436933,2742.486733,1,82273107,82274601,1494,0.12935021767365412
32915,2742.5017,2742.5064,1,82275051,82275192,141,0.8106533823181893
32916,2742.5169,2742.569033,1,82275507,82277070,1563,0.4679072595272521
32917,2742.570533,2742.6655,1,82277115,82279965,2850,0.6169024413000259
32918,2742.7111,2742.908067,1,82281333,82287242,5909,0.4624023457869416
32919,2742.920733,2742.947633,1,82287621,82288428,807,-0.037159049742540744
32920,2742.9489,2742.9607,1,82288467,82288821,354,-0.04636250435331055
32921,2742.962067,2742.977067,1,82288862,82289312,450,-0.00550038019702796
32922,2742.995433,2743.000367,1,82289862,82290011,149,0.6240235197511249
32923,2743.0039,2743.039367,1,82290117,82291181,1064,0.7928007891736532
32924,2743.0404,2743.282767,1,82291212,82298483,7271,0.7688213293134559
32925,2743.296267,2743.3031,1,82298888,82299093,205,-0.20530955118268399
32926,2743.3049,2743.309267,1,82299147,82299278,131,-0.08932850131519286
32927,2743.610733,2743.713167,1,82308321,82311395,3074,0.7017959063611566
32928,2743.726167,2743.737733,1,82311785,82312131,346,0.7926651482584234
32929,2743.739067,2743.764133,1,82312172,82312923,751,0.8092134248259456
32930,2743.776067,2743.787533,1,82313282,82313625,343,0.6956767960786003
32931,2743.793933,2743.8661,1,82313817,82315983,2166,0.6913690647003335
32932,2743.892967,2744.007033,1,82316789,82320210,3421,0.6235362588118993
32933,2744.0081,2744.1451,1,82320243,82324353,4110,0.7796220067882007
32934,2744.161167,2744.166767,1,82324835,82325003,168,-0.09333344493637011
32935,2744.1784,2744.183433,1,82325352,82325502,150,0.28931774801007204
32936,2744.544933,2744.5517,1,82336347,82336551,204,0.7438734744417043
32937,2744.5556,2744.559433,1,82336668,82336782,114,0.5660406844401975
32938,2744.5681,2744.639567,1,82337043,82339187,2144,0.8082628738090395
32939,2744.658267,2744.792433,1,82339748,82343772,4024,0.7640840464766618
32940,2744.797433,2744.865867,1,82343922,82345976,2054,0.7898798506149214
32941,2744.867367,2744.8708,1,82346021,82346124,103,-0.16590662618694077
32942,2744.875767,2744.920367,1,82346273,82347611,1338,0.6350602287960394
32943,2744.9349,2744.944733,1,82348047,82348341,294,-0.10470177295108307
32944,2744.9472,2744.9626,1,82348416,82348878,462,0.08621630913209008
32945,2744.964967,2744.983633,1,82348949,82349508,559,0.06731406722070075
32946,2744.999433,2745.0029,1,82349982,82350087,105,0.4745711090211937
32947,2745.0094,2745.157533,1,82350282,82354725,4443,0.8057820919084921
32948,2745.174167,2745.2251,1,82355225,82356753,1528,0.5867450445779175
32949,2745.231567,2745.237967,1,82356947,82357139,192,0.6187694246258415
32950,2745.254667,2745.515167,1,82357640,82365455,7815,0.7559759916806784
32951,2745.559267,2745.562833,1,82366778,82366884,106,-0.03969890989721463
32952,2745.566667,2745.573167,1,82367000,82367195,195,-0.1195476199504306
32953,2745.805833,2745.816433,1,82374174,82374492,318,0.5909812284461005
32954,2746.037233,2746.040833,1,82381116,82381224,108,0.7956845971986406
32955,2746.055367,2746.151833,1,82381661,82384554,2893,0.6546682255247502
32956,2746.153033,2746.181133,1,82384590,82385433,843,0.6946733641146106
32957,2746.1869,2746.2408,1,82385607,82387224,1617,0.7645801270697835
32958,2746.253733,2746.286833,1,82387611,82388604,993,0.7171577440437324
32959,2746.291633,2746.3004,1,82388748,82389012,264,0.28623160531230896
32960,2746.308367,2746.312067,1,82389251,82389362,111,0.13270251771135055
32961,2746.316,2746.3525,1,82389480,82390575,1095,-0.09653998831945174
32962,2746.3679,2746.370933,1,82391037,82391127,90,0.3261986177136822
32963,2746.374533,2746.4902,1,82391235,82394706,3471,0.5965659318657256
32964,2746.506333,2746.523033,1,82395189,82395690,501,-0.07885621040930864
32965,2746.535867,2746.661667,1,82396076,82399850,3774,0.8172123187392143
32966,2746.668433,2746.6738,1,82400052,82400214,162,-0.21416109907036043
32967,2746.755533,2746.764267,1,82402665,82402928,263,0.5594440383525339
32968,2746.7683,2746.782933,1,82403049,82403487,438,0.7364644837475929
32969,2746.783933,2746.8792,1,82403517,82406376,2859,0.8119751776672312
32970,2746.883367,2746.951267,1,82406501,82408538,2037,0.8339966215982002
32971,2746.969867,2746.989133,1,82409096,82409673,577,0.7694946539543656
32972,2746.9903,2747.0417,1,82409709,82411251,1542,0.6718409661039112
32973,2747.044467,2747.058967,1,82411334,82411769,435,0.6508880538890265
32974,2747.060933,2747.0785,1,82411827,82412355,528,0.7894874097456808
32975,2747.079667,2747.135733,1,82412390,82414071,1681,0.8245761200979826
32976,2747.147,2747.150467,1,82414410,82414514,104,
32977,2747.160833,2747.1822,1,82414824,82415466,642,-0.06021681342450274
32978,2747.184133,2747.1894,1,82415523,82415682,159,
32979,2747.190767,2747.21,1,82415723,82416300,577,0.2160449172633425
32980,2747.233433,2747.321567,1,82417002,82419647,2645,0.7200136938012156
32981,2747.3232,2747.3407,1,82419696,82420221,525,0.8388743233929509
32982,2747.3627,2747.373667,1,82420881,82421210,329,-0.14492549440616675
32983,2747.376,2747.3895,1,82421280,82421685,405,0.10456852951306692
32984,2747.402267,2747.570233,1,82422068,82427106,5038,0.8438382953375585
32985,2747.583367,2747.618767,1,82427501,82428563,1062,0.03594806342123422
32986,2747.620267,2747.6433,1,82428608,82429299,691,0.10808747970355724
32987,2747.6664,2747.803433,1,82429992,82434102,4110,0.7835594219380693
32988,2747.809833,2747.826567,1,82434294,82434797,503,-0.022687213895649646
32989,2747.883467,2747.905733,1,82436504,82437171,667,0.6235092803361844
32990,2747.922567,2747.937733,1,82437677,82438131,454,0.5884684738963737
32991,2747.940333,2748.000133,1,82438209,82440003,1794,0.807508399167032
32992,2748.022533,2748.027933,1,82440675,82440837,162,-0.04447863846947056
32993,2748.418067,2748.448733,1,82452542,82453461,919,0.534073941276187
32994,2748.451067,2748.4563,1,82453532,82453689,157,0.28252846769717893
32995,2748.475433,2748.493367,1,82454262,82454801,539,0.5704410292879295
32996,2748.5879,2748.594167,1,82457637,82457825,188,-0.14294719115959684
32997,2748.750233,2748.852467,1,82462506,82465574,3068,0.7982775245428945
32998,2748.855967,2748.859067,1,82465679,82465772,93,0.1979019914608688
32999,2749.2945,2749.3053,1,82478835,82479159,324,0.5734229221206254
33000,2749.313333,2749.322733,1,82479399,82479681,282,0.6274106983613693
33001,2749.3243,2749.330567,1,82479729,82479917,188,0.7613182197791568
33002,2749.362167,2749.384533,1,82480865,82481535,670,0.7684523894070705
33003,2749.400633,2749.404467,1,82482018,82482134,116,0.03561395683470612
33004,2749.413433,2749.4593,1,82482402,82483779,1377,0.2133915125895632
33005,2749.488167,2749.498,1,82484645,82484940,295,0.6472849634575923
33006,2749.5055,2749.508633,1,82485165,82485258,93,-0.2100752384847249
33007,2749.5181,2749.561833,1,82485543,82486854,1311,0.5582960356520439
33008,2749.583633,2749.605933,1,82487508,82488177,669,0.663823898475879
33009,2749.637467,2749.661333,1,82489124,82489839,715,-0.012494069100958398
33010,2749.667767,2749.683467,1,82490033,82490504,471,-0.027823722093248182
33011,2749.7098,2749.8142,1,82491294,82494426,3132,0.7419158709071347
33012,2749.831133,2749.834633,1,82494933,82495038,105,0.024342360531660345
33013,2749.8361,2749.853933,1,82495083,82495617,534,-0.10179828263307113
33014,2749.8673,2749.978033,1,82496019,82499340,3321,0.8531478728570016
33015,2750.019833,2750.1026,1,82500594,82503078,2484,0.7926508219531225
33016,2750.143533,2750.148833,1,82504305,82504464,159,0.31219365961743323
33017,2751.145433,2751.148667,1,82534362,82534460,98,0.7230313580962526
33018,2751.350233,2751.357967,1,82540506,82540739,233,0.6646803480339303
33019,2751.3659,2751.369167,1,82540977,82541075,98,-0.26401690012035234
33020,2751.402633,2751.4183,1,82542078,82542549,471,0.6198838895349197
33021,2751.461667,2751.4667,1,82543850,82544001,151,0.30707459993678554
33022,2751.471033,2751.497467,1,82544130,82544924,794,0.5495508613523029
33023,2751.507533,2751.526667,1,82545225,82545800,575,0.5217017541202185
33024,2751.569933,2751.5891,1,82547097,82547673,576,0.5891853617762622
33025,2751.610933,2751.6221,1,82548327,82548663,336,0.5078366721428001
33026,2751.626433,2751.637367,1,82548792,82549121,329,0.5108209541844829
33027,2751.677867,2751.717367,1,82550336,82551521,1185,-0.12823033473761103
33028,2751.720267,2751.733133,1,82551608,82551993,385,-0.4751436959841048
33029,2751.7595,2751.9161,1,82552785,82557483,4698,0.8025592155176914
33030,2751.9203,2751.9233,1,82557609,82557699,90,0.45792618277741515
33031,2751.9247,2752.0073,1,82557741,82560219,2478,0.8089904656547932
33032,2752.026133,2752.029467,1,82560783,82560884,101,-0.10452477961211092
33033,2752.213267,2752.2358,1,82566398,82567074,676,0.7408378846256233
33034,2752.237433,2752.271833,1,82567122,82568154,1032,0.7839322869565195
33035,2752.273667,2752.278067,1,82568210,82568342,132,0.1929718659387137
33036,2752.2816,2752.319033,1,82568448,82569570,1122,0.7009703546508228
33037,2752.325133,2752.331533,1,82569753,82569945,192,0.07240891145796424
33038,2752.338633,2752.3417,1,82570158,82570251,93,
33039,2752.343033,2752.348967,1,82570290,82570469,179,-0.07048194842056316
33040,2752.350067,2752.3891,1,82570502,82571673,1171,0.13350622177323632
33041,2752.4103,2752.578233,1,82572309,82577346,5037,0.8207669907905947
33042,2752.594533,2752.6107,1,82577835,82578321,486,-0.02236644986964981
33043,2752.6117,2752.6226,1,82578351,82578678,327,-0.09611396174661771
33044,2752.647333,2752.650467,1,82579419,82579514,95,
33045,2752.8211,2752.8254,1,82584633,82584762,129,0.1571327416287319
33046,2752.833567,2752.867533,1,82585007,82586025,1018,0.5212536786014036
33047,2753.078033,2753.307533,1,82592340,82599225,6885,0.7947394592421717
33048,2753.3194,2753.322667,1,82599582,82599680,98,
33049,2753.3257,2753.3313,1,82599771,82599939,168,0.0646043635782283
33050,2753.8391,2753.876767,1,82615173,82616303,1130,0.6355817989166481
33051,2753.897333,2753.915,1,82616919,82617450,531,0.43784150086030166
33052,2753.945733,2753.950967,1,82618371,82618529,158,0.030269662596369522
33053,2753.969,2753.9818,1,82619070,82619454,384,0.3104624373530025
33054,2754.101467,2754.116233,1,82623044,82623486,442,0.9068809204605471
33055,2754.1174,2754.1459,1,82623522,82624377,855,0.5868825730306527
33056,2754.147533,2754.17,1,82624425,82625100,675,0.6514709367633517
33057,2754.186067,2754.208867,1,82625582,82626266,684,0.7064941601657465
33058,2754.236167,2754.266533,1,82627085,82627995,910,0.742087102340104
33059,2754.284467,2754.370867,1,82628534,82631126,2592,0.5896123919935623
33060,2754.372133,2754.389267,1,82631163,82631678,515,0.6507286387996742
33061,2754.398367,2754.491,1,82631951,82634730,2779,0.7872184778845335
33062,2754.510067,2754.516833,1,82635302,82635504,202,-0.04924252348999123
33063,2754.525033,2754.532667,1,82635750,82635980,230,0.13200169589283217
33064,2754.537233,2754.542967,1,82636116,82636289,173,0.4724196374918806
33065,2754.5836,2754.589733,1,82637508,82637691,183,0.24202303074987938
33066,2754.591133,2754.597433,1,82637733,82637922,189,0.361834805782867
33067,2754.598567,2754.6031,1,82637957,82638093,136,0.19823298363180317
33068,2754.605733,2754.642233,1,82638171,82639266,1095,0.8249664404230067
33069,2754.649333,2754.692433,1,82639479,82640772,1293,0.6399099402472371
33070,2755.383433,2755.393167,1,82661502,82661795,293,-0.06139722940436191
33071,2755.419367,2755.477933,1,82662581,82664337,1756,0.7638348811616269
33072,2755.492933,2755.531167,1,82664787,82665935,1148,0.7436810652611182
33073,2755.555233,2755.563967,1,82666656,82666919,263,0.7590348321684899
33074,2755.567333,2755.594067,1,82667019,82667822,803,0.7276023209394014
33075,2755.6066,2755.6119,1,82668198,82668357,159,0.7285059767126834
33076,2755.632567,2755.642833,1,82668977,82669284,307,0.05793417579888371
33077,2755.653467,2755.656733,1,82669604,82669701,97,
33078,2755.662133,2755.667367,1,82669863,82670021,158,-0.12214379005969504
33079,2755.668933,2755.678533,1,82670067,82670355,288,0.08613391314647778
33080,2755.679533,2755.690833,1,82670385,82670724,339,-0.10347736231110252
33081,2755.694,2755.701867,1,82670820,82671056,236,0.27149023883096857
33082,2755.7969,2755.864,1,82673907,82675920,2013,0.7873506257266636
33083,2755.870533,2755.923833,1,82676115,82677714,1599,0.8295728418921618
33084,2755.937367,2755.9414,1,82678121,82678242,121,
33085,2755.942667,2755.9457,1,82678280,82678371,91,
33086,2755.947133,2755.978933,1,82678413,82679367,954,0.0717176920994189
33087,2756.152233,2756.158233,1,82684566,82684746,180,-0.016424195217426614
33088,2756.163467,2756.309767,1,82684904,82689293,4389,0.822674604516376
33089,2756.3267,2756.347333,1,82689801,82690419,618,0.7677624451189402
33090,2756.3492,2756.380833,1,82690476,82691424,948,0.565656280304594
33091,2756.410533,2756.490667,1,82692315,82694720,2405,0.8050855111894905
33092,2756.510633,2756.5958,1,82695318,82697874,2556,0.7795784116600362
33093,2756.620767,2756.6244,1,82698623,82698732,109,0.19358481181758058
33094,2757.2403,2757.254833,1,82717209,82717644,435,0.49702720487863994
33095,2757.2621,2757.2815,1,82717863,82718445,582,0.5433417434062382
33096,2757.316767,2757.343333,1,82719503,82720299,796,0.8948422586231128
33097,2757.351567,2757.355367,1,82720547,82720661,114,0.18285119086240437
33098,2757.3699,2757.411333,1,82721097,82722339,1242,0.5792492104534562
33099,2757.448667,2757.464567,1,82723460,82723937,477,0.8129915078868418
33100,2757.473033,2757.5151,1,82724190,82725453,1263,0.7454757324308114
33101,2757.522633,2757.528433,1,82725678,82725852,174,0.4155062781907191
33102,2757.538967,2757.5573,1,82726169,82726719,550,0.7562153002735755
33103,2757.564333,2757.570033,1,82726929,82727100,171,0.36184248311885747
33104,2757.585167,2757.590567,1,82727555,82727717,162,0.025105707228201275
33105,2757.6111,2757.615267,1,82728333,82728458,125,-0.03242783112666006
33106,2757.618,2757.625433,1,82728540,82728762,222,-0.07051436551840022
33107,2757.629433,2757.651,1,82728882,82729530,648,0.026720671049143545
33108,2757.670467,2757.8074,1,82730114,82734222,4108,0.793473954419215
33109,2757.812233,2757.920833,1,82734366,82737624,3258,0.7773041860171048
33110,2757.9227,2757.934433,1,82737681,82738032,351,0.5099283671587722
33111,2757.957467,2757.9726,1,82738724,82739178,454,0.04624385761117803
33112,2758.183767,2758.1919,1,82745513,82745757,244,0.3848499529259835
33113,2758.194033,2758.212833,1,82745820,82746384,564,0.8024764262668639
33114,2758.2139,2758.251267,1,82746417,82747538,1121,0.8426387418057829
33115,2758.261033,2758.310733,1,82747830,82749321,1491,0.7765810413379508
33116,2758.317533,2758.324867,1,82749525,82749746,221,-0.023716623320072124
33117,2758.329233,2758.341367,1,82749876,82750241,365,0.06619617103608254
33118,2758.350133,2758.359433,1,82750503,82750782,279,0.6721442042954028
33119,2758.362267,2758.374967,1,82750868,82751249,381,0.12451282203297176
33120,2758.4102,2758.414767,1,82752306,82752443,137,-0.2401214713957038
33121,2758.4169,2758.703333,1,82752507,82761099,8592,0.7528819033530983
33122,2758.704967,2758.7179,1,82761149,82761537,388,0.47504051964212496
33123,2758.720833,2758.725,1,82761624,82761750,126,
33124,2758.727333,2758.730367,1,82761819,82761911,92,0.0019824976082780843
33125,2758.737867,2758.740933,1,82762136,82762227,91,
33126,2759.185867,2759.194167,1,82775576,82775825,249,0.7106943604576336
33127,2759.1959,2759.210167,1,82775877,82776305,428,0.40302202352355043
33128,2759.227667,2759.2782,1,82776830,82778346,1516,0.7522303608743718
33129,2759.2973,2759.3652,1,82778919,82780956,2037,0.7349074583023061
33130,2759.369,2759.446067,1,82781070,82783382,2312,0.7167537814314577
33131,2759.447633,2759.468933,1,82783428,82784067,639,0.4380265210295302
33132,2759.490367,2759.498067,1,82784711,82784942,231,0.023356306652405078
33133,2759.503967,2759.515967,1,82785119,82785479,360,0.09014904393536789
33134,2759.521733,2759.543433,1,82785651,82786302,651,0.2018333123392867
33135,2759.565467,2759.581767,1,82786964,82787453,489,0.614487409504832
33136,2759.5833,2759.625067,1,82787499,82788752,1253,0.8282863466359704
33137,2759.631367,2759.6395,1,82788941,82789185,244,0.8526346779886915
33138,2759.641033,2759.6695,1,82789230,82790085,855,0.8529488260767679
33139,2759.6893,2759.7047,1,82790679,82791141,462,-0.06294037491067292
33140,2759.708233,2759.716633,1,82791246,82791498,252,0.1878072747795709
33141,2759.735033,2759.880067,1,82792050,82796402,4352,0.7910732105802593
33142,2759.881567,2759.888433,1,82796447,82796652,205,0.4135520819164158
33143,2759.906067,2759.909833,1,82797182,82797294,112,0.03922713683634814
33144,2759.917633,2759.9291,1,82797528,82797873,345,0.09539691266516137
33145,2759.933067,2759.939067,1,82797992,82798172,180,0.0853736666890908
33146,2759.948033,2759.9539,1,82798440,82798617,177,-0.059581537635808736
33147,2759.9739,2760.075033,1,82799217,82802250,3033,0.7953530075500506
33148,2760.542233,2760.569867,1,82816266,82817096,830,0.6575078031738422
33149,2760.5723,2760.5828,1,82817169,82817484,315,0.6533962169886972
33150,2760.594867,2760.618267,1,82817846,82818548,702,0.6076027406081113
33151,2760.624633,2760.629433,1,82818738,82818882,144,0.403637482708763
33152,2760.648967,2760.656767,1,82819469,82819703,234,0.6874994605063042
33153,2760.695,2760.708733,1,82820850,82821261,411,0.02980006356735203
33154,2760.7126,2760.716167,1,82821378,82821485,107,
33155,2760.731333,2760.735267,1,82821939,82822058,119,-0.09768630984809727
33156,2760.7366,2760.742467,1,82822098,82822274,176,-0.010065255715849425
33157,2760.7438,2760.753033,1,82822314,82822590,276,-0.15428579069466372
33158,2760.872033,2761.050033,1,82826160,82831500,5340,0.8123115258484028
33159,2761.085233,2761.227767,1,82832556,82836833,4277,0.8014043968407185
33160,2761.252167,2761.2592,1,82837565,82837776,211,-0.15410727976181776
33161,2761.489733,2761.494667,1,82844691,82844840,149,0.6509972536051154
33162,2761.495933,2761.502467,1,82844877,82845074,197,-0.03622898826326236
33163,2761.508633,2761.524733,1,82845258,82845741,483,0.6871822046917823
33164,2761.5358,2761.539,1,82846074,82846170,96,-0.05344060728228851
33165,2761.545567,2761.552933,1,82846367,82846587,220,0.596509293049184
33166,2761.7667,2761.8784,1,82853001,82856352,3351,0.6693587253839085
33167,2761.893667,2761.907367,1,82856810,82857221,411,0.02171799765611617
33168,2761.910267,2761.920867,1,82857308,82857626,318,-0.09864337807805365
33169,2761.926467,2761.933767,1,82857794,82858013,219,0.022078985698972455
33170,2762.135667,2762.142667,1,82864070,82864280,210,-0.06337783214365261
33171,2762.150367,2762.243467,1,82864511,82867304,2793,0.7984666773804447
33172,2762.258033,2762.263333,1,82867740,82867899,159,0.027745985199032822
33173,2762.870933,2762.882033,1,82886127,82886460,333,0.7330226780932211
33174,2762.889067,2762.892167,1,82886672,82886765,93,0.5445312154490711
33175,2762.900067,2762.9048,1,82887002,82887144,142,0.5756773582712822
33176,2762.933333,2762.9475,1,82887999,82888425,426,0.6585094862502636
33177,2762.9566,2762.9604,1,82888698,82888812,114,0.624900748438875
33178,2762.983267,2762.993167,1,82889498,82889795,297,0.7440890271595547
33179,2763.000167,2763.006733,1,82890005,82890201,196,0.30987880739547113
33180,2763.0589,2763.071867,1,82891767,82892156,389,0.24519847711621431
33181,2763.0948,2763.1109,1,82892844,82893327,483,0.4620752846032422
33182,2763.118133,2763.133767,1,82893543,82894013,470,0.7377253518836085
33183,2763.158233,2763.179033,1,82894746,82895370,624,0.7106904283618284
33184,2763.200967,2763.210867,1,82896029,82896326,297,0.6132300065646661
33185,2763.218333,2763.225,1,82896549,82896750,201,0.5543267423386656
33186,2763.237767,2763.241233,1,82897133,82897236,103,-0.013014131774183296
33187,2763.244767,2763.249733,1,82897343,82897491,148,-0.02861593673951908
33188,2763.250967,2763.258133,1,82897529,82897743,214,0.4289603319129318
33189,2763.270133,2763.2763,1,82898103,82898289,186,-0.10136551839288398
33190,2763.278067,2763.3123,1,82898342,82899369,1027,-0.011414230919764927
33191,2763.350933,2763.361,1,82900527,82900830,303,0.20364975226279794
33192,2763.362133,2763.377633,1,82900863,82901328,465,0.14617757941102752
33193,2763.378933,2763.4739,1,82901367,82904217,2850,0.49235363486299355
33194,2763.492267,2763.498533,1,82904768,82904955,187,-0.0012645920351559098
33195,2763.514567,2763.638533,1,82905437,82909155,3718,0.8673631662664474
33196,2763.906033,2763.934933,1,82917180,82918047,867,0.6797966819996524
33197,2764.504367,2764.5113,1,82935131,82935339,208,0.7414835902042389
33198,2764.512733,2764.5334,1,82935381,82936002,621,0.5554950469674302
33199,2764.5622,2764.581867,1,82936866,82937456,590,0.6575198261498588
33200,2764.6356,2764.6425,1,82939068,82939275,207,0.45843890263354425
33201,2764.675233,2764.775133,1,82940256,82943253,2997,0.7414252671856439
33202,2764.7836,2764.788667,1,82943508,82943660,152,-0.09708091151972739
33203,2765.301433,2765.315467,1,82959042,82959464,422,0.6073934920524119
33204,2765.325833,2765.339967,1,82959774,82960199,425,0.17521404078797073
33205,2765.3732,2765.402933,1,82961196,82962087,891,0.720959076614285
33206,2765.4121,2765.415633,1,82962363,82962468,105,0.0983674434525545
33207,2765.473567,2765.4823,1,82964207,82964469,262,0.7079579553964737
33208,2765.4835,2765.488567,1,82964505,82964657,152,0.5147368546708938
33209,2765.521333,2765.537967,1,82965639,82966139,500,0.6292829596818775
33210,2765.5461,2765.565767,1,82966383,82966973,590,0.8016835110022364
33211,2765.5973,2765.610667,1,82967919,82968320,401,0.6053717734584729
33212,2765.633533,2765.660233,1,82969005,82969806,801,0.6598291885498562
33213,2765.6963,2765.744633,1,82970889,82972338,1449,-0.0704075354773328
33214,2765.7719,2765.784633,1,82973157,82973538,381,0.39246569592858727
33215,2765.7865,2765.822167,1,82973595,82974665,1070,0.5702677946143994
33216,2765.823267,2765.872833,1,82974698,82976184,1486,0.8271053747514853
33217,2765.8898,2765.894167,1,82976694,82976825,131,-0.03810203361629413
33218,2765.8954,2765.9088,1,82976862,82977264,402,-0.13384961301117743
33219,2765.9236,2765.9293,1,82977708,82977879,171,-0.1813070340820886
33220,2765.962667,2766.032433,1,82978880,82980972,2092,0.3991860349605838
33221,2766.041267,2766.052067,1,82981238,82981562,324,0.22245020907743285
33222,2766.114033,2766.262733,1,82983420,82987881,4461,0.8007110096363421
33223,2766.277433,2766.291333,1,82988322,82988739,417,0.8771541488882059
33224,2766.295567,2766.327633,1,82988867,82989828,961,0.8397820750539291
33225,2766.3553,2766.379,1,82990659,82991370,711,0.7405537090448834
33226,2766.396567,2766.5054,1,82991897,82995162,3265,0.776997353241381
33227,2766.6021,2766.615433,1,82998063,82998462,399,0.6359099675901733
33228,2766.6184,2766.652933,1,82998552,82999587,1035,0.7574631023409756
33229,2766.654067,2766.7034,1,82999622,83001102,1480,0.7285612062272144
33230,2766.7138,2766.7703,1,83001414,83003109,1695,0.8390157084606725
33231,2766.771567,2766.832033,1,83003147,83004960,1813,0.8261764247075519
33232,2766.834833,2767.092033,1,83005044,83012760,7716,0.6916607263949136
33233,2767.097733,2767.2096,1,83012931,83016288,3357,0.6755496094093338
33234,2767.211933,2767.237933,1,83016357,83017137,780,0.8142419351630341
33235,2767.240633,2767.317833,1,83017218,83019534,2316,0.7947739324412574
33236,2767.320167,2767.360967,1,83019605,83020829,1224,0.7555276547211475
33237,2767.364333,2767.417967,1,83020929,83022539,1610,0.7807874168119725
33238,2767.4265,2767.452633,1,83022795,83023578,783,0.7209763082404482
33239,2767.465467,2767.470167,1,83023964,83024105,141,0.9628958723520823
33240,2767.484567,2767.541533,1,83024537,83026245,1708,0.6704872706542284
33241,2767.557,2767.575433,1,83026710,83027262,552,0.6912875050756015
33242,2767.580467,2767.5983,1,83027414,83027949,535,0.3469593981115524
33243,2767.610167,2767.688267,1,83028305,83030648,2343,0.7735224255129453
33244,2767.6904,2767.704433,1,83030712,83031132,420,0.8004288357787739
33245,2767.706467,2767.7344,1,83031194,83032032,838,0.7726122213105057
33246,2767.736533,2767.814133,1,83032095,83034423,2328,0.788721198745643
33247,2767.8175,2767.8592,1,83034525,83035776,1251,0.669842742051307
33248,2767.8631,2767.957867,1,83035893,83038736,2843,0.8166158178459098
33249,2767.9598,2767.975433,1,83038794,83039262,468,0.7915296708464491
33250,2767.988833,2767.995733,1,83039664,83039871,207,0.6685784682060524
33251,2767.997067,2768.076733,1,83039912,83042301,2389,0.8248175787947057
33252,2768.092167,2768.099767,1,83042765,83042993,228,0.027224488648937145
33253,2768.356433,2768.381233,1,83050692,83051436,744,0.554091087495317
33254,2768.4175,2768.485633,1,83052525,83054568,2043,0.7374708544191876
33255,2768.488733,2768.495067,1,83054661,83054852,191,0.3794001114428812
33256,2768.4966,2768.5073,1,83054898,83055219,321,-0.10974910763714997
33257,2768.717767,2768.788967,1,83061533,83063669,2136,0.7576175110430269
33258,2768.7907,2768.939267,1,83063721,83068178,4457,0.798992417314874
33259,2768.954833,2768.9774,1,83068644,83069322,678,0.4644643350434478
33260,2768.9809,2768.993367,1,83069427,83069801,374,0.306731584803759
33261,2768.996233,2769.0,1,83069886,83070000,114,0.09868819355030387
33262,2769.010433,2769.049233,1,83070312,83071476,1164,0.08448465001095158
33263,2769.0503,2769.1937,1,83071509,83075811,4302,0.8351369095535084
33264,2769.217267,2769.286067,1,83076518,83078582,2064,0.625576177537002
33265,2769.290733,2769.406533,1,83078721,83082195,3474,0.8090402931375706
33266,2769.415033,2769.4202,1,83082450,83082606,156,0.3185013800333615
33267,2769.507033,2769.711367,1,83085210,83091341,6131,0.776021701744587
33268,2769.731167,2769.822133,1,83091935,83094663,2728,0.7879347050145351
33269,2769.826467,2769.842633,1,83094794,83095278,484,0.12281302592596308
33270,2769.845,2769.8578,1,83095350,83095734,384,-0.014110511096415394
33271,2769.8589,2769.879167,1,83095767,83096375,608,-0.25276090888180125
33272,2769.901067,2769.929733,1,83097032,83097891,859,0.3720277350703539
33273,2769.9319,2770.020633,1,83097957,83100618,2661,0.7844886966292394
33274,2770.0331,2770.0551,1,83100993,83101653,660,-0.07279934078447557
33275,2770.0585,2770.076533,1,83101755,83102295,540,0.1609331818688042
33276,2770.078233,2770.081467,1,83102346,83102444,98,0.10090993844391455
33277,2770.082733,2770.0906,1,83102481,83102718,237,0.49267783598599846
33278,2770.464133,2770.539667,1,83113923,83116190,2267,0.4586112861134542
33279,2770.5412,2770.564633,1,83116236,83116938,702,0.5613132471048418
33280,2770.5941,2770.6059,1,83117823,83118177,354,0.6646474209861195
33281,2770.634967,2770.664033,1,83119049,83119920,871,0.560547815000033
33282,2770.692733,2770.7,1,83120781,83121000,219,0.49039741875591225
33283,2770.703167,2770.725067,1,83121095,83121752,657,0.5120341702281114
33284,2770.739967,2770.760967,1,83122199,83122829,630,0.43468071060536145
33285,2770.805367,2770.820833,1,83124161,83124624,463,0.6094216529318619
33286,2770.844967,2770.849767,1,83125349,83125493,144,0.7325124534316068
33287,2770.8584,2770.879,1,83125752,83126370,618,0.7303169206544255
33288,2770.9334,2770.953333,1,83128002,83128599,597,0.010964991645937566
33289,2770.980067,2770.9836,1,83129402,83129508,106,0.2511440257245958
33290,2770.988733,2771.117633,1,83129661,83133528,3867,0.8110433764958036
33291,2771.140067,2771.1459,1,83134202,83134377,175,0.13450003610989328
33292,2771.1469,2771.158133,1,83134407,83134743,336,-0.033646094711154345
33293,2771.160233,2771.1659,1,83134806,83134977,171,-0.08187064660702001
33294,2771.174467,2771.3,1,83135234,83139000,3766,0.7920533259376986
33295,2771.301833,2771.305667,1,83139054,83139170,116,0.3962250051118659
33296,2771.309933,2771.316333,1,83139297,83139489,192,0.12805475966618116
33297,2771.319567,2771.326767,1,83139587,83139803,216,0.18063450066871156
33298,2771.384567,2771.387767,1,83141537,83141633,96,
33299,2771.395,2771.428867,1,83141850,83142866,1016,0.7974915040354423
33300,2771.4311,2771.467867,1,83142933,83144036,1103,0.6111039152308625
33301,2771.469467,2771.542033,1,83144084,83146260,2176,0.5877981467916528
33302,2771.543933,2771.6265,1,83146317,83148795,2478,0.7964736932335993
33303,2771.643133,2771.649133,1,83149293,83149473,180,-0.10045311723842779
33304,2771.651033,2771.665633,1,83149530,83149968,438,-0.02447678475270866
33305,2771.675367,2771.6811,1,83150261,83150433,172,0.2651032151591609
33306,2772.005333,2772.050833,1,83160159,83161524,1365,0.7663459437707543
33307,2772.060533,2772.080367,1,83161815,83162411,596,0.5623455919846027
33308,2772.0878,2772.098067,1,83162634,83162942,308,0.40490562177791306
33309,2772.135667,2772.147233,1,83164070,83164416,346,0.5280488436225153
33310,2772.1505,2772.173633,1,83164515,83165208,693,0.6327452606524951
33311,2772.1902,2772.208367,1,83165706,83166251,545,0.564196402318614
33312,2772.218433,2772.227167,1,83166552,83166815,263,-0.054655181215919245
33313,2772.245433,2772.252967,1,83167362,83167589,227,0.6218104972781995
33314,2772.2542,2772.2657,1,83167626,83167971,345,0.6347693603015296
33315,2772.2673,2772.2887,1,83168019,83168661,642,0.6593206940413706
33316,2772.301733,2772.3111,1,83169051,83169333,282,0.5716006034585649
33317,2772.3476,2772.369033,1,83170428,83171070,642,0.003492108209068557
33318,2772.3702,2772.390867,1,83171106,83171726,620,0.31075239946986627
33319,2772.392033,2772.399067,1,83171760,83171972,212,0.6913021807701134
33320,2772.416933,2772.4216,1,83172507,83172648,141,0.5252609090309195
33321,2772.4273,2772.648633,1,83172819,83179458,6639,0.7633463818208502
33322,2772.667467,2772.673,1,83180024,83180190,166,-0.0020030638689416827
33323,2772.6751,2772.6795,1,83180253,83180385,132,-0.17209183683041532
33324,2772.6873,2772.692,1,83180619,83180760,141,0.0616200367270206
33325,2772.693633,2772.696733,1,83180808,83180901,93,
33326,2772.727567,2772.8178,1,83181827,83184534,2707,0.7647361198866748
33327,2772.895833,2772.896933,1,83186874,83186907,33,
33328,2772.9114,2772.922833,1,83187342,83187684,342,0.8715985449113237
33329,2772.924567,2773.094467,1,83187737,83192834,5097,0.80848710795802
33330,2773.0997,2773.1164,1,83192991,83193492,501,0.8798785895187204
33331,2773.124767,2773.1648,1,83193743,83194944,1201,-0.004387413121965097
33332,2773.165933,2773.180567,1,83194977,83195417,440,0.13775179884006336
33333,2773.201067,2773.207333,1,83196032,83196219,187,0.689207740632549
33334,2773.2084,2773.226567,1,83196252,83196797,545,0.7745475414664584
33335,2773.227567,2773.269967,1,83196827,83198099,1272,0.85531173051504
33336,2773.271033,2773.361733,1,83198130,83200851,2721,0.7771939060671303
33337,2773.368067,2773.385833,1,83201042,83201574,532,0.8713155114808324
33338,2773.393767,2773.467767,1,83201813,83204033,2220,0.8290154591387928
33339,2773.481033,2773.525567,1,83204430,83205767,1337,0.11575601469026815
33340,2773.5267,2773.541967,1,83205801,83206259,458,-0.04510265315199141
33341,2773.544833,2773.553733,1,83206344,83206611,267,0.2819230647692134
33342,2773.557133,2773.6641,1,83206713,83209923,3210,0.736504293093727
33343,2773.676767,2773.7062,1,83210303,83211186,883,-0.027279820851600106
33344,2773.718467,2773.8313,1,83211554,83214939,3385,0.8015138538144593
33345,2773.9229,2773.934367,1,83217687,83218031,344,0.19076493231475755
33346,2773.942367,2774.009033,1,83218271,83220270,1999,0.7737182373963878
33347,2774.010433,2774.129067,1,83220312,83223872,3560,0.7870899445445599
33348,2774.134033,2774.210767,1,83224020,83226323,2303,0.7941974874612822
33349,2774.213367,2774.217367,1,83226401,83226521,120,-0.2505212600618732
33350,2774.241633,2774.309567,1,83227248,83229287,2039,0.5358931522230768
33351,2774.310833,2774.315833,1,83229324,83229474,150,0.18532145447336204
33352,2774.323533,2774.516333,1,83229705,83235489,5784,0.47258937683437235
33353,2774.543433,2774.745767,1,83236302,83242373,6071,0.8072639610948432
33354,2774.7492,2774.755967,1,83242476,83242679,203,0.7703113760787013
33355,2774.7587,2774.7704,1,83242761,83243112,351,0.5804534092346654
33356,2774.7815,2774.8248,1,83243445,83244744,1299,0.07542731291010683
33357,2774.825933,2774.839233,1,83244777,83245176,399,0.1362642293324818
33358,2774.864133,2774.9453,1,83245923,83248359,2436,0.7968563168695594
33359,2774.946433,2774.962333,1,83248392,83248869,477,0.7698220248412407
33360,2774.965733,2774.9978,1,83248971,83249934,963,0.764503244419965
33361,2775.003633,2775.011933,1,83250108,83250357,249,0.4249830731788303
33362,2775.018967,2775.0448,1,83250569,83251344,775,0.5024539495642827
33363,2775.045867,2775.051767,1,83251376,83251553,177,0.28196445469688036
33364,2775.053,2775.165633,1,83251590,83254968,3378,0.7586172374366413
33365,2775.172333,2775.191167,1,83255169,83255735,566,0.012789821550993235
33366,2775.193533,2775.267667,1,83255805,83258030,2225,0.6723987773998967
33367,2775.2749,2775.293033,1,83258247,83258790,543,0.6974430378268653
33368,2775.2944,2775.3892,1,83258832,83261676,2844,0.8119549328500423
33369,2775.390233,2775.3951,1,83261706,83261853,147,0.5803659056054794
33370,2775.411933,2775.459633,1,83262357,83263788,1431,0.02275454563609116
33371,2775.461533,2775.465667,1,83263845,83263970,125,0.32585875727180685
33372,2775.467367,2775.626,1,83264021,83268780,4759,0.8413243977843452
33373,2775.6443,2775.7592,1,83269329,83272776,3447,0.8184328892096371
33374,2775.777933,2775.787233,1,83273337,83273616,279,0.11743316713947642
33375,2775.8598,2775.888567,1,83275794,83276657,863,0.684261294264578
33376,2775.92,2776.0373,1,83277600,83281119,3519,0.7768143921733963
33377,2776.039667,2776.136467,1,83281190,83284094,2904,0.7695135557774844
33378,2776.149367,2776.1827,1,83284481,83285481,1000,0.11139795746539766
33379,2776.183867,2776.197633,1,83285516,83285928,412,0.19220440373575315
33380,2776.198633,2776.2031,1,83285958,83286093,135,
33381,2776.221867,2776.228833,1,83286656,83286864,208,0.0171542015220804
33382,2776.2321,2776.446033,1,83286963,83293380,6417,0.8393248026677708
33383,2777.678433,2777.6844,1,83330352,83330532,180,0.3995686414235156
33384,2778.248433,2778.2602,1,83347452,83347806,354,0.5306853697499332
33385,2778.264967,2778.279033,1,83347949,83348370,421,0.5881082978878428
33386,2778.280067,2778.287133,1,83348402,83348613,211,0.6624494009458105
33387,2778.299933,2778.318767,1,83348997,83349563,566,0.5085224643212662
33388,2778.3436,2778.351567,1,83350308,83350547,239,0.8235790790530864
33389,2778.372733,2778.431767,1,83351181,83352953,1772,0.5970319630067907
33390,2778.448333,2778.464833,1,83353449,83353944,495,0.7356521256776057
33391,2778.483367,2778.502533,1,83354501,83355075,574,0.7650139566060432
33392,2778.503733,2778.5203,1,83355111,83355609,498,0.5824875283652681
33393,2778.525033,2778.528867,1,83355750,83355866,116,0.11080620306652741
33394,2778.5301,2778.598333,1,83355903,83357949,2046,0.5852758694259791
33395,2778.601,2778.6098,1,83358030,83358294,264,0.38201777331935693
33396,2778.6266,2778.7253,1,83358798,83361759,2961,0.8444048506644731
33397,2778.7303,2778.789533,1,83361909,83363685,1776,0.12530389073151174
33398,2778.7921,2778.819767,1,83363763,83364593,830,0.0773438496901848
33399,2778.8361,2778.8458,1,83365083,83365374,291,0.36889011025860985
33400,2778.852167,2778.886667,1,83365565,83366600,1035,0.4210252551712154
33401,2778.8915,2779.0046,1,83366745,83370138,3393,0.7984391243594801
33402,2779.0149,2779.0224,1,83370447,83370672,225,0.4867891680304409
33403,2779.037467,2779.0764,1,83371124,83372292,1168,0.042927594066153076
33404,2779.077733,2779.094633,1,83372331,83372838,507,-0.02663665573127379
33405,2779.115333,2779.1299,1,83373459,83373897,438,-0.13800911532393415
33406,2779.1372,2779.1607,1,83374116,83374821,705,0.0701267447615676
33407,2779.1727,2779.199667,1,83375181,83375990,809,0.0011398396738464243
33408,2779.204967,2779.212433,1,83376149,83376372,223,-0.21414309367164736
33409,2779.271967,2779.276333,1,83378159,83378289,130,0.6494946748656872
33410,2779.278533,2779.282533,1,83378355,83378475,120,0.45069592294922894
33411,2779.2977,2779.3229,1,83378931,83379687,756,0.7731545610344469
33412,2779.3387,2779.371333,1,83380161,83381139,978,0.7801055046166242
33413,2779.3822,2779.433367,1,83381466,83383001,1535,0.6350819932864661
33414,2779.441233,2779.444767,1,83383236,83383343,107,0.7270736095435735
33415,2779.454467,2779.479,1,83383634,83384370,736,0.6920168033257886
33416,2779.5159,2779.5232,1,83385477,83385696,219,0.5224079620209764
33417,2779.531867,2779.575467,1,83385956,83387264,1308,0.0067616197118903374
33418,2779.588067,2779.5964,1,83387642,83387892,250,-0.01112920995079037
33419,2779.6431,2779.7728,1,83389293,83393184,3891,0.8559566526655085
33420,2779.798067,2779.803233,1,83393942,83394096,154,0.5102510596404521
33421,2779.8044,2779.8119,1,83394132,83394357,225,0.2706171503841289
33422,2779.8225,2779.850533,1,83394675,83395515,840,0.1200005922842053
33423,2779.851933,2779.8786,1,83395557,83396358,801,0.12746949309258793
33424,2779.912033,2779.922967,1,83397360,83397689,329,0.10054399544688779
33425,2779.9355,2779.959067,1,83398065,83398772,707,0.34222199251491
33426,2779.971333,2779.986267,1,83399139,83399588,449,0.06423918109317343
33427,2779.9875,2780.0128,1,83399625,83400384,759,0.03452171887140413
33428,2780.0362,2780.043333,1,83401086,83401299,213,0.7697013749504186
33429,2780.0449,2780.0634,1,83401347,83401902,555,0.6420860966192117
33430,2780.0644,2780.1706,1,83401932,83405118,3186,0.7540917207737591
33431,2780.172333,2780.259867,1,83405169,83407796,2627,0.8122222245711855
33432,2780.2757,2780.295067,1,83408271,83408852,581,0.7467374764236901
33433,2780.321667,2780.337767,1,83409650,83410133,483,-0.09668135382431797
33434,2780.357667,2780.367433,1,83410730,83411022,292,-0.024642828010921432
33435,2780.472867,2780.491833,1,83414186,83414754,568,0.3822059494799307
33436,2780.493067,2780.6334,1,83414792,83419002,4210,0.7648461115312776
33437,2780.652367,2780.6858,1,83419571,83420574,1003,0.7231343808476212
33438,2780.7024,2780.741933,1,83421072,83422257,1185,0.08471724322947075
33439,2780.7431,2780.747067,1,83422293,83422412,119,0.05962927778997299
33440,2780.748067,2780.7536,1,83422442,83422608,166,0.0033283208571138023
33441,2780.8133,2780.841833,1,83424399,83425254,855,0.3098868660312213
33442,2780.8455,2780.8865,1,83425365,83426595,1230,-0.08529398352541634
33443,2780.891667,2781.022867,1,83426750,83430686,3936,0.7034919658455228
33444,2781.0348,2781.127233,1,83431044,83433816,2772,0.7848202290948789
33445,2781.555333,2781.566733,1,83446659,83447001,342,0.6604964574858542
33446,2781.576233,2781.581133,1,83447286,83447433,147,0.15894437089808125
33447,2781.6242,2781.6488,1,83448726,83449464,738,0.8408763035323149
33448,2781.662367,2781.670267,1,83449871,83450108,237,0.45467927409090575
33449,2781.673633,2781.721967,1,83450208,83451659,1451,0.7258172848054597
33450,2781.725133,2781.7396,1,83451753,83452188,435,0.8699349862190406
33451,2781.7461,2781.762067,1,83452383,83452862,479,0.6738615460785006
33452,2781.7658,2781.822667,1,83452974,83454680,1706,0.7264036264146552
33453,2781.831533,2781.959867,1,83454945,83458796,3851,0.45270892753107433
33454,2781.977433,2782.100933,1,83459322,83463027,3705,0.8139084309512951
33455,2782.108767,2782.171867,1,83463263,83465156,1893,0.717772054531173
33456,2782.181133,2782.196067,1,83465433,83465882,449,0.8095711604239342
33457,2782.518,2782.632267,1,83475540,83478968,3428,0.6367883288599008
33458,2782.666833,2782.692233,1,83480004,83480766,762,0.8058474947593426
33459,2782.693833,2782.730167,1,83480814,83481905,1091,0.800883795463985
33460,2782.735567,2782.827133,1,83482067,83484813,2746,0.8034593277877242
33461,2782.834367,2782.965967,1,83485031,83488979,3948,0.7643048656995126
33462,2782.990667,2782.9961,1,83489720,83489883,163,-0.06055822445921785
33463,2783.008,2783.143467,1,83490240,83494304,4064,0.8237136283153612
33464,2783.157533,2783.170433,1,83494725,83495112,387,0.022095739890484672
33465,2783.247367,2783.250933,1,83497421,83497527,106,-0.12800737170523416
33466,2783.254033,2783.2594,1,83497620,83497782,162,-0.25799736431061016
33467,2783.2718,2783.366633,1,83498154,83500998,2844,0.7963741942836489
33468,2783.382633,2783.3926,1,83501478,83501778,300,0.18598540677167516
33469,2783.424067,2783.4307,1,83502722,83502921,199,0.6004823887945626
33470,2783.4319,2783.438867,1,83502957,83503166,209,-0.13379458594988078
33471,2783.7847,2783.791267,1,83513541,83513738,197,0.6844530502642647
33472,2783.794033,2783.809333,1,83513820,83514279,459,0.661139621745926
33473,2783.826067,2783.8536,1,83514782,83515608,826,0.7647104390171071
33474,2783.857,2783.950833,1,83515710,83518524,2814,0.7441079078838201
33475,2783.956,2784.050233,1,83518680,83521506,2826,0.7889790886291067
33476,2784.0545,2784.1256,1,83521635,83523768,2133,0.7120109491567923
33477,2784.128567,2784.184467,1,83523857,83525534,1677,0.8024730295102075
33478,2784.1952,2784.210567,1,83525856,83526317,461,0.6623130401716193
33479,2784.218133,2784.2285,1,83526543,83526855,312,0.4110308567580461
33480,2784.248267,2784.253333,1,83527448,83527599,151,-0.20370451552537774
33481,2784.262033,2784.266733,1,83527860,83528001,141,-0.2708230143821217
33482,2784.2703,2784.284633,1,83528109,83528538,429,-0.0914013773096449
33483,2784.309067,2784.425433,1,83529272,83532762,3490,0.8249511844798606
33484,2784.5533,2784.560067,1,83536599,83536802,203,0.6154311024152518
33485,2784.566433,2784.7707,1,83536992,83543121,6129,0.7608970540043782
33486,2784.816567,2784.828733,1,83544497,83544861,364,-0.06041390208540445
33487,2784.8298,2784.8345,1,83544894,83545035,141,-0.07065540941251117
33488,2784.844833,2784.850667,1,83545344,83545520,176,0.5224739470141362
33489,2784.891833,2785.012233,1,83546754,83550366,3612,0.7312601988683214
33490,2785.040267,2785.044667,1,83551208,83551340,132,-0.40082248777542
33491,2785.048667,2785.060567,1,83551460,83551817,357,-0.07193492884722191
33492,2785.063967,2785.0691,1,83551919,83552073,154,
33493,2785.073133,2785.077933,1,83552193,83552337,144,0.1395622805691434
33494,2785.0852,2785.090267,1,83552556,83552708,152,0.6865312203934184
33495,2785.1034,2785.235467,1,83553102,83557064,3962,0.7852266582901636
33496,2785.558333,2785.597,1,83566749,83567910,1161,0.7838530623248352
33497,2785.610267,2785.633433,1,83568308,83569002,694,0.5997646922766413
33498,2785.637633,2785.651833,1,83569128,83569554,426,0.5374386250907156
33499,2785.6907,2785.698033,1,83570721,83570940,219,0.4662845513267477
33500,2785.699033,2785.722967,1,83570970,83571689,719,0.6501804724176496
33501,2785.735767,2785.746,1,83572073,83572380,307,0.5113038212939577
33502,2785.790133,2785.799533,1,83573703,83573985,282,-0.12853095214243868
33503,2785.8026,2785.8257,1,83574078,83574771,693,0.1866616838643314
33504,2785.8407,2785.850767,1,83575221,83575523,302,0.3897587256688933
33505,2785.853967,2786.013467,1,83575619,83580404,4785,0.7393313871158217
33506,2786.025833,2786.1365,1,83580774,83584095,3321,0.7794085878779262
33507,2786.139133,2786.1423,1,83584173,83584269,96,0.5221139163801426
33508,2786.1433,2786.146867,1,83584299,83584406,107,0.17509427368105962
33509,2786.245033,2786.248567,1,83587350,83587457,107,0.49990972873510886
33510,2786.256667,2786.263067,1,83587700,83587892,192,0.8469287130443286
33511,2786.268667,2786.2829,1,83588060,83588487,427,0.33834516448363006
33512,2786.2899,2786.373833,1,83588697,83591214,2517,0.6678728483779721
33513,2786.382133,2786.4543,1,83591463,83593629,2166,0.7530741537078787
33514,2786.456433,2786.498933,1,83593692,83594967,1275,0.7819553922201259
33515,2786.504767,2786.5112,1,83595143,83595336,193,0.7559180187662403
33516,2786.527967,2786.537267,1,83595839,83596118,279,0.3271801509841981
33517,2786.538833,2786.5905,1,83596164,83597715,1551,0.7349240661436359
33518,2786.596233,2786.613067,1,83597886,83598392,506,0.6661579218659905
33519,2786.618333,2786.632,1,83598549,83598960,411,0.5448859055475845
33520,2786.635967,2786.6424,1,83599079,83599272,193,0.673198887411512
33521,2786.6515,2786.689767,1,83599545,83600693,1148,0.0937694199205637
33522,2786.692567,2786.7037,1,83600777,83601111,334,0.6006006099208617
33523,2786.7177,2786.7346,1,83601531,83602038,507,0.655636680147905
33524,2786.736367,2786.779633,1,83602091,83603388,1297,0.7184200039022329
33525,2786.780967,2786.826867,1,83603429,83604806,1377,0.7909122427552117
33526,2786.8378,2786.844133,1,83605134,83605323,189,0.49795055113032405
33527,2786.845867,2786.855567,1,83605376,83605667,291,-0.14394736404985445
33528,2786.856967,2786.865067,1,83605709,83605952,243,-0.06014541046543907
33529,2786.868367,2786.920667,1,83606051,83607620,1569,0.722695609386656
33530,2786.922933,2787.048533,1,83607687,83611455,3768,0.8180790380098749
33531,2787.079633,2787.0834,1,83612388,83612502,114,-0.3351153969350233
33532,2787.084467,2787.0897,1,83612534,83612691,157,
33533,2787.7434,2787.7708,1,83632302,83633124,822,0.5375912051453532
33534,2787.833667,2787.841433,1,83635010,83635242,232,0.3410290702526545
33535,2788.002867,2788.007033,1,83640086,83640210,124,0.567927682721454
33536,2788.0107,2788.0247,1,83640321,83640741,420,0.6258685907698252
33537,2788.0648,2788.0737,1,83641944,83642211,267,0.7351144368661446
33538,2788.0747,2788.094167,1,83642241,83642825,584,0.66744205601591
33539,2788.102767,2788.1062,1,83643083,83643186,103,-0.15786493264236454
33540,2788.1109,2788.114567,1,83643327,83643437,110,0.4297550222207727
33541,2788.132967,2788.151867,1,83643989,83644556,567,-0.05861891734005665
33542,2788.1544,2788.164367,1,83644632,83644931,299,0.15087857231742674
33543,2788.171533,2788.178,1,83645145,83645340,195,-0.026963050636603054
33544,2788.197333,2788.2017,1,83645919,83646051,132,0.6702546170943305
33545,2788.204933,2788.337733,1,83646147,83650131,3984,0.7318448391394666
33546,2788.339467,2788.434067,1,83650184,83653022,2838,0.798887833969285
33547,2788.944133,2788.9533,1,83668323,83668599,276,0.616168094475246
33548,2788.970733,2788.990333,1,83669121,83669709,588,0.6243084861911156
33549,2788.998667,2789.040667,1,83669960,83671220,1260,0.6972310297327583
33550,2789.065467,2789.082467,1,83671964,83672474,510,0.526554132955328
33551,2789.121367,2789.126567,1,83673641,83673797,156,0.45980512625897496
33552,2789.133333,2789.150633,1,83673999,83674518,519,0.4729836640280652
33553,2789.1681,2789.184633,1,83675043,83675538,495,0.5200131238059731
33554,2789.2341,2789.249967,1,83677023,83677499,476,0.5522147209569435
33555,2789.274,2789.283867,1,83678220,83678516,296,0.5701590666945667
33556,2789.293533,2789.298267,1,83678805,83678948,143,0.5744088603703162
33557,2789.3383,2789.342767,1,83680149,83680283,134,0.575223100160762
33558,2789.3595,2789.363733,1,83680785,83680911,126,
33559,2789.3652,2789.3751,1,83680956,83681253,297,-0.02481735020905012
33560,2789.3841,2789.389267,1,83681523,83681678,155,0.09378968659119563
33561,2789.4132,2789.417133,1,83682396,83682513,117,-0.1208161132693475
33562,2789.424333,2789.531867,1,83682729,83685956,3227,0.7951748972941404
33563,2789.540267,2789.549833,1,83686208,83686494,286,0.3319427080453812
33564,2789.552067,2789.563033,1,83686562,83686890,328,-0.07795189706553278
33565,2789.564033,2789.5766,1,83686920,83687298,378,0.0286780668619435
33566,2789.591267,2789.7786,1,83687738,83693358,5620,0.7808017413676455
33567,2789.807333,2789.8133,1,83694219,83694399,180,0.09161682380045098
33568,2789.8693,2789.876367,1,83696079,83696291,212,0.3242314631525344
33569,2789.878767,2790.029433,1,83696363,83700882,4519,0.8046346208184197
33570,2790.041567,2790.0648,1,83701247,83701944,697,-0.08007627175110581
33571,2790.0666,2790.07,1,83701998,83702100,102,-0.0655725565657654
33572,2790.128467,2790.142967,1,83703854,83704289,435,0.5955264800033175
33573,2790.144267,2790.173267,1,83704328,83705198,870,0.7579630110574207
33574,2790.174367,2790.1815,1,83705231,83705445,214,-0.046040673304367084
33575,2790.183633,2790.187933,1,83705508,83705637,129,-0.17230802188889222
33576,2790.1891,2790.233067,1,83705673,83706992,1319,0.6701918498444475
33577,2790.2517,2790.2586,1,83707551,83707758,207,-0.013003539212430998
33578,2790.259767,2790.2634,1,83707793,83707902,109,
33579,2790.2659,2790.2691,1,83707977,83708073,96,
33580,2790.272367,2790.275733,1,83708171,83708271,100,0.037807053779696675
33581,2790.2776,2790.284567,1,83708328,83708537,209,0.5398841960870173
33582,2790.4897,2790.812233,1,83714691,83724366,9675,0.704435407472623
33583,2790.847,2790.850567,1,83725410,83725517,107,
33584,2790.8517,2790.856067,1,83725551,83725682,131,
33585,2791.360467,2791.367467,1,83740814,83741024,210,0.5956395757034946
33586,2791.3708,2791.375,1,83741124,83741250,126,0.6337738901242792
33587,2791.391833,2791.403667,1,83741754,83742110,356,0.60617181841869
33588,2791.426033,2791.462333,1,83742780,83743869,1089,0.6632191229336453
33589,2791.484267,2791.5095,1,83744528,83745285,757,0.6158982295105988
33590,2791.5314,2791.535933,1,83745942,83746077,135,0.5984720621324495
33591,2791.5428,2791.549967,1,83746284,83746499,215,0.43012617408994347
33592,2791.558,2791.5725,1,83746740,83747175,435,0.5007848183146473
33593,2791.5907,2791.6394,1,83747721,83749182,1461,0.5909354524095763
33594,2791.6649,2791.682767,1,83749947,83750483,536,0.6401402671983095
33595,2791.708733,2791.719467,1,83751261,83751584,323,0.6644369171561129
33596,2791.7286,2791.734767,1,83751858,83752043,185,0.5187455758454732
33597,2791.742533,2791.7469,1,83752275,83752407,132,
33598,2791.775933,2791.7794,1,83753277,83753382,105,-0.13251927081669093
33599,2791.786267,2791.798633,1,83753588,83753958,370,0.09489034080107844
33600,2791.7997,2791.802833,1,83753991,83754084,93,
33601,2791.8039,2791.808567,1,83754117,83754257,140,0.20215383935479844
33602,2791.811933,2791.816867,1,83754357,83754506,149,0.45301002685432096
33603,2791.947267,2792.089,1,83758418,83762670,4252,0.8143156070324264
33604,2792.090033,2792.257867,1,83762700,83767736,5036,0.7247593955195679
33605,2792.276067,2792.281733,1,83768282,83768451,169,-0.04997629034406441
33606,2792.295733,2792.303267,1,83768871,83769098,227,-0.17858180180445848
33607,2792.9471,2792.9874,1,83788413,83789622,1209,0.5934244647800676
33608,2793.0059,2793.020733,1,83790177,83790621,444,0.6241432146773153
33609,2793.050133,2793.057067,1,83791503,83791712,209,0.8244132199758474
33610,2793.076733,2793.0891,1,83792301,83792673,372,0.5199316422885001
33611,2793.606267,2793.620567,1,83808188,83808617,429,0.5718178705038787
33612,2793.622633,2793.6301,1,83808678,83808903,225,0.6362951637199757
33613,2793.6398,2793.699433,1,83809194,83810982,1788,0.729010385890168
33614,2793.714933,2793.746567,1,83811447,83812397,950,0.6925450875070096
33615,2793.7754,2793.782967,1,83813262,83813489,227,0.5978300362783332
33616,2793.788067,2793.801133,1,83813642,83814033,391,0.5235335559760864
33617,2793.824267,2793.843233,1,83814728,83815296,568,0.6901762705861663
33618,2793.897933,2793.916167,1,83816937,83817485,548,0.6126488219505256
33619,2793.9385,2793.945967,1,83818155,83818379,224,0.6544318353743334
33620,2793.9546,2793.970767,1,83818638,83819123,485,0.6563458923710147
33621,2802.245267,2802.2511,1,84067358,84067533,175,0.3217438110875757
33622,2803.947867,2803.952467,1,84118436,84118574,138,0.3847435812161235
33623,2804.3492,2804.352533,1,84130476,84130575,99,0.351734603548838
33624,2814.291033,2814.297267,1,84428730,84428918,188,0.5789603265619105
33625,2824.753833,2824.757867,1,84742614,84742736,122,-0.3725505672260405
33626,2824.7832,2824.8403,1,84743496,84745209,1713,0.17110472709342545
33627,2824.855633,2824.929233,1,84745668,84747876,2208,0.09325588388515335
33628,2824.935367,2824.9472,1,84748061,84748416,355,0.10260900700767706
33629,2825.102033,2825.105367,1,84753060,84753161,101,0.0014451741997856694
33630,2825.110533,2825.114133,1,84753315,84753423,108,0.7863462348090208
33631,2825.127367,2825.149833,1,84753821,84754494,673,0.17871673820972872
33632,2825.1524,2825.155667,1,84754572,84754670,98,
33633,2825.244367,2825.253,1,84757331,84757590,259,0.4540847801770298
33634,2825.255933,2825.260667,1,84757677,84757820,143,0.6344387325503303
33635,2825.263533,2825.2683,1,84757905,84758049,144,0.3092613320198656
33636,2825.290667,2825.296067,1,84758720,84758882,162,0.08276536684812848
33637,2825.332967,2825.3395,1,84759989,84760185,196,0.11273147617750376
33638,2825.3416,2825.344733,1,84760248,84760341,93,-0.0011549492808488292
33639,2825.361733,2825.370533,1,84760851,84761115,264,0.34226306377993726
33640,2828.362467,2828.370067,1,84850874,84851102,228,0.23069684919143543
33641,2828.393667,2828.401867,1,84851810,84852056,246,0.13022814131775598
33642,2828.4175,2828.4308,1,84852525,84852924,399,0.2910735188970079
33643,2828.451333,2828.485,1,84853539,84854550,1011,0.1527007060152288
33644,2828.6852,2828.688967,1,84860556,84860669,113,
33645,2829.0468,2829.056133,1,84871404,84871683,279,0.4161029044860686
33646,2829.132567,2829.137033,1,84873977,84874110,133,0.7982878813402415
33647,2829.1764,2829.179533,1,84875292,84875385,93,0.04105838655368476
33648,2829.229967,2829.235567,1,84876899,84877067,168,0.4632496089675981
33649,2854.217667,2854.222667,1,85626530,85626680,150,0.5176913977985605
33650,2864.580167,2864.5837,1,85937405,85937511,106,0.11262466969378995
33651,2895.4802,2895.4848,1,86864406,86864544,138,0.4287045439294528
33652,2895.5673,2895.5708,1,86867019,86867124,105,
33653,2932.582433,2932.587667,1,87977472,87977630,158,0.7785373949686204
33654,2933.4909,2933.499533,1,88004727,88004985,258,0.18539729943435448
33655,2933.895433,2933.902667,1,88016862,88017080,218,0.07445082227048505
33656,2933.9037,2933.925733,1,88017111,88017771,660,0.23267222813065422
33657,2933.926733,2933.944967,1,88017801,88018349,548,0.13163077797449926
33658,2933.9469,2933.951,1,88018407,88018530,123,-0.1936117438228321
33659,2933.9562,2933.9635,1,88018686,88018905,219,0.2577379419423395
33660,2933.969667,2933.974333,1,88019090,88019229,139,-0.04460337886829221
33661,2933.9844,2933.9923,1,88019532,88019769,237,0.3573944924253717
33662,2934.007767,2934.023733,1,88020233,88020711,478,0.2311506602527376
33663,2934.080033,2934.084533,1,88022400,88022535,135,-0.1374494351644119
33664,2934.0876,2934.0915,1,88022628,88022745,117,
33665,2934.111367,2934.118067,1,88023341,88023542,201,0.20207763489436764
33666,2934.1197,2934.1249,1,88023591,88023747,156,-0.11198121057032881
33667,2938.486067,2938.490133,1,88154582,88154703,121,0.35538764627795133
33668,2938.492367,2938.496067,1,88154771,88154882,111,-0.28948055830505304
33669,2959.958033,2959.963267,1,88798740,88798898,158,0.4024874128543341
33670,2960.029733,2960.0368,1,88800891,88801104,213,0.4468891105982299
33671,2976.8801,2976.887667,1,89306403,89306630,227,
33672,2976.926933,2976.931533,1,89307807,89307945,138,
33673,2978.238933,2978.2424,1,89347167,89347272,105,
33674,2978.300233,2978.305933,1,89349006,89349177,171,0.24211753169830694
33675,2978.374433,2978.3912,1,89351232,89351736,504,0.19122588215918157
33676,2978.396233,2978.403533,1,89351886,89352105,219,0.45327251779800815
33677,2979.958767,2979.9787,1,89398763,89399361,598,0.7896644452579948
33678,2980.202867,2980.206933,1,89406086,89406207,121,-0.3000779029480842
33679,2980.491633,2980.5317,1,89414748,89415951,1203,0.8297347766612525
33680,2980.5381,2980.634167,1,89416143,89419025,2882,0.8037591374615156
33681,2984.626233,2984.630233,1,89538786,89538906,120,0.2032563307235862
33682,2984.689667,2984.714033,1,89540690,89541420,730,0.20040672171780366
33683,2984.723867,2984.734433,1,89541716,89542032,316,0.141962293226037
33684,2984.7364,2984.739567,1,89542092,89542187,95,0.5632888527694594
33685,2984.763367,2984.770767,1,89542901,89543123,222,
33686,2984.783733,2984.9939,1,89543511,89549817,6306,0.33518051996156745
33687,2985.008267,2985.014933,1,89550248,89550447,199,-0.13835722238455767
33688,2985.0219,2985.025233,1,89550657,89550756,99,0.2469053886094739
33689,2985.094267,2985.0988,1,89552828,89552964,136,0.6697782228237146
33690,2985.100867,2985.1048,1,89553026,89553144,118,0.36440616705193085
33691,2985.930833,2985.935467,1,89577924,89578064,140,
33692,2985.9411,2985.955567,1,89578233,89578667,434,-0.16455684728122794
33693,2985.956967,2986.023033,1,89578709,89580690,1981,0.02708835462243559
33694,2986.040133,2986.076667,1,89581203,89582300,1097,0.22923887075709762
33695,2986.079633,2986.092067,1,89582388,89582762,374,0.39197610022101537
33696,2986.108567,2986.269767,1,89583257,89588093,4836,0.20403844423236298
33697,2986.275333,2986.283433,1,89588259,89588502,243,0.6948418379995563
33698,2986.284733,2986.298233,1,89588541,89588946,405,0.3762655894115271
33699,2986.301733,2986.307867,1,89589051,89589236,185,0.0777376770065352
33700,2986.3096,2986.318267,1,89589288,89589548,260,-0.046371383521055375
33701,2986.329267,2986.333267,1,89589878,89589998,120,0.786027158293622
33702,2986.352467,2986.3555,1,89590574,89590665,91,
33703,2986.357967,2986.361567,1,89590739,89590847,108,
33704,2986.3701,2986.373567,1,89591103,89591207,104,
33705,2986.3873,2986.393,1,89591619,89591790,171,
33706,2986.3944,2986.402833,1,89591832,89592084,252,0.3700025018489453
33707,2986.416633,2986.420267,1,89592498,89592608,110,
33708,2986.4377,2986.4424,1,89593131,89593272,141,0.5278344582585679
33709,2986.451633,2986.464033,1,89593548,89593920,372,0.20727001279060195
33710,2986.468433,2986.472567,1,89594052,89594177,125,0.5963197824550341
33711,2986.476767,2986.4802,1,89594303,89594406,103,
33712,2986.4982,2986.5025,1,89594946,89595075,129,
33713,2986.511333,2986.516867,1,89595339,89595506,167,-0.35586252813397123
33714,2986.518567,2986.523733,1,89595557,89595711,154,
33715,2986.525433,2986.529167,1,89595762,89595875,113,
33716,2986.541767,2986.546567,1,89596253,89596397,144,-0.09361854370620352
33717,2986.5517,2986.555067,1,89596551,89596652,101,
33718,2986.557,2986.5667,1,89596710,89597001,291,-0.2919246455718091
33719,2986.5677,2986.572867,1,89597031,89597186,155,0.03169311205382805
33720,2986.5775,2986.5811,1,89597325,89597433,108,
33721,2986.855533,2986.858633,1,89605665,89605758,93,
33722,2986.878667,2986.8921,1,89606360,89606763,403,-0.07746278692199242
33723,2986.8931,2986.926033,1,89606793,89607780,987,-0.032341922871019994
33724,2986.927667,2986.938167,1,89607830,89608145,315,0.32109288039028133
33725,2987.1672,2987.1724,1,89615016,89615172,156,0.4245248002767996
33726,2987.1876,2987.197733,1,89615628,89615931,303,-0.017676881051061244
33727,2987.205133,2987.212233,1,89616153,89616366,213,0.3029106117655774
33728,2987.370367,2987.4052,1,89621111,89622156,1045,0.0060113562489671115
33729,2987.407933,2987.463033,1,89622237,89623890,1653,0.3564985380371251
33730,2987.467767,2987.501667,1,89624033,89625050,1017,-0.0590462411791037
33731,2987.5104,2987.550133,1,89625312,89626503,1191,0.02424741930982191
33732,2987.557733,2987.572867,1,89626731,89627186,455,0.13119560182179116
33733,2987.5772,2987.580367,1,89627316,89627411,95,0.5254270571636224
33734,2987.583667,2987.586667,1,89627510,89627600,90,
33735,2987.5879,2987.653433,1,89627637,89629602,1965,0.10831443668240213
33736,2987.655367,2987.672967,1,89629661,89630189,528,0.17249390941396994
33737,2987.6752,2987.686833,1,89630256,89630604,348,0.03991298227610417
33738,2987.692167,2987.703567,1,89630765,89631107,342,-0.004126062060358451
33739,2987.7107,2987.715833,1,89631321,89631474,153,-0.05037415685377847
33740,2987.718267,2987.7213,1,89631548,89631639,91,-0.07634490071858817
33741,2987.722667,2987.769133,1,89631680,89633073,1393,-0.022252858030336598
33742,2987.779533,2987.812233,1,89633385,89634366,981,0.08794235766167095
33743,2987.820633,2987.824033,1,89634618,89634720,102,0.7664197262306395
33744,2987.825167,2987.891233,1,89634755,89636736,1981,-0.018305602580256455
33745,2987.8927,2987.900233,1,89636781,89637006,225,0.18089751466103784
33746,2987.901833,2987.910133,1,89637054,89637303,249,0.17582015396744516
33747,2987.986333,2987.991467,1,89639589,89639744,155,-0.23838707201468792
33748,2987.9932,2987.9969,1,89639796,89639907,111,
33749,2988.032033,2988.0694,1,89640960,89642082,1122,0.03719174190439712
33750,2988.072833,2988.075833,1,89642184,89642274,90,0.15888050997731543
33751,2988.095267,2988.1093,1,89642858,89643279,421,-0.024594855498778666
33752,2988.116233,2988.1197,1,89643486,89643591,105,
33753,2988.1209,2988.150633,1,89643627,89644518,891,-0.040592840027107495
33754,2988.192233,2988.324167,1,89645766,89649725,3959,0.05863585162214057
33755,2988.4065,2988.4095,1,89652195,89652285,90,0.41797693067580355
33756,2988.419533,2988.433467,1,89652585,89653004,419,0.07174524329941347
33757,2988.434467,2988.4443,1,89653034,89653329,295,0.020007264572775057
33758,2988.448967,2988.462333,1,89653469,89653869,400,-0.06745639011780842
33759,2988.4692,2988.4761,1,89654076,89654283,207,
33760,2988.5014,2988.519767,1,89655042,89655593,551,0.11785367578299584
33761,2988.523367,2988.5352,1,89655701,89656056,355,0.4537510002231187
33762,2988.5652,2988.572533,1,89656956,89657175,219,0.41483379758444044
33763,2988.602033,2988.613,1,89658060,89658390,330,0.05176810997026268
33764,2988.6229,2988.629867,1,89658687,89658896,209,-0.15901450429745598
33765,2988.650967,2988.656,1,89659529,89659680,151,0.6064779981753159
33766,2988.6579,2988.664933,1,89659737,89659947,210,0.1756173513538891
33767,2988.6799,2988.6914,1,89660397,89660742,345,-0.064419850334421
33768,2988.702033,2988.727633,1,89661060,89661828,768,0.04952980424199346
33769,2988.771867,2988.779967,1,89663156,89663399,243,-0.025079229679433282
33770,2988.8047,2988.8156,1,89664141,89664468,327,0.05709809444847768
33771,2988.8559,2988.864567,1,89665677,89665937,260,0.27431688121335157
33772,2988.865667,2988.869033,1,89665970,89666070,100,0.48738791020904343
33773,2988.879433,2988.9041,1,89666382,89667123,741,0.06879795273457104
33774,2988.9451,2988.9539,1,89668353,89668617,264,0.60436594757372
33775,2988.965633,2988.9743,1,89668968,89669229,261,0.037919384423733694
33776,2988.9876,2988.998367,1,89669628,89669951,323,-0.02390705613615752
33777,2989.3356,2989.353633,1,89680068,89680608,540,0.5088659519283012
33778,2989.408467,2989.413367,1,89682254,89682401,147,0.2554397559488505
33779,2989.4474,2989.457733,1,89683422,89683731,309,-0.13457131843434084
33780,2989.464067,2989.476,1,89683922,89684280,358,0.6267138160597723
33781,2989.478633,2989.482067,1,89684358,89684462,104,
33782,2989.483133,2989.4875,1,89684493,89684625,132,-0.14288581948143267
33783,2989.516167,2989.5193,1,89685485,89685579,94,
33784,2989.525733,2989.5301,1,89685771,89685903,132,
33785,2989.531333,2989.545033,1,89685939,89686350,411,0.2324182909627027
33786,2989.549633,2989.552867,1,89686488,89686586,98,-0.20003360823135913
33787,2989.578367,2989.609167,1,89687351,89688275,924,-0.07283907497459216
33788,2989.616333,2989.6253,1,89688489,89688759,270,0.5841198808939715
33789,2989.626867,2989.6433,1,89688806,89689299,493,0.13488768241039348
33790,2989.647067,2989.6506,1,89689412,89689518,106,0.6566838509693627
33791,2989.6531,2989.663467,1,89689593,89689904,311,0.5111593106378481
33792,2989.664633,2989.672933,1,89689938,89690187,249,-0.024158806274766367
33793,2989.6764,2989.707567,1,89690292,89691227,935,0.14602758632525015
33794,2989.726,2989.7307,1,89691780,89691921,141,-0.22324171698045794
33795,2989.737367,2989.7458,1,89692121,89692374,253,-0.15767120411009763
33796,2989.759633,2989.7688,1,89692788,89693064,276,
33797,2989.775533,2989.778633,1,89693265,89693358,93,
33798,2989.792567,2989.800133,1,89693777,89694003,226,-0.15955465876850627
33799,2989.819433,2989.8302,1,89694582,89694906,324,-0.3799779238049454
33800,2989.8319,2989.844167,1,89694957,89695325,368,
33801,2989.853233,2989.874033,1,89695596,89696220,624,0.022418111420882025
33802,2989.891333,2989.945933,1,89696739,89698377,1638,0.02520808650884483
33803,2989.9687,2989.971767,1,89699061,89699153,92,
33804,2989.973933,2989.981233,1,89699217,89699436,219,-0.14488172746507613
33805,2989.985933,2989.990233,1,89699577,89699706,129,
33806,2989.991467,2990.005333,1,89699744,89700159,415,0.0041740756489214124
33807,2990.0272,2990.035167,1,89700816,89701055,239,0.37890918079005353
33808,2990.0502,2990.058267,1,89701506,89701748,242,0.3427058081698396
33809,2990.076833,2990.0837,1,89702304,89702511,207,0.30266619308127085
33810,2990.092067,2990.0988,1,89702762,89702964,202,0.6553049539820193
33811,2990.112467,2990.1415,1,89703374,89704245,871,0.0015664308563826496
33812,2990.163433,2990.188433,1,89704902,89705652,750,0.27502297505714746
33813,2990.198867,2990.2034,1,89705966,89706102,136,-0.21675242545812612
33814,2990.221933,2990.236433,1,89706657,89707092,435,0.4331569220021548
33815,2990.257233,2990.2677,1,89707716,89708031,315,-0.016200070215301655
33816,2990.2805,2990.2911,1,89708415,89708733,318,0.4510768238321262
33817,2990.302633,2990.306967,1,89709078,89709209,131,-0.15681724232197702
33818,2990.3089,2990.314033,1,89709267,89709420,153,-0.18260690015947856
33819,2990.350267,2990.366233,1,89710508,89710986,478,0.0016362705098091545
33820,2990.4199,2990.425933,1,89712597,89712777,180,-0.13863612450677407
33821,2990.435067,2990.4397,1,89713052,89713191,139,-0.24174364828840042
33822,2990.4611,2990.470567,1,89713833,89714117,284,0.5569275144631499
33823,2990.4754,2990.479933,1,89714262,89714397,135,0.5489905992715536
33824,2990.4952,2990.500233,1,89714856,89715006,150,-0.2619744785589726
33825,2990.520033,2990.525067,1,89715600,89715752,152,0.4642040338488044
33826,2990.537767,2990.5446,1,89716133,89716338,205,0.478738884490594
33827,2990.545633,2990.549833,1,89716368,89716494,126,-0.0349138974649961
33828,2990.583567,2990.592667,1,89717507,89717780,273,0.19172598367671684
33829,2990.594233,2990.597933,1,89717826,89717937,111,-0.08786107766038477
33830,2990.6145,2990.629967,1,89718435,89718899,464,0.10559178735128097
33831,2990.634,2990.638267,1,89719020,89719148,128,
33832,2990.642167,2990.6491,1,89719265,89719473,208,0.47786429856653473
33833,2990.655533,2990.6607,1,89719665,89719821,156,0.03584103259716607
33834,2990.667833,2990.671967,1,89720034,89720159,125,-0.09064980110281567
33835,2990.6831,2990.704167,1,89720493,89721125,632,0.035296890782894066
33836,2990.717033,2990.733433,1,89721510,89722002,492,0.07328243433028038
33837,2990.740767,2990.782,1,89722223,89723460,1237,0.015160820521115819
33838,2990.8016,2990.8162,1,89724048,89724486,438,-0.07127643193997926
33839,2990.8228,2990.830667,1,89724684,89724920,236,
33840,2990.833,2990.8555,1,89724990,89725665,675,0.03140775412287586
33841,2990.8633,2990.891267,1,89725899,89726738,839,0.029531373599230224
33842,2990.902033,2990.913733,1,89727060,89727411,351,-0.2873617588333433
33843,2990.917267,2990.936667,1,89727518,89728100,582,-0.04547423475564314
33844,2990.944533,2990.951767,1,89728335,89728553,218,-0.08683574979505086
33845,2990.952833,2990.957167,1,89728584,89728715,131,-0.2808974627802741
33846,2990.959367,2990.968533,1,89728781,89729055,274,
33847,2991.014067,2991.020467,1,89730422,89730614,192,0.2093790728036212
33848,2991.547767,2991.5792,1,89746433,89747376,943,0.2267616540479786
33849,2991.604767,2991.626433,1,89748143,89748792,649,0.1642553761884672
33850,2991.629033,2991.633167,1,89748870,89748995,125,0.6515273279909005
33851,2991.676367,2991.7033,1,89750291,89751099,808,0.1969419044622834
33852,2991.7896,2991.795567,1,89753688,89753867,179,0.4291850029431483
33853,2991.809367,2991.8129,1,89754281,89754387,106,0.43034755869339847
33854,2991.8997,2991.911667,1,89756991,89757350,359,0.4491792637838067
33855,2991.925167,2991.931367,1,89757755,89757941,186,0.4913750014742983
33856,2991.937167,2991.943833,1,89758115,89758314,199,0.7033710770448893
33857,2991.960533,2991.964233,1,89758815,89758926,111,-0.4116761829408772
33858,2991.993833,2991.999767,1,89759814,89759993,179,0.7451600936183346
33859,2992.0012,2992.015233,1,89760036,89760456,420,0.21133388078830215
33860,2992.027467,2992.0711,1,89760824,89762133,1309,0.08459343325018016
33861,2992.074067,2992.0841,1,89762222,89762523,301,0.023232467184140716
33862,2992.122533,2992.127167,1,89763675,89763815,140,0.31617234590178533
33863,2992.14,2992.151067,1,89764200,89764532,332,0.5887688590250454
33864,2992.156833,2992.1723,1,89764704,89765169,465,0.08025065563274729
33865,2992.233567,2992.253,1,89767007,89767590,583,0.2285576058573398
33866,2992.260067,2992.2677,1,89767802,89768031,229,0.39941529439039625
33867,2992.336733,2992.353533,1,89770101,89770605,504,0.19291048435366195
33868,2992.420867,2992.425733,1,89772626,89772771,145,0.6891017552456064
33869,2992.4451,2992.470567,1,89773353,89774117,764,0.10069810488402359
33870,2992.475933,2992.478967,1,89774277,89774369,92,
33871,2992.489633,2992.505167,1,89774688,89775155,467,0.17675792200127183
33872,2992.506433,2992.5108,1,89775192,89775324,132,0.4781727178269174
33873,2992.554167,2992.581467,1,89776625,89777444,819,0.18907063546030267
33874,2992.593033,2992.601267,1,89777790,89778038,248,0.033581849518002166
33875,2992.6149,2992.619467,1,89778447,89778584,137,
33876,2992.634233,2992.6443,1,89779026,89779329,303,0.6109343450721513
33877,2992.6456,2992.655,1,89779368,89779650,282,0.03370655956832144
33878,2992.682967,2992.686767,1,89780489,89780603,114,0.2248535314668425
33879,2992.694267,2992.697433,1,89780828,89780922,94,0.4760794536514479
33880,2992.839167,2992.844767,1,89785175,89785343,168,0.26490203901805237
33881,2992.856367,2992.864067,1,89785691,89785922,231,0.08799717474234531
33882,2992.876233,2992.890533,1,89786286,89786715,429,-0.03233060158722672
33883,2992.896467,2992.918667,1,89786894,89787560,666,0.0053489554299478315
33884,2994.717533,2994.725133,1,89841525,89841753,228,-0.521602149623748
33885,2994.729067,2994.7455,1,89841872,89842365,493,0.4968593434012689
33886,2994.746533,2994.753233,1,89842395,89842596,201,0.4339415255984748
33887,2994.754267,2994.7585,1,89842628,89842755,127,-0.09108130401396247
33888,2994.768167,2994.855833,1,89843045,89845674,2629,0.29735805656184716
33889,2994.857733,2994.8628,1,89845731,89845884,153,0.19036866873142644
33890,2994.863933,2994.868967,1,89845917,89846069,152,0.05598284703985085
33891,2995.3309,2995.3452,1,89859927,89860356,429,0.14596119286523573
33892,2995.375033,2995.394633,1,89861250,89861838,588,0.36895390241504367
33893,2995.7835,2995.8052,1,89873505,89874156,651,0.029925159617587467
33894,2995.806633,2995.874833,1,89874198,89876244,2046,0.045969030713562405
33895,2995.884533,2995.903967,1,89876535,89877119,584,-0.06285616731934622
33896,2995.905833,2995.930333,1,89877174,89877909,735,-3.8950795996881925e-05
33897,2995.9335,2995.944533,1,89878005,89878335,330,-0.10696822156271814
33898,2995.9488,2995.9607,1,89878464,89878821,357,-0.05378389568799514
33899,2995.964,2995.972933,1,89878920,89879187,267,-0.04481059961896803
33900,2995.980267,2995.993033,1,89879408,89879790,382,0.34880461568838395
33901,2996.015867,2996.020733,1,89880476,89880621,145,0.550705097070354
33902,2996.061867,2996.081433,1,89881856,89882442,586,0.11718427634307044
33903,2996.091633,2996.115833,1,89882748,89883474,726,0.1429491139505773
33904,2996.123567,2996.134833,1,89883707,89884044,337,0.3027299021485411
33905,2996.1386,2996.143333,1,89884158,89884299,141,
33906,2996.1447,2996.150933,1,89884341,89884527,186,0.5271941561887804
33907,2996.171667,2996.1765,1,89885150,89885295,145,0.2399211116360713
33908,2996.200267,2996.222233,1,89886008,89886666,658,-0.07169744762775973
33909,2996.2323,2996.239567,1,89886969,89887187,218,0.46591297092497524
33910,2996.2649,2996.275933,1,89887947,89888277,330,0.48562747648669685
33911,2996.281067,2996.2907,1,89888432,89888721,289,0.27133416556662415
33912,2996.2993,2996.306167,1,89888979,89889185,206,0.5605183047928827
33913,2996.3094,2996.320667,1,89889282,89889620,338,0.6454881348370235
33914,2996.363267,2996.3663,1,89890898,89890989,91,0.22362098450291937
33915,2996.371,2996.3743,1,89891130,89891229,99,
33916,2996.3823,2996.409867,1,89891469,89892296,827,-0.029605856761633232
33917,2996.421533,2996.437333,1,89892645,89893119,474,0.32040588021029276
33918,2996.446933,2996.477767,1,89893407,89894333,926,0.3030949702797499
33919,2996.4879,2996.497167,1,89894637,89894915,278,0.41800441384744674
33920,2996.499867,2996.513833,1,89894996,89895414,418,0.29600091473458084
33921,2996.561767,2996.568467,1,89896853,89897054,201,0.12216332640128778
33922,2996.574833,2996.597233,1,89897244,89897916,672,0.027775655105560366
33923,2996.6063,2996.6139,1,89898189,89898417,228,0.18170981906992856
33924,2996.617067,2996.6261,1,89898512,89898783,271,-0.14795552904898734
33925,2996.694767,2996.698433,1,89900843,89900952,109,-0.08869031348454917
33926,2996.706433,2996.735467,1,89901192,89902064,872,0.02033687768148437
33927,2996.769033,2996.773867,1,89903070,89903216,146,-0.1671154624484129
33928,2996.789833,2996.822367,1,89903694,89904671,977,0.010939551258740299
33929,2996.841233,2996.844867,1,89905236,89905346,110,0.7793082244977928
33930,2996.889867,2996.8933,1,89906696,89906799,103,0.36201982823763623
33931,2996.9133,2996.9375,1,89907399,89908125,726,0.007750325393152992
33932,2996.964867,2996.968867,1,89908946,89909066,120,0.679970252768096
33933,2997.123267,2997.127333,1,89913698,89913819,121,0.49011922734540797
33934,2997.182467,2997.1883,1,89915474,89915649,175,-0.21835935035795181
33935,2997.196,2997.218067,1,89915880,89916542,662,0.09111443064133742
33936,2997.236433,2997.242467,1,89917092,89917274,182,-0.038144605872872155
33937,2997.246467,2997.2568,1,89917394,89917704,310,0.4112003827623619
33938,2997.258,2997.262367,1,89917740,89917871,131,0.5837130717286423
33939,2997.347267,2997.370033,1,89920418,89921100,682,0.05269231500080887
33940,2997.391067,2997.410133,1,89921732,89922303,571,0.6182331360006608
33941,2997.4479,2997.4535,1,89923437,89923605,168,0.3460047743667055
33942,2997.485767,2997.492733,1,89924573,89924781,208,0.3950438190311198
33943,2997.5147,2997.5232,1,89925441,89925696,255,0.30751134439121147
33944,2997.525367,2997.531233,1,89925761,89925936,175,-0.029125559650508465
33945,2997.549067,2997.572267,1,89926472,89927168,696,0.16555940493177115
33946,2997.5893,2997.5957,1,89927679,89927871,192,0.31635815565705494
33947,2997.606467,2997.6324,1,89928194,89928972,778,-0.05843706536993924
33948,2997.645467,2997.650667,1,89929364,89929520,156,
33949,2997.670267,2997.679433,1,89930108,89930382,274,0.2410338931856936
33950,2997.681367,2997.694333,1,89930441,89930829,388,-0.03407935853778416
33951,2997.702633,2997.7171,1,89931078,89931513,435,-0.09199217614448907
33952,2997.718367,2997.7277,1,89931551,89931831,280,0.33092019560150454
33953,2997.7417,2997.766333,1,89932251,89932989,738,-0.056991405574419035
33954,2997.773667,2997.793867,1,89933210,89933816,606,0.16438465682644743
33955,2997.797267,2997.8161,1,89933918,89934483,565,0.1639043641136959
33956,2997.821567,2997.826133,1,89934647,89934783,136,-0.22408835728864954
33957,2997.829667,2997.834233,1,89934890,89935026,136,
33958,2997.8814,2997.895833,1,89936442,89936874,432,-0.035178359897006684
33959,2997.8969,2997.905667,1,89936907,89937170,263,-0.0769930751737074
33960,2997.911833,2997.931533,1,89937354,89937945,591,
33961,2997.936533,2997.961933,1,89938095,89938857,762,0.4929324263636625
33962,2997.975233,2997.993467,1,89939256,89939804,548,0.288816838412421
33963,2998.005467,2998.017233,1,89940164,89940516,352,-0.07380099086317878
33964,2998.0377,2998.043167,1,89941131,89941295,164,-0.3411254079519804
33965,2998.053467,2998.068,1,89941604,89942040,436,-0.13138792006113212
33966,2998.0711,2998.0996,1,89942133,89942988,855,0.03999634657892481
33967,2998.104433,2998.113733,1,89943132,89943411,279,-0.06859453645455103
33968,2998.1156,2998.151733,1,89943468,89944551,1083,-0.07996622822169482
33969,2998.154433,2998.1698,1,89944632,89945094,462,-0.06515722881393204
33970,2998.171,2998.2007,1,89945130,89946021,891,-0.059414386619158176
33971,2998.201767,2998.205933,1,89946053,89946177,124,
33972,2998.210033,2998.250833,1,89946300,89947524,1224,0.04989483494561628
33973,2998.266467,2998.2712,1,89947994,89948136,142,
33974,2998.283633,2998.289867,1,89948508,89948696,188,-0.06069547363383878
33975,2998.425267,2998.428333,1,89952758,89952849,91,0.8387413620465989
33976,2998.446533,2998.4625,1,89953395,89953875,480,0.3163289503509329
33977,2998.483067,2998.489067,1,89954492,89954672,180,0.42469815770881786
33978,2998.490867,2998.494633,1,89954726,89954838,112,0.2816641893902962
33979,2998.495733,2998.498833,1,89954871,89954964,93,
33980,2998.499833,2998.506867,1,89954994,89955206,212,0.633024270581998
33981,2998.508467,2998.5307,1,89955254,89955921,667,-0.0666856435800895
33982,2998.531833,2998.540133,1,89955954,89956203,249,
33983,2998.542633,2998.5471,1,89956278,89956413,135,
33984,2998.555533,2998.559033,1,89956665,89956770,105,-0.18247453121402457
33985,2998.565867,2998.642733,1,89956976,89959281,2305,-0.047135267853758635
33986,2998.645133,2998.657033,1,89959353,89959710,357,-0.09835811908393144
33987,2998.6615,2998.677133,1,89959845,89960313,468,-0.08488399354728174
33988,2998.6793,2998.7149,1,89960379,89961447,1068,-0.07420780395819673
33989,2998.718433,2998.722667,1,89961552,89961680,128,0.5792816418334285
33990,2998.727467,2998.730533,1,89961824,89961915,91,
33991,2998.732433,2998.761433,1,89961972,89962842,870,-0.06152135740293169
33992,2998.7631,2998.7664,1,89962893,89962992,99,
33993,2999.167067,2999.1945,1,89975012,89975835,823,0.1279977302018942
33994,2999.227767,2999.2321,1,89976833,89976963,130,-0.09980733263805294
33995,2999.2523,2999.2567,1,89977569,89977701,132,
33996,2999.281233,2999.293833,1,89978436,89978814,378,0.20370076852258184
33997,2999.303567,2999.3104,1,89979107,89979312,205,0.1650891335429862
33998,2999.3161,2999.334733,1,89979483,89980041,558,-0.09711931445027129
33999,2999.355833,2999.382367,1,89980674,89981471,797,0.13740509295912862
34000,2999.388733,2999.4026,1,89981661,89982078,417,0.6305164716982681
34001,2999.405433,2999.415067,1,89982162,89982452,290,-0.07699422302364221
34002,2999.460033,2999.467433,1,89983800,89984022,222,0.7101292727081051
34003,2999.469433,2999.475067,1,89984082,89984252,170,
34004,2999.4765,2999.4815,1,89984295,89984445,150,
34005,2999.4867,2999.499733,1,89984601,89984991,390,-0.11472916209224626
34006,2999.502467,2999.506133,1,89985074,89985183,109,0.16785082119233014
34007,2999.5072,2999.5122,1,89985216,89985366,150,0.4382366612413183
34008,2999.5302,2999.5342,1,89985906,89986026,120,0.42645766625045095
34009,2999.546667,2999.553467,1,89986400,89986604,204,0.5206913128029631
34010,2999.566167,2999.5729,1,89986985,89987187,202,
34011,2999.574567,2999.579667,1,89987237,89987390,153,0.8173795153595812
34012,2999.655667,2999.6592,1,89989670,89989776,106,
34013,2999.6785,2999.682767,1,89990355,89990483,128,-0.03818789971603435
34014,2999.684733,2999.689,1,89990541,89990670,129,-0.1740896177622724
34015,2999.694867,2999.697867,1,89990846,89990936,90,
34016,2999.7008,2999.7138,1,89991024,89991414,390,-0.0019990419661597945
34017,2999.719333,2999.743767,1,89991579,89992313,734,0.19643233909799782
34018,2999.759767,2999.781867,1,89992793,89993456,663,0.05185906128051216
34019,2999.817767,2999.8253,1,89994533,89994759,226,0.16546788341263424
34020,2999.843767,2999.849367,1,89995313,89995481,168,-0.13454756076470736
34021,2999.878533,2999.883533,1,89996355,89996505,150,
34022,2999.8846,2999.897467,1,89996538,89996924,386,0.2505986261108704
34023,2999.9176,2999.924033,1,89997528,89997720,192,0.36311458681535985
34024,2999.9304,2999.9643,1,89997912,89998929,1017,0.13909938675951958
34025,2999.966167,2999.975067,1,89998985,89999252,267,
34026,3000.014067,3000.019733,1,90000422,90000591,169,0.22882344781130834
34027,3000.087433,3000.091433,1,90002622,90002742,120,
34028,3000.132533,3000.135633,1,90003975,90004068,93,
34029,3000.137567,3000.1427,1,90004127,90004281,154,0.3187774858952217
34030,3000.148333,3000.1639,1,90004449,90004917,468,0.037356241536502924
34031,3000.165333,3000.175667,1,90004959,90005270,311,-0.14058947948435171
34032,3000.193067,3000.212167,1,90005792,90006365,573,-0.019499100321135377
34033,3000.2178,3000.242067,1,90006534,90007262,728,-0.13562402442802002
34034,3000.249667,3000.2643,1,90007490,90007929,439,0.3954182402428571
34035,3000.314967,3000.325267,1,90009449,90009758,309,-0.21171077018180737
34036,3000.351133,3000.354133,1,90010533,90010623,90,
34037,3000.3576,3000.362233,1,90010728,90010866,138,0.6530687963399668
34038,3000.363433,3000.3666,1,90010902,90010998,96,0.6068774739662367
34039,3000.3963,3000.400867,1,90011889,90012026,137,-0.2024688685623045
34040,3000.444467,3000.456533,1,90013334,90013695,361,0.06552627207321389
34041,3000.463833,3000.472833,1,90013914,90014184,270,0.3369373374280783
34042,3000.476,3000.484767,1,90014280,90014543,263,-0.10725762178353847
34043,3000.4944,3000.5448,1,90014832,90016344,1512,0.08764209292343393
34044,3000.5466,3000.559033,1,90016398,90016770,372,0.04483002815697608
34045,3000.562433,3000.565867,1,90016872,90016976,104,
34046,3000.569467,3000.616067,1,90017084,90018482,1398,0.22061644907656494
34047,3000.6874,3000.709,1,90020622,90021270,648,0.41840623944051036
34048,3000.723633,3000.733833,1,90021708,90022014,306,0.5245044793543293
34049,3000.7742,3000.784367,1,90023226,90023531,305,0.45674984297243876
34050,3000.7859,3000.793467,1,90023577,90023804,227,-0.07923173245300681
34051,3000.805633,3000.813933,1,90024168,90024417,249,0.029452083425977632
34052,3000.8329,3000.837167,1,90024987,90025115,128,
34053,3000.858833,3000.866533,1,90025764,90025995,231,0.008936502967560172
34054,3000.874533,3000.888933,1,90026235,90026667,432,-0.009114549684810767
34055,3000.900367,3000.905433,1,90027011,90027162,151,0.6815169938128064
34056,3000.907167,3000.9308,1,90027215,90027924,709,-0.07616203589910635
34057,3000.9323,3000.938,1,90027969,90028140,171,0.06517803633973798
34058,3000.948067,3000.958767,1,90028442,90028763,321,0.15948449729501865
34059,3000.9727,3000.996133,1,90029181,90029883,702,0.2977324689634036
34060,3001.009333,3001.031933,1,90030279,90030957,678,-0.10404904549880438
34061,3001.080133,3001.083267,1,90032403,90032498,95,
34062,3001.099233,3001.103067,1,90032976,90033092,116,0.4692453300406637
34063,3001.1055,3001.112633,1,90033165,90033378,213,
34064,3001.360367,3001.364667,1,90040811,90040940,129,0.7173552195535265
34065,3001.462867,3001.466,1,90043886,90043980,94,0.1826604945023285
34066,3001.4722,3001.483633,1,90044166,90044508,342,-0.11870545787598026
34067,3001.497967,3001.503433,1,90044939,90045102,163,-0.30710928157590694
34068,3001.508,3001.511867,1,90045240,90045356,116,0.07478182539225976
34069,3001.5129,3001.516833,1,90045387,90045504,117,-0.22197397471037306
34070,3001.525567,3001.529367,1,90045767,90045881,114,
34071,3001.531133,3001.541867,1,90045933,90046256,323,0.6624177215919012
34072,3001.789667,3001.799467,1,90053690,90053984,294,0.31631956937926753
34073,3001.8363,3001.840433,1,90055089,90055212,123,
34074,3002.020633,3002.0374,1,90060618,90061122,504,-0.07584402769334063
34075,3002.043433,3002.0509,1,90061302,90061527,225,0.1718202610104277
34076,3002.158,3002.179233,1,90064740,90065376,636,-0.029583152916862983
34077,3002.189767,3002.195967,1,90065693,90065879,186,0.16572691474010562
34078,3002.2263,3002.232467,1,90066789,90066974,185,0.4591736859194466
34079,3002.2933,3002.3061,1,90068799,90069183,384,-0.15172059727677847
34080,3002.314933,3002.325667,1,90069447,90069770,323,0.736171244091717
34081,3002.3268,3002.335833,1,90069804,90070074,270,0.6176080465906328
34082,3002.3486,3002.3652,1,90070458,90070956,498,0.10683563699187956
34083,3002.367067,3002.3788,1,90071012,90071364,352,0.2977724725068009
34084,3002.388167,3002.4036,1,90071645,90072108,463,-0.04359734897334833
34085,3002.4069,3002.4216,1,90072207,90072648,441,0.1558364825572414
34086,3002.460933,3002.4732,1,90073827,90074196,369,0.03499856016987322
34087,3002.489867,3002.4935,1,90074696,90074805,109,0.5865482689690829
34088,3002.5051,3002.511233,1,90075153,90075336,183,-0.055996423795572736
34089,3002.565467,3002.574467,1,90076964,90077234,270,-0.11392832551736647
34090,3002.586533,3002.596833,1,90077595,90077904,309,0.34378345221270284
34091,3002.609833,3002.625333,1,90078294,90078759,465,-0.0959419513746146
34092,3002.631033,3002.6371,1,90078930,90079113,183,0.7134799060051114
34093,3002.6383,3002.642633,1,90079149,90079278,129,0.19671378212172733
34094,3002.6582,3002.661467,1,90079746,90079844,98,0.3251360355798268
34095,3002.7125,3002.720067,1,90081375,90081602,227,-0.23978659824612517
34096,3002.778967,3002.788033,1,90083369,90083640,271,0.29518300171872686
34097,3002.797267,3002.8012,1,90083918,90084036,118,0.5445016287734232
34098,3002.8107,3002.817533,1,90084321,90084525,204,-0.39547369517246933
34099,3002.827433,3002.8438,1,90084822,90085314,492,0.06366635811055031
34100,3002.869733,3002.8778,1,90086091,90086334,243,0.4731562730481578
34101,3002.917933,3002.9285,1,90087537,90087855,318,0.10411243394876661
34102,3003.045567,3003.048733,1,90091367,90091461,94,
34103,3003.146667,3003.152,1,90094400,90094560,160,0.6895128141329409
34104,3003.177633,3003.183233,1,90095328,90095496,168,-0.061537027611250114
34105,3003.202133,3003.205267,1,90096063,90096158,95,
34106,3003.212133,3003.218133,1,90096363,90096543,180,-0.11751040504999452
34107,3003.221967,3003.232867,1,90096659,90096986,327,0.4768814469717625
34108,3003.247167,3003.2738,1,90097415,90098214,799,0.02861286471098397
34109,3003.3902,3003.394667,1,90101706,90101840,134,0.3271027042674999
34110,3003.411167,3003.4196,1,90102335,90102588,253,0.01167438649027574
34111,3003.420833,3003.442067,1,90102624,90103262,638,-0.02405992564564369
34112,3003.488767,3003.493233,1,90104663,90104796,133,0.08878047443931585
34113,3003.575967,3003.603433,1,90107279,90108102,823,-0.012483610066250185
34114,3003.806267,3003.826333,1,90114188,90114789,601,0.11404779323866016
34115,3003.937667,3003.966133,1,90118130,90118983,853,-0.054861514260583014
34116,3004.004767,3004.036233,1,90120143,90121086,943,0.13767516492049048
34117,3004.041133,3004.0463,1,90121233,90121389,156,0.5070196573569962
34118,3004.047767,3004.074567,1,90121433,90122237,804,-0.05828069874321981
34119,3004.079067,3004.094967,1,90122372,90122849,477,0.18906634796271926
34120,3004.114667,3004.125967,1,90123440,90123779,339,0.04171988452856415
34121,3004.131533,3004.1357,1,90123945,90124071,126,
34122,3004.138667,3004.1425,1,90124160,90124275,115,0.7334541753523484
34123,3004.150133,3004.1533,1,90124503,90124599,96,0.9538916260971936
34124,3004.2851,3004.2909,1,90128553,90128727,174,0.3051953715077139
34125,3004.3038,3004.314567,1,90129114,90129437,323,-0.07607917771532996
34126,3004.469733,3004.479367,1,90134091,90134381,290,0.2951849324460943
34127,3004.493733,3004.500067,1,90134811,90135002,191,0.06987332451775596
34128,3004.508533,3004.5155,1,90135255,90135465,210,0.5279345384177706
34129,3004.530367,3004.5342,1,90135911,90136026,115,
34130,3004.5379,3004.543133,1,90136137,90136293,156,-0.16465823753346423
34131,3004.5551,3004.5617,1,90136653,90136851,198,0.8167480150257904
34132,3004.570667,3004.575233,1,90137120,90137256,136,0.32890548578324585
34133,3004.5834,3004.596667,1,90137502,90137900,398,-0.083330025603869
34134,3004.598867,3004.609233,1,90137966,90138276,310,0.16527649405208922
34135,3004.622533,3004.645167,1,90138675,90139355,680,0.04458525712766881
34136,3004.6495,3004.6582,1,90139485,90139746,261,0.1866640911449956
34137,3004.659467,3004.669833,1,90139784,90140094,310,-0.07610338043317325
34138,3004.681267,3004.6947,1,90140438,90140841,403,-0.03297327458358453
34139,3004.700367,3004.707867,1,90141011,90141236,225,0.3604920040967824
34140,3004.7215,3004.7268,1,90141645,90141804,159,
34141,3004.742033,3004.745067,1,90142260,90142352,92,
34142,3004.8118,3004.814967,1,90144354,90144449,95,
34143,3004.8255,3004.8523,1,90144765,90145569,804,0.02746817171028438
34144,3004.853567,3004.8574,1,90145607,90145722,115,-0.21217307962316873
34145,3004.894,3004.899033,1,90146820,90146970,150,0.28384569721176783
34146,3004.987033,3005.009933,1,90149610,90150297,687,-0.0361904726759156
34147,3005.186767,3005.211367,1,90155603,90156341,738,-0.057502493488453196
34148,3005.279633,3005.283167,1,90158388,90158495,107,0.6272550595384879
34149,3005.3062,3005.336133,1,90159186,90160083,897,-0.015723941604159075
34150,3005.3557,3005.360167,1,90160671,90160805,134,0.03029957934588699
34151,3005.367433,3005.373767,1,90161022,90161213,191,0.1523379011204947
34152,3005.377633,3005.380833,1,90161328,90161424,96,
34153,3005.447533,3005.451867,1,90163425,90163556,131,0.0013861525240706808
34154,3005.4562,3005.460367,1,90163686,90163811,125,-0.18824514120746838
34155,3005.471067,3005.4753,1,90164132,90164259,127,0.5185867409244365
34156,3005.491067,3005.4948,1,90164732,90164844,112,
34157,3005.501867,3005.5114,1,90165056,90165342,286,-0.04239936397291802
34158,3005.533267,3005.5368,1,90165998,90166104,106,0.2728450433034079
34159,3005.566567,3005.569667,1,90166997,90167090,93,
34160,3005.727933,3005.7329,1,90171837,90171987,150,-0.08755475775864807
34161,3005.734633,3005.7553,1,90172038,90172659,621,0.004179721389199619
34162,3005.928667,3005.9324,1,90177860,90177972,112,-0.01963499391920198
34163,3005.946333,3005.950367,1,90178389,90178511,122,0.04783572896486666
34164,3005.9555,3005.960467,1,90178665,90178814,149,0.5933154810309205
34165,3006.013733,3006.0199,1,90180411,90180597,186,0.5649599157988077
34166,3006.033367,3006.039233,1,90181001,90181176,175,0.1938316391966581
34167,3006.043633,3006.047367,1,90181308,90181421,113,0.21892146979775362
34168,3006.097167,3006.1007,1,90182915,90183021,106,-0.18599705688999923
34169,3006.116733,3006.130867,1,90183501,90183926,425,0.02080589300913784
34170,3006.4627,3006.474067,1,90193881,90194222,341,0.5529793794810552
34171,3007.6868,3007.708233,1,90230604,90231246,642,0.3073310651632847
34172,3007.712533,3007.718233,1,90231375,90231546,171,-0.10818677682872815
34173,3007.796167,3007.801467,1,90233885,90234044,159,-0.23897958629846966
34174,3007.813933,3007.818133,1,90234417,90234543,126,0.3201794244462593
34175,3007.851233,3007.882367,1,90235536,90236471,935,0.16037681006978952
34176,3007.895267,3007.916367,1,90236858,90237491,633,-0.03699845615902822
34177,3007.936,3007.942533,1,90238080,90238275,195,0.38101272766147254
34178,3008.0012,3008.007167,1,90240036,90240215,179,0.13134095577951121
34179,3008.021167,3008.043633,1,90240635,90241308,673,-0.07233750004078476
34180,3008.065567,3008.078667,1,90241967,90242360,393,0.4564341860706558
34181,3008.0811,3008.092967,1,90242433,90242789,356,0.4148442263542272
34182,3008.094567,3008.0989,1,90242837,90242967,130,0.7751710959953746
34183,3008.109167,3008.134867,1,90243275,90244046,771,-0.0429787984971927
34184,3008.161867,3008.19,1,90244856,90245700,844,0.2903164743599801
34185,3008.193433,3008.220233,1,90245802,90246606,804,0.07396147928172703
34186,3008.239,3008.242833,1,90247170,90247284,114,0.19799309647735436
34187,3008.257933,3008.267833,1,90247737,90248034,297,0.28530897080766265
34188,3008.272933,3008.276533,1,90248187,90248295,108,0.19884283222793372
34189,3008.317033,3008.331467,1,90249510,90249944,434,-0.10353520614236647
34190,3008.340733,3008.355233,1,90250221,90250656,435,0.35195706508771935
34191,3008.4904,3008.513933,1,90254712,90255417,705,-0.0016827655872673607
34192,3008.627933,3008.6591,1,90258837,90259773,936,-0.0931178960792356
34193,3008.707,3008.711667,1,90261210,90261350,140,0.14557165864542593
34194,3008.720333,3008.724233,1,90261609,90261726,117,-0.2904419221893478
34195,3008.725233,3008.742867,1,90261756,90262286,530,-0.04126497749233501
34196,3009.473833,3009.487367,1,90284214,90284621,407,-0.07555969518167646
34197,3009.499633,3009.507633,1,90284988,90285228,240,-0.09625490933792688
34198,3009.609167,3009.6304,1,90288275,90288912,637,0.06727059754401327
34199,3009.6339,3009.6445,1,90289017,90289335,318,-0.05568959425522597
34200,3009.646267,3009.651667,1,90289388,90289550,162,-0.12444498911802433
34201,3009.652667,3009.657233,1,90289580,90289716,136,0.2651553968647652
34202,3009.668233,3009.6741,1,90290046,90290223,177,0.31269021909005473
34203,3010.096967,3010.1007,1,90302909,90303021,112,0.5834227436635722
34204,3010.101867,3010.104967,1,90303056,90303149,93,-0.2697608814030847
34205,3010.106267,3010.116033,1,90303188,90303480,292,0.4432326057031571
34206,3010.121167,3010.1676,1,90303635,90305028,1393,0.7172252990038581
34207,3010.169333,3010.213667,1,90305079,90306410,1331,0.7263087358902941
34208,3010.235767,3010.261267,1,90307073,90307838,765,0.2392032033729568
34209,3010.263033,3010.2903,1,90307890,90308709,819,-0.050741151748629004
34210,3010.297267,3010.306467,1,90308918,90309194,276,0.14738771562694586
34211,3010.335367,3010.348667,1,90310061,90310460,399,0.057835683036014884
34212,3010.360367,3010.367367,1,90310811,90311021,210,0.22450883106694536
34213,3010.3702,3010.452967,1,90311106,90313589,2483,0.10306285795956821
34214,3010.480033,3010.483567,1,90314400,90314507,107,-0.16784818662645157
34215,3010.493233,3010.496533,1,90314796,90314895,99,0.0007099021748819093
34216,3010.5024,3010.5099,1,90315072,90315297,225,-0.09642873102836727
34217,3010.514867,3010.5199,1,90315446,90315597,151,0.056930361951398646
34218,3010.527733,3010.536133,1,90315831,90316083,252,0.5951586224266641
34219,3010.544233,3010.578867,1,90316326,90317366,1040,0.11302430832220697
34220,3010.592767,3010.6192,1,90317783,90318576,793,0.0018743850430412948
34221,3010.643933,3010.648233,1,90319317,90319446,129,-0.2500130310546801
34222,3011.1417,3011.1459,1,90334251,90334377,126,0.08892753907302879
34223,3011.1517,3011.160667,1,90334551,90334820,269,0.3930175439901693
34224,3011.161833,3011.192333,1,90334854,90335769,915,0.014526522531255132
34225,3011.194,3011.231367,1,90335820,90336941,1121,0.1151524430669161
34226,3011.276667,3011.281133,1,90338300,90338433,133,-0.19683075998412963
34227,3012.7277,3012.828567,1,90381831,90384857,3026,0.819118648476743
34228,3013.4284,3013.4495,1,90402852,90403485,633,0.9218612174539269
34229,3013.476967,3013.480667,1,90404309,90404420,111,0.7914049492963224
34230,3013.4841,3013.493033,1,90404523,90404790,267,0.7756365834878786
34231,3013.5028,3013.519033,1,90405084,90405570,486,0.717782705986183
34232,3013.520133,3013.525333,1,90405603,90405759,156,0.4616543197096916
34233,3013.529867,3013.587267,1,90405896,90407618,1722,0.6589513500321834
34234,3013.603067,3013.623967,1,90408092,90408719,627,0.7983212682784834
34235,3013.644367,3013.658533,1,90409331,90409755,424,0.7633738375601351
34236,3013.666867,3013.6843,1,90410006,90410529,523,0.7731571776873656
34237,3013.7974,3013.814167,1,90413922,90414425,503,0.6641472046557304
34238,3013.818467,3013.826067,1,90414554,90414782,228,0.6376213657043682
34239,3013.863533,3013.8796,1,90415905,90416388,483,0.6713559227939047
34240,3014.107233,3014.1534,1,90423216,90424602,1386,0.4870034020729124
34241,3014.156867,3014.159967,1,90424706,90424799,93,0.7579268107216858
34242,3014.5409,3014.755067,1,90436227,90442652,6425,0.8049562695401664
34243,3014.897767,3014.9054,1,90446933,90447162,229,0.5422119880182174
34244,3015.237,3015.2524,1,90457110,90457572,462,0.4980846489614776
34245,3015.279033,3015.299,1,90458370,90458970,600,0.6916571378931027
34246,3015.310167,3015.362333,1,90459305,90460869,1564,0.8218606755731944
34247,3015.370333,3015.474733,1,90461109,90464241,3132,0.8002117574242591
34248,3015.4786,3015.4831,1,90464358,90464493,135,0.6665634656994545
34249,3015.5,3015.5673,1,90465000,90467019,2019,0.7696420047331878
34250,3015.5757,3015.639467,1,90467271,90469184,1913,0.6913220423517705
34251,3015.6427,3015.718633,1,90469281,90471558,2277,0.7271391409396912
34252,3015.727567,3015.735633,1,90471827,90472068,241,0.5251027161240871
34253,3015.737733,3015.7504,1,90472131,90472512,381,0.7488948141960732
34254,3015.757,3015.7671,1,90472710,90473013,303,0.6877961250062156
34255,3016.1378,3016.3274,1,90484134,90489822,5688,0.8055452833272647
34256,3016.3509,3016.369233,1,90490527,90491076,549,0.7404771425706567
34257,3016.370833,3016.376067,1,90491124,90491282,158,0.7117207893198518
34258,3016.378933,3016.556867,1,90491367,90496706,5339,0.7780662952338173
34259,3016.601667,3016.604767,1,90498050,90498143,93,
34260,3016.9517,3017.0074,1,90508551,90510222,1671,0.7887657541445242
34261,3017.017133,3017.030133,1,90510513,90510903,390,0.2403046789369347
34262,3017.4047,3017.411233,1,90522141,90522336,195,0.6797633650728435
34263,3017.413167,3017.4268,1,90522395,90522804,409,0.6817137584441633
34264,3017.4402,3017.443233,1,90523206,90523296,90,0.6837639845710112
34265,3017.444333,3017.5145,1,90523329,90525435,2106,0.7722566588204349
34266,3017.925867,3017.935267,1,90537776,90538058,282,0.7167830407175848
34267,3017.938933,3017.962,1,90538167,90538860,693,0.6197892745002
34268,3017.983567,3018.082233,1,90539507,90542466,2959,0.773490163747835
34269,3018.100067,3018.103433,1,90543002,90543102,100,-0.008445052331906747
34270,3018.408033,3018.412267,1,90552240,90552368,128,0.5461493237465904
34271,3018.428967,3018.434267,1,90552869,90553028,159,0.8136703897700369
34272,3018.435267,3018.439,1,90553058,90553170,112,0.41883526988312497
34273,3018.473167,3018.487967,1,90554195,90554639,444,0.6616335501373908
34274,3018.4969,3018.506333,1,90554907,90555189,282,0.6951988407177991
34275,3018.5364,3018.557067,1,90556092,90556712,620,0.7536857110616462
34276,3018.5922,3018.602567,1,90557766,90558077,311,0.7893650818333426
34277,3018.6153,3018.665733,1,90558459,90559971,1512,0.6784853279358772
34278,3018.6829,3018.696567,1,90560487,90560897,410,0.6459657876596512
34279,3018.7017,3018.712167,1,90561051,90561365,314,0.5987809449404192
34280,3018.7363,3018.744667,1,90562089,90562340,251,-0.121826993341959
34281,3018.756533,3018.765033,1,90562695,90562950,255,-0.10388027603220405
34282,3018.767467,3018.785333,1,90563024,90563559,535,0.036545088874415606
34283,3018.7869,3018.8082,1,90563607,90564246,639,0.21779524649180504
34284,3018.809333,3018.815233,1,90564279,90564456,177,0.37192587320168324
34285,3018.820367,3018.964967,1,90564611,90568949,4338,0.8127973118060978
34286,3018.977233,3019.1482,1,90569316,90574446,5130,0.7376191397243722
34287,3019.158667,3019.162733,1,90574760,90574881,121,-0.06277582217121112
34288,3019.560133,3019.567367,1,90586803,90587021,218,0.5058103968547296
34289,3019.5712,3019.584067,1,90587136,90587522,386,0.8141104361066605
34290,3019.5944,3019.6264,1,90587832,90588792,960,0.7193618518797942
34291,3019.6372,3019.661833,1,90589116,90589854,738,0.7342003536754118
34292,3019.665633,3019.669867,1,90589968,90590096,128,0.15760240024455283
34293,3019.692967,3019.720633,1,90590789,90591618,829,0.7193796754602109
34294,3019.7316,3019.735133,1,90591948,90592053,105,0.9415331060280145
34295,3019.7364,3019.7424,1,90592092,90592272,180,0.2265492655260876
34296,3019.743433,3019.8126,1,90592302,90594378,2076,0.73621152550853
34297,3019.825167,3019.875267,1,90594755,90596258,1503,0.818142292091653
34298,3019.876933,3019.904667,1,90596307,90597140,833,0.6508516625412948
34299,3019.9071,3019.9122,1,90597213,90597366,153,0.2996663013383258
34300,3019.928833,3020.014833,1,90597864,90600444,2580,0.7713582252158814
34301,3020.0161,3020.019167,1,90600483,90600575,92,0.6773841675277907
34302,3020.0246,3020.0277,1,90600738,90600831,93,0.7101467660653142
34303,3020.032933,3020.035967,1,90600987,90601079,92,-0.2189205197026313
34304,3020.040767,3020.044067,1,90601223,90601322,99,-0.04315104130514552
34305,3020.046467,3020.049933,1,90601394,90601497,103,-0.07249916424757114
34306,3020.3677,3020.449333,1,90611031,90613479,2448,0.6788104553263196
34307,3020.4568,3020.4681,1,90613704,90614043,339,0.7325483167763358
34308,3020.471033,3020.5866,1,90614130,90617598,3468,0.7714142919972056
34309,3020.626133,3020.629833,1,90618783,90618894,111,
34310,3020.633167,3020.6368,1,90618995,90619104,109,0.5363430036580074
34311,3021.096267,3021.099267,1,90632888,90632978,90,0.8483124626803391
34312,3021.1096,3021.208367,1,90633288,90636251,2963,0.8011408099807673
34313,3021.21,3021.295167,1,90636300,90638855,2555,0.7852721005310661
34314,3021.3051,3021.340833,1,90639153,90640224,1071,0.7653457765541091
34315,3021.382633,3021.431467,1,90641478,90642944,1466,0.6617215397199553
34316,3021.4325,3021.500367,1,90642975,90645011,2036,0.8066716287384792
34317,3021.7805,3021.8859,1,90653415,90656577,3162,0.8746462245309347
34318,3022.187867,3022.210533,1,90665636,90666315,679,0.7471529211033795
34319,3022.238667,3022.246733,1,90667160,90667401,241,0.6342623039300489
34320,3022.247967,3022.251367,1,90667439,90667541,102,0.6939272388228721
34321,3022.263167,3022.314033,1,90667895,90669420,1525,0.8227107085152175
34322,3022.3235,3022.360333,1,90669705,90670809,1104,0.797619131318452
34323,3022.366867,3022.433533,1,90671006,90673005,1999,0.8393385211351693
34324,3022.4364,3022.515033,1,90673092,90675450,2358,0.7707609794571908
34325,3022.519767,3022.535,1,90675593,90676050,457,0.6762752737861449
34326,3022.5409,3022.592,1,90676227,90677760,1533,0.7617138862495365
34327,3022.6017,3022.609833,1,90678051,90678294,243,0.7785138166866612
34328,3022.813067,3022.9273,1,90684392,90687819,3427,0.8430892095420328
34329,3023.235033,3023.2431,1,90697050,90697293,243,0.6342845422965493
34330,3023.245,3023.388733,1,90697350,90701661,4311,0.8404955765526964
34331,3023.400833,3023.404167,1,90702024,90702125,101,0.9331783840461652
34332,3023.4053,3023.449733,1,90702159,90703491,1332,0.7787615763767117
34333,3023.453867,3023.526767,1,90703616,90705803,2187,0.7688352393973905
34334,3023.530233,3023.533433,1,90705906,90706002,96,0.049390317011345754
34335,3023.5349,3023.542633,1,90706047,90706278,231,0.600832858325144
34336,3023.545967,3023.628467,1,90706379,90708854,2475,0.7764893699728898
34337,3023.6495,3023.6526,1,90709485,90709578,93,
34338,3023.932633,3023.937833,1,90717978,90718134,156,0.15994233678321543
34339,3023.9423,3024.135533,1,90718269,90724065,5796,0.8586065923651061
34340,3024.223367,3024.2523,1,90726701,90727569,868,0.6461907981919953
34341,3024.2605,3024.345633,1,90727815,90730368,2553,0.8333584142164636
34342,3024.6723,3024.679867,1,90740169,90740396,227,0.6188083793411799
34343,3024.681267,3024.698433,1,90740438,90740952,514,0.8165350773949296
34344,3024.7014,3024.8,1,90741042,90744000,2958,0.8544278061814949
34345,3024.801133,3024.842167,1,90744033,90745265,1232,0.8246020046309077
34346,3024.851633,3024.854733,1,90745548,90745641,93,0.7588793216509269
34347,3024.863633,3024.8953,1,90745908,90746859,951,0.7845591695904255
34348,3024.896667,3024.966533,1,90746900,90748995,2095,0.7617629857976193
34349,3024.9791,3024.983233,1,90749373,90749496,123,-0.015009060126693292
34350,3024.985967,3025.083067,1,90749579,90752492,2913,0.8220718914578272
34351,3025.114167,3025.117533,1,90753425,90753525,100,
34352,3025.124767,3025.1295,1,90753743,90753885,142,0.3018158266882511
34353,3025.139567,3025.229633,1,90754187,90756888,2701,0.7874584363309673
34354,3025.5711,3025.576633,1,90767133,90767298,165,0.4243871764670131
34355,3025.578533,3025.594233,1,90767355,90767826,471,0.736008353211924
34356,3025.595233,3025.71,1,90767856,90771300,3444,0.8379155476393653
34357,3025.721633,3025.8412,1,90771648,90775236,3588,0.8392164568932122
34358,3025.849033,3026.043133,1,90775470,90781293,5823,0.8012354449482444
34359,3026.070733,3026.0754,1,90782121,90782262,141,0.5457482550054613
34360,3026.0838,3026.0897,1,90782514,90782691,177,
34361,3026.0908,3026.103967,1,90782724,90783119,395,0.15629579596636753
34362,3026.106367,3026.109467,1,90783191,90783284,93,0.6329469457293647
34363,3026.4602,3026.535733,1,90793806,90796071,2265,0.5536430510633207
34364,3026.548867,3026.5839,1,90796466,90797517,1051,0.6554689659078733
34365,3026.602333,3026.6059,1,90798069,90798177,108,0.5849890029425336
34366,3026.6071,3026.618867,1,90798213,90798566,353,0.634224217859183
34367,3026.622633,3026.6413,1,90798678,90799239,561,0.5874988897320204
34368,3026.657833,3026.671067,1,90799734,90800132,398,0.5012043101254813
34369,3026.6953,3026.6992,1,90800859,90800976,117,-0.17042275690544947
34370,3026.707467,3026.747833,1,90801224,90802434,1210,0.01822918425912761
34371,3026.749,3026.7603,1,90802470,90802809,339,-0.13943979914156587
34372,3026.7682,3026.782667,1,90803046,90803480,434,0.5557376605202452
34373,3026.785433,3026.878267,1,90803562,90806348,2786,0.8258392317036449
34374,3026.909167,3026.9149,1,90807275,90807447,172,
34375,3026.917633,3026.9263,1,90807528,90807789,261,0.03543858405444425
34376,3027.113,3027.292567,1,90813390,90818777,5387,0.8573103135700327
34377,3027.2952,3027.298533,1,90818856,90818955,99,
34378,3027.300333,3027.348833,1,90819009,90820464,1455,0.8297811258880138
34379,3027.3612,3027.4043,1,90820836,90822129,1293,0.7822242996643896
34380,3027.420433,3027.524733,1,90822612,90825741,3129,0.784498263301632
34381,3027.556133,3027.5611,1,90826683,90826833,150,0.5899676618375721
34382,3027.872333,3027.878167,1,90836169,90836345,176,0.6923996342918822
34383,3027.8808,3027.884333,1,90836424,90836529,105,0.5806844356909827
34384,3027.890667,3027.9848,1,90836720,90839544,2824,0.7761312806910493
34385,3027.996633,3028.040133,1,90839898,90841203,1305,0.8117595222953446
34386,3028.041267,3028.0846,1,90841238,90842538,1300,0.7187005309861274
34387,3028.0881,3028.102767,1,90842643,90843083,440,0.6338632546451803
34388,3028.110367,3028.132333,1,90843311,90843969,658,0.7427675479921154
34389,3028.134067,3028.158433,1,90844022,90844752,730,0.8013627315170542
34390,3028.1642,3028.221767,1,90844926,90846653,1727,0.7923876106763159
34391,3028.230433,3028.248533,1,90846912,90847455,543,0.7442359632025115
34392,3028.253367,3028.262167,1,90847601,90847865,264,0.28680798964796667
34393,3028.278633,3028.288767,1,90848358,90848663,305,-0.10919759302319612
34394,3028.290633,3028.294133,1,90848718,90848823,105,-0.019090319059047362
34395,3028.301567,3028.3068,1,90849047,90849204,157,-0.14530974637344488
34396,3028.321467,3028.3303,1,90849644,90849909,265,0.3854556904417732
34397,3028.3734,3028.403333,1,90851202,90852099,897,0.7065951623946429
34398,3028.405067,3028.501433,1,90852152,90855042,2890,0.8397525740485393
34399,3028.5832,3028.713567,1,90857496,90861407,3911,0.8134354372431458
34400,3028.728967,3028.732767,1,90861869,90861983,114,-0.07146520382197205
34401,3029.0693,3029.0776,1,90872079,90872328,249,0.7389711953961237
34402,3029.080467,3029.1002,1,90872414,90873006,592,0.7352732016994008
34403,3029.101933,3029.1393,1,90873057,90874179,1122,0.8727225180699087
34404,3029.1421,3029.245467,1,90874263,90877364,3101,0.8172588637645612
34405,3029.246567,3029.301133,1,90877397,90879033,1636,0.8272634160615703
34406,3029.304667,3029.323667,1,90879140,90879710,570,0.7456310287280937
34407,3029.326867,3029.401267,1,90879806,90882038,2232,0.8113340427314597
34408,3029.423267,3029.4274,1,90882698,90882822,124,-0.19834997598452894
34409,3029.4444,3029.4493,1,90883332,90883479,147,0.600012803968676
34410,3029.827033,3029.830333,1,90894810,90894909,99,0.5537637243377328
34411,3029.8363,3029.839333,1,90895089,90895179,90,0.2656931859576156
34412,3029.8741,3029.899133,1,90896223,90896973,750,0.7308306483352106
34413,3029.933433,3029.952233,1,90898002,90898566,564,0.6435969085837581
34414,3029.954,3029.961467,1,90898620,90898844,224,0.693562947028595
34415,3029.964733,3030.0071,1,90898941,90900213,1272,0.6567260342270899
34416,3030.044067,3030.051067,1,90901322,90901532,210,0.46588529396967104
34417,3030.167367,3030.299,1,90905021,90908970,3949,0.8590026990150235
34418,3030.547667,3030.552067,1,90916430,90916562,132,0.5589690861595343
34419,3030.5623,3030.612867,1,90916869,90918386,1517,0.5979036459423733
34420,3030.6209,3030.663067,1,90918627,90919892,1265,0.8763162887396567
34421,3030.6781,3030.6991,1,90920343,90920973,630,-0.004469841891857057
34422,3030.703833,3030.720167,1,90921114,90921605,491,0.3140159271237301
34423,3031.0062,3031.011333,1,90930186,90930339,153,0.663801394994906
34424,3031.012433,3031.016833,1,90930372,90930504,132,0.47971006814895595
34425,3031.031333,3031.042733,1,90930939,90931281,342,0.5714596895956651
34426,3031.058633,3031.064267,1,90931758,90931928,170,0.603737984728427
34427,3031.070967,3031.075067,1,90932129,90932252,123,0.38979800749802557
34428,3031.076067,3031.0981,1,90932282,90932943,661,0.6298300906143678
34429,3031.101967,3031.105067,1,90933059,90933152,93,0.27836375510983935
34430,3031.120633,3031.133133,1,90933618,90933993,375,0.7080334158409214
34431,3031.134333,3031.137467,1,90934029,90934124,95,0.1722636880439771
34432,3031.138467,3031.148,1,90934154,90934440,286,0.5845582700928893
34433,3031.178867,3031.208267,1,90935366,90936248,882,0.5861067852064441
34434,3031.2247,3031.242633,1,90936741,90937278,537,0.5773415393847571
34435,3031.258733,3031.2688,1,90937761,90938064,303,0.49197045642447623
34436,3031.2927,3031.309467,1,90938781,90939284,503,0.6653529782256131
34437,3031.332233,3031.3415,1,90939966,90940245,279,0.6594267738501746
34438,3031.348533,3031.355467,1,90940455,90940664,209,0.629666081754894
34439,3031.396667,3031.4052,1,90941900,90942156,256,-0.022534568208028835
34440,3031.4079,3031.4407,1,90942237,90943221,984,0.2661696061805063
34441,3031.460767,3031.577133,1,90943823,90947313,3490,0.7669917695920695
34442,3031.8521,3032.153867,1,90955563,90964616,9053,0.7588767908285947
34443,3032.229,3032.2331,1,90966870,90966993,123,0.3522641401307727
34444,3032.521567,3032.5266,1,90975647,90975798,151,0.8381369521101435
34445,3032.528233,3032.538667,1,90975846,90976160,314,0.7840138553397947
34446,3032.542667,3032.6258,1,90976280,90978774,2494,0.879421039915719
34447,3032.6395,3032.682633,1,90979185,90980478,1293,0.6606304002161413
34448,3032.6861,3032.729933,1,90980583,90981897,1314,0.6967770785204446
34449,3032.7501,3032.7686,1,90982503,90983058,555,0.8108667413195655
34450,3032.785033,3032.798667,1,90983550,90983960,410,0.8093902245318136
34451,3032.809333,3032.824333,1,90984279,90984729,450,0.745472802973351
34452,3032.834,3032.837133,1,90985020,90985113,93,-0.03004691907926499
34453,3032.842,3032.8884,1,90985260,90986652,1392,0.11882035244057981
34454,3032.912233,3032.9162,1,90987366,90987486,120,0.4273956996543158
34455,3032.9233,3033.000867,1,90987699,90990026,2327,0.6628790837781287
34456,3033.0031,3033.017867,1,90990093,90990536,443,0.7186037549307764
34457,3033.029267,3033.0559,1,90990878,90991677,799,0.6776177836746343
34458,3033.0617,3033.064867,1,90991851,90991946,95,0.6196226125720286
34459,3033.065967,3033.1705,1,90991979,90995115,3136,0.8102160496862361
34460,3033.210333,3033.217033,1,90996309,90996510,201,0.02453078540724662
34461,3033.218767,3033.291967,1,90996563,90998759,2196,0.524122928845037
34462,3033.331233,3033.3388,1,90999936,91000164,228,0.2519670432190869
34463,3033.342133,3033.524533,1,91000263,91005735,5472,0.8436524012256962
34464,3034.0813,3034.1071,1,91022439,91023213,774,0.6877749854853985
34465,3034.1164,3034.1384,1,91023492,91024152,660,0.822848749595647
34466,3034.1571,3034.166633,1,91024713,91024998,285,0.9180736119180696
34467,3034.194267,3034.207733,1,91025828,91026231,403,0.7539267806824888
34468,3034.219933,3034.2245,1,91026597,91026735,138,0.43533119385364
34469,3034.2463,3034.265133,1,91027389,91027953,564,0.7577467979736153
34470,3034.276433,3034.2974,1,91028292,91028922,630,0.5788306588040111
34471,3034.2984,3034.306233,1,91028952,91029186,234,0.5665126125096303
34472,3034.314367,3034.3239,1,91029431,91029717,286,0.7442066890289268
34473,3034.3253,3034.359,1,91029759,91030770,1011,0.739702329456464
34474,3034.364367,3034.405867,1,91030931,91032176,1245,0.6182780471336653
34475,3034.443367,3034.450433,1,91033301,91033512,211,-0.019907364548466838
34476,3034.451533,3034.465067,1,91033545,91033952,407,0.045078033363431476
34477,3034.469233,3034.476767,1,91034076,91034303,227,0.13415280679598507
34478,3034.481433,3034.4979,1,91034442,91034937,495,0.07391982601576615
34479,3034.499267,3034.505733,1,91034978,91035171,193,0.3182294538868438
34480,3034.535967,3034.554767,1,91036079,91036643,564,0.7899039511414634
34481,3034.5567,3034.614867,1,91036701,91038446,1745,0.7609594448231172
34482,3034.616033,3034.652667,1,91038480,91039580,1100,0.7353288811130014
34483,3035.027533,3035.038433,1,91050825,91051152,327,0.4144508124409732
34484,3035.0616,3035.0888,1,91051848,91052664,816,0.8233384029085026
34485,3035.0902,3035.104733,1,91052706,91053141,435,0.7317463804443336
34486,3035.109633,3035.152633,1,91053288,91054578,1290,0.8437510703207178
34487,3035.1678,3035.180167,1,91055034,91055405,371,-0.11402201108762805
34488,3035.1846,3035.200733,1,91055538,91056021,483,0.07794452978211551
34489,3035.202667,3035.2142,1,91056080,91056426,346,0.26318498993950185
34490,3035.457,3035.461933,1,91063710,91063857,147,0.15484248085382335
34491,3035.466333,3035.518767,1,91063989,91065563,1574,0.7861426859058215
34492,3035.5199,3035.568767,1,91065597,91067063,1466,0.8371925853145779
34493,3035.596767,3035.6005,1,91067903,91068015,112,-0.13859683958326524
34494,3035.601567,3035.606533,1,91068047,91068195,148,
34495,3035.612433,3035.6155,1,91068372,91068465,93,
34496,3035.871633,3035.950533,1,91076148,91078515,2367,0.8242761631275327
34497,3035.963967,3035.9796,1,91078919,91079388,469,0.7381511192305247
34498,3035.991533,3036.017133,1,91079745,91080513,768,0.806578175209257
34499,3036.021033,3036.071033,1,91080630,91082130,1500,0.7388558905304903
34500,3036.077367,3036.204133,1,91082321,91086123,3802,0.7587824143263859
34501,3036.209967,3036.219733,1,91086299,91086591,292,0.38360700634703426
34502,3036.222367,3036.252367,1,91086671,91087571,900,0.7673518192408707
34503,3036.273867,3036.2972,1,91088216,91088916,700,-0.07013574550871073
34504,3036.301933,3036.321833,1,91089057,91089654,597,0.3420005802524789
34505,3036.326433,3036.330867,1,91089792,91089926,134,-0.18057170861716393
34506,3036.503467,3036.5078,1,91095104,91095234,130,0.4487657610332002
34507,3036.512733,3036.5291,1,91095381,91095873,492,0.6102107781807243
34508,3036.5317,3036.623967,1,91095951,91098719,2768,0.8289666216391673
34509,3036.9402,3036.9907,1,91108206,91109721,1515,0.7058538725602626
34510,3036.992333,3037.2025,1,91109769,91116075,6306,0.6937145832040632
34511,3037.215133,3037.219167,1,91116453,91116575,122,
34512,3037.511067,3037.658333,1,91125332,91129749,4417,0.8463760340800406
34513,3037.663467,3037.732567,1,91129904,91131977,2073,0.7730556919191917
34514,3037.741333,3037.825167,1,91132239,91134755,2516,0.842565538801462
34515,3037.8512,3037.8542,1,91135536,91135626,90,
34516,3037.8553,3037.8646,1,91135659,91135938,279,0.11847461141761827
34517,3038.135867,3038.2044,1,91144076,91146132,2056,0.8388551197456127
34518,3038.207767,3038.265533,1,91146233,91147965,1732,0.8548454076886975
34519,3038.2738,3038.3692,1,91148214,91151076,2862,0.7903023900088111
34520,3038.371333,3038.3786,1,91151139,91151358,219,0.4476240047799238
34521,3038.393567,3038.489433,1,91151807,91154682,2875,0.8022596925424801
34522,3038.492767,3038.511133,1,91154783,91155333,550,0.772990183261973
34523,3038.512567,3038.564333,1,91155377,91156929,1552,0.8020745983271534
34524,3038.568567,3038.624333,1,91157057,91158729,1672,0.8444575733552391
34525,3038.6365,3038.6702,1,91159095,91160106,1011,0.7132430711284434
34526,3038.693667,3038.697467,1,91160810,91160924,114,-0.09750080778505604
34527,3038.7036,3038.710033,1,91161108,91161300,192,-0.20979660998272753
34528,3038.9278,3038.936733,1,91167834,91168101,267,0.48361062076960193
34529,3038.961833,3038.969867,1,91168854,91169096,242,-0.007832067209142117
34530,3039.041133,3039.0914,1,91171233,91172742,1509,0.8196518605461943
34531,3039.094867,3039.165433,1,91172846,91174962,2116,0.8272748480378647
34532,3039.1733,3039.233267,1,91175199,91176998,1799,0.8401464048427097
34533,3039.234467,3039.245667,1,91177034,91177370,336,0.502936346475075
34534,3039.247933,3039.252867,1,91177437,91177586,149,-0.5297692489793121
34535,3039.270633,3039.334067,1,91178118,91180022,1904,0.8261538937088926
34536,3039.355367,3039.384767,1,91180661,91181543,882,0.8301728386013169
34537,3039.4102,3039.422333,1,91182306,91182669,363,-0.12468589656053819
34538,3039.4391,3039.445667,1,91183173,91183370,197,0.2693555956542123
34539,3039.654733,3039.6908,1,91189641,91190724,1083,0.8210993786904306
34540,3039.945233,3039.9499,1,91198356,91198497,141,0.5885672782806715
34541,3039.966667,3039.972733,1,91199000,91199181,181,0.8109217241515573
34542,3039.9756,3040.006867,1,91199268,91200206,938,0.8259647496730914
34543,3040.0137,3040.0365,1,91200411,91201095,684,0.8321842989445752
34544,3040.044033,3040.049033,1,91201320,91201470,150,0.5622176166624698
34545,3040.0728,3040.090233,1,91202184,91202706,522,0.8003420421923966
34546,3040.0922,3040.104533,1,91202766,91203135,369,0.620374490084922
34547,3040.114433,3040.156467,1,91203432,91204694,1262,0.7291386696365387
34548,3040.1575,3040.195967,1,91204725,91205879,1154,0.5672591987843043
34549,3040.209433,3040.291767,1,91206282,91208753,2471,0.841632948317314
34550,3040.292867,3040.301033,1,91208786,91209030,244,0.5501442037270063
34551,3040.308767,3040.412667,1,91209263,91212380,3117,0.7209713500165728
34552,3040.4173,3040.4391,1,91212519,91213173,654,0.7505975880153838
34553,3040.440767,3040.447667,1,91213223,91213430,207,0.8256235506487974
34554,3040.475667,3040.487067,1,91214270,91214612,342,0.28419930569068935
34555,3040.491267,3040.566033,1,91214738,91216980,2242,0.799435189701622
34556,3040.589667,3040.6143,1,91217690,91218429,739,0.7264877240706229
34557,3040.6194,3040.707133,1,91218582,91221213,2631,0.7018448698946944
34558,3040.723633,3040.729933,1,91221708,91221897,189,-0.06910827505384054
34559,3040.733467,3040.739133,1,91222004,91222173,169,0.0706381767677908
34560,3040.851267,3040.8613,1,91225538,91225839,301,0.6628087083638952
34561,3040.8629,3040.898567,1,91225887,91226957,1070,0.6831119285952453
34562,3041.1303,3041.2632,1,91233909,91237896,3987,0.83274631122772
34563,3041.265733,3041.285967,1,91237971,91238579,608,0.7122467630900317
34564,3041.292467,3041.340867,1,91238774,91240226,1452,0.7967084795622085
34565,3041.341867,3041.392067,1,91240256,91241762,1506,0.6614097012970832
34566,3041.809533,3041.813667,1,91254285,91254410,125,0.6837136913607598
34567,3041.817167,3041.824267,1,91254515,91254728,213,0.49324361423181823
34568,3041.851333,3041.904633,1,91255539,91257138,1599,0.5382102549113661
34569,3041.9343,3041.950367,1,91258029,91258511,482,0.6168709959501603
34570,3041.9688,3042.011467,1,91259064,91260344,1280,0.5578708837998415
34571,3042.038267,3042.0488,1,91261148,91261464,316,0.5795854168768022
34572,3042.0502,3042.0634,1,91261506,91261902,396,0.633814948941824
34573,3042.172533,3042.3139,1,91265175,91269417,4242,0.7937212225146153
34574,3042.523133,3042.526933,1,91275693,91275807,114,0.06255506807691932
34575,3042.533533,3042.582567,1,91276005,91277477,1472,0.768145371704398
34576,3042.591267,3042.6357,1,91277738,91279071,1333,0.8134997485952582
34577,3042.637233,3042.6413,1,91279116,91279239,123,0.12297280737108084
34578,3042.6782,3042.683833,1,91280346,91280514,168,-0.06612634525659027
34579,3042.690833,3042.6955,1,91280724,91280865,141,-0.08168722500082808
34580,3042.8558,3042.921167,1,91285674,91287635,1961,0.795421160581955
34581,3042.923133,3042.952567,1,91287693,91288577,884,0.8002761135583524
34582,3042.953933,3043.009767,1,91288617,91290293,1676,0.798327323975729
34583,3043.0228,3043.083167,1,91290684,91292495,1811,0.8164762094110315
34584,3043.1088,3043.112967,1,91293264,91293389,125,-0.031609032223213054
34585,3043.379,3043.516567,1,91301370,91305497,4127,0.8446585917607282
34586,3043.5476,3043.737167,1,91306428,91312115,5687,0.7380993579250692
34587,3044.0387,3044.043033,1,91321161,91321290,129,0.4447370715641407
34588,3044.0445,3044.0491,1,91321335,91321473,138,0.6928858405517611
34589,3044.0638,3044.088167,1,91321914,91322645,731,0.8172563474341913
34590,3044.089267,3044.1304,1,91322678,91323912,1234,0.337615212888965
34591,3044.135267,3044.1409,1,91324058,91324227,169,0.7502274352718631
34592,3044.155767,3044.187533,1,91324673,91325625,952,0.5956148133174292
34593,3044.203767,3044.275533,1,91326113,91328265,2152,0.6719403078435436
34594,3044.2766,3044.297467,1,91328298,91328924,626,0.6916696848015376
34595,3044.327833,3044.336867,1,91329834,91330106,272,0.01373522542719723
34596,3044.634467,3044.642267,1,91339034,91339268,234,0.5498164100698869
34597,3044.662733,3044.667033,1,91339881,91340010,129,0.7887333297102809
34598,3044.672067,3044.6792,1,91340162,91340376,214,0.588570090870919
34599,3044.686433,3044.690867,1,91340592,91340726,134,0.650440141608516
34600,3044.703733,3044.721767,1,91341111,91341653,542,0.6636699762437736
34601,3044.7571,3044.7697,1,91342713,91343091,378,0.4271747123585451
34602,3044.799267,3044.8288,1,91343978,91344864,886,0.5446534910534838
34603,3044.858033,3044.863733,1,91345740,91345911,171,0.45990445851868333
34604,3044.8701,3044.891233,1,91346103,91346736,633,0.6651780354648642
34605,3044.903967,3044.9215,1,91347119,91347645,526,0.5913845451711284
34606,3044.956867,3044.9608,1,91348706,91348824,118,
34607,3044.9701,3044.975733,1,91349103,91349271,168,0.606867880045623
34608,3044.9778,3044.987267,1,91349334,91349618,284,0.5364389386293055
34609,3045.010033,3045.015467,1,91350300,91350464,164,0.7645527483914614
34610,3045.024433,3045.035667,1,91350732,91351070,338,0.7006231954062087
34611,3045.136433,3045.2658,1,91354092,91357974,3882,0.8262840925837786
34612,3045.270667,3045.2762,1,91358120,91358286,166,0.19270451779249895
34613,3045.547967,3045.572,1,91366439,91367160,721,0.6881529469889767
34614,3045.5754,3045.625067,1,91367262,91368752,1490,0.8371908467728136
34615,3045.6269,3045.704633,1,91368807,91371138,2331,0.8419163655580908
34616,3045.715167,3045.7817,1,91371455,91373451,1996,0.8505857007794317
34617,3045.7924,3045.830167,1,91373772,91374905,1133,0.7219686030719346
34618,3046.218133,3046.222967,1,91386543,91386689,146,0.6481203608043086
34619,3046.256867,3046.292033,1,91387706,91388760,1054,0.6072675192455756
34620,3046.318833,3046.333633,1,91389564,91390008,444,0.6921930456172246
34621,3046.336167,3046.347,1,91390085,91390410,325,0.5371694466238017
34622,3046.351133,3046.396667,1,91390533,91391900,1367,0.6269257903187664
34623,3046.418533,3046.428433,1,91392555,91392852,297,0.6497321716067663
34624,3046.433467,3046.440433,1,91393004,91393212,208,0.6136628985248761
34625,3046.505367,3046.508733,1,91395161,91395261,100,0.05997181046857594
34626,3046.511733,3046.520967,1,91395351,91395629,278,0.0008742211601446516
34627,3046.527633,3046.5318,1,91395828,91395954,126,0.6383183243649297
34628,3046.547267,3046.662967,1,91396418,91399889,3471,0.8103603435495168
34629,3046.667933,3046.7029,1,91400037,91401087,1050,0.8224418186949142
34630,3046.7074,3046.810333,1,91401222,91404309,3087,0.8333254837207615
34631,3047.098233,3047.1154,1,91412946,91413462,516,0.8708342048008617
34632,3047.116933,3047.170133,1,91413507,91415103,1596,0.7339963424436724
34633,3047.209567,3047.213367,1,91416287,91416401,114,0.1892399728728488
34634,3047.229967,3047.2898,1,91416899,91418694,1795,0.717440031168815
34635,3047.290867,3047.294433,1,91418726,91418832,106,0.19852742674769422
34636,3047.3063,3047.346733,1,91419189,91420401,1212,0.68414107463819
34637,3047.348133,3047.359667,1,91420443,91420790,347,0.5873332868222962
34638,3047.372533,3047.387467,1,91421175,91421624,449,0.6369445401853703
34639,3047.390967,3047.407767,1,91421729,91422233,504,0.6391907546074714
34640,3047.451333,3047.4725,1,91423539,91424175,636,0.6287592422593942
34641,3047.4868,3047.490567,1,91424604,91424717,113,0.6049711075349126
34642,3047.4925,3047.5238,1,91424775,91425714,939,0.5812600151963346
34643,3047.5317,3047.6046,1,91425951,91428138,2187,0.7392246015754961
34644,3047.607533,3047.615333,1,91428225,91428459,234,0.7308242017774582
34645,3047.6197,3047.6576,1,91428591,91429728,1137,0.7131449993335454
34646,3047.677233,3047.684567,1,91430316,91430537,221,0.6442348609214202
34647,3047.690933,3047.7099,1,91430727,91431297,570,0.710889937922419
34648,3048.189467,3048.215967,1,91445684,91446479,795,0.7584178890025373
34649,3048.217067,3048.295667,1,91446512,91448870,2358,0.8158787611224675
34650,3048.3559,3048.363733,1,91450677,91450911,234,0.5937485708178452
34651,3048.3649,3048.3991,1,91450947,91451973,1026,0.6241391034226283
34652,3048.400467,3048.479533,1,91452014,91454385,2371,0.7897141929127016
34653,3048.4866,3048.4912,1,91454598,91454736,138,-0.11994031271551886
34654,3048.723767,3048.728967,1,91461713,91461869,156,0.3989746596968261
34655,3048.733267,3048.885267,1,91461998,91466558,4560,0.8148047221894499
34656,3049.230767,3049.237167,1,91476923,91477115,192,0.6277064702617553
34657,3049.239867,3049.2442,1,91477196,91477326,130,0.5304162980062692
34658,3049.259567,3049.2788,1,91477787,91478364,577,0.8360272150051823
34659,3049.3013,3049.408533,1,91479039,91482255,3216,0.8056451097719112
34660,3049.411633,3049.4297,1,91482348,91482891,543,0.5799195940633209
34661,3049.4312,3049.442667,1,91482936,91483280,344,0.49665994610305664
34662,3049.444033,3049.495067,1,91483320,91484852,1532,0.8474684415625137
34663,3049.496633,3049.500433,1,91484898,91485012,114,0.5329962729308071
34664,3049.506133,3049.530833,1,91485183,91485924,741,0.7504861739695174
34665,3049.540533,3049.544467,1,91486215,91486334,119,-0.17751080607548805
34666,3049.5517,3049.565233,1,91486551,91486956,405,-0.04989166450208752
34667,3049.571733,3049.5784,1,91487151,91487352,201,-0.15250775591265217
34668,3049.584533,3049.595433,1,91487535,91487862,327,0.17629209950162858
34669,3049.7865,3049.7901,1,91493595,91493703,108,0.30890708937940403
34670,3049.792333,3049.9113,1,91493769,91497339,3570,0.8210007197442044
34671,3049.988267,3050.0999,1,91499648,91502997,3349,0.7909409917458963
34672,3050.399667,3050.405967,1,91511990,91512179,189,0.6325007654448764
34673,3050.442267,3050.521567,1,91513268,91515647,2379,0.8360851984637551
34674,3050.5233,3050.608967,1,91515699,91518269,2570,0.8372038964020889
34675,3050.6205,3050.6347,1,91518615,91519041,426,0.8029638632711862
34676,3050.641733,3050.652167,1,91519251,91519565,314,0.6703316776351026
34677,3050.938267,3050.942733,1,91528148,91528281,133,0.2888021908294038
34678,3050.948767,3051.0878,1,91528463,91532634,4171,0.7980947974977701
34679,3051.091,3051.1196,1,91532730,91533588,858,0.8022148298423076
34680,3051.157267,3051.182667,1,91534718,91535480,762,0.797025136290879
34681,3051.185067,3051.275667,1,91535552,91538270,2718,0.7141774732299565
34682,3051.724533,3051.861533,1,91551735,91555845,4110,0.8465464242030043
34683,3051.8646,3051.907133,1,91555938,91557213,1275,0.8005963823240273
34684,3051.911967,3052.0204,1,91557359,91560612,3253,0.7536092045690234
34685,3052.506433,3052.528433,1,91575192,91575852,660,0.5899253291035009
34686,3052.5805,3052.594133,1,91577415,91577823,408,0.6743696587224683
34687,3052.611,3052.6232,1,91578330,91578696,366,0.7949586239256384
34688,3052.684533,3052.6922,1,91580535,91580766,231,0.39932394110240405
34689,3052.696233,3052.7047,1,91580886,91581141,255,0.08522883284101372
34690,3052.709233,3052.719433,1,91581276,91581582,306,0.5270385717118624
34691,3052.769167,3052.784567,1,91583075,91583537,462,0.6274564369813995
34692,3052.851633,3052.8636,1,91585548,91585908,360,0.24735358005694838
34693,3052.8805,3052.8864,1,91586415,91586592,177,0.618852071225041
34694,3052.892733,3052.9069,1,91586781,91587207,426,0.750944474887097
34695,3052.9084,3053.012633,1,91587252,91590378,3126,0.7857047965813572
34696,3053.014633,3053.153633,1,91590438,91594608,4170,0.7818103011419356
34697,3053.5175,3053.521867,1,91605525,91605656,131,0.4529022827166041
34698,3053.522967,3053.5381,1,91605689,91606143,454,0.6168714109350028
34699,3053.540567,3053.631033,1,91606217,91608930,2713,0.778896501887065
34700,3053.6586,3053.6687,1,91609758,91610061,303,0.6230561336930633
34701,3053.670233,3053.7074,1,91610106,91611222,1116,0.6919959801734178
34702,3053.710233,3053.7884,1,91611306,91613652,2346,0.7710211715758131
34703,3053.8033,3053.810067,1,91614099,91614302,203,0.1328876305621318
34704,3054.0669,3054.0725,1,91622007,91622175,168,0.7169073194472169
34705,3054.077033,3054.123267,1,91622310,91623698,1388,0.6725993007543084
34706,3054.135567,3054.139633,1,91624067,91624188,121,0.37841235600588397
34707,3054.1408,3054.190067,1,91624224,91625702,1478,0.8254023849459738
34708,3054.480933,3054.5052,1,91634427,91635156,729,0.6603856225431328
34709,3054.5067,3054.593833,1,91635201,91637814,2613,0.8429899020601561
34710,3054.596733,3054.633433,1,91637901,91639002,1101,0.83989224181484
34711,3054.6501,3054.669367,1,91639503,91640081,578,0.771416199712036
34712,3054.672767,3054.712967,1,91640183,91641389,1206,0.8207882779948689
34713,3054.714033,3054.815533,1,91641420,91644465,3045,0.805923806613558
34714,3054.84,3054.924233,1,91645200,91647726,2526,0.7829182041470936
34715,3054.9291,3054.9379,1,91647873,91648137,264,-0.01909495202143407
34716,3055.0639,3055.072067,1,91651917,91652162,245,0.4871548841399233
34717,3055.077967,3055.1008,1,91652339,91653024,685,0.33277537515029537
34718,3055.103833,3055.1474,1,91653114,91654422,1308,0.08699373106746523
34719,3055.148733,3055.1741,1,91654461,91655223,762,0.08946400330695257
34720,3055.2114,3055.324033,1,91656342,91659720,3378,0.82296462566734
34721,3055.3419,3055.3465,1,91660257,91660395,138,0.0710770662794254
34722,3055.357533,3055.360833,1,91660725,91660824,99,0.04159159186514536
34723,3055.361933,3055.372233,1,91660857,91661166,309,-0.11062507117262102
34724,3055.616067,3055.7006,1,91668482,91671018,2536,0.6973269201777438
34725,3055.703133,3055.7397,1,91671093,91672191,1098,0.7686772015478585
34726,3055.746933,3055.788167,1,91672407,91673645,1238,0.8556066863598744
34727,3055.790033,3055.836367,1,91673700,91675091,1391,0.8230886641285358
34728,3055.838567,3055.9048,1,91675157,91677144,1987,0.6778855606249292
34729,3055.918167,3055.9216,1,91677545,91677648,103,0.03322136439643943
34730,3055.983433,3055.995233,1,91679502,91679856,354,0.6970656742010918
34731,3056.004033,3056.055433,1,91680120,91681662,1542,0.7927162125558864
34732,3056.3665,3056.557,1,91690995,91696710,5715,0.8340569122542351
34733,3057.016533,3057.127267,1,91710495,91713818,3323,0.8439555008263341
34734,3057.451567,3057.462833,1,91723547,91723884,337,0.774042195451084
34735,3057.4682,3057.4857,1,91724046,91724571,525,-0.12914054138951578
34736,3057.519133,3057.541367,1,91725573,91726241,668,0.5805429136183158
34737,3057.566933,3057.578467,1,91727007,91727354,347,0.5594793586807826
34738,3057.612267,3057.6405,1,91728368,91729215,847,0.43088535689967267
34739,3057.663133,3057.667033,1,91729893,91730010,117,0.653685522214416
34740,3057.672667,3057.678033,1,91730180,91730340,160,0.5751906869769843
34741,3057.684733,3057.7023,1,91730541,91731069,528,0.5623264901483312
34742,3057.722233,3057.734067,1,91731666,91732022,356,0.5376243731568056
34743,3057.786333,3057.8032,1,91733589,91734096,507,0.6480308584208203
34744,3057.838767,3057.846467,1,91735163,91735394,231,0.4598759022083992
34745,3057.934567,3057.943133,1,91738037,91738293,256,0.46904673018866283
34746,3057.945767,3058.058833,1,91738373,91741764,3391,0.8062812592477898
34747,3058.0677,3058.130767,1,91742031,91743923,1892,0.8179930951331139
34748,3058.153133,3058.238167,1,91744593,91747145,2552,0.8377783142136797
34749,3058.517833,3058.525233,1,91755534,91755756,222,0.47220936617434234
34750,3058.526967,3058.584,1,91755809,91757520,1711,0.8553275431169941
34751,3058.587333,3058.627667,1,91757619,91758830,1211,0.7879836247006925
34752,3058.883567,3058.887767,1,91766507,91766633,126,
34753,3058.889033,3059.002233,1,91766670,91770066,3396,0.8902072354973637
34754,3059.3074,3059.325867,1,91779222,91779776,554,0.7475294974346509
34755,3059.332433,3059.3619,1,91779972,91780857,885,0.7854648876233923
34756,3059.363,3059.4815,1,91780890,91784445,3555,0.8249286415389155
34757,3059.4863,3059.532,1,91784589,91785960,1371,0.8088425729777696
34758,3059.536467,3059.5708,1,91786094,91787124,1030,0.8914293585930498
34759,3059.5932,3059.599567,1,91787796,91787987,191,-0.08691780812332046
34760,3059.6067,3059.609967,1,91788201,91788299,98,-0.046738682735973064
34761,3059.611933,3059.617033,1,91788357,91788510,153,-0.05268487114709412
34762,3059.621233,3059.632967,1,91788636,91788989,353,0.21628902373017497
34763,3059.823467,3059.829467,1,91794704,91794884,180,0.3995827638218435
34764,3059.837133,3060.037967,1,91795113,91801139,6026,0.7935786589675387
34765,3060.069033,3060.070233,1,91802070,91802106,36,
34766,3060.289167,3060.4215,1,91808675,91812645,3970,0.8172722310136404
34767,3060.422567,3060.4266,1,91812677,91812798,121,0.5764963811096947
34768,3060.4391,3060.443767,1,91813173,91813313,140,0.7289458606505332
34769,3060.445667,3060.470533,1,91813370,91814115,745,0.7938935925724864
34770,3060.474,3060.503833,1,91814220,91815114,894,0.7516301688497631
34771,3060.516567,3060.593167,1,91815497,91817795,2298,0.7940899509001685
34772,3060.611167,3060.634133,1,91818335,91819023,688,0.7645703985913807
34773,3060.656733,3060.6753,1,91819701,91820259,558,-0.02413920430839547
34774,3061.164233,3061.171767,1,91834926,91835153,227,0.4589817302376007
34775,3061.173833,3061.1844,1,91835214,91835532,318,0.572963307221454
34776,3061.207033,3061.249667,1,91836210,91837490,1280,0.5928531612778409
34777,3061.283467,3061.296933,1,91838504,91838907,403,0.6264061618290617
34778,3061.316033,3061.358833,1,91839480,91840764,1284,0.6221443193906464
34779,3061.382767,3061.3931,1,91841483,91841793,310,0.6419486804710454
34780,3061.395767,3061.4089,1,91841873,91842267,394,0.5545394700801123
34781,3061.455033,3061.4588,1,91843650,91843764,114,-0.06600745610694912
34782,3061.462067,3061.470633,1,91843862,91844118,256,0.13339371738679628
34783,3061.4717,3061.4816,1,91844151,91844448,297,0.37104200478775523
34784,3061.521,3061.535033,1,91845630,91846050,420,0.7735287388150371
34785,3061.536267,3061.700033,1,91846088,91851000,4912,0.8241450358832557
34786,3061.701233,3061.709933,1,91851036,91851297,261,0.3923510544718875
34787,3061.7277,3061.8157,1,91851831,91854471,2640,0.8424472429892157
34788,3061.859833,3061.865967,1,91855794,91855979,185,-0.16861493832483068
34789,3062.1028,3062.270067,1,91863084,91868102,5018,0.8587279613485168
34790,3062.2824,3062.329167,1,91868472,91869875,1403,0.827661268265225
34791,3062.343667,3062.349833,1,91870310,91870494,184,0.5227246771648504
34792,3062.3529,3062.391167,1,91870587,91871735,1148,0.6834935859891693
34793,3062.705733,3062.709933,1,91881171,91881297,126,0.8230357736499339
34794,3062.724933,3062.733533,1,91881747,91882005,258,0.6135122288376582
34795,3062.743367,3062.8034,1,91882301,91884102,1801,0.7448381253435867
34796,3062.807833,3062.820667,1,91884234,91884620,386,0.4745896990483807
34797,3062.827167,3062.838,1,91884815,91885140,325,0.7934923933180372
34798,3062.8699,3062.883567,1,91886097,91886507,410,0.6022915298661103
34799,3062.8915,3062.9528,1,91886745,91888584,1839,0.5971594993955306
34800,3062.968,3062.9828,1,91889040,91889484,444,0.3937959266291745
34801,3062.985467,3063.000967,1,91889564,91890029,465,0.40829765167247645
34802,3063.037833,3063.0673,1,91891134,91892019,885,0.5722206951206662
34803,3063.0854,3063.1103,1,91892562,91893309,747,0.6962419191453224
34804,3063.159667,3063.1694,1,91894790,91895082,292,0.2316900272046637
34805,3063.213,3063.533533,1,91896390,91906005,9615,0.7225393583256149
34806,3063.8726,3063.8815,1,91916178,91916445,267,0.6262225373082019
34807,3063.883033,3063.902967,1,91916490,91917089,599,0.7395093482033444
34808,3063.925433,3063.9372,1,91917762,91918116,354,0.47260621226064226
34809,3063.953667,3064.025667,1,91918610,91920770,2160,0.6556874188100977
34810,3064.044533,3064.155733,1,91921335,91924671,3336,0.757263323496217
34811,3064.159533,3064.217033,1,91924785,91926510,1725,0.7905504874775018
34812,3064.227267,3064.243033,1,91926818,91927290,472,0.7010960158874775
34813,3064.244967,3064.262467,1,91927349,91927874,525,0.6987102119118839
34814,3064.311867,3064.3341,1,91929356,91930023,667,0.670404563893909
34815,3064.349433,3064.352833,1,91930482,91930584,102,0.2736280761484908
34816,3064.3542,3064.361433,1,91930626,91930842,216,0.6910431583341543
34817,3064.362567,3064.4721,1,91930877,91934163,3286,0.6329211253584692
34818,3064.474967,3064.492667,1,91934249,91934780,531,0.2705350189210689
34819,3064.495033,3064.5336,1,91934850,91936008,1158,0.7175673341966959
34820,3064.5451,3064.5585,1,91936353,91936755,402,0.49688322453044736
34821,3064.563733,3064.5789,1,91936911,91937367,456,0.6456136474082915
34822,3064.752467,3064.767367,1,91942574,91943021,447,0.7888896839210707
34823,3064.771467,3064.830533,1,91943144,91944915,1771,0.6623873895704727
34824,3064.8321,3064.870367,1,91944963,91946111,1148,0.6570163012424236
34825,3064.894333,3064.901333,1,91946829,91947039,210,
34826,3064.983133,3064.987733,1,91949493,91949631,138,
34827,3065.0026,3065.013,1,91950078,91950390,312,0.20572049820861163
34828,3065.014,3065.021133,1,91950420,91950633,213,0.2707502240733444
34829,3065.300433,3065.309733,1,91959012,91959291,279,-0.019882318004433186
34830,3065.311733,3065.318033,1,91959351,91959540,189,0.7646872780588996
34831,3065.3312,3065.4272,1,91959936,91962816,2880,0.07115214822404194
34832,3065.475033,3065.513533,1,91964250,91965405,1155,0.7273613751418869
34833,3065.517633,3065.5839,1,91965528,91967517,1989,0.6986110455101658
34834,3065.5876,3065.590833,1,91967628,91967724,96,
34835,3065.5919,3065.600333,1,91967757,91968009,252,0.45157107465885193
34836,3065.602033,3065.6364,1,91968060,91969092,1032,0.0556953931230169
34837,3065.640533,3065.657033,1,91969215,91969710,495,0.24674528327984954
34838,3065.658033,3065.668267,1,91969740,91970048,308,-0.06881283939759181
34839,3065.706633,3065.725767,1,91971198,91971773,575,0.1493784651703375
34840,3065.7339,3065.744367,1,91972017,91972331,314,0.5244959986572149
34841,3065.746667,3065.791067,1,91972400,91973732,1332,0.09250141613868947
34842,3065.793467,3065.917433,1,91973804,91977522,3718,0.8532178575211342
34843,3066.170433,3066.190633,1,91985112,91985718,606,0.6817779409367772
34844,3066.198867,3066.209367,1,91985966,91986281,315,0.47861798775170045
34845,3066.264267,3066.272367,1,91987928,91988171,243,0.5647073501949246
34846,3066.3014,3066.3257,1,91989042,91989771,729,0.7465836004260583
34847,3066.3274,3066.331333,1,91989822,91989939,117,
34848,3066.3333,3066.348333,1,91989999,91990449,450,0.8571552858338217
34849,3066.3787,3066.394433,1,91991361,91991832,471,0.7422542443039503
34850,3066.417,3066.447367,1,91992510,91993421,911,0.7577756871055646
34851,3066.454467,3066.458133,1,91993634,91993743,109,
34852,3066.4628,3066.4744,1,91993884,91994232,348,0.4385044358961442
34853,3066.476133,3066.5292,1,91994283,91995876,1593,0.04030102699111507
34854,3066.559667,3066.5771,1,91996790,91997313,523,0.8239684403342317
34855,3066.5783,3066.670967,1,91997349,92000129,2780,0.8167333752409606
34856,3066.6942,3066.748633,1,92000826,92002458,1632,-0.00575727048489841
34857,3066.7709,3066.802733,1,92003127,92004081,954,0.8240759301705042
34858,3066.8039,3066.9271,1,92004117,92007813,3696,0.8302771446967068
34859,3066.968433,3066.973467,1,92009052,92009204,152,0.2927734384825308
34860,3066.981,3066.9843,1,92009430,92009529,99,0.11553877579216257
34861,3067.105367,3067.1171,1,92013161,92013513,352,0.42789336312222687
34862,3067.126333,3067.176467,1,92013789,92015294,1505,0.08203118786583273
34863,3067.177567,3067.1808,1,92015327,92015424,97,0.34008739155199996
34864,3067.1849,3067.188867,1,92015547,92015666,119,0.494029035384381
34865,3067.208933,3067.2836,1,92016267,92018508,2241,0.7772075420399657
34866,3067.299767,3067.314667,1,92018993,92019440,447,0.8170388011234189
34867,3067.318733,3067.324333,1,92019561,92019729,168,0.10932788834676342
34868,3067.333133,3067.405933,1,92019993,92022177,2184,0.7924960444476065
34869,3067.409067,3067.422533,1,92022272,92022675,403,0.7155214323390063
34870,3067.453767,3067.5061,1,92023613,92025183,1570,0.8481846675584158
34871,3067.519167,3067.5333,1,92025575,92025999,424,0.5846881926077284
34872,3067.579467,3067.6069,1,92027384,92028207,823,0.015112063041806342
34873,3067.6086,3067.615533,1,92028258,92028465,207,0.11825522629921538
34874,3067.6207,3067.633933,1,92028621,92029017,396,0.14261136045476688
34875,3067.635133,3067.648167,1,92029053,92029445,392,0.008429668081660634
34876,3067.6728,3067.6758,1,92030184,92030274,90,0.34629744998114903
34877,3067.6861,3067.701333,1,92030583,92031039,456,0.839398352446408
34878,3067.7029,3067.8244,1,92031087,92034732,3645,0.8089494379683663
34879,3067.825733,3067.832067,1,92034771,92034962,191,0.7002124782228476
34880,3067.833133,3067.8529,1,92034993,92035587,594,0.6748847902284372
34881,3067.855167,3067.869233,1,92035655,92036076,421,0.4608660994256402
34882,3067.877233,3067.9465,1,92036316,92038395,2079,0.8158889779228085
34883,3067.965767,3067.989733,1,92038973,92039691,718,0.6759430646734346
34884,3069.107467,3069.177333,1,92073224,92075319,2095,0.7947055873483693
34885,3069.1813,3069.2071,1,92075439,92076213,774,0.8717019534816457
34886,3069.292967,3069.296233,1,92078789,92078886,97,0.31432695255886584
34887,3069.416867,3069.4326,1,92082506,92082978,472,0.44650627232598467
34888,3069.435333,3069.5597,1,92083059,92086791,3732,0.22680752668036203
34889,3069.5636,3069.582533,1,92086908,92087475,567,0.8123226089642942
34890,3069.615267,3069.6196,1,92088458,92088588,130,0.5454022876147895
34891,3069.951167,3069.983867,1,92098535,92099516,981,0.6723921169505521
34892,3069.985467,3069.9902,1,92099564,92099706,142,0.5991723381793806
34893,3070.0193,3070.041367,1,92100579,92101241,662,0.6437670967228631
34894,3070.064033,3070.075567,1,92101920,92102267,347,0.7565583248901949
34895,3070.093,3070.1064,1,92102790,92103192,402,0.6762406369175191
34896,3070.1264,3070.143533,1,92103792,92104305,513,0.5346499157012627
34897,3070.144733,3070.186633,1,92104341,92105598,1257,0.15055238929969625
34898,3070.190267,3070.213933,1,92105708,92106417,709,0.21527809390458327
34899,3070.232667,3070.2935,1,92106980,92108805,1825,0.7277963838909488
34900,3070.2958,3070.378267,1,92108874,92111348,2474,0.6165603810717485
34901,3070.3943,3070.485233,1,92111829,92114556,2727,0.32189311891731376
34902,3070.5841,3070.646133,1,92117523,92119383,1860,0.8158284934874749
34903,3070.6487,3070.695333,1,92119461,92120859,1398,0.6958737092160535
34904,3070.699067,3070.797833,1,92120972,92123934,2962,0.747439428425984
34905,3070.815567,3070.8444,1,92124467,92125332,865,0.7141244897315128
34906,3070.8503,3070.942167,1,92125509,92128265,2756,0.5346816754508348
34907,3070.961933,3071.0817,1,92128857,92132451,3594,0.7839163390124607
34908,3071.120533,3071.129367,1,92133615,92133881,266,0.5322680573846507
34909,3071.140167,3071.147233,1,92134205,92134416,211,-0.08810552142420516
34910,3071.3503,3071.379433,1,92140509,92141382,873,0.5805946755496819
34911,3071.3929,3071.4041,1,92141787,92142123,336,0.7396556396838875
34912,3071.415067,3071.431733,1,92142452,92142951,499,0.699847260439447
34913,3071.467267,3071.478833,1,92144018,92144364,346,0.6627597008499142
34914,3071.485033,3071.502767,1,92144550,92145083,533,0.8250088193496281
34915,3071.530567,3071.548967,1,92145917,92146469,552,0.731366017745084
34916,3071.5501,3071.565367,1,92146503,92146961,458,0.591808937509964
34917,3071.5697,3071.673467,1,92147091,92150204,3113,0.7650341367815595
34918,3071.674567,3071.6791,1,92150237,92150373,136,0.5094996200245416
34919,3071.682767,3071.685933,1,92150483,92150577,94,
34920,3071.713933,3071.717633,1,92151417,92151528,111,0.6466703587523769
34921,3071.764167,3071.769367,1,92152925,92153081,156,0.4335261530172792
34922,3071.782,3071.9517,1,92153460,92158551,5091,0.8279147843443686
34923,3071.966333,3071.977367,1,92158989,92159321,332,0.47651515020060725
34924,3071.986867,3072.009333,1,92159606,92160279,673,-0.045982248238862655
34925,3072.010867,3072.016467,1,92160326,92160494,168,-0.10453906264155702
34926,3072.0177,3072.041533,1,92160531,92161245,714,0.0691509881721143
34927,3072.079267,3072.213867,1,92162378,92166416,4038,0.8373461386029787
34928,3072.230833,3072.2378,1,92166924,92167134,210,0.14905575581111882
34929,3072.2495,3072.267367,1,92167485,92168021,536,-0.010707572753803251
34930,3072.269067,3072.2817,1,92168072,92168451,379,0.21782047440703764
34931,3072.2847,3072.2969,1,92168541,92168907,366,0.01158303148487304
34932,3072.303867,3072.3091,1,92169116,92169273,157,-0.054045476583825476
34933,3072.499633,3072.555933,1,92174988,92176677,1689,0.699937838945643
34934,3072.5747,3072.584567,1,92177241,92177537,296,0.9099739332771996
34935,3072.609067,3072.642067,1,92178272,92179262,990,0.6697411822636142
34936,3072.663,3072.6997,1,92179890,92180991,1101,0.7743160371274814
34937,3072.709067,3072.7618,1,92181272,92182854,1582,0.762523411776464
34938,3072.779467,3072.8187,1,92183384,92184561,1177,0.7812010448341458
34939,3072.8355,3072.8621,1,92185065,92185863,798,0.788339191010141
34940,3072.863467,3072.8754,1,92185904,92186262,358,-0.02892387928561045
34941,3072.876433,3072.933467,1,92186292,92188004,1712,0.6553013287164738
34942,3072.9546,3073.076533,1,92188638,92192295,3657,0.7921803610893422
34943,3073.1093,3073.1206,1,92193279,92193618,339,0.5110476962111713
34944,3073.127,3073.1573,1,92193810,92194719,909,-0.018318007100158656
34945,3073.1583,3073.170033,1,92194749,92195100,351,0.19370931039614162
34946,3073.171133,3073.195267,1,92195133,92195858,725,0.12548508176998702
34947,3073.206233,3073.3772,1,92196186,92201316,5130,0.7829428923000368
34948,3073.4172,3073.425567,1,92202516,92202767,251,-0.1168867679588985
34949,3073.437233,3073.440767,1,92203116,92203223,107,0.1768909141521762
34950,3073.540167,3073.556,1,92206205,92206680,475,0.12878893265110938
34951,3073.557667,3073.6435,1,92206730,92209305,2575,0.750451348259202
34952,3073.651,3073.655367,1,92209530,92209661,131,
34953,3073.670067,3073.683,1,92210102,92210490,388,-0.07639910891752819
34954,3073.693467,3073.701033,1,92210804,92211030,226,0.2222845899818869
34955,3073.708867,3073.7202,1,92211266,92211606,340,0.3192520500029461
34956,3073.731767,3073.857833,1,92211953,92215734,3781,0.8432730904008952
34957,3073.884733,3073.976533,1,92216541,92219295,2754,0.8001221057810581
34958,3074.260833,3074.263867,1,92227824,92227916,92,0.8315644605536302
34959,3074.2857,3074.306733,1,92228571,92229201,630,0.8559488765183855
34960,3074.334333,3074.362167,1,92230029,92230865,836,0.8486750027521599
34961,3074.3671,3074.3862,1,92231013,92231586,573,0.7867197448828377
34962,3074.388033,3074.391667,1,92231640,92231750,110,0.5982084828552408
34963,3074.395267,3074.4444,1,92231858,92233332,1474,0.660483830581612
34964,3074.453433,3074.582733,1,92233602,92237481,3879,0.7811628149677142
34965,3074.595467,3074.6024,1,92237864,92238072,208,0.6174880252471583
34966,3074.6106,3074.642967,1,92238318,92239289,971,0.7275689416090052
34967,3074.6495,3074.698733,1,92239485,92240961,1476,0.056259151745495346
34968,3074.701767,3074.725067,1,92241053,92241752,699,0.1344762963660085
34969,3074.759667,3074.853,1,92242790,92245590,2800,0.7641524257010548
34970,3074.855033,3074.882667,1,92245650,92246480,830,0.7461272312013832
34971,3074.918533,3074.921533,1,92247555,92247645,90,
34972,3074.935167,3074.945633,1,92248055,92248368,313,0.5938291486922226
34973,3074.9555,3075.007633,1,92248665,92250228,1563,0.0324313728415109
34974,3075.0312,3075.175833,1,92250936,92255274,4338,0.7510443826079009
34975,3075.2218,3075.228467,1,92256654,92256854,200,0.4667174773432622
34976,3075.2383,3075.274633,1,92257149,92258238,1089,0.045248421037605846
34977,3075.2789,3075.294567,1,92258367,92258837,470,0.4079684223906138
34978,3075.295667,3075.302867,1,92258870,92259086,216,0.7680940782358422
34979,3075.3319,3075.493267,1,92259957,92264798,4841,0.8517413534765049
34980,3075.494833,3075.6287,1,92264844,92268861,4017,0.7652565583710365
34981,3075.672767,3075.685533,1,92270183,92270565,382,0.5041781567095701
34982,3075.6965,3075.717667,1,92270895,92271530,635,-0.07783376893053852
34983,3075.742067,3075.8568,1,92272262,92275704,3442,0.7928479967928146
34984,3075.859533,3075.873133,1,92275785,92276193,408,0.7403266677035857
34985,3075.8802,3075.927833,1,92276406,92277834,1428,0.8081000745738232
34986,3075.935267,3075.976033,1,92278058,92279280,1222,0.7889905886002675
34987,3075.988133,3076.017967,1,92279643,92280539,896,0.7527902569871973
34988,3076.021833,3076.082533,1,92280654,92282475,1821,0.7688664826658885
34989,3076.088567,3076.121167,1,92282657,92283635,978,0.6364985594378701
34990,3076.137767,3076.167767,1,92284133,92285033,900,-0.026435503527244563
34991,3076.171667,3076.197333,1,92285150,92285919,769,0.019336481398108216
34992,3076.222133,3076.243967,1,92286663,92287319,656,0.8111528717186965
34993,3076.245433,3076.387733,1,92287362,92291631,4269,0.8088915129415422
34994,3076.412,3076.422533,1,92292360,92292675,315,0.7460202438845462
34995,3076.4236,3076.436133,1,92292708,92293083,375,0.8149414039378935
34996,3076.4417,3076.505133,1,92293251,92295153,1902,0.7555167180165119
34997,3076.513267,3076.5236,1,92295398,92295708,310,0.35580741692596096
34998,3076.5283,3076.5372,1,92295849,92296116,267,0.09709499196247699
34999,3076.540267,3076.592367,1,92296208,92297771,1563,0.07199418012206167
35000,3076.623233,3076.731467,1,92298696,92301944,3248,0.7862287997303398
35001,3076.7438,3076.746833,1,92302314,92302404,90,
35002,3076.759867,3076.769433,1,92302796,92303082,286,0.5429190215277344
35003,3076.7719,3077.028967,1,92303157,92310869,7712,0.7345083653674347
35004,3077.030933,3077.035667,1,92310927,92311070,143,-0.17768480364360761
35005,3077.120833,3077.124867,1,92313624,92313746,122,-0.19680056739958063
35006,3077.142633,3077.146967,1,92314278,92314409,131,0.5882292660694491
35007,3077.166467,3077.186067,1,92314994,92315582,588,0.4837733347200021
35008,3077.196367,3077.207433,1,92315891,92316222,331,0.7585507055515884
35009,3077.2089,3077.2193,1,92316267,92316579,312,0.6872304401201643
35010,3077.255233,3077.289667,1,92317656,92318690,1034,0.8286871054003025
35011,3077.2982,3077.3813,1,92318946,92321439,2493,0.7687936297878416
35012,3077.3937,3077.448067,1,92321811,92323442,1631,-0.010281646484469466
35013,3077.471467,3077.4856,1,92324144,92324568,424,0.009777043838397644
35014,3077.486967,3077.570433,1,92324609,92327112,2503,0.8193028714772036
35015,3077.5729,3077.687833,1,92327187,92330634,3447,0.8406288026508982
35016,3077.7045,3077.710133,1,92331135,92331303,168,0.11453185108143173
35017,3077.7204,3077.735867,1,92331612,92332076,464,-0.08239248911493374
35018,3077.739167,3077.761233,1,92332175,92332836,661,0.12416980050234412
35019,3077.762333,3077.768267,1,92332869,92333048,179,0.6916946204936539
35020,3077.779233,3077.784133,1,92333376,92333523,147,0.11255195339201106
35021,3077.787767,3077.793867,1,92333633,92333816,183,0.8416816766108772
35022,3077.7951,3077.948,1,92333853,92338440,4587,0.8385782901173967
35023,3077.9569,3077.964,1,92338707,92338920,213,-0.06284826761401305
35024,3077.976933,3077.988067,1,92339307,92339642,335,-0.06640817716480707
35025,3077.991733,3078.007433,1,92339751,92340222,471,0.02235020171637818
35026,3078.009933,3078.016933,1,92340297,92340507,210,-0.049522587310124905
35027,3078.020933,3078.031333,1,92340627,92340939,312,0.205824927558098
35028,3078.056867,3078.212433,1,92341706,92346372,4666,0.7948609099181663
35029,3078.223867,3078.303433,1,92346716,92349102,2386,0.7907899885981976
35030,3078.346033,3078.3476,1,92350380,92350428,48,
35031,3078.400433,3078.404767,1,92352012,92352143,131,0.29182022270282815
35032,3078.414167,3078.417167,1,92352425,92352515,90,0.17972022785752895
35033,3078.430433,3078.474167,1,92352912,92354225,1313,0.7537320030015798
35034,3078.4752,3078.483967,1,92354256,92354519,263,0.7973691917951488
35035,3078.488033,3078.6104,1,92354640,92358312,3672,0.8231996424716078
35036,3078.636033,3078.667033,1,92359080,92360010,930,-0.03256557556330279
35037,3078.670667,3078.683367,1,92360120,92360501,381,0.21413463688350082
35038,3078.7027,3078.7202,1,92361081,92361606,525,0.7587666747015461
35039,3078.7221,3078.823567,1,92361663,92364707,3044,0.793607800096007
35040,3078.8439,3078.854267,1,92365317,92365628,311,-0.005212285435108068
35041,3078.8558,3078.899033,1,92365674,92366970,1296,0.09006057286362894
35042,3078.907533,3078.9141,1,92367225,92367423,198,0.09139602240600582
35043,3078.9189,3078.989667,1,92367567,92369690,2123,0.7939238315935268
35044,3078.991667,3079.054,1,92369750,92371620,1870,0.8297144359994242
35045,3079.0597,3079.063233,1,92371791,92371896,105,
35046,3079.072233,3079.077667,1,92372166,92372330,164,0.1297297051052215
35047,3079.084933,3079.088433,1,92372547,92372652,105,-0.05146122136326255
35048,3079.330133,3079.343667,1,92379903,92380310,407,0.05770585865727395
35049,3079.346367,3079.388767,1,92380391,92381663,1272,-0.011463966607982493
35050,3079.417033,3079.491467,1,92382510,92384744,2234,0.8014334346437323
35051,3079.492533,3079.5562,1,92384775,92386686,1911,0.8311689880967474
35052,3079.565767,3079.593033,1,92386973,92387790,817,-0.0023175493452040562
35053,3079.598033,3079.624867,1,92387940,92388746,806,0.17997120194427285
35054,3079.626467,3079.641233,1,92388794,92389236,442,0.22037067308997865
35055,3079.6486,3079.654267,1,92389458,92389628,170,0.5628940260271481
35056,3079.658567,3079.806767,1,92389757,92394203,4446,0.8025034751940485
35057,3079.812867,3079.8179,1,92394386,92394537,151,-0.01770134665870406
35058,3079.8213,3079.833767,1,92394639,92395013,374,-0.02282810367111597
35059,3079.853267,3079.8569,1,92395598,92395707,109,-0.20532991923499844
35060,3079.864,3079.8737,1,92395920,92396211,291,-0.002319640895128766
35061,3079.9029,3080.040867,1,92397087,92401226,4139,0.7939755309587287
35062,3080.0575,3080.100133,1,92401725,92403003,1278,0.03999536091894205
35063,3080.102267,3080.123833,1,92403068,92403714,646,0.42063094333989937
35064,3080.140233,3080.140967,1,92404206,92404229,23,
35065,3080.1497,3080.2345,1,92404491,92407035,2544,0.8256112198222346
35066,3080.239,3080.291833,1,92407170,92408754,1584,0.8292736962481437
35067,3080.303033,3080.3369,1,92409090,92410107,1017,-0.027873501590899224
35068,3080.338733,3080.360133,1,92410161,92410803,642,0.04174648925736957
35069,3080.395533,3080.4467,1,92411865,92413401,1536,0.7672578566955355
35070,3080.448367,3080.452633,1,92413451,92413578,127,-0.04206201189627603
35071,3080.454833,3080.468533,1,92413644,92414055,411,0.9448630604438266
35072,3080.470233,3080.488167,1,92414106,92414645,539,0.8938664779615615
35073,3080.490567,3080.524733,1,92414717,92415741,1024,0.7534296274402494
35074,3080.539133,3080.548167,1,92416173,92416445,272,-0.04855360465998618
35075,3080.554033,3080.565233,1,92416620,92416956,336,0.09744041817127976
35076,3080.575733,3080.5792,1,92417271,92417376,105,
35077,3080.583633,3080.590733,1,92417508,92417721,213,-0.10238293807272959
35078,3080.606633,3080.61,1,92418198,92418300,102,0.713796923267663
35079,3080.657633,3080.6612,1,92419728,92419836,108,0.3210236248993258
35080,3080.665067,3080.754967,1,92419952,92422649,2697,0.7532828497014771
35081,3080.758933,3080.765467,1,92422767,92422964,197,0.5138287937557092
35082,3080.769033,3080.788733,1,92423070,92423661,591,0.8042686788997817
35083,3080.8152,3080.8256,1,92424456,92424768,312,0.006011901110785541
35084,3080.833033,3080.837167,1,92424990,92425115,125,-0.16586675621855848
35085,3080.847133,3080.853433,1,92425413,92425602,189,0.1786567330618115
35086,3080.8566,3080.862067,1,92425698,92425862,164,-0.27899904742107473
35087,3080.898033,3081.045133,1,92426940,92431353,4413,0.7347726058088146
35088,3081.357067,3081.361333,1,92440712,92440839,127,-0.24178130064469017
35089,3081.369067,3081.397733,1,92441072,92441931,859,0.5676395168743118
35090,3081.4213,3081.437833,1,92442639,92443134,495,0.5588415625851487
35091,3081.445967,3081.449,1,92443379,92443470,91,-0.0670303042056389
35092,3081.600633,3081.607333,1,92448018,92448219,201,0.549781542669648
35093,3081.615033,3081.6264,1,92448450,92448792,342,0.5771360651832788
35094,3081.629533,3081.671933,1,92448885,92450157,1272,0.8460988792802413
35095,3081.6732,3081.797467,1,92450196,92453924,3728,0.8159252594448368
35096,3081.798533,3081.8325,1,92453955,92454975,1020,0.8229414191015691
35097,3081.843633,3081.849567,1,92455308,92455487,179,0.6659871037211026
35098,3081.8746,3081.881233,1,92456238,92456436,198,-0.11706756549908247
35099,3082.405833,3082.414,1,92472174,92472420,246,0.6292049344261974
35100,3082.420667,3082.442433,1,92472620,92473272,652,0.6181567000798406
35101,3082.4699,3082.483767,1,92474097,92474513,416,0.6526804742866429
35102,3082.514833,3082.520967,1,92475444,92475629,185,0.7344151710252661
35103,3082.5419,3082.552967,1,92476257,92476589,332,0.6832019188468367
35104,3082.731967,3082.7367,1,92481959,92482101,142,0.5872496590295105
35105,3082.74,3082.757933,1,92482200,92482737,537,0.8041397351279925
35106,3082.759167,3082.818067,1,92482775,92484542,1767,0.7181366559818042
35107,3082.826233,3082.849633,1,92484786,92485488,702,0.7261073948724911
35108,3083.076767,3083.083367,1,92492303,92492501,198,0.5809689071225931
35109,3083.085233,3083.241333,1,92492556,92497239,4683,0.8007898718366573
35110,3083.243033,3083.341233,1,92497290,92500236,2946,0.74071889906056
35111,3083.355667,3083.383,1,92500670,92501490,820,-0.052377914332540305
35112,3083.385167,3083.396633,1,92501555,92501898,343,0.06268823050722074
35113,3083.398067,3083.408,1,92501942,92502240,298,0.11989038122431309
35114,3083.428433,3083.4332,1,92502852,92502996,144,0.7277567925423426
35115,3083.440967,3083.631967,1,92503229,92508959,5730,0.8329674634243258
35116,3083.6428,3083.685067,1,92509284,92510552,1268,0.835897687365456
35117,3083.6863,3083.724633,1,92510589,92511738,1149,0.8090895089152362
35118,3083.739967,3083.7439,1,92512199,92512317,118,-0.0748070957082352
35119,3083.745067,3083.757333,1,92512352,92512719,367,-0.07226200800032258
35120,3083.759467,3083.765333,1,92512784,92512959,175,-0.07475396358386205
35121,3083.770667,3083.779667,1,92513120,92513390,270,0.272143562299951
35122,3083.7863,3083.794467,1,92513589,92513834,245,0.19901794449725405
35123,3083.9895,3084.0176,1,92519685,92520528,843,0.8128640987701464
35124,3084.033067,3084.0425,1,92520992,92521275,283,0.7314818758224989
35125,3084.059333,3084.0955,1,92521779,92522865,1086,0.7809221032631196
35126,3084.0973,3084.130533,1,92522919,92523915,996,0.7109589567335319
35127,3084.1317,3084.1436,1,92523951,92524308,357,0.6710987637848251
35128,3084.163,3084.214267,1,92524890,92526428,1538,0.6905371800391501
35129,3084.215467,3084.282267,1,92526464,92528468,2004,0.7189012428563195
35130,3084.2892,3084.3028,1,92528676,92529084,408,0.5802305753883601
35131,3084.306433,3084.3246,1,92529192,92529738,546,0.7950039444002932
35132,3084.3268,3084.407533,1,92529804,92532225,2421,0.7297615928766314
35133,3084.460067,3084.4674,1,92533802,92534022,220,0.6945127237458977
35134,3084.486167,3084.495733,1,92534585,92534871,286,-0.08110737109393651
35135,3084.506433,3084.509567,1,92535192,92535287,95,
35136,3084.510633,3084.517067,1,92535318,92535512,194,0.39047935628933456
35137,3084.523,3084.634833,1,92535690,92539044,3354,0.8232457519595473
35138,3084.641067,3084.644333,1,92539232,92539329,97,0.8701990595136424
35139,3084.655433,3084.662433,1,92539662,92539872,210,
35140,3084.666267,3084.673067,1,92539988,92540192,204,-0.008216557018090436
35141,3084.678833,3084.7013,1,92540364,92541039,675,0.27529672238065206
35142,3084.702533,3084.7084,1,92541075,92541252,177,-0.05773825016681442
35143,3084.726067,3084.760067,1,92541782,92542802,1020,0.816921555544508
35144,3084.762133,3084.845667,1,92542863,92545370,2507,0.8206725257196615
35145,3084.8645,3084.882033,1,92545935,92546460,525,0.7940148793166977
35146,3084.883433,3084.928867,1,92546502,92547866,1364,0.8182238725985256
35147,3084.943333,3084.986567,1,92548299,92549597,1298,0.7516813374005676
35148,3084.9985,3085.018,1,92549955,92550540,585,-0.07873120611620985
35149,3085.019333,3085.030267,1,92550579,92550908,329,0.1665348441988528
35150,3085.0317,3085.037933,1,92550951,92551137,186,0.30969573441562775
35151,3085.044833,3085.051033,1,92551344,92551530,186,0.21855937968535788
35152,3085.072533,3085.079233,1,92552175,92552376,201,0.16703673356154816
35153,3085.0811,3085.2283,1,92552433,92556849,4416,0.8399466825369053
35154,3085.264967,3085.270833,1,92557949,92558124,175,0.2910311544396969
35155,3085.2736,3085.321333,1,92558208,92559639,1431,0.004812008649792854
35156,3085.323833,3085.407267,1,92559714,92562218,2504,0.812251609778141
35157,3085.4116,3085.525467,1,92562348,92565764,3416,0.8546345967833366
35158,3085.531033,3085.534933,1,92565930,92566047,117,0.6554577671104631
35159,3085.5408,3085.544667,1,92566224,92566340,116,-0.15983680152819865
35160,3085.547067,3085.5659,1,92566412,92566977,565,0.02376854371210858
35161,3085.5691,3085.5926,1,92567073,92567778,705,0.24609789462216716
35162,3085.594,3085.599067,1,92567820,92567972,152,0.5626737782599885
35163,3085.614633,3085.6212,1,92568438,92568636,198,0.2618417124425606
35164,3085.6287,3085.648633,1,92568861,92569458,597,0.8268934244991736
35165,3085.650833,3085.7505,1,92569524,92572515,2991,0.7796212351891282
35166,3085.755567,3085.761533,1,92572667,92572845,178,0.7625397096711946
35167,3085.777933,3085.893467,1,92573337,92576804,3467,0.7895927129817611
35168,3085.994167,3086.001567,1,92579825,92580047,222,0.31226694418363155
35169,3086.008233,3086.0153,1,92580246,92580459,213,0.6535370565130575
35170,3086.016867,3086.0601,1,92580506,92581803,1297,0.8459245032211364
35171,3086.062633,3086.073633,1,92581878,92582208,330,0.8708401109875267
35172,3086.076867,3086.197533,1,92582306,92585925,3619,0.8148226270321475
35173,3086.219733,3086.232433,1,92586591,92586972,381,0.07026087163016874
35174,3086.2349,3086.253167,1,92587047,92587595,548,-0.015925146390896247
35175,3086.259867,3086.281667,1,92587796,92588450,654,0.3037110100477569
35176,3086.2862,3086.293367,1,92588586,92588801,215,-0.025066511443518694
35177,3086.3,3086.499967,1,92589000,92594999,5999,0.7887029562544274
35178,3086.504867,3086.5634,1,92595146,92596902,1756,0.7507140660340043
35179,3086.573533,3086.591567,1,92597205,92597747,542,-0.04636412910800039
35180,3086.5977,3086.604533,1,92597931,92598135,204,0.02590329852766178
35181,3086.606933,3086.6196,1,92598207,92598588,381,0.3448063211761587
35182,3086.620733,3086.627867,1,92598621,92598836,215,0.325956527941886
35183,3086.6518,3086.735867,1,92599554,92602076,2522,0.8219752975664162
35184,3086.737167,3086.8544,1,92602115,92605632,3517,0.810854689929996
35185,3086.870567,3086.946667,1,92606117,92608400,2283,0.7424464460299656
35186,3086.951567,3086.972433,1,92608547,92609172,625,0.4443411746831303
35187,3086.9753,3087.034967,1,92609259,92611049,1790,0.7160543003873947
35188,3087.036567,3087.058367,1,92611097,92611751,654,0.8247589282947433
35189,3087.061533,3087.073233,1,92611845,92612196,351,0.734271159599509
35190,3087.075467,3087.0803,1,92612264,92612409,145,0.22578622467070975
35191,3087.081333,3087.085167,1,92612439,92612555,116,0.8174663835717404
35192,3087.0882,3087.172933,1,92612646,92615187,2541,0.8128462266273841
35193,3087.177367,3087.202367,1,92615321,92616071,750,0.3345280056680877
35194,3087.205667,3087.2806,1,92616170,92618418,2248,0.8220259878400882
35195,3087.282433,3087.296967,1,92618472,92618909,437,0.7635868745255658
35196,3087.2993,3087.326667,1,92618979,92619800,821,0.7377069269893114
35197,3087.329867,3087.4249,1,92619896,92622747,2851,0.7969987324593869
35198,3087.430467,3087.451767,1,92622914,92623553,639,0.8082097816702791
35199,3087.4557,3087.513933,1,92623671,92625417,1746,0.818872534622713
35200,3087.519333,3087.548233,1,92625579,92626446,867,0.7580769691187357
35201,3087.557233,3087.569533,1,92626716,92627085,369,0.8394447153711819
35202,3087.583567,3087.639767,1,92627507,92629193,1686,0.8008472146720957
35203,3087.646633,3087.649733,1,92629398,92629491,93,
35204,3087.650767,3087.674233,1,92629523,92630226,703,0.6999419207769296
35205,3087.677467,3087.6837,1,92630324,92630511,187,0.17866674846134215
35206,3087.685367,3087.692167,1,92630561,92630765,204,0.5094567454839424
35207,3087.695967,3087.700967,1,92630879,92631029,150,0.5163384337604023
35208,3087.707333,3087.8015,1,92631219,92634045,2826,0.8072629486925494
35209,3087.805633,3087.8315,1,92634168,92634945,777,0.8278577796949789
35210,3087.8347,3087.931033,1,92635041,92637930,2889,0.8008219574026102
35211,3087.932233,3087.9603,1,92637966,92638809,843,0.8548969812857965
35212,3087.9631,3088.036267,1,92638893,92641088,2195,0.8206531652158932
35213,3088.039233,3088.042667,1,92641176,92641280,104,0.26320546093877206
35214,3088.044667,3088.0569,1,92641340,92641707,367,0.8085110898071991
35215,3088.060967,3088.086933,1,92641829,92642607,778,0.8486913813665632
35216,3088.090833,3088.188933,1,92642724,92645667,2943,0.836180965522541
35217,3088.190567,3088.206433,1,92645717,92646192,475,0.8745136353027558
35218,3088.212067,3088.218833,1,92646362,92646564,202,0.694325131438437
35219,3088.222933,3088.325733,1,92646687,92649771,3084,0.7890283952403512
35220,3088.3301,3088.333633,1,92649903,92650008,105,0.38362539582901817
35221,3088.337167,3088.342967,1,92650115,92650289,174,0.8716812244660717
35222,3088.3462,3088.3561,1,92650386,92650683,297,0.8257901169679716
35223,3088.3598,3088.462867,1,92650794,92653886,3092,0.7767648453228649
35224,3088.468033,3088.493633,1,92654040,92654808,768,0.8282683254297555
35225,3088.497967,3088.556133,1,92654939,92656683,1744,0.7251687138209184
35226,3088.566433,3088.593033,1,92656992,92657790,798,0.668466008537859
35227,3088.599233,3088.616833,1,92657976,92658504,528,0.8779009778543146
35228,3088.629667,3088.667867,1,92658890,92660036,1146,0.7124866525511343
35229,3088.670267,3088.6839,1,92660108,92660517,409,0.7625617376567506
35230,3088.698933,3088.719333,1,92660967,92661579,612,0.6445272237175825
35231,3088.727567,3088.736467,1,92661827,92662094,267,0.7843516215607826
35232,3088.7419,3088.803533,1,92662257,92664105,1848,0.7057367115216556
35233,3088.818033,3088.8222,1,92664540,92664666,126,-0.14800717075145559
35234,3088.8236,3088.8437,1,92664708,92665311,603,0.2885764409490106
35235,3088.851833,3088.913967,1,92665554,92667419,1865,0.7612443463143547
35236,3088.935467,3088.9442,1,92668064,92668326,262,0.4694596603794855
35237,3088.963033,3088.9679,1,92668890,92669037,147,0.0627001701703101
35238,3089.236633,3089.265633,1,92677098,92677968,870,0.6480020370996694
35239,3089.3019,3089.313433,1,92679057,92679402,345,0.6886847008249563
35240,3089.449567,3089.4549,1,92683487,92683647,160,0.6101465679981305
35241,3089.46,3089.637933,1,92683800,92689137,5337,0.8491180503678945
35242,3089.659567,3089.7329,1,92689787,92691987,2200,0.8053023418159146
35243,3089.759833,3089.789,1,92692794,92693670,876,0.7853623392108796
35244,3089.7936,3089.800733,1,92693808,92694021,213,0.3336772065133647
35245,3089.805233,3089.8737,1,92694156,92696211,2055,0.7965844637418533
35246,3089.875367,3089.887033,1,92696261,92696610,349,0.80193289589995
35247,3089.888467,3089.8993,1,92696654,92696979,325,0.21747933349006957
35248,3089.9028,3089.989867,1,92697084,92699696,2612,0.7892935971142231
35249,3089.993133,3090.016533,1,92699793,92700495,702,0.48470166157086003
35250,3090.0229,3090.120067,1,92700687,92703602,2915,0.8287571602905006
35251,3090.121633,3090.127167,1,92703648,92703815,167,0.6104124123656036
35252,3090.131067,3090.139033,1,92703932,92704170,238,0.7190104291818794
35253,3090.1553,3090.210633,1,92704659,92706318,1659,0.7704577643479745
35254,3090.2226,3090.227667,1,92706678,92706830,152,0.8545422783110478
35255,3090.229533,3090.245233,1,92706885,92707356,471,0.8619218439730165
35256,3090.248933,3090.2535,1,92707467,92707605,138,0.7717785884454904
35257,3090.280167,3090.336167,1,92708405,92710085,1680,0.7933145915802916
35258,3090.3373,3090.354367,1,92710119,92710631,512,0.6256467534459288
35259,3090.355533,3090.374833,1,92710665,92711244,579,0.8234952566354092
35260,3090.378867,3090.3839,1,92711366,92711517,151,0.7693277704020556
35261,3090.409267,3090.467133,1,92712278,92714013,1735,0.7982245998347215
35262,3090.468867,3090.503533,1,92714066,92715105,1039,0.7270983404344774
35263,3090.508467,3090.514133,1,92715254,92715423,169,0.8255909353068844
35264,3090.5154,3090.5265,1,92715462,92715795,333,0.587531430721533
35265,3090.5398,3090.5797,1,92716194,92717391,1197,0.820453090718414
35266,3090.580867,3090.612333,1,92717426,92718369,943,0.7882122114112547
35267,3090.614933,3090.6363,1,92718447,92719089,642,0.7669381103296439
35268,3090.639933,3090.645867,1,92719197,92719376,179,0.7870753751751365
35269,3090.647767,3090.659,1,92719433,92719770,337,0.6459761042995894
35270,3090.6725,3090.768433,1,92720175,92723052,2877,0.8131091241245919
35271,3090.7716,3090.7932,1,92723148,92723796,648,0.5500643005506872
35272,3090.803267,3090.902233,1,92724098,92727066,2968,0.8205003170239494
35273,3090.905967,3091.026367,1,92727179,92730791,3612,0.509494403788152
35274,3091.034033,3091.045567,1,92731020,92731367,347,0.6835970082242793
35275,3091.0487,3091.0577,1,92731461,92731731,270,0.633414918860558
35276,3091.061733,3091.152233,1,92731851,92734566,2715,0.800043556916886
35277,3091.160967,3091.176733,1,92734829,92735301,472,0.6871381016728338
35278,3091.1792,3091.185433,1,92735376,92735562,186,0.48806643231922675
35279,3091.189867,3091.279533,1,92735696,92738385,2689,0.8163986554389578
35280,3091.286633,3091.305233,1,92738598,92739156,558,0.7016531917699546
35281,3091.308367,3091.318333,1,92739251,92739549,298,0.7609194763987601
35282,3091.3196,3091.343,1,92739588,92740290,702,0.7327711438113219
35283,3091.344167,3091.352833,1,92740325,92740584,259,0.7290485736448341
35284,3091.3573,3091.360533,1,92740719,92740815,96,-0.21904203368046585
35285,3091.3691,3091.4108,1,92741073,92742324,1251,0.6747363063083551
35286,3091.423333,3091.426533,1,92742699,92742795,96,0.6855990466242828
35287,3091.4307,3091.4599,1,92742921,92743797,876,-0.05065192504548286
35288,3091.4639,3091.472667,1,92743917,92744180,263,0.028986313198840027
35289,3091.5577,3091.5608,1,92746731,92746824,93,0.5262070103450947
35290,3091.587033,3091.6034,1,92747610,92748102,492,0.4014389683736916
35291,3091.605833,3091.617933,1,92748174,92748537,363,0.5018624440423289
35292,3091.629467,3091.632967,1,92748884,92748989,105,
35293,3091.758933,3091.783667,1,92752767,92753510,743,0.5366964972309892
35294,3091.803333,3091.832367,1,92754099,92754971,872,0.588703856302566
35295,3091.983567,3091.997467,1,92759507,92759924,417,0.5191122504381729
35296,3092.008,3092.030467,1,92760240,92760914,674,0.43621005505877797
35297,3092.031767,3092.039067,1,92760953,92761172,219,0.4174873097701589
35298,3092.059367,3092.066,1,92761781,92761980,199,-0.10165922935631555
35299,3092.0741,3092.080667,1,92762223,92762420,197,0.5339078022745868
35300,3092.0885,3092.094333,1,92762655,92762829,174,0.42646626812993715
35301,3092.167367,3092.174733,1,92765021,92765241,220,0.4414846654857682
35302,3092.1851,3092.2157,1,92765553,92766471,918,0.41407059728322165
35303,3092.2397,3092.248967,1,92767191,92767469,278,-0.0005880859689797023
35304,3092.25,3092.256333,1,92767500,92767689,189,0.8222087256532268
35305,3092.257533,3092.260533,1,92767725,92767815,90,0.14453607868099666
35306,3092.2655,3092.269133,1,92767965,92768073,108,
35307,3092.334367,3092.341033,1,92770031,92770230,199,0.7143029019090386
35308,3092.3431,3092.3953,1,92770293,92771859,1566,0.5464160241115896
35309,3092.4002,3092.4076,1,92772006,92772228,222,0.18223495897562747
35310,3092.431233,3092.455,1,92772936,92773650,714,0.5795814867286526
35311,3092.479867,3092.4927,1,92774396,92774781,385,0.5749552935832778
35312,3092.496833,3092.517467,1,92774904,92775524,620,0.5389192143559252
35313,3092.5327,3092.536767,1,92775981,92776103,122,0.3647129869016417
35314,3092.577833,3092.580967,1,92777334,92777429,95,
35315,3092.582033,3092.633167,1,92777460,92778995,1535,0.07695864724082555
35316,3092.634633,3092.6489,1,92779038,92779467,429,-0.12569267773098589
35317,3092.653667,3092.769267,1,92779610,92783078,3468,0.8277794071799588
35318,3092.787567,3092.7998,1,92783627,92783994,367,0.5433953432990485
35319,3092.807067,3092.811767,1,92784212,92784353,141,0.3840886209263423
35320,3092.8139,3092.836167,1,92784417,92785085,668,0.10009041567525544
35321,3092.837867,3092.869233,1,92785136,92786076,940,0.2205087605977167
35322,3092.8946,3093.067733,1,92786838,92792031,5193,0.8291373005770479
35323,3093.107667,3093.111967,1,92793230,92793359,129,
35324,3093.2575,3093.278,1,92797725,92798340,615,0.7176391431312201
35325,3093.282933,3093.295667,1,92798487,92798870,383,0.7316615930807555
35326,3093.353733,3093.3682,1,92800611,92801046,435,0.7160067288328241
35327,3093.394867,3093.400867,1,92801846,92802026,180,0.6273282372023287
35328,3093.402233,3093.443367,1,92802066,92803301,1235,0.7628485762844174
35329,3093.471633,3093.486,1,92804148,92804580,432,0.7782153785654297
35330,3093.508367,3093.524733,1,92805251,92805741,490,0.7548320458149219
35331,3093.528267,3093.5366,1,92805848,92806098,250,0.6315767621489254
35332,3093.545233,3093.550567,1,92806356,92806517,161,0.48398209033089057
35333,3093.562,3093.586833,1,92806860,92807604,744,0.10616891264831244
35334,3093.589367,3093.615,1,92807681,92808450,769,0.22407886588083134
35335,3093.617133,3093.624067,1,92808513,92808722,209,0.12957345861904923
35336,3093.6376,3093.6421,1,92809128,92809263,135,-0.03144798232977076
35337,3093.660033,3093.809167,1,92809800,92814275,4475,0.7834483215165002
35338,3093.8217,3093.8601,1,92814651,92815803,1152,0.751420060097684
35339,3093.894967,3093.976367,1,92816849,92819291,2442,0.7417306511387413
35340,3094.078533,3094.140533,1,92822355,92824215,1860,0.7813340134548874
35341,3094.1455,3094.153533,1,92824365,92824605,240,0.5862323503857775
35342,3094.156067,3094.188467,1,92824682,92825654,972,0.7884589155910446
35343,3094.200167,3094.2407,1,92826005,92827221,1216,0.059843891151759414
35344,3094.2471,3094.2539,1,92827413,92827617,204,-0.061115041085122286
35345,3094.266133,3094.4582,1,92827983,92833746,5763,0.7986532096317235
35346,3094.462967,3094.5374,1,92833889,92836122,2233,0.8263521256309496
35347,3095.508567,3095.534067,1,92865257,92866022,765,0.7375357849278942
35348,3095.637167,3095.646433,1,92869115,92869392,277,0.6659210782565489
35349,3095.704667,3095.717867,1,92871140,92871536,396,0.5071199043192499
35350,3096.132033,3096.149733,1,92883960,92884491,531,0.6980710684959877
35351,3096.164633,3096.174067,1,92884938,92885222,284,0.675173727379381
35352,3096.1964,3096.203633,1,92885892,92886108,216,0.8624325934618658
35353,3096.232033,3096.240267,1,92886960,92887208,248,0.6978407143139044
35354,3096.2463,3096.286767,1,92887389,92888603,1214,0.4619192374138089
35355,3096.3125,3096.333467,1,92889375,92890004,629,0.6668077706905632
35356,3096.358533,3096.371867,1,92890755,92891156,401,0.634008909568104
35357,3096.3776,3096.4435,1,92891328,92893305,1977,0.10298533976782868
35358,3096.490433,3096.554533,1,92894712,92896635,1923,0.7947076241953079
35359,3096.555567,3096.585167,1,92896667,92897555,888,0.7712967875531767
35360,3097.2306,3097.249133,1,92916918,92917473,555,0.3194773702810148
35361,3097.280633,3097.3224,1,92918418,92919672,1254,0.8219784388085936
35362,3097.3235,3097.377433,1,92919705,92921322,1617,0.8378096685095753
35363,3097.3998,3097.404033,1,92921994,92922120,126,0.3341296404952306
35364,3097.4217,3097.440833,1,92922651,92923224,573,0.13995149491642872
35365,3097.443167,3097.452033,1,92923295,92923560,265,0.39621231154336983
35366,3097.768667,3097.839667,1,92933060,92935190,2130,0.6633734860426191
35367,3097.8408,3097.844367,1,92935224,92935331,107,-0.2930529874288247
35368,3097.854767,3097.8756,1,92935643,92936268,625,0.7050093872518517
35369,3097.893,3097.898767,1,92936790,92936963,173,-0.089480998036878
35370,3097.921067,3097.928167,1,92937632,92937845,213,0.6564698260313648
35371,3097.929733,3097.933167,1,92937891,92937995,104,0.578393944402161
35372,3097.9367,3097.9761,1,92938101,92939283,1182,0.02443859844211815
35373,3097.9851,3098.005033,1,92939553,92940150,597,-0.08738124613224668
35374,3098.014267,3098.021967,1,92940428,92940659,231,-0.043072789773680474
35375,3098.027233,3098.123,1,92940816,92943690,2874,0.5779623074851866
35376,3098.1343,3098.138467,1,92944029,92944154,125,0.14675208874645648
35377,3098.150433,3098.2875,1,92944512,92948625,4113,0.376310053496215
35378,3098.311533,3098.330733,1,92949345,92949921,576,0.7655357598293556
35379,3098.340767,3098.3441,1,92950223,92950323,100,-0.1341259440010018
35380,3098.363833,3098.374367,1,92950914,92951231,317,0.515382673631614
35381,3098.383233,3098.4207,1,92951496,92952621,1125,0.06845793363923523
35382,3098.424433,3098.4398,1,92952732,92953194,462,0.2942406886415143
35383,3098.442167,3098.452067,1,92953265,92953562,297,-0.05492659449439174
35384,3098.489467,3098.4975,1,92954684,92954925,241,0.11098958506270469
35385,3098.509967,3098.601633,1,92955299,92958048,2749,0.11907890401150148
35386,3098.6027,3098.611533,1,92958081,92958345,264,0.3789959270502269
35387,3098.659367,3098.665433,1,92959781,92959962,181,0.6262502406774672
35388,3098.6808,3098.691967,1,92960424,92960759,335,0.6824546461205042
35389,3098.693467,3098.702133,1,92960804,92961063,259,0.3775796667101771
35390,3098.735667,3098.750667,1,92962070,92962520,450,0.7922578558079695
35391,3098.760167,3098.768367,1,92962805,92963051,246,0.7118716605849835
35392,3098.791867,3098.8228,1,92963756,92964684,928,0.7046536611161377
35393,3098.834733,3098.8511,1,92965041,92965533,492,0.5336233642234784
35394,3098.859,3098.8651,1,92965770,92965953,183,0.4867632644389522
35395,3098.871167,3098.8912,1,92966135,92966736,601,0.5581019506741375
35396,3098.905467,3098.920833,1,92967164,92967624,460,0.4932356157012703
35397,3098.9733,3098.988133,1,92969199,92969643,444,0.49595776710318207
35398,3099.012533,3099.024167,1,92970375,92970725,350,0.5557681982138883
35399,3099.0994,3099.1044,1,92972982,92973132,150,-0.0008407222663134845
35400,3099.109167,3099.115933,1,92973275,92973477,202,0.8957978376353357
35401,3099.176,3099.298167,1,92975280,92978945,3665,0.6998282953594013
35402,3099.346167,3099.418733,1,92980385,92982561,2176,0.4910679159257984
35403,3099.431167,3099.499167,1,92982935,92984975,2040,0.09203823929182978
35404,3099.500667,3099.563467,1,92985020,92986904,1884,0.48653633663058965
35405,3099.5648,3099.676367,1,92986944,92990291,3347,0.37676975216674613
35406,3099.850533,3099.855867,1,92995515,92995676,161,0.5192452172559251
35407,3099.8675,3099.898933,1,92996025,92996967,942,0.2891501913730067
35408,3099.900367,3099.9421,1,92997011,92998263,1252,0.06579393360253542
35409,3099.943867,3099.966833,1,92998316,92999004,688,0.27929325067651606
35410,3099.986067,3100.096533,1,92999582,93002895,3313,0.8367051593121881
35411,3100.108567,3100.120967,1,93003257,93003629,372,0.3235700871802238
35412,3100.138833,3100.168867,1,93004164,93005066,902,-0.09004905295721856
35413,3100.175333,3100.178333,1,93005259,93005349,90,
35414,3100.5513,3100.662333,1,93016539,93019869,3330,0.7845343669828151
35415,3100.6893,3100.7007,1,93020679,93021021,342,0.32673498820860025
35416,3100.704667,3100.7521,1,93021140,93022563,1423,0.2665902862030264
35417,3100.7534,3100.778367,1,93022602,93023351,749,0.24854745516703128
35418,3100.825533,3100.832967,1,93024765,93024989,224,0.19189791074783072
35419,3100.840033,3100.8593,1,93025200,93025779,579,0.43170354981462344
35420,3100.860833,3100.871067,1,93025824,93026132,308,0.3196196982086145
35421,3100.875533,3100.9223,1,93026265,93027669,1404,0.2007645341119365
35422,3100.923667,3100.972833,1,93027710,93029184,1474,0.4213472702258593
35423,3100.9739,3101.008467,1,93029217,93030254,1037,0.8544964545508157
35424,3101.021933,3101.175133,1,93030657,93035253,4596,0.834883609391548
35425,3101.1772,3101.180733,1,93035316,93035421,105,0.3300001003783975
35426,3101.186867,3101.204567,1,93035606,93036137,531,0.7332257918354403
35427,3101.230033,3101.240933,1,93036900,93037227,327,0.4997257875174638
35428,3101.2506,3101.273367,1,93037518,93038201,683,-0.11737425975820763
35429,3101.278,3101.285367,1,93038340,93038561,221,-0.04728235658716456
35430,3101.2944,3101.2999,1,93038832,93038997,165,0.5564430888193268
35431,3101.4797,3101.485,1,93044391,93044550,159,0.7135024471546307
35432,3101.488,3101.495033,1,93044640,93044850,210,0.6473842538028598
35433,3101.504867,3101.537333,1,93045146,93046119,973,0.747446204745284
35434,3101.551033,3101.6035,1,93046530,93048105,1575,0.7403297706690721
35435,3101.606533,3101.638267,1,93048195,93049148,953,0.7744182537170773
35436,3101.654167,3101.6916,1,93049625,93050748,1123,0.6593733505434275
35437,3101.697667,3101.752,1,93050930,93052560,1630,0.5878412724133584
35438,3101.771233,3101.7905,1,93053136,93053715,579,0.7963005182711388
35439,3101.807533,3101.822133,1,93054225,93054663,438,0.8252093320489604
35440,3101.832767,3101.852233,1,93054983,93055566,583,0.7812619991946772
35441,3101.854567,3101.862333,1,93055637,93055869,232,0.5658314456001281
35442,3101.8661,3101.945033,1,93055983,93058350,2367,0.5506610653386127
35443,3101.9722,3102.1512,1,93059166,93064536,5370,0.8405612581746341
35444,3102.1697,3102.195733,1,93065091,93065871,780,0.8324092273225286
35445,3102.2006,3102.2803,1,93066018,93068409,2391,0.7985372242395301
35446,3102.552133,3102.699767,1,93076563,93080993,4430,0.811359008735481
35447,3102.7015,3102.7751,1,93081045,93083253,2208,0.7682924513720037
35448,3102.784267,3102.7992,1,93083528,93083976,448,0.7891184693504691
35449,3102.800267,3102.8711,1,93084008,93086133,2125,0.7918025068941902
35450,3102.880567,3102.885,1,93086417,93086550,133,0.45700612377521355
35451,3102.8877,3102.901267,1,93086631,93087038,407,-0.039584065656400935
35452,3102.902567,3102.9058,1,93087077,93087174,97,0.2600063386980692
35453,3102.907233,3102.9107,1,93087216,93087321,105,
35454,3102.917167,3102.9242,1,93087515,93087726,211,0.08607184952206583
35455,3103.160367,3103.1638,1,93094811,93094914,103,0.640831552415139
35456,3103.1816,3103.1923,1,93095448,93095769,321,0.6331813105800418
35457,3103.201633,3103.276067,1,93096048,93098282,2234,0.8166727553288305
35458,3103.2825,3103.3069,1,93098475,93099207,732,0.6814361256105915
35459,3103.313233,3103.372067,1,93099396,93101162,1766,0.8209549085680715
35460,3103.385933,3103.416433,1,93101577,93102492,915,0.6743508880352227
35461,3103.4286,3103.4348,1,93102858,93103044,186,0.718790093642326
35462,3103.445233,3103.4606,1,93103356,93103818,462,-0.10150993385367875
35463,3103.4657,3103.4736,1,93103971,93104208,237,0.19241176585780406
35464,3103.478,3103.490267,1,93104340,93104708,368,0.025330593742365994
35465,3103.492667,3103.4997,1,93104780,93104991,211,0.5378086902252086
35466,3103.576533,3103.5899,1,93107295,93107697,402,0.3662448615063145
35467,3103.5965,3103.5997,1,93107895,93107991,96,0.8875887174524745
35468,3103.603333,3103.626067,1,93108099,93108782,683,-0.04191362526490115
35469,3103.6277,3103.649167,1,93108831,93109475,644,0.022187390775477083
35470,3103.655233,3103.758433,1,93109656,93112752,3096,0.8483328736969632
35471,3103.794967,3103.824233,1,93113849,93114726,877,0.5655861416950075
35472,3103.825267,3103.919933,1,93114758,93117597,2839,0.7830345715270406
35473,3103.930867,3103.935333,1,93117926,93118059,133,-0.07930024733690022
35474,3103.9368,3103.942067,1,93118104,93118262,158,0.16905738262116196
35475,3104.348733,3104.353533,1,93130461,93130605,144,0.6143755924190173
35476,3104.3556,3104.371933,1,93130668,93131157,489,0.6576418149006084
35477,3104.373433,3104.401133,1,93131202,93132033,831,0.790542002738342
35478,3104.4304,3104.438467,1,93132912,93133154,242,0.9396046344158525
35479,3104.440133,3104.4546,1,93133203,93133638,435,0.925299146361354
35480,3104.467733,3104.472333,1,93134031,93134169,138,0.5576072675927067
35481,3104.4869,3104.504333,1,93134607,93135129,522,0.37524395715892017
35482,3104.507667,3104.521367,1,93135230,93135641,411,0.7339359616751259
35483,3104.5537,3104.611133,1,93136611,93138333,1722,0.7962414613360077
35484,3104.623,3104.638833,1,93138690,93139164,474,0.5825667077594678
35485,3104.6514,3104.658167,1,93139542,93139745,203,0.6998512728462007
35486,3104.667467,3104.6729,1,93140024,93140187,163,-0.10552577622965789
35487,3104.6929,3104.7037,1,93140787,93141111,324,-0.00253240121966025
35488,3104.720333,3104.731,1,93141609,93141930,321,0.13197879925150088
35489,3104.733067,3104.738533,1,93141992,93142155,163,0.7070158033990749
35490,3104.9391,3105.106,1,93148173,93153180,5007,0.837355135681091
35491,3105.1238,3105.238167,1,93153714,93157145,3431,0.7820272370859493
35492,3105.240667,3105.318933,1,93157220,93159567,2347,0.7437119152786215
35493,3105.3203,3105.382233,1,93159609,93161466,1857,0.7743258723102422
35494,3105.400667,3105.404167,1,93162020,93162125,105,-0.02524643986387445
35495,3105.4056,3105.446133,1,93162168,93163383,1215,0.5101297749237268
35496,3105.453067,3105.4814,1,93163592,93164442,850,-0.07122219547387404
35497,3105.4936,3105.497467,1,93164808,93164924,116,0.16273797871348872
35498,3105.521733,3105.5299,1,93165651,93165897,246,0.05982157563063729
35499,3105.532567,3105.5576,1,93165977,93166728,751,0.06347515430944661
35500,3105.564733,3105.578633,1,93166941,93167358,417,0.19266478420917907
35501,3105.583733,3105.655333,1,93167511,93169659,2148,0.6966990265843138
35502,3105.678833,3105.7327,1,93170364,93171981,1617,0.7476690921760335
35503,3105.739567,3105.830133,1,93172187,93174903,2716,0.7979680340391175
35504,3105.8324,3105.869233,1,93174972,93176076,1104,0.8010284976219754
35505,3105.8706,3105.951567,1,93176118,93178547,2429,0.7148785564124128
35506,3105.9617,3105.987567,1,93178851,93179627,776,0.6610240425256135
35507,3105.9957,3106.0169,1,93179871,93180507,636,0.8254101450161057
35508,3106.0317,3106.056833,1,93180951,93181704,753,0.15321140390548338
35509,3106.0583,3106.107867,1,93181749,93183236,1487,0.47164301867266184
35510,3106.1104,3106.2836,1,93183312,93188508,5196,0.8350530738319201
35511,3106.3284,3106.336367,1,93189852,93190091,239,0.46608830346441743
35512,3106.337967,3106.348533,1,93190139,93190455,316,0.5045491219744227
35513,3106.349567,3106.414733,1,93190487,93192441,1954,0.7513045175071935
35514,3106.417,3106.433667,1,93192510,93193010,500,0.7064158414026892
35515,3106.434867,3106.482867,1,93193046,93194486,1440,0.7943299752506857
35516,3106.497733,3106.536467,1,93194931,93196094,1163,0.8282304746103032
35517,3106.5515,3106.590833,1,93196545,93197724,1179,0.06464286434679128
35518,3106.592233,3106.612033,1,93197766,93198360,594,0.09620748954743884
35519,3106.6199,3106.6236,1,93198597,93198708,111,0.6389142838885123
35520,3106.629433,3106.767233,1,93198882,93203016,4134,0.8090049452817084
35521,3106.791633,3106.878933,1,93203748,93206367,2619,0.8113526896667458
35522,3106.905233,3106.908533,1,93207156,93207255,99,
35523,3106.9174,3106.921167,1,93207522,93207635,113,
35524,3106.944267,3106.9507,1,93208328,93208521,193,-0.23499247996148018
35525,3107.162233,3107.1954,1,93214866,93215862,996,0.6185955575763332
35526,3107.2012,3107.214933,1,93216036,93216447,411,0.5491330471391674
35527,3107.221433,3107.307867,1,93216642,93219236,2594,0.7931729128080077
35528,3107.309,3107.3154,1,93219270,93219462,192,0.09288206536020531
35529,3107.322433,3107.344767,1,93219672,93220343,671,0.7822828625503733
35530,3107.345833,3107.417367,1,93220374,93222521,2147,0.8330290565350086
35531,3107.4342,3107.474467,1,93223026,93224234,1208,-0.04878593861925122
35532,3107.5174,3107.529767,1,93225522,93225893,371,0.6109642774818719
35533,3107.530833,3107.714033,1,93225924,93231420,5496,0.8038691191037679
35534,3107.7466,3107.754367,1,93232398,93232631,233,0.4355127797733272
35535,3107.760433,3107.783633,1,93232812,93233508,696,-0.006548049445895323
35536,3107.784867,3107.795633,1,93233546,93233868,322,0.13063689794476593
35537,3107.796633,3107.805167,1,93233898,93234155,257,0.0507579722903601
35538,3107.842233,3108.011367,1,93235266,93240341,5075,0.7865288635895392
35539,3108.012367,3108.0565,1,93240371,93241695,1324,0.7566864664698466
35540,3108.064567,3108.132367,1,93241937,93243971,2034,0.7524222783970581
35541,3108.1509,3108.158567,1,93244527,93244757,230,0.5028009594163574
35542,3108.160033,3108.173933,1,93244800,93245217,417,0.7166104880066446
35543,3108.180167,3108.2014,1,93245405,93246042,637,0.7374590005559812
35544,3108.226667,3108.276133,1,93246800,93248283,1483,-0.002364081647835549
35545,3108.3008,3108.304367,1,93249024,93249131,107,-0.14294123159871217
35546,3108.309833,3108.433667,1,93249294,93253010,3716,0.8388929606422977
35547,3108.4443,3108.5096,1,93253329,93255288,1959,0.8239283555218067
35548,3108.5299,3108.5406,1,93255897,93256218,321,0.8349480689999818
35549,3108.543533,3108.581167,1,93256305,93257435,1130,0.7538063964106402
35550,3108.582367,3108.613733,1,93257471,93258411,940,0.8016390163582086
35551,3108.6149,3108.731067,1,93258447,93261932,3485,0.7471248262788049
35552,3108.744633,3108.793633,1,93262338,93263808,1470,0.7469520250430307
35553,3108.7947,3108.827967,1,93263841,93264839,998,0.837604643827219
35554,3108.846767,3108.850133,1,93265403,93265503,100,0.355463119379626
35555,3108.866933,3108.8804,1,93266007,93266412,405,0.13208585624226282
35556,3109.212367,3109.218367,1,93276371,93276551,180,0.552905120109396
35557,3109.223267,3109.233567,1,93276698,93277007,309,0.5013299090056066
35558,3109.2679,3109.2709,1,93278037,93278127,90,0.6536866554075488
35559,3109.2721,3109.297667,1,93278163,93278930,767,0.6119265702511946
35560,3109.327567,3109.3426,1,93279827,93280278,451,0.47460425237963544
35561,3109.344633,3109.347667,1,93280338,93280430,92,0.16328699670680244
35562,3109.349733,3109.355733,1,93280491,93280671,180,0.5879615855714769
35563,3109.367067,3109.402367,1,93281012,93282071,1059,0.5197466060062172
35564,3109.4279,3109.4407,1,93282837,93283221,384,0.5954679177297816
35565,3109.442467,3109.4552,1,93283274,93283656,382,0.6508345695943881
35566,3109.4981,3109.531667,1,93284943,93285950,1007,0.03736741569818742
35567,3109.5336,3109.5381,1,93286008,93286143,135,0.22294897040125553
35568,3109.546133,3109.554967,1,93286383,93286649,266,-0.023070613086302618
35569,3109.564567,3109.705833,1,93286937,93291174,4237,0.8149127327145492
35570,3109.7215,3109.760833,1,93291645,93292824,1179,0.7507871416973707
35571,3109.768333,3109.8896,1,93293049,93296688,3639,0.7930792169599826
35572,3109.906567,3109.912867,1,93297197,93297386,189,0.03404134851481073
35573,3110.018833,3110.130467,1,93300564,93303914,3350,0.7891464810209753
35574,3110.1539,3110.1695,1,93304617,93305085,468,-0.08956724192664059
35575,3110.173167,3110.178833,1,93305195,93305364,169,-0.05708467548877898
35576,3110.185533,3110.197867,1,93305565,93305936,371,0.14586710822940047
35577,3110.199267,3110.206,1,93305978,93306180,202,-0.2432347743605748
35578,3110.2253,3110.229133,1,93306759,93306873,114,0.6608732986983759
35579,3110.2355,3110.471033,1,93307065,93314130,7065,0.8123081265074448
35580,3110.4866,3110.540067,1,93314598,93316202,1604,0.8026189162159768
35581,3110.5543,3110.569767,1,93316629,93317093,464,0.6521168538164591
35582,3110.577867,3110.587933,1,93317336,93317637,301,0.6148696738359164
35583,3110.606767,3110.638733,1,93318203,93319161,958,-0.04885903289652272
35584,3110.639733,3110.649567,1,93319191,93319487,296,0.21270477154789524
35585,3110.650967,3110.657767,1,93319529,93319733,204,0.23630938804672325
35586,3110.669333,3110.6751,1,93320079,93320253,174,0.17009580292171203
35587,3110.676867,3110.8519,1,93320306,93325557,5251,0.8498182892816376
35588,3110.892533,3110.9022,1,93326775,93327066,291,0.7055240040261694
35589,3110.9053,3110.9813,1,93327159,93329439,2280,0.8156235087273342
35590,3110.9837,3111.0105,1,93329511,93330315,804,0.7564907615572828
35591,3111.0115,3111.063033,1,93330345,93331890,1545,0.73726335390388
35592,3111.0669,3111.1726,1,93332007,93335178,3171,0.7829566465803767
35593,3111.174233,3111.194267,1,93335226,93335828,602,0.42307255102234576
35594,3111.2094,3111.231967,1,93336282,93336959,677,-0.11128139679908111
35595,3111.252167,3111.258867,1,93337565,93337766,201,-0.09705515809295781
35596,3112.175,3112.1844,1,93365250,93365532,282,0.7452281089825219
35597,3112.186067,3112.1901,1,93365582,93365703,121,0.31631634340819675
35598,3112.2033,3112.212067,1,93366099,93366362,263,0.6351429966556214
35599,3112.2479,3112.260967,1,93367437,93367829,392,0.6917879838578731
35600,3112.366067,3112.393033,1,93370982,93371790,808,0.3398438083437595
35601,3112.398567,3112.476467,1,93371957,93374294,2337,0.5678139669727419
35602,3112.521367,3112.606767,1,93375641,93378203,2562,0.7756491133351807
35603,3112.6723,3112.684233,1,93380169,93380526,357,0.38078725904596605
35604,3112.705067,3112.714267,1,93381152,93381428,276,0.18094332419699796
35605,3112.728667,3112.7827,1,93381860,93383481,1621,0.8028857597151102
35606,3112.783733,3112.815367,1,93383511,93384461,950,0.8417062419328971
35607,3112.829367,3112.845467,1,93384881,93385364,483,0.22073238786159047
35608,3112.8539,3112.878033,1,93385617,93386340,723,0.03959240795842919
35609,3112.881933,3112.9123,1,93386457,93387369,912,0.13368348035704844
35610,3112.940067,3112.943233,1,93388202,93388296,94,
35611,3112.9478,3112.9798,1,93388434,93389394,960,0.8706553250810224
35612,3112.985,3113.028067,1,93389550,93390842,1292,0.7200651500022469
35613,3113.0333,3113.058533,1,93390999,93391755,756,0.8775723398303624
35614,3113.089233,3113.1197,1,93392676,93393591,915,0.7477374687993772
35615,3113.133767,3113.191933,1,93394013,93395757,1744,0.6404826101742473
35616,3113.200967,3113.204,1,93396029,93396120,91,0.055907505530010226
35617,3113.2141,3113.245633,1,93396423,93397368,945,0.7614428011559407
35618,3113.269433,3113.290833,1,93398082,93398724,642,0.08001275125047609
35619,3113.292,3113.3153,1,93398760,93399459,699,0.24826137904036985
35620,3113.316667,3113.3249,1,93399500,93399747,247,0.2380931286805808
35621,3113.372667,3113.589367,1,93401180,93407681,6501,0.8312417770421553
35622,3113.601667,3113.617867,1,93408050,93408536,486,0.7077160586202877
35623,3113.619033,3113.6366,1,93408570,93409098,528,0.5857998828250867
35624,3113.647967,3113.655267,1,93409439,93409658,219,0.46354847331868454
35625,3113.6603,3113.6789,1,93409809,93410367,558,-0.08171357134864964
35626,3113.682067,3113.701267,1,93410462,93411038,576,0.05820325737429282
35627,3113.705533,3113.712533,1,93411165,93411375,210,0.2634491491521582
35628,3113.740433,3113.766867,1,93412212,93413006,794,0.7798120716492176
35629,3113.768,3114.018633,1,93413040,93420558,7518,0.7812021843033187
35630,3114.475533,3114.482467,1,93434265,93434474,209,0.28389537217536565
35631,3114.493967,3114.569933,1,93434819,93437097,2278,0.8246500154013195
35632,3114.5786,3114.625533,1,93437358,93438765,1407,0.8718496563580646
35633,3114.634,3114.6425,1,93439020,93439275,255,0.7476544467861144
35634,3114.653733,3114.663633,1,93439611,93439908,297,-0.039400308526242676
35635,3114.667033,3114.677933,1,93440010,93440337,327,0.15985365389300918
35636,3114.679767,3114.686067,1,93440393,93440582,189,0.351289789409973
35637,3114.962033,3114.971333,1,93448860,93449139,279,0.5867917877914024
35638,3114.989767,3114.9962,1,93449693,93449886,193,0.6315483923424251
35639,3115.011267,3115.018367,1,93450338,93450551,213,0.6232548692933082
35640,3115.026633,3115.057067,1,93450798,93451712,914,0.6818767271116166
35641,3115.0595,3115.062733,1,93451785,93451881,96,-0.21325493202550339
35642,3115.076333,3115.082667,1,93452289,93452480,191,0.6631081278817164
35643,3115.095033,3115.101733,1,93452850,93453051,201,0.7318620865446966
35644,3115.136367,3115.144033,1,93454091,93454320,229,0.5937040695752247
35645,3115.1487,3115.166633,1,93454461,93454998,537,0.5310132045622902
35646,3115.187267,3115.1993,1,93455618,93455979,361,0.6227340983173434
35647,3115.2531,3115.2589,1,93457593,93457767,174,0.6823245987479223
35648,3115.260933,3115.271833,1,93457827,93458154,327,0.5682463605709951
35649,3115.31,3115.314467,1,93459300,93459434,134,0.41978587026110176
35650,3115.442067,3115.4482,1,93463262,93463446,184,0.19358785293496913
35651,3115.449767,3115.5779,1,93463493,93467337,3844,0.8205714778491812
35652,3115.652367,3115.6762,1,93469571,93470286,715,0.6065675365366825
35653,3115.680967,3115.8486,1,93470429,93475458,5029,0.7613145277052226
35654,3115.8596,3115.8651,1,93475788,93475953,165,-0.052621831888288666
35655,3116.3693,3116.377867,1,93491079,93491336,257,0.5785595320980613
35656,3116.383067,3116.4116,1,93491492,93492348,856,0.7640306671574076
35657,3116.415167,3116.5241,1,93492455,93495723,3268,0.7820229385006717
35658,3116.539633,3116.605233,1,93496188,93498156,1968,0.7300896531531805
35659,3116.6174,3116.6948,1,93498522,93500844,2322,0.8028407815916062
35660,3116.702267,3116.736967,1,93501068,93502109,1041,0.726811316049419
35661,3116.760967,3116.771967,1,93502829,93503159,330,-0.01577983497120581
35662,3116.797733,3116.801733,1,93503931,93504051,120,0.8805608359723532
35663,3116.8075,3116.8602,1,93504225,93505806,1581,0.5888019343544295
35664,3116.862,3116.922567,1,93505860,93507677,1817,0.7918927845463735
35665,3116.933567,3116.9394,1,93508007,93508182,175,0.016053145121297588
35666,3117.225567,3117.348833,1,93516767,93520464,3697,0.8530234413466675
35667,3117.365767,3117.5503,1,93520973,93526509,5536,0.7675859602331658
35668,3117.5643,3117.5723,1,93526929,93527169,240,-0.11634529265254928
35669,3117.593367,3117.5966,1,93527801,93527898,97,0.6198126538294119
35670,3117.597833,3117.601533,1,93527934,93528045,111,
35671,3118.2494,3118.257467,1,93547482,93547724,242,0.7603545910116548
35672,3118.2595,3118.263567,1,93547785,93547907,122,0.6656266464278073
35673,3118.266767,3118.2733,1,93548003,93548199,196,0.534863135452312
35674,3118.274967,3118.2825,1,93548249,93548475,226,0.5260906601647688
35675,3118.283867,3118.2906,1,93548516,93548718,202,0.6227379132718028
35676,3118.292267,3118.2977,1,93548768,93548931,163,0.39902456255817764
35677,3118.309833,3118.328267,1,93549294,93549848,554,0.6153525659811778
35678,3118.332933,3118.3364,1,93549987,93550092,105,0.5022098806705133
35679,3118.3573,3118.3645,1,93550719,93550935,216,0.7328131488945153
35680,3118.390333,3118.3961,1,93551709,93551883,174,0.3159049287896413
35681,3118.514067,3118.532033,1,93555422,93555960,538,0.510363415051879
35682,3118.536467,3118.544633,1,93556094,93556338,244,0.6938669720536208
35683,3118.581533,3118.592733,1,93557445,93557781,336,0.7404310246164774
35684,3118.593833,3118.6005,1,93557814,93558015,201,0.678088626477661
35685,3118.669533,3118.678433,1,93560085,93560352,267,0.37505603684103156
35686,3118.696767,3118.7035,1,93560903,93561105,202,0.01997367791462223
35687,3118.717167,3118.720167,1,93561515,93561605,90,-0.2187657891118553
35688,3118.729367,3118.796267,1,93561881,93563888,2007,0.6979600100402136
35689,3118.798733,3118.8817,1,93563961,93566451,2490,0.6950308847697457
35690,3118.940567,3118.9534,1,93568217,93568602,385,-0.01808754614136158
35691,3118.959967,3118.962967,1,93568799,93568889,90,
35692,3118.992833,3119.001633,1,93569784,93570048,264,0.027896680150952497
35693,3119.0119,3119.0164,1,93570357,93570492,135,-0.20434533894229592
35694,3119.021267,3119.024633,1,93570638,93570738,100,
35695,3119.025767,3119.031867,1,93570773,93570956,183,-0.10335754317478603
35696,3119.213133,3119.2163,1,93576393,93576489,96,0.590334554613725
35697,3119.2222,3119.455633,1,93576666,93583668,7002,0.7593666574978962
35698,3119.4659,3119.470667,1,93583977,93584120,143,-0.1366780742139056
35699,3119.8087,3119.848733,1,93594261,93595461,1200,0.6049240502298557
35700,3119.8632,3119.887733,1,93595896,93596631,735,0.5731098253252538
35701,3119.889733,3119.897567,1,93596691,93596927,236,0.4687866013859275
35702,3119.901167,3119.913267,1,93597035,93597398,363,0.6899185212435849
35703,3119.953233,3119.960467,1,93598596,93598814,218,-0.12898284952238123
35704,3119.9668,3119.971467,1,93599004,93599144,140,0.6297441394589273
35705,3119.9725,3119.979267,1,93599175,93599378,203,0.3218379708077571
35706,3119.991333,3120.0033,1,93599739,93600099,360,-0.02925703802221403
35707,3120.005133,3120.028033,1,93600153,93600840,687,0.0693113652152281
35708,3120.0829,3120.086167,1,93602487,93602585,98,0.05422272505430796
35709,3120.122367,3120.216,1,93603671,93606480,2809,0.771968906189453
35710,3120.228567,3120.231867,1,93606857,93606956,99,0.5757702272924625
35711,3120.238233,3120.303333,1,93607146,93609099,1953,0.07696635105619958
35712,3120.3333,3120.336733,1,93609999,93610101,102,
35713,3120.357267,3120.376633,1,93610718,93611298,580,0.1939549868101973
35714,3120.380833,3120.3872,1,93611424,93611616,192,0.570793733741892
35715,3120.401733,3120.407767,1,93612051,93612233,182,0.03718849410940706
35716,3120.409033,3120.414233,1,93612270,93612426,156,0.07383224777721509
35717,3120.416633,3120.421,1,93612498,93612630,132,0.5100223184483467
35718,3120.441533,3120.444733,1,93613245,93613341,96,-0.16636100835730153
35719,3120.446167,3120.473033,1,93613385,93614190,805,0.7152066292479993
35720,3120.5043,3120.508267,1,93615129,93615248,119,-0.18966885930038657
35721,3120.686867,3120.691867,1,93620606,93620756,150,0.6344034085229285
35722,3120.7023,3120.7376,1,93621069,93622128,1059,0.7909919735497261
35723,3120.7563,3120.768,1,93622689,93623040,351,0.5952774158017798
35724,3120.779767,3120.819833,1,93623393,93624594,1201,0.7325680965535176
35725,3120.8406,3120.9689,1,93625218,93629067,3849,0.7210465687404733
35726,3120.973833,3121.0476,1,93629214,93631428,2214,0.7187471335108387
35727,3121.054867,3121.070033,1,93631646,93632100,454,0.6838721599910907
35728,3121.074833,3121.152367,1,93632244,93634571,2327,0.6254024768176111
35729,3121.157567,3121.167767,1,93634727,93635033,306,0.7162166279259378
35730,3121.1785,3121.1821,1,93635355,93635463,108,-0.10626298441093628
35731,3121.2092,3121.217733,1,93636276,93636531,255,0.22320720702371252
35732,3121.4283,3121.4328,1,93642849,93642984,135,0.5936500706932621
35733,3121.4342,3121.482767,1,93643026,93644483,1457,0.7189554208965824
35734,3121.4839,3121.5398,1,93644517,93646194,1677,0.7380825986633924
35735,3121.540867,3121.552033,1,93646226,93646560,334,0.2236227711203599
35736,3121.5595,3121.579733,1,93646785,93647391,606,0.23319909102485004
35737,3121.581133,3121.591767,1,93647433,93647753,320,0.04016290104136676
35738,3121.592833,3121.596867,1,93647784,93647906,122,0.21875489688166647
35739,3121.603467,3121.614,1,93648104,93648420,316,0.21074701542024246
35740,3121.615467,3121.620933,1,93648464,93648627,163,0.023881392569632877
35741,3121.6814,3121.7334,1,93650442,93652002,1560,0.7102217907093511
35742,3121.743067,3121.8248,1,93652292,93654744,2452,0.834048573713886
35743,3121.828067,3121.833033,1,93654842,93654990,148,0.5197188370512772
35744,3121.954467,3122.071733,1,93658634,93662151,3517,0.7898549077397513
35745,3122.103633,3122.115133,1,93663108,93663453,345,0.6309594019445259
35746,3122.120933,3122.148167,1,93663627,93664445,818,-0.07586787836122828
35747,3122.156867,3122.1829,1,93664706,93665487,781,0.7109063851503691
35748,3122.1925,3122.3697,1,93665775,93671091,5316,0.8012671874127704
35749,3122.371633,3122.375433,1,93671148,93671262,114,0.06831315138655526
35750,3122.377733,3122.416533,1,93671331,93672495,1164,0.5822006903753404
35751,3122.423567,3122.430933,1,93672707,93672927,220,0.6594413627941467
35752,3122.4398,3122.503133,1,93673194,93675093,1899,0.7786581095238572
35753,3122.509333,3122.540967,1,93675279,93676229,950,0.6192263474756261
35754,3122.560967,3122.570567,1,93676829,93677117,288,-0.10442620213849606
35755,3122.574,3122.608167,1,93677220,93678245,1025,0.0975291003149335
35756,3122.6281,3122.736867,1,93678843,93682106,3263,0.7750078633394124
35757,3122.751767,3122.759933,1,93682553,93682797,244,-0.08175122036501166
35758,3122.783,3122.9045,1,93683490,93687135,3645,0.8326379160295142
35759,3122.945033,3122.956367,1,93688350,93688691,341,0.2820911856230198
35760,3123.168867,3123.195267,1,93695066,93695858,792,0.5834420839435425
35761,3123.200667,3123.2369,1,93696020,93697107,1087,0.5854730177972933
35762,3123.2396,3123.297933,1,93697188,93698937,1749,0.7758004462379395
35763,3123.3052,3123.319867,1,93699156,93699596,440,0.7075607848290415
35764,3123.322,3123.3886,1,93699660,93701658,1998,0.7786517251344067
35765,3123.391333,3123.406367,1,93701739,93702191,452,0.6546299699984635
35766,3123.409133,3123.4136,1,93702273,93702408,135,0.5757809461168933
35767,3123.431067,3123.527967,1,93702932,93705839,2907,0.6981655749146716
35768,3123.532133,3123.599733,1,93705963,93707991,2028,0.5695715513988931
35769,3123.603433,3123.680267,1,93708102,93710408,2306,0.7902963853738774
35770,3123.6972,3123.707767,1,93710916,93711233,317,-0.00822879066504237
35771,3123.718133,3123.724067,1,93711543,93711722,179,-0.03948500103050519
35772,3123.730933,3123.735567,1,93711927,93712067,140,
35773,3123.753767,3123.757867,1,93712613,93712736,123,0.02223069300750069
35774,3123.7626,3123.933667,1,93712878,93718010,5132,0.6971350071968293
35775,3123.9567,3123.9835,1,93718701,93719505,804,0.8000475051000083
35776,3123.986833,3124.0382,1,93719604,93721146,1542,0.7086091093115355
35777,3124.039333,3124.075067,1,93721179,93722252,1073,0.8277032606774787
35778,3124.076867,3124.174133,1,93722306,93725223,2917,0.7893175324170628
35779,3124.182267,3124.2017,1,93725468,93726051,583,0.6278953748334923
35780,3124.2042,3124.275533,1,93726126,93728265,2139,0.8006689015600507
35781,3124.279667,3124.2948,1,93728390,93728844,454,0.608480059060033
35782,3124.2996,3124.311267,1,93728988,93729338,350,0.5740283409127047
35783,3124.328833,3124.3699,1,93729864,93731097,1233,0.027915058512989064
35784,3124.374333,3124.3817,1,93731229,93731451,222,-0.11096111478678894
35785,3124.397833,3124.400933,1,93731934,93732027,93,-0.35350549066804654
35786,3124.410533,3124.4341,1,93732315,93733023,708,0.5711064236449791
35787,3124.436733,3124.5265,1,93733101,93735795,2694,0.7620850909440758
35788,3124.5439,3124.5628,1,93736317,93736884,567,-0.09101372845761276
35789,3124.5647,3124.573433,1,93736941,93737202,261,-0.018606143429520217
35790,3124.575067,3124.5871,1,93737252,93737613,361,0.0779351066852715
35791,3124.615033,3124.772567,1,93738450,93743177,4727,0.7716134461423273
35792,3125.2975,3125.312,1,93758925,93759360,435,0.6471569062791096
35793,3125.3191,3125.386133,1,93759573,93761583,2010,0.7412636869392225
35794,3125.403967,3125.434067,1,93762119,93763022,903,0.6959490789831736
35795,3125.452433,3125.456867,1,93763572,93763706,134,0.5832945965621421
35796,3125.4583,3125.4682,1,93763749,93764046,297,0.5853947404845281
35797,3125.4722,3125.495267,1,93764166,93764858,692,0.6268945198930116
35798,3125.507333,3125.513467,1,93765219,93765404,185,0.3773355581013806
35799,3125.5518,3125.556767,1,93766554,93766703,149,0.007782240043345522
35800,3125.5581,3125.584333,1,93766743,93767529,786,0.04082000531703552
35801,3125.585767,3125.5919,1,93767573,93767757,184,0.3088016827192669
35802,3125.6239,3125.679567,1,93768717,93770387,1670,0.7903644528191247
35803,3125.688367,3125.730433,1,93770651,93771912,1261,0.8564219801473028
35804,3125.7466,3125.7875,1,93772398,93773625,1227,-0.04491216649538492
35805,3125.790333,3125.9111,1,93773709,93777333,3624,0.8629334435149196
35806,3125.931533,3126.019033,1,93777945,93780570,2625,0.8054006965823984
35807,3126.045267,3126.048867,1,93781358,93781466,108,-0.2131948786385757
35808,3126.590433,3126.601833,1,93797712,93798054,342,0.6706964854961255
35809,3126.610467,3126.629467,1,93798314,93798884,570,0.4343463138363434
35810,3126.6526,3126.680433,1,93799578,93800412,834,0.734531702855647
35811,3126.700233,3126.777667,1,93801006,93803330,2324,0.46285619333087724
35812,3126.782333,3126.866067,1,93803469,93805982,2513,0.7610105283836123
35813,3126.879933,3126.906633,1,93806397,93807198,801,0.7664880002911467
35814,3126.908433,3127.008533,1,93807252,93810255,3003,0.7731600881659323
35815,3127.0377,3127.042367,1,93811131,93811271,140,-0.07009709936680575
35816,3127.043833,3127.047667,1,93811314,93811430,116,0.03175529123786209
35817,3127.1203,3127.221367,1,93813609,93816641,3032,0.6633854996437191
35818,3127.237567,3127.2416,1,93817127,93817248,121,-0.0222408414895867
35819,3127.249967,3127.2859,1,93817499,93818577,1078,0.023225181761534455
35820,3127.317767,3127.492533,1,93819533,93824775,5242,0.8108958408284433
35821,3127.494233,3127.511767,1,93824826,93825353,527,0.844915736185718
35822,3127.5219,3127.552533,1,93825657,93826575,918,0.8063349826055427
35823,3127.554,3127.566933,1,93826620,93827007,387,0.7564304314077925
35824,3127.573233,3127.605,1,93827196,93828150,954,0.8504390908661967
35825,3127.616833,3127.629367,1,93828504,93828881,377,-0.1698985621856569
35826,3127.631067,3127.7235,1,93828932,93831705,2773,0.7614702239607108
35827,3127.735,3127.738367,1,93832050,93832151,101,0.09742488150189572
35828,3127.740933,3127.754467,1,93832227,93832634,407,0.025403711702830394
35829,3127.8248,3127.830067,1,93834744,93834902,158,0.10112954631166293
35830,3127.832033,3127.991567,1,93834960,93839747,4787,0.8020106736946132
35831,3128.0388,3128.046833,1,93841164,93841404,240,0.7051020066646978
35832,3128.0509,3128.124667,1,93841527,93843740,2213,0.752867351477853
35833,3128.125867,3128.204933,1,93843776,93846147,2371,0.7340381958264807
35834,3128.210533,3128.223267,1,93846315,93846698,383,0.7041232241943679
35835,3128.231433,3128.322333,1,93846942,93849669,2727,0.7747511152591359
35836,3128.328533,3128.337133,1,93849855,93850113,258,0.5353835667962838
35837,3128.353367,3128.358767,1,93850601,93850763,162,0.16917245021795813
35838,3128.3602,3128.369067,1,93850806,93851072,266,-0.15944375284888146
35839,3128.371633,3128.403133,1,93851148,93852093,945,-0.007463123953160203
35840,3128.429867,3128.486333,1,93852896,93854589,1693,0.7714291931933966
35841,3128.4875,3128.538033,1,93854625,93856140,1515,0.7795169312387913
35842,3128.5391,3128.543433,1,93856173,93856302,129,0.7609342077335451
35843,3128.554133,3128.566233,1,93856623,93856986,363,-0.1337860833826154
35844,3128.574667,3128.582733,1,93857240,93857481,241,-0.01273023730894419
35845,3128.607033,3128.766,1,93858210,93862980,4770,0.8385247744242881
35846,3129.190433,3129.235333,1,93875712,93877059,1347,0.6412727968967809
35847,3129.261133,3129.360767,1,93877833,93880823,2990,0.7872451960099399
35848,3129.457633,3129.606367,1,93883728,93888191,4463,0.5895975197664513
35849,3129.612533,3129.682867,1,93888375,93890486,2111,0.6066408523094882
35850,3129.6935,3129.770733,1,93890805,93893121,2316,0.8103966848345211
35851,3129.780533,3129.7891,1,93893415,93893673,258,0.8731378110856503
35852,3129.791467,3129.8248,1,93893744,93894744,1000,0.7413949754423264
35853,3129.8328,3129.844833,1,93894984,93895344,360,-0.09841445705409368
35854,3129.8463,3129.8897,1,93895389,93896691,1302,0.04489576899735792
35855,3129.902867,3130.2092,1,93897086,93906276,9190,0.7521939065593639
35856,3130.224067,3130.229233,1,93906722,93906876,154,-0.05239036583049094
35857,3130.2363,3130.242033,1,93907089,93907260,171,0.31341477482733515
35858,3130.290033,3130.294467,1,93908700,93908834,134,0.6183798680808613
35859,3130.304267,3130.323667,1,93909128,93909710,582,0.7909117891738718
35860,3130.325,3130.367,1,93909750,93911010,1260,0.7405643586042472
35861,3130.370067,3130.4162,1,93911102,93912486,1384,0.8059185364691887
35862,3130.4287,3130.467833,1,93912861,93914034,1173,-0.07886157440889258
35863,3130.4694,3130.473567,1,93914082,93914207,125,-0.1736771754246834
35864,3130.477433,3130.603333,1,93914322,93918099,3777,0.8054323957530697
35865,3130.624133,3130.690367,1,93918723,93920711,1988,0.8237124536876597
35866,3130.701567,3130.749733,1,93921047,93922491,1444,0.8271665830418777
35867,3130.774867,3130.784767,1,93923246,93923543,297,-0.057470363911383736
35868,3131.075933,3131.1361,1,93932277,93934083,1806,0.7941798171331675
35869,3131.145467,3131.149567,1,93934364,93934487,123,0.33393196009609927
35870,3131.150967,3131.1581,1,93934529,93934743,214,-0.0706507377305411
35871,3131.5745,3131.584267,1,93947235,93947528,293,0.7426060704932608
35872,3131.586533,3131.603367,1,93947595,93948101,506,0.6153794530445766
35873,3131.6307,3131.652433,1,93948921,93949572,651,0.6280793651284139
35874,3131.899333,3131.9506,1,93956979,93958518,1539,0.7502458077059515
35875,3131.955867,3131.960233,1,93958676,93958806,130,0.3491334581842492
35876,3131.9613,3132.007567,1,93958839,93960227,1388,0.8014879192323607
35877,3132.025167,3132.0361,1,93960755,93961083,328,-0.058354822637155114
35878,3132.0452,3132.0492,1,93961356,93961476,120,-0.07754558593419107
35879,3132.060633,3132.072733,1,93961818,93962181,363,-0.08951789189182317
35880,3132.151733,3132.171867,1,93964551,93965156,605,0.5855312964749876
35881,3132.188,3132.207033,1,93965640,93966210,570,0.5956418853036242
35882,3132.2082,3132.275867,1,93966246,93968276,2030,0.7848768091954305
35883,3132.307767,3132.311167,1,93969233,93969335,102,-0.21614263495992644
35884,3133.1917,3133.200967,1,93995751,93996029,278,0.6887476802960081
35885,3133.205233,3133.211267,1,93996156,93996338,182,0.4873577341408404
35886,3133.2192,3133.231433,1,93996576,93996942,366,0.6104634668432497
35887,3133.2583,3133.279267,1,93997749,93998378,629,0.6978923679305115
35888,3133.309433,3133.316867,1,93999282,93999506,224,0.6010961136456443
35889,3133.318033,3133.338633,1,93999540,94000158,618,0.5983861041565814
35890,3133.340833,3133.3593,1,94000224,94000779,555,0.5890232140594283
35891,3133.393333,3133.4016,1,94001799,94002048,249,0.5640121919536067
35892,3133.408933,3133.426333,1,94002267,94002789,522,0.6097818095977253
35893,3133.444667,3133.461833,1,94003340,94003854,514,0.5618433647634629
35894,3133.494833,3133.499567,1,94004844,94004987,143,
35895,3133.515267,3133.531267,1,94005458,94005938,480,0.5973806028290827
35896,3133.5549,3133.560967,1,94006647,94006829,182,0.34865198851865664
35897,3133.5669,3133.585033,1,94007007,94007550,543,0.1349809012190692
35898,3133.6377,3133.642133,1,94009131,94009263,132,0.12874014586478208
35899,3133.644833,3133.649,1,94009344,94009470,126,
35900,3133.6517,3133.656033,1,94009551,94009680,129,0.7972452986142521
35901,3133.703933,3133.708833,1,94011117,94011264,147,0.49039735496938897
35902,3133.715433,3133.962733,1,94011462,94018881,7419,0.7846681682743647
35903,3134.6795,3134.717467,1,94040385,94041524,1139,0.5681203140438026
35904,3134.740333,3134.757867,1,94042209,94042736,527,0.547948775041429
35905,3134.7854,3134.793867,1,94043562,94043816,254,0.8078925212430047
35906,3134.811833,3134.8236,1,94044354,94044708,354,0.6346398772885299
35907,3134.8331,3134.8419,1,94044993,94045257,264,0.2620624950250795
35908,3134.848433,3134.859867,1,94045452,94045796,344,-0.33955166387163477
35909,3134.876633,3134.894367,1,94046298,94046831,533,0.0796540275729602
35910,3134.9533,3134.9567,1,94048599,94048701,102,0.6697272916915632
35911,3134.967933,3135.116633,1,94049037,94053498,4461,0.8047154284270857
35912,3135.1211,3135.149933,1,94053633,94054497,864,0.8421811367091877
35913,3135.155933,3135.298167,1,94054677,94058945,4268,0.7897097300352137
35914,3135.300733,3135.305567,1,94059021,94059167,146,-0.15022838442319414
35915,3135.309133,3135.315,1,94059273,94059450,177,0.07523083449907063
35916,3135.8204,3135.833167,1,94074612,94074995,383,-0.06674349329265516
35917,3135.8404,3135.8448,1,94075212,94075344,132,0.07702666254462817
35918,3135.853267,3135.9086,1,94075598,94077258,1660,0.5721733138731079
35919,3135.925067,3135.961967,1,94077752,94078859,1107,0.7722583970756913
35920,3135.978233,3136.018,1,94079346,94080540,1194,0.7265846095126349
35921,3136.0294,3136.0355,1,94080882,94081065,183,0.7074019165068672
35922,3136.0458,3136.056433,1,94081374,94081692,318,-0.04537465936920343
35923,3136.058833,3136.063667,1,94081764,94081910,146,0.4948143940298155
35924,3136.0789,3136.0861,1,94082367,94082583,216,0.0665503378204885
35925,3136.087633,3136.1194,1,94082628,94083582,954,0.1759384581749913
35926,3136.154533,3136.257033,1,94084635,94087710,3075,0.7193740040838322
35927,3136.263533,3136.275433,1,94087905,94088262,357,0.1998666725609059
35928,3136.283033,3136.286133,1,94088490,94088583,93,-0.11697519630049849
35929,3136.289367,3136.306533,1,94088681,94089195,514,0.12136641820863572
35930,3136.311533,3136.435033,1,94089345,94093050,3705,0.8592047057723522
35931,3136.4673,3136.552833,1,94094019,94096584,2565,0.8287274378608285
35932,3136.568333,3136.574067,1,94097049,94097222,173,0.02620026254761561
35933,3136.5785,3136.5823,1,94097355,94097469,114,0.13549500269488485
35934,3136.939933,3136.944067,1,94108197,94108322,125,
35935,3137.0013,3137.0083,1,94110039,94110249,210,0.6104833799943644
35936,3137.009533,3137.075167,1,94110285,94112255,1970,0.8190499226351314
35937,3137.079,3137.136,1,94112370,94114080,1710,0.80954779026851
35938,3137.144167,3137.154633,1,94114325,94114638,313,0.6306550734247629
35939,3137.1627,3137.197867,1,94114881,94115936,1055,0.7412240244601349
35940,3137.1992,3137.240933,1,94115976,94117227,1251,0.727897148169947
35941,3137.245133,3137.251333,1,94117353,94117539,186,0.7918611115808193
35942,3137.2687,3137.323067,1,94118061,94119692,1631,0.8067298259999904
35943,3137.335967,3137.353067,1,94120079,94120592,513,0.7649094235722441
35944,3137.354367,3137.3713,1,94120631,94121139,508,0.3379768800451651
35945,3137.3896,3137.423433,1,94121688,94122702,1014,0.09601127078260449
35946,3137.4332,3137.4365,1,94122996,94123095,99,-0.2226559948216772
35947,3137.478567,3137.620933,1,94124357,94128627,4270,0.7858185831748082
35948,3137.622333,3137.722633,1,94128669,94131678,3009,0.800124304608925
35949,3137.7487,3137.7536,1,94132461,94132608,147,-0.08099603505319218
35950,3137.776167,3137.782533,1,94133285,94133475,190,0.22822446895117146
35951,3138.1758,3138.192,1,94145274,94145760,486,0.6400378802886695
35952,3138.200067,3138.233433,1,94146002,94147002,1000,0.6965841487441692
35953,3138.2434,3138.278933,1,94147302,94148367,1065,0.7862248554947117
35954,3138.289033,3138.299933,1,94148670,94148997,327,0.48802253988360045
35955,3138.301,3138.3708,1,94149030,94151124,2094,0.7967893605378558
35956,3138.376533,3138.4499,1,94151295,94153497,2202,0.7092554948461378
35957,3138.460733,3138.504733,1,94153821,94155141,1320,0.7083511255086937
35958,3138.521633,3138.5344,1,94155648,94156032,384,0.01809162116498162
35959,3138.540767,3138.571567,1,94156223,94157147,924,0.15776327488324043
35960,3138.602467,3138.766467,1,94158074,94162994,4920,0.7408967499430027
35961,3138.7681,3138.777333,1,94163043,94163319,276,0.3834200811673698
35962,3138.7802,3138.861967,1,94163406,94165859,2453,0.623438953687532
35963,3138.870567,3138.926467,1,94166117,94167794,1677,0.7822849268628833
35964,3138.948233,3138.9716,1,94168446,94169148,702,0.13393486431602508
35965,3138.9728,3138.9766,1,94169184,94169298,114,0.6622462565590553
35966,3138.9778,3138.983067,1,94169334,94169492,158,0.7576000573991433
35967,3139.486833,3139.5273,1,94184604,94185819,1215,0.601534691739761
35968,3139.5304,3139.534167,1,94185912,94186025,113,
35969,3139.5519,3139.5712,1,94186557,94187136,579,0.6820220180950245
35970,3139.589267,3139.5985,1,94187678,94187955,277,0.41469492226466126
35971,3140.037567,3140.0433,1,94201127,94201299,172,0.5058839362442085
35972,3140.0543,3140.0613,1,94201629,94201839,210,0.45727267634619706
35973,3140.094367,3140.1001,1,94202831,94203003,172,0.4141254831925043
35974,3140.101633,3140.1245,1,94203048,94203735,687,0.6411662641878968
35975,3140.149233,3140.1659,1,94204476,94204977,501,0.58382190530962
35976,3140.2082,3140.2135,1,94206246,94206405,159,0.3534748469161063
35977,3140.2179,3140.2356,1,94206537,94207068,531,0.4714583269977254
35978,3140.254933,3140.2702,1,94207647,94208106,459,0.5935444559322711
35979,3140.3193,3140.3252,1,94209579,94209756,177,-0.08939458114301549
35980,3140.3268,3140.335567,1,94209804,94210067,263,0.28118180718629426
35981,3140.359067,3140.3678,1,94210772,94211034,262,0.039122529638895724
35982,3140.374233,3140.382567,1,94211226,94211477,251,0.08905750484111807
35983,3140.521067,3140.573167,1,94215632,94217195,1563,0.8100565896364412
35984,3140.574633,3140.6319,1,94217238,94218957,1719,0.7910575274424676
35985,3140.647067,3140.656233,1,94219412,94219686,274,-0.04640532243273072
35986,3140.658333,3140.6784,1,94219749,94220352,603,0.20385159946668463
35987,3140.679733,3140.6832,1,94220391,94220496,105,-0.0052124490041210465
35988,3140.694967,3140.8653,1,94220849,94225959,5110,0.8309567483451927
35989,3141.3361,3141.3794,1,94240083,94241382,1299,0.6192180702962381
35990,3141.396967,3141.4176,1,94241909,94242528,619,0.6169206523105512
35991,3141.446233,3141.455433,1,94243386,94243662,276,0.6552001476668742
35992,3141.472933,3141.484267,1,94244187,94244528,341,0.6439280401135089
35993,3141.760167,3141.766133,1,94252805,94252983,178,-0.17308121983583802
35994,3141.7684,3141.884567,1,94253052,94256537,3485,0.8585892851500575
35995,3141.9156,3141.998533,1,94257468,94259955,2487,0.7883824992333396
35996,3142.003867,3142.007333,1,94260116,94260219,103,-0.12273952380584785
35997,3142.668967,3142.683933,1,94280069,94280517,448,0.6711591018037362
35998,3142.688467,3142.694867,1,94280654,94280846,192,0.407600273614821
35999,3142.705067,3142.7136,1,94281152,94281408,256,0.43664958018643873
36000,3142.722467,3142.730067,1,94281674,94281902,228,0.2631296405969771
36001,3142.7334,3142.7511,1,94282002,94282533,531,0.40474416211352593
36002,3142.7874,3142.798633,1,94283622,94283958,336,-0.07436430549894195
36003,3142.806633,3142.819367,1,94284198,94284581,383,0.15423687999906466
36004,3142.854433,3142.878067,1,94285632,94286342,710,0.6094558423379681
36005,3142.9057,3142.9093,1,94287171,94287279,108,0.5558962732066874
36006,3142.911333,3142.9248,1,94287339,94287744,405,0.5176359728002619
36007,3142.925967,3142.9432,1,94287779,94288296,517,0.5393743366265084
36008,3142.960767,3142.9747,1,94288823,94289241,418,0.4896477509591874
36009,3143.027067,3143.0463,1,94290812,94291389,577,0.5784875209087829
36010,3143.072333,3143.080467,1,94292169,94292414,245,0.555920099585345
36011,3143.088033,3143.094633,1,94292640,94292838,198,0.6279057512122471
36012,3143.1484,3143.159067,1,94294452,94294772,320,-0.15666412025831256
36013,3143.1651,3143.1682,1,94294953,94295046,93,0.08015615967204737
36014,3143.3274,3143.3558,1,94299822,94300674,852,0.7724602248212686
36015,3149.496067,3149.499433,1,94484882,94484982,100,0.5562684954153666
36016,3151.980733,3151.9851,1,94559421,94559553,132,-0.0323559021434151
36017,3152.350233,3152.354433,1,94570506,94570632,126,
36018,3152.384267,3152.391433,1,94571528,94571742,214,0.22302787379020575
36019,3152.459267,3152.463333,1,94573778,94573899,121,0.5512837560897998
36020,3152.6418,3152.646333,1,94579254,94579389,135,-0.1761804030974392
36021,3155.236733,3155.242467,1,94657101,94657274,173,0.33155454721756916
36022,3155.251233,3155.264567,1,94657536,94657937,401,0.41731471043869695
36023,3155.274667,3155.2791,1,94658240,94658373,133,0.07698764855077521
36024,3155.288567,3155.292767,1,94658657,94658783,126,0.3208138591706287
36025,3155.3167,3155.343833,1,94659501,94660314,813,0.0552225836370041
36026,3155.371233,3155.374267,1,94661136,94661228,92,0.1530352087245208
36027,3163.415733,3163.420167,1,94902471,94902605,134,
36028,3163.421433,3163.444067,1,94902642,94903322,680,0.1924136543867379
36029,3163.4462,3163.453667,1,94903386,94903610,224,0.12865081726120395
36030,3163.473567,3163.476567,1,94904207,94904297,90,
36031,3163.490567,3163.5038,1,94904717,94905114,397,0.054503341626886616
36032,3163.539067,3163.547033,1,94906172,94906410,238,0.01880314103266015
36033,3163.552633,3163.5566,1,94906578,94906698,120,0.18401708159345373
36034,3165.5622,3165.567567,1,94966866,94967027,161,
36035,3165.568933,3165.6159,1,94967067,94968477,1410,0.11809359639045523
36036,3165.642333,3165.647867,1,94969269,94969436,167,0.200573366468883
36037,3165.6562,3165.705167,1,94969686,94971155,1469,0.49512662322106177
36038,3166.7601,3166.766233,1,95002803,95002986,183,-0.1852894685228018
36039,3166.768067,3166.787733,1,95003042,95003631,589,0.2970755186040139
36040,3166.792867,3166.808933,1,95003786,95004267,481,0.2295733947154638
36041,3166.810067,3166.816733,1,95004302,95004501,199,0.14416876233085657
36042,3166.922867,3166.926233,1,95007686,95007786,100,0.1961751360949294
36043,3167.009467,3167.019467,1,95010284,95010584,300,0.004118428519413004
36044,3167.026933,3167.062233,1,95010807,95011866,1059,0.4026682482161065
36045,3167.065733,3167.081033,1,95011971,95012430,459,0.1522096347464715
36046,3167.432867,3167.440767,1,95022986,95023223,237,0.3288281713276145
36047,3169.7702,3169.781,1,95093106,95093430,324,0.28485576166047455
36048,3169.818667,3169.8246,1,95094560,95094738,178,0.32134312446058516
36049,3169.890333,3169.895767,1,95096709,95096873,164,
36050,3169.9372,3169.9482,1,95098116,95098446,330,0.11794591086444682
36051,3169.954333,3169.957533,1,95098629,95098725,96,
36052,3172.436967,3172.4402,1,95173109,95173206,97,0.4043032469372838
36053,3173.852167,3173.8612,1,95215565,95215836,271,0.3724890005058019
36054,3173.872333,3173.939533,1,95216169,95218185,2016,0.09444905409533494
36055,3173.976567,3174.0032,1,95219297,95220096,799,-0.030882338598080976
36056,3174.0516,3174.061733,1,95221548,95221851,303,-0.08644548252718758
36057,3174.0705,3174.0738,1,95222115,95222214,99,0.13189948335357207
36058,3175.377367,3175.3872,1,95261321,95261616,295,0.3253019947593491
36059,3177.5094,3177.5167,1,95325282,95325501,219,-0.008090829235261734
36060,3177.541967,3177.549667,1,95326259,95326490,231,0.5438848330282569
36061,3177.551067,3177.657033,1,95326532,95329710,3178,0.5570840873556282
36062,3177.658333,3177.682267,1,95329749,95330468,719,-0.032584657025348844
36063,3177.688067,3177.713533,1,95330642,95331405,763,-0.044960601139673706
36064,3177.714633,3177.7266,1,95331438,95331798,360,-0.019115727341987805
36065,3177.732267,3177.7467,1,95331968,95332401,433,0.13073685640369165
36066,3177.747767,3177.754733,1,95332433,95332641,208,-0.030108357555472396
36067,3177.7565,3177.835267,1,95332695,95335058,2363,0.42044771226335004
36068,3177.983133,3177.991667,1,95339493,95339750,257,-0.001169548152062191
36069,3178.037667,3178.040967,1,95341130,95341229,99,-0.04153391135323952
36070,3178.328033,3178.331633,1,95349840,95349948,108,0.2571101956329967
36071,3178.374367,3178.392567,1,95351231,95351777,546,0.2902094534466555
36072,3178.394733,3178.401167,1,95351841,95352035,194,0.5084771772868844
36073,3178.4131,3178.416267,1,95352393,95352488,95,
36074,3178.417367,3178.512167,1,95352521,95355365,2844,0.13432990336330325
36075,3178.521333,3178.5338,1,95355639,95356014,375,0.026356306827508186
36076,3178.536933,3178.561167,1,95356107,95356835,728,0.007591360698156432
36077,3178.564033,3178.587433,1,95356920,95357622,702,0.1122021183142715
36078,3178.5894,3178.653067,1,95357682,95359592,1910,0.2538997025963759
36079,3180.327733,3180.331233,1,95409831,95409936,105,-0.23151126424832005
36080,3180.354533,3180.4481,1,95410635,95413443,2808,0.4396976442283899
36081,3180.4536,3180.485267,1,95413608,95414558,950,0.02642082068850148
36082,3180.499033,3180.509033,1,95414970,95415270,300,0.22282101442764277
36083,3180.512467,3180.5528,1,95415374,95416584,1210,0.07408009342033968
36084,3180.558833,3180.610367,1,95416764,95418311,1547,0.10139314807956239
36085,3180.6117,3180.615133,1,95418351,95418453,102,0.8445428156155236
36086,3181.223367,3181.231533,1,95436701,95436945,244,0.4694594694434693
36087,3181.273067,3181.2883,1,95438192,95438649,457,0.43338188344922207
36088,3181.313767,3181.323633,1,95439413,95439708,295,-0.06626508345252452
36089,3181.3247,3181.3278,1,95439741,95439834,93,
36090,3181.337933,3181.4079,1,95440137,95442237,2100,0.11286671343358888
36091,3181.409433,3181.414467,1,95442282,95442434,152,0.21857408885196594
36092,3181.4173,3181.432333,1,95442519,95442969,450,0.04782659057517056
36093,3181.4334,3181.4512,1,95443002,95443536,534,-0.12335236228356002
36094,3181.457,3181.478167,1,95443710,95444345,635,0.0155031744077942
36095,3181.479367,3181.511667,1,95444381,95445350,969,0.20080810302755056
36096,3181.519333,3181.570233,1,95445579,95447106,1527,0.06968835567548752
36097,3181.585933,3181.5931,1,95447577,95447793,216,-0.13761679762312745
36098,3181.639933,3181.643833,1,95449197,95449314,117,-0.31776534525775524
36099,3182.374567,3182.386133,1,95471237,95471583,346,-0.013813904217959493
36100,3182.4409,3182.454633,1,95473227,95473638,411,0.41236784483504607
36101,3182.4578,3182.5355,1,95473734,95476065,2331,0.21917890921185434
36102,3182.5597,3182.585467,1,95476791,95477564,773,-0.09676626536258123
36103,3182.5887,3182.5998,1,95477661,95477994,333,-0.022073098756104817
36104,3182.6013,3182.610667,1,95478039,95478320,281,-0.062041443499227716
36105,3182.612867,3182.6422,1,95478386,95479266,880,0.29154954455384735
36106,3182.652667,3182.742633,1,95479580,95482278,2698,0.40000975582198434
36107,3182.744867,3182.7488,1,95482346,95482464,118,0.460276570460427
36108,3182.7672,3182.7719,1,95483016,95483157,141,0.15153638778032086
36109,3182.788733,3182.801167,1,95483661,95484035,374,0.32872906314413225
36110,3182.824533,3182.8293,1,95484735,95484879,144,0.859005857293636
36111,3183.006633,3183.0168,1,95490198,95490504,306,0.16787868466202788
36112,3183.062333,3183.0701,1,95491869,95492103,234,0.3557889948639853
36113,3183.631467,3183.637367,1,95508944,95509121,177,0.07474612657896368
36114,3185.345833,3185.3498,1,95560374,95560494,120,
36115,3185.3511,3185.451667,1,95560533,95563550,3017,0.1257600420367062
36116,3185.455467,3185.471333,1,95563664,95564139,475,0.020422204782090427
36117,3185.4763,3185.488233,1,95564289,95564646,357,0.03270486530697331
36118,3185.490367,3185.5013,1,95564711,95565039,328,0.01423864377970005
36119,3185.505133,3185.519167,1,95565153,95565575,422,0.01885028897514868
36120,3185.524567,3185.536967,1,95565737,95566109,372,-0.011485396418865399
36121,3185.5534,3185.5604,1,95566602,95566812,210,-0.0638713843244426
36122,3185.563067,3185.605167,1,95566892,95568155,1263,0.05773023156201281
36123,3185.606233,3185.6102,1,95568186,95568306,120,0.17559141124793812
36124,3185.6121,3185.673333,1,95568363,95570199,1836,0.26135785376258014
36125,3185.6798,3185.683167,1,95570394,95570495,101,-0.26145711095785823
36126,3185.744167,3185.7501,1,95572325,95572503,178,0.3038461990913641
36127,3186.729367,3186.753533,1,95601881,95602605,724,0.28502277676766463
36128,3186.757033,3186.761067,1,95602710,95602832,122,-0.04336187052884352
36129,3186.7657,3186.826967,1,95602971,95604809,1838,0.1613136700355056
36130,3186.8296,3186.863567,1,95604888,95605907,1019,0.05040196053524165
36131,3186.874667,3186.896433,1,95606240,95606892,652,0.08347296064018285
36132,3186.9022,3186.923967,1,95607066,95607719,653,0.06831344546337284
36133,3186.929333,3186.992,1,95607879,95609760,1881,0.09359822702792711
36134,3186.9982,3187.002133,1,95609946,95610063,117,-0.3599578188516305
36135,3187.058933,3187.071467,1,95611767,95612144,377,0.549750595300504
36136,3187.624,3187.627567,1,95628720,95628827,107,0.15178677462766413
36137,3187.6308,3187.634133,1,95628924,95629023,99,
36138,3187.6658,3187.686233,1,95629974,95630586,612,0.31367769662487266
36139,3187.693033,3187.7681,1,95630790,95633043,2253,0.11162383162778892
36140,3187.776467,3187.782633,1,95633294,95633478,184,0.05014623165779984
36141,3187.784267,3187.792633,1,95633528,95633778,250,0.2666712882313535
36142,3187.7976,3187.811,1,95633928,95634330,402,0.23377561151497225
36143,3187.813433,3187.880133,1,95634402,95636403,2001,0.0649707752866361
36144,3187.896933,3187.904767,1,95636907,95637143,236,0.5390267499545308
36145,3187.9132,3187.917567,1,95637396,95637527,131,0.6661970922748933
36146,3187.973267,3187.9778,1,95639198,95639334,136,
36147,3189.687,3189.692033,1,95690610,95690760,150,0.492204234874394
36148,3189.783367,3189.8651,1,95693501,95695953,2452,0.3071771523361313
36149,3189.867367,3189.9001,1,95696021,95697003,982,-0.05375575503468374
36150,3189.9056,3189.9499,1,95697168,95698497,1329,0.06342856574643518
36151,3189.951933,3189.960833,1,95698557,95698824,267,-0.022914781789092828
36152,3189.972033,3189.9805,1,95699160,95699415,255,0.09507359121971577
36153,3189.983133,3190.003,1,95699493,95700090,597,0.2515272245033595
36154,3190.0078,3190.076867,1,95700234,95702306,2072,0.32755018608269953
36155,3190.0841,3190.0905,1,95702523,95702715,192,-0.18842356238858204
36156,3190.096667,3190.110167,1,95702900,95703305,405,0.38751487828984615
36157,3190.117133,3190.125567,1,95703513,95703767,254,-0.004460712717066257
36158,3190.1513,3190.176733,1,95704539,95705301,762,0.2509066078003852
36159,3190.210833,3190.214233,1,95706324,95706426,102,-0.11978150747969372
36160,3190.3357,3190.347267,1,95710071,95710418,347,0.13937074646027933
36161,3190.778433,3190.783333,1,95723352,95723499,147,-0.2252083183542426
36162,3190.7847,3190.7877,1,95723541,95723631,90,0.44550473505294597
36163,3190.788733,3190.8515,1,95723661,95725545,1884,0.13487525572532022
36164,3190.858467,3190.861733,1,95725754,95725851,97,0.1743834273115882
36165,3190.8633,3190.8922,1,95725899,95726766,867,0.022526416909316976
36166,3190.8965,3190.927633,1,95726895,95727828,933,0.28244341163127634
36167,3190.933167,3190.9519,1,95727995,95728557,562,0.0657333001535774
36168,3190.9653,3191.043267,1,95728959,95731298,2339,0.41331451344082387
36169,3191.065733,3191.077333,1,95731971,95732319,348,0.5906934235536436
36170,3191.078467,3191.085467,1,95732354,95732564,210,0.15105286570100177
36171,3191.1153,3191.1209,1,95733459,95733627,168,0.5267516876855429
36172,3191.134067,3191.142967,1,95734022,95734289,267,0.17676660397961955
36173,3191.964467,3192.035133,1,95758934,95761053,2119,0.14582655802288766
36174,3192.037267,3192.052967,1,95761118,95761589,471,0.10283248892363622
36175,3192.054,3192.071367,1,95761620,95762141,521,-0.07656243335873583
36176,3192.076367,3192.140033,1,95762291,95764200,1909,0.12756442101233578
36177,3192.145367,3192.163133,1,95764361,95764893,532,0.36223899567001683
36178,3192.172567,3192.2745,1,95765177,95768235,3058,0.3240151653629294
36179,3192.2778,3192.2923,1,95768334,95768769,435,0.3220578207000219
36180,3192.3369,3192.344467,1,95770107,95770334,227,0.5117731117075092
36181,3192.351133,3192.355033,1,95770533,95770650,117,-0.4505699202206539
36182,3192.375467,3192.378767,1,95771264,95771363,99,-0.2683389527198973
36183,3192.390533,3192.3961,1,95771715,95771883,168,0.31788692140123953
36184,3192.986167,3192.9962,1,95789585,95789886,301,0.15728663298017642
36185,3192.998067,3193.019167,1,95789942,95790575,633,0.03516861781078231
36186,3193.024933,3193.037033,1,95790747,95791110,363,0.06574067271302292
36187,3193.0421,3193.057433,1,95791263,95791722,459,0.06428261038751491
36188,3193.1219,3193.151533,1,95793657,95794545,888,0.3113863545579542
36189,3193.238033,3193.2437,1,95797140,95797311,171,-0.04247514827829768
36190,3193.245233,3193.251533,1,95797356,95797545,189,0.22637942950602233
36191,3193.252633,3193.260933,1,95797578,95797827,249,0.5713356988815133
36192,3193.262167,3193.2694,1,95797865,95798082,217,0.346592289543233
36193,3193.274567,3193.2964,1,95798237,95798892,655,0.14079607888269047
36194,3193.3659,3193.380267,1,95800977,95801408,431,0.366443772761637
36195,3193.398333,3193.454467,1,95801949,95803634,1685,0.07738096441321714
36196,3193.455467,3193.461,1,95803664,95803830,166,0.20384359771050797
36197,3193.4628,3193.4823,1,95803884,95804469,585,0.12590962186062593
36198,3193.498867,3193.518333,1,95804966,95805549,583,0.14220112362085477
36199,3193.519533,3193.5307,1,95805585,95805921,336,0.08277051672250284
36200,3193.532,3193.579233,1,95805960,95807376,1416,0.17915625333837956
36201,3193.608933,3193.6134,1,95808267,95808402,135,0.31994544808911785
36202,3193.641933,3193.6481,1,95809257,95809443,186,0.28003718854471144
36203,3193.6591,3193.6646,1,95809773,95809938,165,-0.310261276377896
36204,3194.744033,3194.865833,1,95842320,95845974,3654,0.5695333911597811
36205,3194.8669,3194.880333,1,95846007,95846409,402,-0.07463019972442171
36206,3194.885567,3194.8989,1,95846567,95846967,400,0.0603545703097888
36207,3194.905167,3194.941767,1,95847155,95848253,1098,0.08685205357014941
36208,3194.961433,3195.013467,1,95848842,95850404,1562,0.19834287049398305
36209,3195.022333,3195.102467,1,95850669,95853074,2405,0.23151776788207132
36210,3195.159933,3195.1671,1,95854797,95855013,216,-0.23893571734435565
36211,3195.183367,3195.195267,1,95855501,95855858,357,0.1035773279961849
36212,3196.066967,3196.078933,1,95882009,95882367,358,0.6164055689327004
36213,3196.1385,3196.143167,1,95884155,95884295,140,0.4544010707770057
36214,3196.145467,3196.1617,1,95884364,95884851,487,0.4469714634318252
36215,3196.1788,3196.2448,1,95885364,95887344,1980,0.42702874847108657
36216,3196.2519,3196.278633,1,95887557,95888358,801,-0.08543788172150862
36217,3196.284267,3196.295067,1,95888528,95888852,324,0.2374195986462671
36218,3196.309167,3196.321433,1,95889275,95889642,367,-0.025486209515269552
36219,3196.325333,3196.338,1,95889759,95890140,381,0.1456152440224826
36220,3196.356733,3196.3798,1,95890701,95891394,693,0.20883966153588165
36221,3196.401233,3196.4127,1,95892036,95892381,345,0.023942707391016043
36222,3196.4137,3196.4306,1,95892411,95892918,507,0.1678634276060401
36223,3196.4363,3196.538167,1,95893089,95896145,3056,0.252361575804713
36224,3196.548967,3196.553333,1,95896469,95896599,130,0.43204775691143416
36225,3196.563367,3196.577467,1,95896901,95897324,423,-0.09167243618296338
36226,3196.590867,3196.601833,1,95897726,95898054,328,-0.005901475159461819
36227,3196.605367,3196.612567,1,95898161,95898377,216,-0.19034439075463191
36228,3197.901967,3197.9054,1,95937059,95937162,103,0.1919452352978562
36229,3198.0265,3198.031367,1,95940795,95940941,146,0.49906922704226414
36230,3198.093233,3198.096433,1,95942796,95942892,96,-0.24437151220108122
36231,3198.102067,3198.1157,1,95943062,95943471,409,0.47167268087479924
36232,3198.1192,3198.1342,1,95943576,95944026,450,0.09999890976328094
36233,3198.146633,3198.208833,1,95944398,95946264,1866,0.3534303742342719
36234,3198.224333,3198.242233,1,95946729,95947266,537,-0.06521670085642756
36235,3198.246333,3198.259633,1,95947389,95947788,399,0.006500589157240431
36236,3198.261033,3198.2855,1,95947830,95948565,735,-0.027984452898208462
36237,3198.286633,3198.2931,1,95948598,95948793,195,-0.057513535982698226
36238,3198.307,3198.3228,1,95949210,95949684,474,-0.04766918354290512
36239,3198.327967,3198.343833,1,95949839,95950314,475,0.2065676826059885
36240,3198.353867,3198.417167,1,95950616,95952515,1899,0.39353142617047804
36241,3198.4467,3198.452633,1,95953401,95953578,177,0.10629846216658034
36242,3198.4736,3198.488667,1,95954208,95954660,452,0.02163054718700997
36243,3199.589767,3199.596567,1,95987693,95987897,204,0.09651116130101266
36244,3200.494033,3200.497433,1,96014820,96014922,102,
36245,3200.566067,3200.571533,1,96016982,96017145,163,0.1337056718289508
36246,3200.605967,3200.609267,1,96018179,96018278,99,0.09444894706754982
36247,3200.620067,3200.6295,1,96018602,96018885,283,0.44276296785409797
36248,3200.640133,3200.646333,1,96019203,96019389,186,0.4322063137154009
36249,3200.714733,3200.720633,1,96021441,96021618,177,0.3986079847228665
36250,3200.725267,3200.770167,1,96021758,96023105,1347,0.17031584072789807
36251,3200.7771,3200.780333,1,96023313,96023409,96,
36252,3200.784667,3200.801167,1,96023540,96024035,495,-0.10229416152049554
36253,3200.8113,3200.857967,1,96024339,96025739,1400,0.08242839950791987
36254,3200.859733,3200.872433,1,96025791,96026172,381,-0.08286648101985546
36255,3200.8753,3200.910567,1,96026259,96027317,1058,0.35317249566801245
36256,3200.913133,3200.992033,1,96027393,96029760,2367,0.3211269384010061
36257,3200.998833,3201.004267,1,96029964,96030128,164,-0.1033678037485366
36258,3201.006367,3201.0168,1,96030191,96030504,313,-0.04797061437634109
36259,3201.02,3201.039033,1,96030600,96031170,570,0.06661349679800435
36260,3201.040533,3201.045533,1,96031215,96031365,150,0.16949764951263982
36261,3201.052767,3201.0649,1,96031583,96031947,364,0.08301475365782754
36262,3201.323333,3201.326433,1,96039699,96039792,93,-0.2277825343323634
36263,3201.3308,3201.333933,1,96039924,96040017,93,0.5638363586657544
36264,3201.361667,3201.3717,1,96040850,96041151,301,0.3840270487797816
36265,3201.392667,3201.439167,1,96041780,96043175,1395,0.11703438175076684
36266,3201.4501,3201.457067,1,96043503,96043712,209,0.2855536195955507
36267,3201.460633,3201.484867,1,96043818,96044546,728,-0.049365657077488745
36268,3201.4905,3201.513633,1,96044715,96045408,693,0.10988319605033083
36269,3201.5232,3201.6199,1,96045696,96048597,2901,0.30187963321646133
36270,3201.630433,3201.647967,1,96048912,96049439,527,0.1247908473276586
36271,3201.6531,3201.659167,1,96049593,96049775,182,0.256086287910479
36272,3201.668067,3201.672267,1,96050042,96050168,126,0.2059732186168868
36273,3201.678433,3201.714733,1,96050352,96051441,1089,0.6043917235744811
36274,3201.740033,3201.757,1,96052200,96052710,510,-0.08623833669262458
36275,3201.790067,3201.8001,1,96053702,96054003,301,0.22897943972953627
36276,3201.8081,3201.818533,1,96054243,96054555,312,0.15871102982030963
36277,3201.878367,3201.8878,1,96056351,96056634,283,0.38162825243574183
36278,3201.919667,3201.987033,1,96057590,96059610,2020,0.27995179242872587
36279,3201.992567,3202.002833,1,96059777,96060084,307,0.2731292174220157
36280,3202.005233,3202.011233,1,96060156,96060336,180,0.08965509988970696
36281,3202.0191,3202.0327,1,96060573,96060981,408,-0.021332221943121062
36282,3202.0394,3202.061667,1,96061182,96061850,668,0.1219825434206208
36283,3202.062733,3202.097833,1,96061881,96062934,1053,0.13321447590780888
36284,3202.109767,3202.127967,1,96063293,96063839,546,0.23323833566244034
36285,3202.130367,3202.195167,1,96063911,96065855,1944,0.17467231936506186
36286,3202.209667,3202.212667,1,96066290,96066380,90,
36287,3202.2205,3202.230433,1,96066615,96066912,297,-0.07389005534237378
36288,3202.234867,3202.241467,1,96067046,96067244,198,0.3169277188659308
36289,3202.451767,3202.4554,1,96073553,96073662,109,
36290,3202.463967,3202.474767,1,96073919,96074243,324,0.20529257625701375
36291,3202.507,3202.514267,1,96075210,96075428,218,0.47879779165220326
36292,3202.521833,3202.525267,1,96075654,96075758,104,-0.14737469466194159
36293,3202.536933,3202.543767,1,96076107,96076313,206,0.02843469347499845
36294,3202.544767,3202.5548,1,96076343,96076644,301,-0.00764965583929142
36295,3202.9017,3202.9049,1,96087051,96087147,96,0.23999141193933693
36296,3202.906267,3202.909533,1,96087188,96087285,97,
36297,3202.9153,3202.926167,1,96087459,96087785,326,0.4007233858810525
36298,3202.9273,3203.018733,1,96087819,96090561,2742,0.10096393498623372
36299,3203.0539,3203.065767,1,96091617,96091973,356,-0.005379719501547115
36300,3203.067467,3203.0842,1,96092024,96092526,502,-0.06687530038568176
36301,3203.089467,3203.097533,1,96092684,96092925,241,-0.05858217410035715
36302,3203.100067,3203.104267,1,96093002,96093128,126,0.25198171695271926
36303,3203.109967,3203.123367,1,96093299,96093701,402,-0.10848130069490292
36304,3203.1255,3203.139867,1,96093765,96094196,431,0.11764859297177484
36305,3203.148,3203.1545,1,96094440,96094635,195,0.008327365268686474
36306,3203.156467,3203.167233,1,96094694,96095016,322,0.06717817946938659
36307,3203.174433,3203.192967,1,96095232,96095789,557,0.053025131138439464
36308,3203.195067,3203.210867,1,96095852,96096326,474,0.21591009944505146
36309,3203.2255,3203.304833,1,96096765,96099144,2379,0.3276563617806212
36310,3203.311867,3203.332167,1,96099356,96099965,609,0.2607352630513093
36311,3204.9875,3204.991133,1,96149625,96149733,108,0.5762855216497129
36312,3204.9944,3205.01,1,96149832,96150300,468,0.20599251004180297
36313,3205.029033,3205.033133,1,96150870,96150993,123,0.5405536477101441
36314,3205.036133,3205.122967,1,96151083,96153689,2606,0.5553916729380353
36315,3205.1267,3205.1963,1,96153801,96155889,2088,-0.015589638343150906
36316,3205.199867,3205.2044,1,96155996,96156132,136,-0.09615975494346575
36317,3205.221067,3205.2261,1,96156632,96156783,151,-0.022620896966327134
36318,3205.2307,3205.2365,1,96156921,96157095,174,-0.02446696089179787
36319,3205.246267,3205.261733,1,96157388,96157851,463,0.21154727390741884
36320,3205.2672,3205.274967,1,96158016,96158249,233,0.10393715022315503
36321,3205.2781,3205.3394,1,96158343,96160182,1839,0.21038154082541757
36322,3205.343,3205.349433,1,96160290,96160482,192,-0.14267258670164043
36323,3205.354267,3205.358467,1,96160628,96160754,126,0.7488194859304385
36324,3205.361433,3205.365167,1,96160842,96160955,113,0.4284628386295243
36325,3205.710033,3205.716467,1,96171300,96171494,194,0.32750009831312277
36326,3205.742367,3205.7485,1,96172271,96172455,184,0.4311107315815777
36327,3205.787633,3205.790733,1,96173628,96173721,93,
36328,3205.793567,3205.855267,1,96173807,96175658,1851,0.10983198106523928
36329,3205.8564,3205.872733,1,96175692,96176181,489,0.0657826220484417
36330,3205.8744,3205.882133,1,96176232,96176463,231,0.2532136969232049
36331,3205.883767,3205.889767,1,96176513,96176693,180,-0.043017321590202905
36332,3205.892533,3205.9137,1,96176775,96177411,636,-0.0973138384643587
36333,3205.920567,3205.931367,1,96177617,96177941,324,0.0765580960400592
36334,3205.9336,3205.9377,1,96178008,96178131,123,-0.12215874854238377
36335,3205.942867,3205.958,1,96178286,96178740,454,0.16555762251501657
36336,3205.959367,3206.0015,1,96178781,96180045,1264,0.037287549268180176
36337,3206.007967,3206.016533,1,96180239,96180495,256,-0.20930215217277134
36338,3206.017667,3206.0258,1,96180530,96180774,244,0.6252974861754395
36339,3206.028233,3206.0333,1,96180846,96180999,153,
36340,3206.1891,3206.195633,1,96185673,96185868,195,-0.13186426157167355
36341,3206.209233,3206.212467,1,96186276,96186374,98,
36342,3206.4544,3206.4662,1,96193632,96193986,354,0.2753938022720049
36343,3206.471333,3206.504967,1,96194139,96195149,1010,-0.009693425470948194
36344,3206.548033,3206.6398,1,96196440,96199194,2754,0.3269014622634757
36345,3206.650567,3206.667633,1,96199517,96200028,511,0.19021491033643997
36346,3206.679067,3206.6899,1,96200372,96200697,325,0.09340117717782363
36347,3206.716467,3206.746033,1,96201494,96202380,886,0.24466124842165082
36348,3206.760567,3206.7831,1,96202817,96203493,676,-0.068342241866506
36349,3206.7857,3206.794833,1,96203571,96203844,273,0.40776483504239136
36350,3206.804033,3206.819233,1,96204120,96204576,456,0.07308519392615145
36351,3206.8247,3206.8326,1,96204741,96204978,237,0.27951323006244094
36352,3206.8549,3206.8614,1,96205647,96205842,195,0.5424001506956628
36353,3206.863033,3206.8683,1,96205890,96206049,159,0.29381904073492077
36354,3206.882833,3206.9056,1,96206484,96207168,684,0.10099380480685057
36355,3206.907933,3206.913633,1,96207237,96207408,171,0.016383995820638667
36356,3206.923867,3206.931533,1,96207716,96207945,229,0.3805122500420159
36357,3206.943467,3206.9508,1,96208304,96208524,220,0.26812920987427336
36358,3206.954,3206.9604,1,96208620,96208812,192,0.6452119605874007
36359,3206.9661,3206.975467,1,96208983,96209264,281,-0.008881756026388079
36360,3206.989367,3207.0094,1,96209681,96210282,601,0.15498864583188518
36361,3207.0158,3207.028533,1,96210474,96210855,381,0.16472709851727488
36362,3207.051533,3207.123167,1,96211545,96213695,2150,0.15587155325674013
36363,3207.1369,3207.145833,1,96214107,96214374,267,0.4719201335101182
36364,3207.152867,3207.166967,1,96214586,96215009,423,0.05959705945174881
36365,3207.174467,3207.1988,1,96215234,96215964,730,0.3440470300289083
36366,3207.215067,3207.222667,1,96216452,96216680,228,0.39403154224923365
36367,3207.2278,3207.234733,1,96216834,96217041,207,0.3395170061517286
36368,3207.238833,3207.245567,1,96217164,96217367,203,-0.26121951151326483
36369,3207.247967,3207.2615,1,96217439,96217845,406,0.32358637453349975
36370,3208.8547,3208.858433,1,96265641,96265752,111,0.40218095636076384
36371,3208.859833,3208.8888,1,96265794,96266664,870,0.12761487944486316
36372,3208.9279,3208.9395,1,96267837,96268185,348,0.3811438371206297
36373,3208.9573,3208.9614,1,96268719,96268842,123,-0.05112971565537879
36374,3208.969333,3208.974933,1,96269079,96269247,168,0.11187162725696263
36375,3208.976067,3209.0159,1,96269282,96270477,1195,0.28835535071503565
36376,3209.102633,3209.108533,1,96273078,96273255,177,0.5130088741942624
36377,3209.1122,3209.1239,1,96273366,96273717,351,0.028140184985541883
36378,3209.133867,3209.150567,1,96274016,96274517,501,0.22667467542588632
36379,3209.165133,3209.234067,1,96274953,96277022,2069,0.33064558432581137
36380,3209.237667,3209.266867,1,96277130,96278006,876,0.039098068364142945
36381,3209.277867,3209.2828,1,96278336,96278484,148,0.05051106008074069
36382,3209.284933,3209.288133,1,96278547,96278643,96,
36383,3209.2918,3209.301333,1,96278754,96279039,285,0.08367791992141829
36384,3209.303067,3209.307533,1,96279092,96279225,133,-0.1333142537633754
36385,3209.331133,3209.344633,1,96279933,96280338,405,0.0730053191244088
36386,3209.8347,3209.8445,1,96295041,96295335,294,0.16027442417655724
36387,3209.890933,3209.8982,1,96296727,96296946,219,0.41953313794133373
36388,3209.9043,3209.915867,1,96297129,96297476,347,0.15350008299972742
36389,3209.917433,3209.985267,1,96297522,96299558,2036,0.03448017309157236
36390,3209.9863,3210.013233,1,96299589,96300396,807,-0.018822271130240376
36391,3210.024433,3210.039967,1,96300732,96301199,467,0.1438075262242594
36392,3210.041367,3210.049067,1,96301241,96301472,231,-0.08624490617743084
36393,3210.077267,3210.081133,1,96302318,96302433,115,0.37372947111350413
36394,3210.085433,3210.089033,1,96302562,96302670,108,0.28436366038529826
36395,3210.100667,3210.113067,1,96303020,96303392,372,0.09843823726351877
36396,3210.1155,3210.132133,1,96303465,96303963,498,0.21059751707131064
36397,3210.137833,3210.203733,1,96304134,96306111,1977,0.3345586654872207
36398,3211.089167,3211.0998,1,96332675,96332994,319,0.3820387184355203
36399,3211.102233,3211.122233,1,96333066,96333666,600,0.1571479315659151
36400,3211.131733,3211.1348,1,96333951,96334044,93,-0.09215566696299782
36401,3211.240867,3211.247933,1,96337226,96337437,211,0.14272789182777187
36402,3211.273667,3211.284233,1,96338210,96338526,316,-0.077079986180367
36403,3212.082,3212.086067,1,96362460,96362582,122,0.31531827444623634
36404,3212.0874,3212.094433,1,96362622,96362832,210,0.25767237971523294
36405,3212.168,3212.175733,1,96365040,96365271,231,0.39948005296668504
36406,3212.1846,3212.191467,1,96365538,96365744,206,0.451570850184052
36407,3212.234667,3212.246767,1,96367040,96367403,363,0.4069459072772634
36408,3212.311,3212.3261,1,96369330,96369783,453,0.24360689066494354
36409,3212.3704,3212.39,1,96371112,96371700,588,0.37198838438933973
36410,3212.3924,3212.399967,1,96371772,96371999,227,0.032997039013483005
36411,3212.431067,3212.436933,1,96372932,96373107,175,0.3655445465918294
36412,3212.444533,3212.4477,1,96373335,96373431,96,
36413,3212.4575,3212.4666,1,96373725,96373998,273,0.1947172192404905
36414,3212.475167,3212.534467,1,96374255,96376034,1779,0.16940690526174504
36415,3212.538933,3212.546267,1,96376167,96376388,221,0.12583391803555946
36416,3212.547833,3212.58,1,96376434,96377400,966,0.02955348098030425
36417,3212.583067,3212.599567,1,96377492,96377987,495,-0.07737067224846882
36418,3212.6051,3212.6186,1,96378153,96378558,405,-0.004814644512210232
36419,3212.6233,3212.660167,1,96378699,96379805,1106,0.24495298399647758
36420,3212.6688,3212.672233,1,96380064,96380166,102,
36421,3212.6736,3212.7459,1,96380208,96382377,2169,0.24140030388764028
36422,3212.749033,3212.753467,1,96382470,96382604,134,0.16874166321858333
36423,3212.761333,3212.7788,1,96382839,96383364,525,0.37770913176579307
36424,3212.78,3212.803233,1,96383400,96384096,696,0.07952026402511837
36425,3212.813233,3212.818767,1,96384396,96384563,167,0.44026815170924904
36426,3212.821133,3212.838067,1,96384633,96385142,509,0.4340449399468968
36427,3214.847733,3214.8531,1,96445431,96445593,162,0.6339052371896706
36428,3214.921967,3214.945033,1,96447659,96448350,691,0.3788669505940125
36429,3214.953333,3215.017867,1,96448599,96450536,1937,0.37579863989699736
36430,3215.0198,3215.026,1,96450594,96450780,186,0.02362816646868119
36431,3215.030933,3215.0442,1,96450927,96451326,399,0.021811378922205086
36432,3215.055433,3215.062433,1,96451662,96451872,210,0.19656963233901398
36433,3215.065133,3215.072267,1,96451953,96452168,215,0.01853679239034154
36434,3215.076833,3215.084533,1,96452304,96452535,231,0.259932481291708
36435,3215.098133,3215.101733,1,96452943,96453051,108,-0.028153986662083394
36436,3215.112133,3215.1164,1,96453363,96453492,129,0.2556180263576507
36437,3215.117567,3215.123267,1,96453527,96453698,171,0.3759281683197304
36438,3215.124833,3215.1327,1,96453744,96453981,237,0.012871926110774243
36439,3215.1362,3215.156533,1,96454086,96454695,609,-0.009013742163037776
36440,3215.1618,3215.1895,1,96454854,96455685,831,0.4795219515000342
36441,3215.191,3215.210567,1,96455730,96456317,587,0.2058343461459518
36442,3215.212467,3215.220033,1,96456374,96456600,226,0.09015132507981126
36443,3215.2275,3215.2436,1,96456825,96457308,483,0.2298332758138892
36444,3215.2511,3215.322167,1,96457533,96459665,2132,0.18314666424749476
36445,3216.7768,3216.783833,1,96503304,96503514,210,-0.04437568592383421
36446,3216.796933,3216.832667,1,96503907,96504980,1073,0.12911142314376461
36447,3216.8486,3216.869967,1,96505458,96506099,641,0.34026407320480556
36448,3216.895033,3216.901367,1,96506850,96507041,191,0.08492986778958565
36449,3217.092767,3217.1012,1,96512783,96513036,253,0.4358866417320088
36450,3217.103867,3217.110667,1,96513116,96513320,204,0.3322723520624613
36451,3217.113333,3217.124533,1,96513399,96513735,336,0.15807782124739525
36452,3217.1291,3217.133,1,96513873,96513990,117,0.2553511359978169
36453,3217.137133,3217.1775,1,96514113,96515325,1212,0.19897856069633568
36454,3217.178933,3217.201767,1,96515367,96516053,686,0.18180261931715774
36455,3217.211833,3217.2266,1,96516354,96516798,444,0.04472923804175521
36456,3217.2354,3217.245467,1,96517062,96517364,302,0.051730061258425906
36457,3217.247133,3217.2531,1,96517413,96517593,180,0.1317699437535461
36458,3217.2546,3217.288633,1,96517638,96518658,1020,0.011468285533855106
36459,3217.294733,3217.3027,1,96518841,96519081,240,0.10976910083200762
36460,3217.3116,3217.324933,1,96519348,96519747,399,-0.029084617709103675
36461,3217.327633,3217.359867,1,96519828,96520796,968,0.06432814245058306
36462,3217.361333,3217.3836,1,96520839,96521508,669,0.08439310043543542
36463,3217.389367,3217.410767,1,96521681,96522323,642,0.236579213307838
36464,3217.413567,3217.4866,1,96522407,96524598,2191,0.2976257461560972
36465,3217.772267,3217.776167,1,96533168,96533285,117,
36466,3218.6108,3218.615567,1,96558324,96558467,143,0.21499363766857651
36467,3219.092433,3219.100233,1,96572772,96573006,234,0.2529748401637744
36468,3220.263167,3220.272667,1,96607895,96608180,285,0.20697406684089703
36469,3220.276767,3220.292667,1,96608303,96608780,477,0.26082364661216295
36470,3220.305733,3220.383433,1,96609171,96611502,2331,0.6984980985962399
36471,3220.392633,3220.435733,1,96611778,96613071,1293,0.0024441026414740294
36472,3220.438667,3220.447067,1,96613160,96613412,252,0.012512987950449424
36473,3220.4562,3220.468833,1,96613686,96614064,378,-0.012787117998625646
36474,3220.472233,3220.5016,1,96614166,96615048,882,0.07064181443328026
36475,3220.5166,3220.537867,1,96615498,96616136,638,0.13397644061768213
36476,3220.5451,3220.6129,1,96616353,96618387,2034,0.18588055609023207
36477,3220.6185,3220.623267,1,96618555,96618698,143,-0.00754970513041829
36478,3220.627333,3220.633,1,96618819,96618990,171,0.7107224841993633
36479,3220.634433,3220.6433,1,96619032,96619299,267,0.42185787274566827
36480,3220.6536,3220.667533,1,96619608,96620025,417,0.24059542438602585
36481,3221.464633,3221.476467,1,96643938,96644294,356,-0.024739477654108766
36482,3221.4797,3221.487433,1,96644391,96644622,231,0.18732767400467024
36483,3221.504967,3221.511567,1,96645149,96645347,198,0.5335679256328528
36484,3221.5165,3221.5208,1,96645495,96645624,129,0.5201921054553126
36485,3221.558433,3221.566267,1,96646752,96646988,236,-0.014449047334660351
36486,3221.571967,3221.576933,1,96647159,96647307,148,0.2441528826409107
36487,3221.601533,3221.6159,1,96648045,96648477,432,0.18882129149267846
36488,3221.620633,3221.6449,1,96648618,96649347,729,0.1571751354301249
36489,3221.650033,3221.653467,1,96649500,96649604,104,
36490,3225.895833,3225.9096,1,96776874,96777288,414,0.42845426857095625
36491,3225.938833,3225.954867,1,96778164,96778646,482,0.11265751896366745
36492,3225.9672,3225.974833,1,96779016,96779244,228,0.12697146238026227
36493,3226.077267,3226.087367,1,96782318,96782621,303,0.01173036900666205
36494,3226.0957,3226.100633,1,96782871,96783018,147,0.20743498419343367
36495,3226.103433,3226.123933,1,96783102,96783717,615,-0.04110889064155668
36496,3228.248933,3228.260933,1,96847467,96847827,360,0.14922317862216267
36497,3228.262967,3228.266567,1,96847889,96847997,108,0.30540593912712466
36498,3228.318667,3228.329533,1,96849560,96849885,325,0.026733291986385823
36499,3228.418733,3228.434633,1,96852561,96853038,477,0.010019349447975506
36500,3228.440933,3228.4479,1,96853227,96853437,210,0.2718782169906638
36501,3228.4497,3228.481533,1,96853491,96854445,954,0.09910643171192582
36502,3229.840867,3229.847333,1,96895226,96895419,193,0.47618680124112117
36503,3230.611533,3230.622067,1,96918345,96918662,317,0.11746605099985716
36504,3230.623567,3230.644133,1,96918707,96919323,616,0.13867439760655625
36505,3230.6606,3230.665033,1,96919818,96919950,132,0.24663577153023164
36506,3230.6689,3230.6988,1,96920067,96920964,897,0.2865121396627974
36507,3230.782633,3230.796933,1,96923478,96923907,429,0.20421965913543083
36508,3230.799633,3230.8189,1,96923988,96924567,579,0.18477391982101585
36509,3231.305033,3231.3112,1,96939150,96939336,186,-0.09741654205408913
36510,3232.008733,3232.035167,1,96960261,96961055,794,0.22326791598310494
36511,3232.0588,3232.0618,1,96961764,96961854,90,-0.0034928393721780403
36512,3232.077133,3232.0863,1,96962313,96962589,276,0.04949224854406941
36513,3232.155967,3232.1847,1,96964679,96965541,862,-0.05215567940204765
36514,3232.197367,3232.2037,1,96965921,96966111,190,0.3736787446650701
36515,3232.2056,3232.218767,1,96966168,96966563,395,0.11320081008166985
36516,3232.3482,3232.359667,1,96970446,96970790,344,0.2459509918848271
36517,3232.364867,3232.384567,1,96970946,96971537,591,0.1055345988540491
36518,3232.401167,3232.407,1,96972035,96972210,175,0.3569626660006082
36519,3232.4095,3232.513167,1,96972285,96975395,3110,0.6965630177015841
36520,3232.522467,3232.5372,1,96975674,96976116,442,0.12951600328096652
36521,3232.538533,3232.556767,1,96976155,96976703,548,0.11473098218865148
36522,3232.557867,3232.5628,1,96976736,96976884,148,0.015330165460846711
36523,3232.565633,3232.574733,1,96976968,96977241,273,0.34281716107700605
36524,3232.604933,3232.608267,1,96978147,96978248,101,-0.04942864614938604
36525,3232.612,3232.620333,1,96978360,96978609,249,-0.03230127907941553
36526,3232.628133,3232.643233,1,96978843,96979296,453,-0.009822826759675383
36527,3232.6461,3232.652367,1,96979383,96979571,188,-0.11795583827580933
36528,3232.6572,3232.670667,1,96979716,96980120,404,0.0728563758399905
36529,3232.681067,3232.748633,1,96980432,96982458,2026,0.1858062045823275
36530,3232.755633,3232.767967,1,96982668,96983039,371,0.1638182152811186
36531,3232.7732,3232.782033,1,96983196,96983460,264,0.7248077997053941
36532,3232.791367,3232.799667,1,96983741,96983990,249,0.05272643969923734
36533,3232.807233,3232.8246,1,96984216,96984738,522,0.48531118797306444
36534,3232.834333,3232.840667,1,96985029,96985220,191,0.0024000662519762053
36535,3233.0246,3233.0313,1,96990738,96990939,201,-0.0043895249876071945
36536,3233.032633,3233.037,1,96990978,96991110,132,0.7956242491011087
36537,3233.048833,3233.052033,1,96991464,96991560,96,0.15995694633425653
36538,3233.364033,3233.391167,1,97000920,97001735,815,0.12115242834965956
36539,3233.392467,3233.402067,1,97001774,97002062,288,-0.056500146725271226
36540,3233.432933,3233.441933,1,97002987,97003257,270,-0.13563547362197154
36541,3233.445567,3233.460933,1,97003367,97003827,460,0.262780557397683
36542,3234.473267,3234.4773,1,97034198,97034319,121,0.7183898678407823
36543,3234.513233,3234.6049,1,97035396,97038147,2751,0.1121474209792506
36544,3234.607767,3234.617,1,97038233,97038510,277,-0.08710713496074396
36545,3234.6282,3234.639767,1,97038846,97039193,347,0.13842320361810012
36546,3234.644467,3234.6743,1,97039334,97040229,895,0.11359900686578435
36547,3234.675333,3234.682867,1,97040259,97040486,227,0.002705636085806383
36548,3234.684733,3234.687767,1,97040541,97040633,92,
36549,3234.7007,3234.710833,1,97041021,97041324,303,-0.058059754962247655
36550,3234.7141,3234.7369,1,97041423,97042107,684,0.22148171114985624
36551,3234.7405,3234.7473,1,97042215,97042419,204,0.16174911972315895
36552,3234.750033,3234.835767,1,97042500,97045073,2573,0.21702460806295937
36553,3234.851733,3234.8562,1,97045551,97045686,135,0.36649966317667365
36554,3234.864967,3234.886067,1,97045949,97046582,633,0.1660466801724991
36555,3234.926433,3234.936767,1,97047792,97048103,311,0.2504158518512209
36556,3234.9425,3234.967,1,97048275,97049010,735,0.23041122028681615
36557,3234.968467,3234.9772,1,97049054,97049316,262,0.18060929059406716
36558,3234.984167,3234.990867,1,97049525,97049726,201,-0.06313271996119448
36559,3234.997533,3235.000667,1,97049925,97050020,95,
36560,3235.0206,3235.034267,1,97050618,97051028,410,-0.06795557833376752
36561,3235.794833,3235.798433,1,97073844,97073952,108,
36562,3235.818567,3235.8222,1,97074557,97074666,109,-0.17252766384698737
36563,3235.829067,3235.842667,1,97074872,97075280,408,0.23004154646257544
36564,3235.858267,3235.8614,1,97075748,97075842,94,-0.17398041252230695
36565,3235.866467,3235.8713,1,97075994,97076139,145,-0.037173524049732634
36566,3235.905567,3235.927333,1,97077167,97077819,652,0.2123086496208138
36567,3235.933667,3235.9707,1,97078010,97079121,1111,0.1536423059671899
36568,3235.972333,3235.978833,1,97079169,97079364,195,0.42942009900313416
36569,3235.9942,3236.070367,1,97079826,97082111,2285,0.34368902125187395
36570,3236.073767,3236.0838,1,97082213,97082514,301,0.01839805081900548
36571,3236.107433,3236.1135,1,97083222,97083405,183,-0.16290668199794228
36572,3237.934967,3237.9573,1,97138049,97138719,670,0.2183741707423964
36573,3237.964233,3238.0381,1,97138926,97141143,2217,0.28491300406462416
36574,3238.044,3238.051933,1,97141320,97141557,237,0.08013692850428096
36575,3238.058833,3238.1045,1,97141764,97143135,1371,0.05678058980078389
36576,3238.1194,3238.164667,1,97143582,97144940,1358,0.24908344524896034
36577,3238.169633,3238.245133,1,97145088,97147353,2265,0.28357113162680536
36578,3238.964067,3238.971967,1,97168922,97169159,237,0.019236211858744166
36579,3240.9691,3240.974,1,97229073,97229220,147,-0.11479400695581779
36580,3241.042267,3241.061767,1,97231268,97231853,585,0.057217967247699626
36581,3241.067,3241.159333,1,97232010,97234779,2769,0.2304462237721225
36582,3241.170267,3241.1787,1,97235108,97235361,253,-0.09672841154315488
36583,3241.185433,3241.2072,1,97235562,97236216,654,0.10119659424484297
36584,3241.219,3241.2885,1,97236570,97238655,2085,0.09267200249617204
36585,3241.294567,3241.312,1,97238837,97239360,523,0.2748529781983171
36586,3241.322433,3241.333367,1,97239672,97240001,329,0.00934003266760171
36587,3241.372533,3241.3824,1,97241175,97241472,297,0.11867050286074642
36588,3242.571167,3242.6036,1,97277135,97278108,973,0.1510968040944305
36589,3242.619967,3242.631533,1,97278599,97278945,346,0.48145381549434857
36590,3242.664267,3242.6795,1,97279928,97280385,457,0.12643999534792713
36591,3242.700267,3242.705633,1,97281008,97281168,160,-0.009201680667863818
36592,3242.828767,3242.831967,1,97284863,97284959,96,
36593,3243.8817,3243.911433,1,97316451,97317342,891,0.15905554939836958
36594,3243.949733,3243.9707,1,97318491,97319121,630,0.18971305769411506
36595,3244.016333,3244.0212,1,97320489,97320636,147,0.10863246374960937
36596,3244.138233,3244.142467,1,97324146,97324274,128,0.4734801717017508
36597,3244.164633,3244.180267,1,97324938,97325408,470,0.1791106267900885
36598,3244.183467,3244.188067,1,97325504,97325642,138,0.2768977198516262
36599,3244.197533,3244.263033,1,97325925,97327890,1965,0.16812838621326656
36600,3244.264533,3244.2738,1,97327935,97328214,279,0.4407078362791555
36601,3244.2764,3244.2914,1,97328292,97328742,450,-0.0643064531075506
36602,3244.294633,3244.3421,1,97328838,97330263,1425,0.13740746031012804
36603,3244.3438,3244.356067,1,97330314,97330682,368,-0.08766115220463419
36604,3244.360533,3244.377867,1,97330815,97331336,521,0.3138715041553322
36605,3244.385767,3244.458533,1,97331573,97333755,2182,0.1675542067128779
36606,3245.379667,3245.394533,1,97361390,97361835,445,0.12928726512105934
36607,3245.405767,3245.4276,1,97362173,97362828,655,0.1486291723008504
36608,3245.4307,3245.5112,1,97362921,97365336,2415,0.23205328177784834
36609,3245.5161,3245.532467,1,97365483,97365974,491,0.23450681904626616
36610,3245.536033,3245.6041,1,97366080,97368123,2043,0.16649952262305032
36611,3246.652267,3246.768767,1,97399568,97403063,3495,0.47783433950677856
36612,3246.775467,3246.789867,1,97403264,97403696,432,-0.0383962682300587
36613,3246.795267,3246.808333,1,97403858,97404249,391,0.05064660337598806
36614,3246.811267,3246.842167,1,97404338,97405265,927,0.0003682935510320568
36615,3246.843833,3246.855733,1,97405314,97405671,357,-0.04995705196379809
36616,3246.861033,3246.876067,1,97405830,97406282,452,0.10470915301924143
36617,3246.887,3246.953267,1,97406610,97408598,1988,0.21513203644941015
36618,3246.9574,3246.962367,1,97408722,97408871,149,-0.2116502769897373
36619,3246.967933,3246.978033,1,97409037,97409340,303,-0.055765320632777116
36620,3246.982467,3247.019567,1,97409474,97410587,1113,0.08132121521882978
36621,3247.020733,3247.028667,1,97410621,97410860,239,0.40247710255845914
36622,3247.0413,3247.0489,1,97411239,97411467,228,-0.022912510153205598
36623,3247.7472,3247.751933,1,97432416,97432557,141,0.4387852056799659
36624,3247.7582,3247.761767,1,97432746,97432853,107,
36625,3247.7634,3247.767067,1,97432902,97433012,110,0.2391426348861711
36626,3247.851833,3247.862533,1,97435554,97435875,321,-0.021564570719929517
36627,3247.933067,3247.947233,1,97437992,97438416,424,0.13485665014090759
36628,3247.954267,3247.9624,1,97438628,97438872,244,0.4271871324636315
36629,3247.9651,3247.991367,1,97438953,97439741,788,0.09446325296471685
36630,3248.014967,3248.0947,1,97440449,97442841,2392,0.4930198372809834
36631,3248.1028,3248.1514,1,97443084,97444542,1458,0.15980779060739875
36632,3248.152833,3248.175133,1,97444584,97445253,669,0.040791593935973376
36633,3248.1825,3248.187,1,97445475,97445610,135,-0.01044712242389141
36634,3248.191,3248.2285,1,97445730,97446855,1125,0.07975025608072997
36635,3248.238,3248.2496,1,97447140,97447488,348,-0.06975341713670785
36636,3248.436533,3248.442167,1,97453095,97453265,170,0.1659714669889816
36637,3248.485967,3248.4909,1,97454579,97454727,148,0.15157367038560027
36638,3248.504667,3248.51,1,97455140,97455300,160,0.37391024154823543
36639,3248.527067,3248.5378,1,97455812,97456134,322,0.3735332818751887
36640,3248.5777,3248.633133,1,97457331,97458993,1662,0.25697784831441106
36641,3248.651,3248.659267,1,97459530,97459778,248,-0.07474579959226192
36642,3248.660733,3248.6727,1,97459821,97460181,360,-0.06797836304155089
36643,3248.678933,3248.686033,1,97460367,97460580,213,0.011802837870652394
36644,3248.692433,3248.709567,1,97460772,97461287,515,-0.07649142777896804
36645,3248.715067,3248.727633,1,97461452,97461828,376,0.17865896206461296
36646,3248.731067,3248.769733,1,97461932,97463091,1159,0.38677459094116146
36647,3248.774233,3248.839567,1,97463226,97465187,1961,0.016493415574899743
36648,3248.841933,3248.865667,1,97465257,97465970,713,0.18788950301188673
36649,3248.8672,3248.8849,1,97466016,97466547,531,-0.06970059244460454
36650,3248.885933,3248.889433,1,97466577,97466682,105,0.04301810872423225
36651,3248.906433,3248.911067,1,97467192,97467332,140,0.11246005495027006
36652,3248.912067,3248.9165,1,97467362,97467495,133,0.16791023847953762
36653,3249.677,3249.688467,1,97490310,97490654,344,0.008844797653056848
36654,3249.689833,3249.7027,1,97490694,97491081,387,0.4672600542008035
36655,3249.707033,3249.7148,1,97491210,97491444,234,0.19777971817832599
36656,3249.719133,3249.7249,1,97491573,97491747,174,0.10579332078579508
36657,3249.744467,3249.761433,1,97492334,97492842,508,0.2381450002267376
36658,3249.7883,3249.794467,1,97493649,97493834,185,-0.0260122901902754
36659,3249.842567,3249.859533,1,97495277,97495785,508,-0.0027657435262845908
36660,3249.862,3249.8727,1,97495860,97496181,321,0.3287317078720047
36661,3249.879067,3249.883533,1,97496372,97496505,133,-0.15138165714699356
36662,3249.8968,3249.9077,1,97496904,97497231,327,0.3466273343637296
36663,3249.910433,3249.9173,1,97497312,97497519,207,0.19415350360937117
36664,3249.949967,3249.963433,1,97498499,97498902,403,0.07688495389716257
36665,3249.9668,3249.980833,1,97499004,97499424,420,0.2529486867097773
36666,3249.984167,3249.9916,1,97499525,97499748,223,0.1831899461893053
36667,3249.995533,3249.998633,1,97499865,97499958,93,
36668,3250.0029,3250.006067,1,97500087,97500182,95,-0.08898708231757838
36669,3250.0166,3250.067367,1,97500498,97502021,1523,0.39038565009370746
36670,3250.0692,3250.084333,1,97502076,97502529,453,0.15813148344177003
36671,3250.091267,3250.103433,1,97502738,97503102,364,-0.07305612877887259
36672,3250.108433,3250.170167,1,97503252,97505105,1853,0.08018664500547217
36673,3250.175833,3250.189867,1,97505274,97505696,422,0.22410993281507277
36674,3250.196833,3250.2616,1,97505904,97507848,1944,0.04514553042568353
36675,3250.270333,3250.276467,1,97508109,97508294,185,
36676,3250.280867,3250.291567,1,97508426,97508747,321,0.07357814007570376
36677,3250.303533,3250.3071,1,97509105,97509213,108,-0.22235587573748833
36678,3250.3316,3250.344167,1,97509948,97510325,377,-0.020766084759656085
36679,3250.3808,3250.3858,1,97511424,97511574,150,0.8340528878796155
36680,3250.3971,3250.4032,1,97511913,97512096,183,0.5653551140596302
36681,3250.404367,3250.4214,1,97512131,97512642,511,0.23684924115563338
36682,3250.4264,3250.455967,1,97512792,97513679,887,0.07339799641384186
36683,3250.4585,3250.4681,1,97513755,97514043,288,0.36368846463813403
36684,3250.478467,3250.4862,1,97514354,97514586,232,-0.006512246423624155
36685,3250.548567,3250.5523,1,97516457,97516569,112,0.15992411702771717
36686,3250.5617,3250.572,1,97516851,97517160,309,0.2734900550086385
36687,3250.612867,3250.617733,1,97518386,97518531,145,0.3512284436322311
36688,3250.628433,3250.632067,1,97518852,97518962,110,
36689,3250.660967,3250.6646,1,97519829,97519938,109,
36690,3250.918433,3250.922433,1,97527552,97527672,120,0.4381989431896194
36691,3251.013433,3251.0211,1,97530402,97530633,231,0.19754364638594976
36692,3251.026733,3251.029967,1,97530801,97530899,98,0.24304117565974606
36693,3251.034233,3251.0476,1,97531026,97531428,402,0.20474394105694357
36694,3251.0552,3251.066467,1,97531656,97531994,338,0.3211592443440172
36695,3251.0682,3251.071333,1,97532046,97532139,93,
36696,3251.087167,3251.099267,1,97532615,97532978,363,0.2438507492112769
36697,3251.173567,3251.181133,1,97535207,97535433,226,-0.04763401857735709
36698,3251.184733,3251.197433,1,97535541,97535922,381,-0.019634452559004072
36699,3251.205733,3251.2151,1,97536171,97536453,282,0.33479107648183076
36700,3251.8547,3251.858167,1,97555641,97555745,104,0.6593711767122121
36701,3251.865967,3251.883133,1,97555979,97556493,514,0.4137499608123538
36702,3251.8871,3251.890933,1,97556613,97556727,114,0.023037336716748617
36703,3251.902767,3251.906567,1,97557083,97557197,114,0.030919201460071995
36704,3251.908567,3251.915567,1,97557257,97557467,210,0.2457826081108008
36705,3251.928,3251.9489,1,97557840,97558467,627,0.40603588833774346
36706,3251.974033,3251.977667,1,97559220,97559330,110,
36707,3252.0138,3252.0196,1,97560414,97560588,174,0.566318567718883
36708,3252.081967,3252.110767,1,97562459,97563323,864,0.21265045322078122
36709,3252.112133,3252.1165,1,97563363,97563495,132,-0.09017116072580482
36710,3252.124867,3252.1288,1,97563746,97563864,118,0.5558581775922402
36711,3252.130667,3252.196433,1,97563920,97565892,1972,0.18063583387813328
36712,3252.200833,3252.2054,1,97566024,97566162,138,-0.029712632890833614
36713,3252.208067,3252.227467,1,97566242,97566824,582,-0.0869287091898293
36714,3252.229333,3252.2449,1,97566879,97567347,468,0.06157444996137439
36715,3252.2535,3252.285,1,97567605,97568550,945,0.05927738008690008
36716,3252.289667,3252.316633,1,97568690,97569498,808,0.06700197716607553
36717,3252.3238,3252.3336,1,97569714,97570008,294,0.12289277104792079
36718,3252.334867,3252.391467,1,97570046,97571744,1698,0.15890411292648357
36719,3252.460467,3252.463467,1,97573814,97573904,90,
36720,3253.068467,3253.081733,1,97592054,97592451,397,0.2106434855762821
36721,3253.0829,3253.0969,1,97592487,97592907,420,0.3156960976272663
36722,3253.1122,3253.121533,1,97593366,97593645,279,0.2417764099867913
36723,3253.150033,3253.1652,1,97594500,97594956,456,0.030259948016218105
36724,3253.226667,3253.272333,1,97596800,97598169,1369,0.12441013672169461
36725,3253.274633,3253.2797,1,97598238,97598391,153,0.06794941502405748
36726,3253.2807,3253.3135,1,97598421,97599405,984,0.08536260852773776
36727,3253.324833,3253.340633,1,97599744,97600218,474,-0.027481045832857726
36728,3253.3994,3253.406333,1,97601982,97602189,207,0.05046819572928617
36729,3253.410433,3253.420133,1,97602312,97602603,291,0.0627273577810383
36730,3253.427933,3253.4399,1,97602837,97603197,360,0.16747393089404575
36731,3253.4449,3253.468833,1,97603347,97604064,717,0.14394970744276867
36732,3253.470967,3253.479333,1,97604129,97604379,250,0.1093453440021805
36733,3253.489167,3253.546,1,97604675,97606380,1705,0.26154510223455196
36734,3253.5502,3253.576767,1,97606506,97607303,797,-0.05612648103402748
36735,3253.5818,3253.595,1,97607454,97607850,396,0.03937699549212398
36736,3253.601633,3253.610733,1,97608048,97608321,273,0.0852288780090849
36737,3253.611733,3253.6225,1,97608351,97608675,324,0.03501069939930175
36738,3253.628833,3253.641133,1,97608864,97609233,369,0.027966854903070732
36739,3253.648333,3253.653233,1,97609449,97609596,147,-0.042143786388512544
36740,3253.655433,3253.664333,1,97609662,97609929,267,0.3337306656233822
36741,3253.667567,3253.682833,1,97610027,97610484,457,0.22602157126234962
36742,3253.6916,3253.7508,1,97610748,97612524,1776,0.18785523523509
36743,3253.8363,3253.841433,1,97615089,97615242,153,-0.16914258179959013
36744,3253.842667,3253.857267,1,97615280,97615718,438,0.07251785311041226
36745,3253.8583,3253.8631,1,97615749,97615893,144,0.7455232927637774
36746,3253.870633,3253.874033,1,97616118,97616220,102,0.06654927882965544
36747,3253.903833,3253.910067,1,97617114,97617302,188,-0.34417324031297936
36748,3254.04,3254.0691,1,97621200,97622073,873,0.40125272553673286
36749,3254.0741,3254.102967,1,97622223,97623089,866,0.05579728779177613
36750,3254.110233,3254.120333,1,97623306,97623609,303,0.2766995391530387
36751,3254.121333,3254.133233,1,97623639,97623996,357,0.19045669770823256
36752,3254.139033,3254.1469,1,97624170,97624407,237,0.3629298429257234
36753,3254.4079,3254.4159,1,97632237,97632477,240,0.6509160763872092
36754,3254.423367,3254.446667,1,97632701,97633400,699,-0.004447509235820632
36755,3254.516067,3254.5201,1,97635482,97635603,121,0.21032510686048453
36756,3254.529033,3254.557767,1,97635870,97636733,863,0.1129064552980937
36757,3254.5678,3254.573333,1,97637034,97637199,165,-0.08416059306506422
36758,3254.578533,3254.589833,1,97637355,97637694,339,0.2842043586855618
36759,3254.608733,3254.6393,1,97638261,97639179,918,0.20098870380820516
36760,3254.647133,3254.653067,1,97639413,97639592,179,-0.012834549086081214
36761,3254.6596,3254.676033,1,97639788,97640280,492,0.3479805856023988
36762,3254.6796,3254.690267,1,97640388,97640708,320,0.2501622394140603
36763,3254.704267,3254.7184,1,97641128,97641552,424,0.06436266356093152
36764,3254.7698,3254.777467,1,97643094,97643324,230,0.02314838797501798
36765,3254.787733,3254.792233,1,97643631,97643766,135,0.10065889031111351
36766,3254.793867,3254.7996,1,97643816,97643988,172,0.4205866991247607
36767,3254.807233,3254.8244,1,97644216,97644732,516,0.02559906823128012
36768,3254.826167,3254.835533,1,97644785,97645065,280,0.13754154805357852
36769,3254.837333,3254.883767,1,97645119,97646513,1394,0.21567200680687473
36770,3254.892433,3254.9149,1,97646772,97647447,675,0.04068699290837592
36771,3254.920233,3254.9324,1,97647606,97647972,366,0.17374755519715177
36772,3254.9376,3254.9433,1,97648128,97648299,171,0.04843723729973654
36773,3254.945533,3254.953333,1,97648365,97648599,234,0.07743303500463194
36774,3254.956767,3255.075133,1,97648703,97652253,3550,0.03563554453236627
36775,3257.693333,3257.726833,1,97730799,97731804,1005,0.32064865248824087
36776,3257.7397,3257.745967,1,97732191,97732379,188,0.03161454255046229
36777,3257.772267,3257.778,1,97733168,97733340,172,0.1711113047320363
36778,3257.783067,3257.822233,1,97733492,97734666,1174,0.1305494164464497
36779,3258.6984,3258.7244,1,97760952,97761732,780,0.28412424286077376
36780,3258.770333,3258.7785,1,97763109,97763355,246,-0.06522938168891233
36781,3258.7806,3258.790833,1,97763418,97763724,306,-0.03630224037107757
36782,3258.791867,3258.795,1,97763756,97763850,94,
36783,3258.8091,3258.812733,1,97764273,97764381,108,0.0677196293807508
36784,3258.869133,3258.8828,1,97766073,97766484,411,0.05857002617853284
36785,3258.895667,3258.903667,1,97766870,97767110,240,0.4950915846097571
36786,3258.911367,3258.9163,1,97767341,97767489,148,0.5926557042059868
36787,3258.918233,3258.921733,1,97767546,97767651,105,0.13515103212395516
36788,3258.9284,3258.934433,1,97767852,97768032,180,0.01037744801659228
36789,3258.939833,3259.125367,1,97768194,97773761,5567,0.6736109936935758
36790,3259.164933,3259.178733,1,97774947,97775361,414,0.2526068273126463
36791,3259.179867,3259.192667,1,97775396,97775780,384,0.30050793006605664
36792,3259.1993,3259.2098,1,97775979,97776294,315,0.16248256154773075
36793,3259.215933,3259.307,1,97776477,97779210,2733,0.25427084493497865
36794,3259.320667,3259.332367,1,97779620,97779971,351,0.0954564251524376
36795,3259.334633,3259.347433,1,97780038,97780422,384,0.11567028354317745
36796,3259.3487,3259.381167,1,97780461,97781435,974,0.06073597347813196
36797,3259.389367,3259.4028,1,97781681,97782084,403,0.06711611261072115
36798,3259.4138,3259.4736,1,97782414,97784208,1794,0.08130430276673557
36799,3259.4791,3259.5278,1,97784373,97785834,1461,0.03819023062825886
36800,3259.530467,3259.5336,1,97785914,97786008,94,0.6268207400850186
36801,3259.5415,3259.5513,1,97786245,97786539,294,-0.0927848417751266
36802,3259.555767,3259.560667,1,97786673,97786820,147,0.47245823228277634
36803,3259.599233,3259.604167,1,97787976,97788125,149,-0.13021271441785623
36804,3259.607967,3259.6133,1,97788239,97788399,160,-0.3043745298283596
36805,3259.636733,3259.6407,1,97789101,97789221,120,0.4420645214076133
36806,3259.724933,3259.7342,1,97791747,97792026,279,0.24967387416825426
36807,3260.175633,3260.202167,1,97805268,97806065,797,0.11482857502708875
36808,3260.203267,3260.2132,1,97806098,97806396,298,0.4153430611687882
36809,3260.262733,3260.268533,1,97807881,97808055,174,-0.16578199501305146
36810,3260.3029,3260.356,1,97809087,97810680,1593,0.5955083941606427
36811,3260.363333,3260.3674,1,97810899,97811022,123,0.1896536940629955
36812,3260.379733,3260.409833,1,97811391,97812294,903,0.14678712765568314
36813,3260.432,3260.450567,1,97812960,97813517,557,0.20443036697281497
36814,3260.4522,3260.473733,1,97813566,97814211,645,0.10646069889740115
36815,3260.4878,3260.503067,1,97814634,97815092,458,0.21810242466325633
36816,3260.526033,3260.5369,1,97815780,97816107,327,0.2248948612168683
36817,3260.6262,3260.630167,1,97818786,97818905,119,
36818,3260.631167,3260.649033,1,97818935,97819470,535,0.014833241080024182
36819,3260.6628,3260.6679,1,97819884,97820037,153,0.21704157289677736
36820,3260.670433,3260.679467,1,97820112,97820384,272,0.22964671841747825
36821,3260.682533,3260.731267,1,97820475,97821938,1463,0.223675275116273
36822,3260.737533,3260.7826,1,97822125,97823478,1353,0.009780337796611416
36823,3260.788833,3260.803933,1,97823664,97824117,453,0.047118287872444146
36824,3260.813133,3260.842667,1,97824393,97825280,887,0.01385552789626004
36825,3260.8446,3260.883133,1,97825338,97826493,1155,0.003410412165535694
36826,3260.8892,3260.965433,1,97826676,97828962,2286,0.08621634096631434
36827,3263.136433,3263.141867,1,97894092,97894256,164,0.6988973315196072
36828,3263.155167,3263.175733,1,97894655,97895271,616,0.1062992138083784
36829,3263.210167,3263.2152,1,97896305,97896456,151,
36830,3263.222167,3263.225833,1,97896665,97896774,109,-0.23085793044360686
36831,3263.2285,3263.237467,1,97896855,97897124,269,0.15433323452688258
36832,3263.322867,3263.355633,1,97899686,97900668,982,0.2417815256036106
36833,3263.365867,3263.386467,1,97900976,97901594,618,-0.07461775084925726
36834,3263.3927,3263.411867,1,97901781,97902356,575,0.19774147497180772
36835,3263.416433,3263.4235,1,97902492,97902705,213,0.07311682227112701
36836,3263.435967,3263.4453,1,97903079,97903359,280,0.15854087946760742
36837,3263.451333,3263.465867,1,97903539,97903976,437,0.3148245840457811
36838,3263.862567,3263.866433,1,97915877,97915992,115,-0.006300281781048832
36839,3263.8786,3263.892967,1,97916358,97916789,431,-0.015939594295967415
36840,3263.951867,3263.962833,1,97918556,97918884,328,-0.09861619974232237
36841,3263.970533,3263.985633,1,97919115,97919568,453,3.091133985743813e-05
36842,3263.987133,3264.035533,1,97919613,97921065,1452,0.08340967975178708
36843,3264.041067,3264.0497,1,97921232,97921491,259,0.013046641811878654
36844,3264.0541,3264.061267,1,97921623,97921838,215,0.43539550503575414
36845,3264.0699,3264.120467,1,97922097,97923614,1517,0.035994130428306674
36846,3264.124833,3264.143833,1,97923744,97924314,570,0.23938992150316157
36847,3264.149433,3264.232167,1,97924482,97926965,2483,0.2161458824875451
36848,3264.236233,3264.2499,1,97927086,97927497,411,0.45213945086690815
36849,3267.2619,3267.271667,1,98017857,98018150,293,-0.1516297088210504
36850,3267.2729,3267.2895,1,98018187,98018685,498,0.08777791722202682
36851,3267.335833,3267.359367,1,98020074,98020781,707,0.4643336479294484
36852,3267.4388,3267.4486,1,98023164,98023458,294,-0.10632732634551555
36853,3267.460833,3267.467967,1,98023824,98024039,215,-0.04266969179826641
36854,3267.4765,3267.4912,1,98024295,98024736,441,0.03294272402638819
36855,3267.4982,3267.5314,1,98024946,98025942,996,0.20744445935849523
36856,3267.533367,3267.5397,1,98026001,98026191,190,-0.07257121072548373
36857,3267.547667,3267.556133,1,98026430,98026683,253,0.3683556439145992
36858,3267.560267,3267.583633,1,98026808,98027508,700,0.019424161454534652
36859,3267.589733,3267.5985,1,98027691,98027955,264,0.4920367866778503
36860,3267.600433,3267.609,1,98028012,98028270,258,0.546803827006598
36861,3267.610133,3267.6149,1,98028303,98028447,144,0.34793027379794556
36862,3267.641,3267.650833,1,98029230,98029524,294,0.2771094856415154
36863,3267.658633,3267.664833,1,98029758,98029944,186,0.19878649369664966
36864,3267.787267,3267.798867,1,98033618,98033966,348,0.5359425104466252
36865,3267.8414,3267.850933,1,98035242,98035527,285,-0.36121770892320204
36866,3267.945767,3267.952467,1,98038373,98038574,201,0.047581747492664854
36867,3268.0094,3268.0137,1,98040282,98040411,129,-0.11328004381432336
36868,3268.014833,3268.023967,1,98040444,98040719,275,0.4223135757609393
36869,3269.465167,3269.476933,1,98083955,98084307,352,0.09022074474516047
36870,3269.5245,3269.533033,1,98085735,98085990,255,0.1533114419371087
36871,3269.606333,3269.625367,1,98088189,98088761,572,0.055603493813329886
36872,3269.635133,3269.646633,1,98089053,98089398,345,0.2531660231294433
36873,3269.665367,3269.6804,1,98089961,98090412,451,0.1381978240950717
36874,3271.064167,3271.0976,1,98131925,98132928,1003,0.08476242621123613
36875,3271.099033,3271.107333,1,98132970,98133219,249,0.041869278662614515
36876,3271.121667,3271.1258,1,98133650,98133774,124,0.7792339764899011
36877,3271.126833,3271.1367,1,98133804,98134101,297,0.1041121234878836
36878,3271.154133,3271.1574,1,98134623,98134722,99,-0.12807996204400918
36879,3271.171667,3271.207467,1,98135150,98136224,1074,0.309656580529536
36880,3271.211933,3271.237867,1,98136357,98137136,779,0.15523241355331283
36881,3271.241533,3271.331567,1,98137245,98139947,2702,0.5607244764446039
36882,3271.3467,3271.370933,1,98140401,98141127,726,0.15994968825260517
36883,3272.4297,3272.436633,1,98172891,98173098,207,-0.006126120651098135
36884,3272.439033,3272.4708,1,98173170,98174124,954,0.2600584371270342
36885,3272.473567,3272.544367,1,98174207,98176331,2124,0.010560464303175582
36886,3272.549833,3272.565833,1,98176494,98176974,480,-0.019232144889347217
36887,3272.571967,3272.631167,1,98177159,98178935,1776,0.3697283476382917
36888,3272.632267,3272.637,1,98178968,98179110,142,0.14563106543641324
36889,3272.6424,3272.7181,1,98179272,98181543,2271,0.28213255064704384
36890,3273.284967,3273.307033,1,98198549,98199210,661,0.09716086405748711
36891,3273.395367,3273.409167,1,98201861,98202275,414,0.1319316174444114
36892,3273.4128,3273.4287,1,98202384,98202861,477,0.038036311264122435
36893,3273.460033,3273.465567,1,98203800,98203967,167,0.04018402182088673
36894,3273.4859,3273.500833,1,98204577,98205024,447,0.08185934662458638
36895,3273.5192,3273.5521,1,98205576,98206563,987,0.056387178081632794
36896,3274.831933,3274.836,1,98244957,98245080,123,
36897,3274.840667,3274.855833,1,98245220,98245674,454,0.2308798370717784
36898,3274.857033,3274.861633,1,98245710,98245848,138,0.05269600260578985
36899,3274.866667,3274.8739,1,98246000,98246217,217,0.23092595480804068
36900,3274.894767,3274.910733,1,98246843,98247321,478,0.3489183007151029
36901,3275.015267,3275.031867,1,98250458,98250956,498,0.07109054699750335
36902,3275.036633,3275.062433,1,98251098,98251872,774,0.30623187551295666
36903,3275.064167,3275.0763,1,98251925,98252289,364,0.11196375803699447
36904,3275.077467,3275.080833,1,98252324,98252424,100,
36905,3275.082767,3275.088333,1,98252483,98252649,166,0.2919437451005405
36906,3275.127567,3275.254233,1,98253827,98257626,3799,0.47722674659944453
36907,3275.2667,3275.2739,1,98258001,98258217,216,0.32087817646697325
36908,3275.2776,3275.292867,1,98258328,98258786,458,0.13386686671012354
36909,3275.296433,3275.329033,1,98258892,98259870,978,0.12534015387573155
36910,3275.335133,3275.340533,1,98260053,98260215,162,
36911,3277.432133,3277.472367,1,98322963,98324171,1208,0.2723880456256586
36912,3277.5357,3277.541367,1,98326071,98326241,170,0.10266649577660415
36913,3277.5493,3277.5596,1,98326479,98326788,309,0.07792561238864308
36914,3277.562033,3277.570533,1,98326860,98327115,255,-0.027409376497776514
36915,3277.640967,3277.650667,1,98329229,98329520,291,0.08642147872173196
36916,3277.6819,3277.691233,1,98330457,98330736,279,0.032780828459200065
36917,3277.692833,3277.708067,1,98330784,98331242,458,0.11238009516134617
36918,3277.794167,3277.809033,1,98333825,98334270,445,0.004688086287993301
36919,3277.823867,3277.8296,1,98334716,98334888,172,0.07567603154347294
36920,3277.8759,3277.889,1,98336277,98336670,393,0.11866326448711004
36921,3277.9091,3277.923267,1,98337273,98337698,425,0.29954112151159384
36922,3282.468267,3282.474633,1,98474048,98474238,190,-0.031138475257144468
36923,3282.484767,3282.493167,1,98474543,98474795,252,0.2820433052690724
36924,3282.501633,3282.515767,1,98475048,98475473,425,0.12931471224256127
36925,3282.5572,3282.5659,1,98476716,98476977,261,-0.05559558758298199
36926,3282.598333,3282.605833,1,98477949,98478174,225,0.6056006757395512
36927,3282.664,3282.670267,1,98479920,98480108,188,0.036617458509730236
36928,3282.6764,3282.6946,1,98480292,98480838,546,0.16973122906468183
36929,3282.7127,3282.729467,1,98481381,98481884,503,0.10242751251927251
36930,3282.7318,3282.817633,1,98481954,98484528,2574,0.10149244795959805
36931,3282.824167,3282.833367,1,98484725,98485001,276,0.06597587716008046
36932,3282.8391,3282.875467,1,98485173,98486264,1091,0.004438485715868858
36933,3282.876467,3282.901333,1,98486294,98487039,745,-0.020905925198155994
36934,3282.906933,3282.928567,1,98487207,98487857,650,0.04537447174943994
36935,3282.9306,3282.9588,1,98487918,98488764,846,0.029136482455518833
36936,3282.960833,3282.971233,1,98488824,98489136,312,-0.041338924333788496
36937,3282.979933,3282.993467,1,98489397,98489804,407,0.0699402959392105
36938,3283.035833,3283.1395,1,98491074,98494185,3111,0.541273273395791
36939,3283.148433,3283.153433,1,98494452,98494602,150,
36940,3283.159267,3283.182633,1,98494778,98495478,700,0.1598182117175913
36941,3283.189633,3283.193733,1,98495688,98495811,123,-0.01593295230779191
36942,3283.220767,3283.225333,1,98496623,98496759,136,0.001911978108930068
36943,3283.2265,3283.234833,1,98496795,98497044,249,0.03504762868981951
36944,3283.2642,3283.280367,1,98497926,98498411,485,0.09958501248176743
36945,3283.282033,3283.285033,1,98498460,98498550,90,
36946,3283.287633,3283.2913,1,98498628,98498739,111,
36947,3283.6144,3283.6186,1,98508432,98508558,126,0.297585699752648
36948,3284.220867,3284.251167,1,98526626,98527535,909,0.14669785195244514
36949,3284.253667,3284.340467,1,98527610,98530214,2604,0.6551130906292674
36950,3284.3447,3284.4206,1,98530341,98532618,2277,0.012324328130240956
36951,3284.424633,3284.439767,1,98532738,98533193,455,0.1706202475489676
36952,3284.442533,3284.451233,1,98533275,98533536,261,-0.024202736727268633
36953,3284.4531,3284.466167,1,98533593,98533985,392,0.04797275858586838
36954,3284.467167,3284.523333,1,98534015,98535699,1684,0.17174007243762243
36955,3284.538167,3284.541767,1,98536145,98536253,108,
36956,3284.546967,3284.5609,1,98536409,98536827,418,0.16473831121980606
36957,3284.5634,3284.567667,1,98536902,98537030,128,0.4384273887798251
36958,3284.5884,3284.5992,1,98537652,98537976,324,0.10689230217101647
36959,3284.609333,3284.618967,1,98538279,98538569,290,0.14365562554653302
36960,3284.62,3284.625467,1,98538600,98538764,164,-0.2707010483998043
36961,3285.116733,3285.1233,1,98553501,98553699,198,-0.04108516824495595
36962,3285.1305,3285.2212,1,98553915,98556636,2721,0.07155798404668985
36963,3285.226933,3285.2356,1,98556807,98557068,261,0.00011021934772408941
36964,3285.238067,3285.2735,1,98557142,98558205,1063,0.1955338150021751
36965,3285.275733,3285.297,1,98558271,98558910,639,0.3044069010264186
36966,3285.298933,3285.357767,1,98558967,98560733,1766,0.0789032635416624
36967,3285.3604,3285.3824,1,98560812,98561472,660,-0.03625981538052942
36968,3285.4196,3285.423333,1,98562588,98562699,111,0.49877983384352625
36969,3285.429067,3285.446267,1,98562872,98563388,516,0.14442904855126285
36970,3285.459967,3285.474567,1,98563799,98564237,438,0.19275289534234774
36971,3285.4769,3285.4846,1,98564307,98564538,231,0.5600854740207426
36972,3285.486533,3285.522333,1,98564595,98565669,1074,0.2090381892112297
36973,3285.530233,3285.5386,1,98565906,98566158,252,-0.07960105705493115
36974,3285.7346,3285.738133,1,98572038,98572143,105,0.26890828876695816
36975,3285.8157,3285.818833,1,98574471,98574564,93,0.7490029015532076
36976,3285.842,3285.847267,1,98575260,98575418,158,0.340831727174189
36977,3285.8622,3285.8741,1,98575866,98576223,357,0.08342265406393991
36978,3285.903133,3285.906833,1,98577093,98577204,111,0.15221318964280373
36979,3289.076833,3289.097067,1,98672304,98672912,608,0.15733321039614181
36980,3289.1331,3289.147233,1,98673993,98674416,423,0.20063290094645594
36981,3289.176733,3289.183267,1,98675301,98675498,197,-0.027322193848291317
36982,3289.293733,3289.332667,1,98678811,98679980,1169,0.07482158799897569
36983,3289.3343,3289.341,1,98680029,98680230,201,-0.3155331320232389
36984,3289.342,3289.347433,1,98680260,98680422,162,-0.06863432237344759
36985,3289.353733,3289.359533,1,98680611,98680785,174,-0.11557245109972027
36986,3289.372267,3289.446067,1,98681168,98683382,2214,0.6205474978366291
36987,3289.448433,3289.457367,1,98683452,98683721,269,-0.0037898755681648644
36988,3289.474533,3289.481067,1,98684235,98684432,197,0.13663158394168656
36989,3289.483367,3289.522367,1,98684501,98685671,1170,0.25380323529820153
36990,3289.557133,3289.564267,1,98686713,98686928,215,0.09274493663102597
36991,3289.5684,3289.5735,1,98687052,98687205,153,0.6449876669751285
36992,3289.593933,3289.5997,1,98687817,98687991,174,0.16672100828009545
36993,3290.9675,3290.997233,1,98729025,98729916,891,0.13647312906532247
36994,3290.999033,3291.059467,1,98729970,98731784,1814,0.23891479526061446
36995,3291.081533,3291.0855,1,98732445,98732565,120,-0.08281841383085449
36996,3291.0969,3291.206667,1,98732907,98736200,3293,0.20248577975063656
36997,3291.208233,3291.2128,1,98736246,98736384,138,0.24399428569216552
36998,3291.223367,3291.253567,1,98736701,98737607,906,0.19344115134850415
36999,3292.1387,3292.164067,1,98764161,98764922,761,0.33214534637494864
37000,3292.1733,3292.176367,1,98765199,98765291,92,
37001,3292.1818,3292.1906,1,98765454,98765718,264,0.11888355714833178
37002,3292.220767,3292.253767,1,98766623,98767613,990,0.5303255970966635
37003,3292.317533,3292.3503,1,98769525,98770509,984,-0.03594939376001395
37004,3292.357833,3292.374533,1,98770734,98771235,501,0.09373125651100149
37005,3292.391533,3292.569233,1,98771745,98777076,5331,0.5307331778237002
37006,3295.503367,3295.518767,1,98865101,98865563,462,0.3848240357491184
37007,3295.556567,3295.561733,1,98866697,98866851,154,0.1992893068416775
37008,3295.569167,3295.582133,1,98867075,98867463,388,0.361609486762852
37009,3295.607467,3295.615467,1,98868224,98868464,240,-0.03464156207492838
37010,3295.655867,3295.6654,1,98869676,98869962,286,0.19284674510282263
37011,3295.6766,3295.680267,1,98870298,98870408,110,0.5122557830372478
37012,3295.683867,3295.687567,1,98870516,98870627,111,-0.15922367236209356
37013,3295.702033,3295.7107,1,98871060,98871321,261,-0.001984137506360734
37014,3295.719267,3295.726267,1,98871578,98871788,210,0.10720168444072098
37015,3295.732567,3295.7377,1,98871977,98872131,154,0.35363661569911903
37016,3295.740133,3295.7508,1,98872203,98872524,321,0.3146814461804019
37017,3295.7568,3295.785133,1,98872704,98873553,849,0.10301414598202319
37018,3295.786833,3295.794667,1,98873604,98873840,236,0.07642849103702537
37019,3297.889633,3297.917267,1,98936688,98937518,830,0.17793992354578803
37020,3297.945967,3297.954167,1,98938379,98938625,246,0.20080402466489228
37021,3297.9556,3297.966633,1,98938668,98938998,330,0.15247804405559648
37022,3298.002,3298.0055,1,98940060,98940165,105,-0.061633376311579294
37023,3298.145533,3298.156167,1,98944365,98944685,320,0.01803515930140681
37024,3298.158,3298.1656,1,98944740,98944968,228,-0.2025588229442656
37025,3298.183233,3298.187233,1,98945496,98945616,120,0.49018884958954667
37026,3298.188333,3298.1972,1,98945649,98945916,267,-0.2490437469630275
37027,3298.2068,3298.234633,1,98946204,98947038,834,0.11964700223870538
37028,3298.290667,3298.301133,1,98948720,98949033,313,0.07012064183741144
37029,3298.363633,3298.3826,1,98950908,98951478,570,0.09647173180914996
37030,3298.393967,3298.401633,1,98951819,98952048,229,0.3102657398748999
37031,3298.427167,3298.453067,1,98952815,98953592,777,0.2880750512289301
37032,3300.2694,3300.2837,1,99008082,99008511,429,0.19233636831180642
37033,3300.2928,3300.296167,1,99008784,99008885,101,0.5415020888763526
37034,3300.298233,3300.3015,1,99008946,99009045,99,-0.20007499804009485
37035,3300.327967,3300.3325,1,99009839,99009975,136,0.19403570201786868
37036,3300.810867,3300.8191,1,99024326,99024573,247,0.19081488806510705
37037,3300.8527,3300.856967,1,99025581,99025709,128,-0.18502292238753446
37038,3303.075733,3303.094767,1,99092271,99092843,572,0.11831610374985542
37039,3303.1026,3303.108467,1,99093078,99093254,176,0.44896534854016834
37040,3303.172933,3303.1833,1,99095187,99095499,312,0.12723566328804273
37041,3303.9463,3303.954567,1,99118389,99118637,248,-0.10739160502516004
37042,3303.963967,3303.971433,1,99118919,99119142,223,0.013410529711983903
37043,3303.997333,3304.011167,1,99119919,99120335,416,0.2862388270244017
37044,3304.085467,3304.099433,1,99122564,99122982,418,-0.03889676862954912
37045,3304.1019,3304.1086,1,99123057,99123258,201,-0.10713377252468932
37046,3304.115833,3304.120833,1,99123474,99123624,150,-0.10606128169034626
37047,3304.1222,3304.126433,1,99123666,99123792,126,-0.2532261058701819
37048,3304.128433,3304.1409,1,99123852,99124227,375,0.08445189352518606
37049,3304.151033,3304.154167,1,99124530,99124625,95,
37050,3304.2898,3304.292967,1,99128694,99128789,95,0.39993291850643886
37051,3305.122367,3305.143833,1,99153671,99154314,643,0.22560920542242655
37052,3305.159033,3305.1625,1,99154770,99154875,105,0.4721576961397308
37053,3305.1821,3305.1943,1,99155463,99155829,366,0.1673180091616323
37054,3305.2439,3305.248533,1,99157317,99157455,138,-0.027625064824591292
37055,3305.2589,3305.263567,1,99157767,99157907,140,0.15294104841893089
37056,3305.2676,3305.2722,1,99158028,99158166,138,-0.2877295377891134
37057,3305.280367,3305.2856,1,99158411,99158568,157,0.18116293656066157
37058,3305.2882,3305.293967,1,99158646,99158819,173,-0.16054117343462884
37059,3305.301833,3305.323133,1,99159054,99159693,639,-0.02241328508285927
37060,3305.4066,3305.414,1,99162198,99162420,222,0.025337672112325318
37061,3305.431067,3305.434933,1,99162932,99163047,115,0.1233310606262734
37062,3305.447833,3305.451567,1,99163434,99163547,113,0.6258030002259393
37063,3305.458433,3305.464667,1,99163752,99163940,188,0.2156224293269067
37064,3308.0432,3308.048933,1,99241296,99241467,171,0.6257605945582888
37065,3308.088733,3308.099833,1,99242661,99242994,333,0.0196670146685862
37066,3308.1896,3308.209633,1,99245688,99246288,600,-0.0591480857823251
37067,3308.2166,3308.224,1,99246498,99246720,222,-0.10004155337146117
37068,3308.2497,3308.2681,1,99247491,99248043,552,-0.029766184793631006
37069,3309.5019,3309.513667,1,99285057,99285410,353,0.17885152851894245
37070,3309.5165,3309.519533,1,99285495,99285585,90,
37071,3309.5518,3309.563967,1,99286554,99286919,365,0.23788954316637154
37072,3309.590733,3309.6032,1,99287721,99288096,375,-0.03485590892045904
37073,3311.473167,3311.4806,1,99344195,99344418,223,0.15059352620588484
37074,3311.484367,3311.490433,1,99344531,99344712,181,0.14769560888338187
37075,3311.497633,3311.503967,1,99344928,99345119,191,0.2624594954236844
37076,3311.580233,3311.5925,1,99347406,99347775,369,0.42624876380675913
37077,3311.675467,3311.684167,1,99350264,99350525,261,0.2096583963752075
37078,3311.689367,3311.696667,1,99350681,99350900,219,0.11648056115448653
37079,3311.710333,3311.714933,1,99351309,99351447,138,0.07643888214166712
37080,3311.719267,3311.733033,1,99351578,99351990,412,0.1728292937670012
37081,3311.734033,3311.742967,1,99352020,99352289,269,0.528271847388911
37082,3311.743967,3311.747233,1,99352319,99352416,97,
37083,3311.759933,3311.765833,1,99352797,99352974,177,-0.13380374464935338
37084,3312.609333,3312.621,1,99378279,99378630,351,0.236830745672175
37085,3312.622267,3312.637333,1,99378668,99379119,451,0.2569272781620929
37086,3312.639067,3312.6545,1,99379172,99379635,463,0.134712191651819
37087,3312.695733,3312.7012,1,99380871,99381036,165,0.36897429447025276
37088,3312.735733,3312.739467,1,99382071,99382184,113,
37089,3312.748267,3312.77,1,99382448,99383100,652,0.501411157965138
37090,3315.101633,3315.108633,1,99453048,99453258,210,0.41564948846230043
37091,3315.1595,3315.185767,1,99454785,99455573,788,0.45229760102698185
37092,3315.324533,3315.3477,1,99459735,99460431,696,0.2595072858393212
37093,3315.361267,3315.3709,1,99460838,99461127,289,0.2699632064884069
37094,3315.383933,3315.390367,1,99461517,99461711,194,0.006977368065560189
37095,3315.399333,3315.467667,1,99461979,99464030,2051,0.12678490578808982
37096,3315.472733,3315.504233,1,99464181,99465126,945,0.0760532677571056
37097,3315.5063,3315.515167,1,99465189,99465455,266,0.01982201556996335
37098,3315.520433,3315.5757,1,99465612,99467271,1659,-0.01574433489905695
37099,3315.579233,3315.593433,1,99467376,99467802,426,0.08921671852217912
37100,3315.6015,3315.6147,1,99468045,99468441,396,0.11331428061040653
37101,3315.616833,3315.670667,1,99468504,99470120,1616,0.0611184084704136
37102,3315.681733,3315.684767,1,99470451,99470543,92,-0.17014992979792024
37103,3315.688733,3315.691733,1,99470661,99470751,90,0.7753806812146727
37104,3316.032233,3316.042967,1,99480966,99481289,323,0.24618298639444666
37105,3316.8975,3316.907967,1,99506925,99507239,314,0.11823137878805223
37106,3316.9121,3316.927867,1,99507363,99507836,473,0.26663354675445833
37107,3316.931767,3317.012867,1,99507953,99510386,2433,0.17848249541464953
37108,3317.014167,3317.017733,1,99510425,99510531,106,0.3179106771568567
37109,3317.025733,3317.047567,1,99510771,99511427,656,-0.01611922927589633
37110,3317.054367,3317.0954,1,99511631,99512862,1231,0.07981833954420102
37111,3317.1035,3317.115333,1,99513105,99513459,354,0.05310562280518383
37112,3317.120533,3317.1343,1,99513615,99514029,414,0.08261301868462458
37113,3317.137433,3317.215633,1,99514122,99516468,2346,0.21161856999795986
37114,3317.222367,3317.227067,1,99516671,99516812,141,-0.11961915329871657
37115,3317.228067,3317.231867,1,99516842,99516956,114,0.5982911623471996
37116,3317.2336,3317.244967,1,99517008,99517349,341,0.31870785360842313
37117,3317.274967,3317.281067,1,99518249,99518432,183,0.18708224202582877
37118,3318.2032,3318.2214,1,99546096,99546642,546,0.07092415722866227
37119,3318.227,3318.2657,1,99546810,99547971,1161,0.14418831955953887
37120,3318.284267,3318.2971,1,99548528,99548913,385,0.06900369686868972
37121,3318.3782,3318.382,1,99551346,99551460,114,-0.026313790637078425
37122,3318.4111,3318.417233,1,99552333,99552516,183,0.46604559055064715
37123,3318.418233,3318.429633,1,99552546,99552888,342,0.0762222247431195
37124,3318.4307,3318.446367,1,99552921,99553391,470,0.23338099920299077
37125,3318.4583,3318.464267,1,99553749,99553928,179,0.19627701154947716
37126,3318.4661,3318.5426,1,99553983,99556278,2295,0.3731528678512502
37127,3318.553733,3318.5656,1,99556611,99556968,357,0.05435559613662707
37128,3318.5708,3318.617567,1,99557124,99558527,1403,0.03251751245070177
37129,3318.6253,3318.631933,1,99558759,99558957,198,-0.06236492756027001
37130,3318.689233,3318.711233,1,99560676,99561336,660,0.09467220197341508
37131,3318.7147,3318.7666,1,99561441,99562998,1557,0.11740251328020161
37132,3318.772667,3318.7804,1,99563180,99563412,232,0.02769778266313345
37133,3318.789767,3318.806,1,99563693,99564180,487,0.6232744972923587
37134,3319.509,3319.544467,1,99585270,99586334,1064,0.13191243441021983
37135,3319.565333,3319.580467,1,99586959,99587414,455,0.1446215452526937
37136,3319.585833,3319.598433,1,99587574,99587952,378,0.02452359753592105
37137,3319.601267,3319.623367,1,99588038,99588701,663,0.0064031984761396005
37138,3319.677433,3319.681533,1,99590322,99590445,123,0.14660802849911142
37139,3319.722267,3319.725333,1,99591668,99591759,91,
37140,3319.734067,3319.765767,1,99592022,99592973,951,0.2400215062707109
37141,3319.770233,3319.774533,1,99593106,99593235,129,0.18058867091169542
37142,3319.776167,3319.8706,1,99593285,99596118,2833,0.09132243846316264
37143,3319.8736,3319.8784,1,99596208,99596352,144,0.1205114830803976
37144,3319.8905,3319.9145,1,99596715,99597435,720,-0.02476959172240925
37145,3319.9156,3319.947267,1,99597468,99598418,950,0.10637191045474724
37146,3319.9551,3320.044467,1,99598653,99601334,2681,0.36164605358173363
37147,3320.056667,3320.061,1,99601700,99601830,130,0.5219507245108768
37148,3320.205633,3320.211733,1,99606168,99606351,183,-0.10542149068970486
37149,3320.638233,3320.6413,1,99619146,99619239,93,0.09370563885344349
37150,3320.647867,3320.6554,1,99619436,99619662,226,0.03869147210956977
37151,3320.6702,3320.6734,1,99620106,99620202,96,0.7354741877525666
37152,3320.811067,3320.832133,1,99624332,99624963,631,0.025464585815881412
37153,3320.858367,3320.892667,1,99625751,99626780,1029,0.3313127012920484
37154,3320.989867,3320.998767,1,99629696,99629963,267,0.6066165203780839
37155,3321.0003,3321.017967,1,99630009,99630539,530,0.14121548861877048
37156,3321.032867,3321.1057,1,99630986,99633171,2185,0.23662585840901904
37157,3321.107533,3321.111967,1,99633225,99633359,134,-0.05793903721029824
37158,3321.117433,3321.133833,1,99633522,99634014,492,0.0904643710154504
37159,3321.143333,3321.1947,1,99634299,99635841,1542,0.05366861706016601
37160,3321.206467,3321.274467,1,99636194,99638234,2040,0.259826112168038
37161,3321.277333,3321.2825,1,99638319,99638475,156,0.18383314303356302
37162,3321.295733,3321.302333,1,99638871,99639069,198,0.6985082733867147
37163,3321.315133,3321.321067,1,99639453,99639632,179,-0.11320262154755553
37164,3321.322067,3321.326067,1,99639662,99639782,120,-0.0011725629014705716
37165,3322.112167,3322.1182,1,99663365,99663546,181,0.5166413144032904
37166,3322.186867,3322.191333,1,99665606,99665739,133,0.16411346049293932
37167,3322.194833,3322.199933,1,99665844,99665997,153,0.48391487395611477
37168,3323.004133,3323.035133,1,99690123,99691053,930,0.2712698974326415
37169,3323.046433,3323.0516,1,99691392,99691548,156,0.0358200237909824
37170,3323.081867,3323.096467,1,99692456,99692894,438,0.028954865460758067
37171,3323.133233,3323.1369,1,99693996,99694107,111,-0.1265684155681404
37172,3323.185633,3323.2097,1,99695568,99696291,723,0.036053273014700155
37173,3323.218833,3323.229167,1,99696564,99696875,311,0.15250719376390656
37174,3323.2335,3323.272767,1,99697005,99698183,1178,0.23708964452228953
37175,3323.3134,3323.318167,1,99699402,99699545,143,0.443235167539649
37176,3323.327267,3323.357133,1,99699818,99700713,895,0.14314294226841964
37177,3323.359533,3323.428333,1,99700785,99702849,2064,0.31955348638380215
37178,3323.436233,3323.453867,1,99703086,99703616,530,-0.03303810304140805
37179,3323.461333,3323.470933,1,99703839,99704127,288,0.014139572301294645
37180,3323.478033,3323.485767,1,99704340,99704573,233,0.09076453290918216
37181,3323.488033,3323.528767,1,99704640,99705863,1223,0.08150672676976556
37182,3323.535533,3323.621367,1,99706065,99708641,2576,0.299250550779156
37183,3323.6305,3323.644733,1,99708915,99709341,426,0.03509591546154406
37184,3323.646067,3323.665333,1,99709382,99709959,577,0.05894037269829115
37185,3323.667267,3323.684533,1,99710018,99710535,517,-0.056975186750908124
37186,3323.689867,3323.700933,1,99710696,99711027,331,0.1902427754872135
37187,3324.292867,3324.298833,1,99728786,99728964,178,
37188,3324.501967,3324.5163,1,99735059,99735489,430,0.2719074956011246
37189,3324.5175,3324.536633,1,99735525,99736098,573,0.1860123646020721
37190,3324.5407,3324.616167,1,99736221,99738485,2264,0.4731124234527209
37191,3324.619467,3324.627667,1,99738584,99738830,246,0.13636329157248228
37192,3324.631567,3324.6429,1,99738947,99739287,340,0.018494969716833246
37193,3324.646633,3324.675733,1,99739398,99740271,873,0.14607959162647458
37194,3324.676833,3324.680967,1,99740304,99740429,125,0.15631290520645563
37195,3324.685067,3324.699333,1,99740552,99740979,427,-0.10092756341193813
37196,3324.702633,3324.715633,1,99741078,99741468,390,0.10622442216941076
37197,3324.718533,3324.750667,1,99741555,99742520,965,0.21722008899193873
37198,3324.763867,3324.8508,1,99742916,99745524,2608,0.10681501351967178
37199,3324.852633,3324.883167,1,99745578,99746495,917,0.1288006037494856
37200,3324.906933,3324.920233,1,99747207,99747606,399,0.17472687080015248
37201,3324.961767,3324.965867,1,99748853,99748976,123,0.24815821874419028
37202,3324.967867,3324.974367,1,99749036,99749231,195,-0.04289792200539517
37203,3324.989867,3324.994967,1,99749696,99749849,153,
37204,3325.0085,3325.0155,1,99750255,99750465,210,0.48341236531348647
37205,3325.018667,3325.0286,1,99750560,99750858,298,0.2430943020821891
37206,3325.0501,3325.0587,1,99751503,99751761,258,-0.1115738964556
37207,3326.926233,3326.939,1,99807786,99808170,384,0.30866081223733915
37208,3326.9409,3326.966433,1,99808227,99808992,765,0.09923411410787518
37209,3326.972367,3327.034167,1,99809171,99811025,1854,0.17795457870154097
37210,3327.035633,3327.062467,1,99811068,99811874,806,-0.05992260865331039
37211,3327.073067,3327.133033,1,99812192,99813990,1798,0.038069160074606014
37212,3327.145167,3327.216267,1,99814355,99816488,2133,0.2871396257951186
37213,3327.2216,3327.233967,1,99816648,99817019,371,-0.06891399767409014
37214,3327.239567,3327.274067,1,99817187,99818222,1035,0.21176090027578232
37215,3327.276433,3327.285333,1,99818292,99818559,267,0.4216233762651314
37216,3327.292933,3327.299633,1,99818787,99818988,201,0.5032965665451472
37217,3327.307433,3327.314567,1,99819222,99819437,215,-0.10772955051604369
37218,3327.325467,3327.339567,1,99819764,99820187,423,0.48519168788844785
37219,3327.340933,3327.3477,1,99820227,99820431,204,0.3074660519807953
37220,3327.4015,3327.405533,1,99822045,99822165,120,0.10745747809786703
37221,3327.410533,3327.436633,1,99822315,99823098,783,0.14411954268186156
37222,3327.4476,3327.4551,1,99823428,99823653,225,0.38461775022545047
37223,3327.462133,3327.466,1,99823863,99823980,117,0.25570602410119775
37224,3327.522733,3327.5277,1,99825681,99825831,150,0.0743384638990431
37225,3327.585333,3327.5916,1,99827559,99827748,189,-0.15903153179822993
37226,3327.592933,3327.5961,1,99827787,99827883,96,0.39942520016407257
37227,3327.599133,3327.603133,1,99827973,99828093,120,-0.055114634987357074
37228,3327.607,3327.6153,1,99828210,99828459,249,0.375909534759409
37229,3327.618,3327.6254,1,99828540,99828762,222,
37230,3327.654333,3327.659067,1,99829629,99829772,143,0.49602532953723044
37231,3327.664433,3327.6859,1,99829932,99830577,645,0.20636671589490677
37232,3327.691067,3327.7009,1,99830732,99831027,295,0.3017048747377624
37233,3327.710433,3327.718767,1,99831312,99831563,251,-0.1455058978391689
37234,3327.731433,3327.7469,1,99831942,99832407,465,0.1116265967450344
37235,3327.7511,3327.758767,1,99832533,99832763,230,-0.23840326537066983
37236,3327.765633,3327.8437,1,99832968,99835311,2343,0.156104406981729
37237,3327.851833,3327.856,1,99835554,99835680,126,-0.1012722747140148
37238,3327.9085,3327.916733,1,99837255,99837501,246,0.05573423545638786
37239,3327.917767,3327.925733,1,99837533,99837771,238,0.3949983218872618
37240,3327.959367,3327.9761,1,99838781,99839283,502,-0.057801027701054754
37241,3327.9771,3327.982067,1,99839313,99839462,149,0.12708121648344525
37242,3328.737067,3328.75,1,99862112,99862500,388,0.363516294468186
37243,3328.7582,3328.777867,1,99862746,99863336,590,0.15983861281340778
37244,3328.786767,3328.791433,1,99863603,99863742,139,-0.06026239191509316
37245,3328.796933,3328.8432,1,99863907,99865296,1389,0.12095526363166821
37246,3328.846567,3328.8568,1,99865397,99865704,307,0.011318763684318668
37247,3328.863367,3328.875767,1,99865901,99866273,372,0.02749320498388755
37248,3328.881267,3328.935133,1,99866438,99868053,1615,0.08625890409809993
37249,3328.942267,3328.951033,1,99868268,99868530,262,0.3384749220365185
37250,3328.955033,3328.9655,1,99868650,99868965,315,0.1530213844279875
37251,3328.968267,3328.999867,1,99869048,99869996,948,0.1822574712203685
37252,3329.006833,3329.096133,1,99870204,99872883,2679,0.2381991607988663
37253,3329.0973,3329.1103,1,99872919,99873309,390,0.6734751787830259
37254,3329.120967,3329.1262,1,99873629,99873786,157,0.165447669603236
37255,3329.140467,3329.156,1,99874214,99874680,466,0.057777966444880514
37256,3329.611033,3329.617333,1,99888330,99888519,189,0.37882990829377794
37257,3329.6186,3329.635067,1,99888558,99889052,494,0.17950326292877997
37258,3329.650033,3329.656333,1,99889500,99889689,189,0.19127290366065888
37259,3329.681233,3329.6858,1,99890436,99890574,138,0.09704477721101079
37260,3329.6872,3329.700933,1,99890616,99891027,411,0.28196300110508815
37261,3329.723,3329.729433,1,99891690,99891882,192,-0.019863083202572032
37262,3329.746567,3329.7501,1,99892397,99892503,106,0.3966832556360553
37263,3329.765567,3329.7687,1,99892967,99893061,94,
37264,3329.786933,3329.7924,1,99893607,99893772,165,
37265,3329.897667,3329.926833,1,99896930,99897804,874,0.18365540543619185
37266,3329.935767,3330.004367,1,99898073,99900131,2058,0.1571372502007288
37267,3330.009933,3330.0434,1,99900297,99901302,1005,-0.00010583535905499764
37268,3330.052267,3330.076467,1,99901568,99902294,726,0.1027786636197696
37269,3330.077867,3330.115,1,99902336,99903450,1114,0.08967760759654832
37270,3330.131833,3330.152333,1,99903954,99904569,615,0.31932420999671474
37271,3330.153333,3330.217367,1,99904599,99906521,1922,0.12817795486926126
37272,3330.235867,3330.239067,1,99907076,99907172,96,
37273,3331.198,3331.211867,1,99935940,99936356,416,0.3994967289531883
37274,3331.235733,3331.2439,1,99937071,99937317,246,0.047452912554229815
37275,3331.5076,3331.515267,1,99945228,99945458,230,0.011344567450326045
37276,3331.516433,3331.5344,1,99945492,99946032,540,0.14572936790261543
37277,3331.540167,3331.5441,1,99946205,99946323,118,0.14766947098465577
37278,3331.5622,3331.594767,1,99946866,99947843,977,0.3307636634981864
37279,3331.634167,3331.639133,1,99949025,99949173,148,-0.09817182031105114
37280,3331.712,3331.729133,1,99951360,99951873,513,0.1949956832751296
37281,3331.732633,3331.738133,1,99951978,99952143,165,0.07975563762625348
37282,3331.7575,3331.771567,1,99952725,99953147,422,0.1694872372028144
37283,3331.776133,3331.7867,1,99953283,99953601,318,0.048886971112483524
37284,3331.789067,3331.793033,1,99953672,99953790,118,0.06225032918852153
37285,3331.8036,3331.819033,1,99954108,99954570,462,0.1990995067376204
37286,3331.832867,3331.844967,1,99954986,99955349,363,0.056174261332279686
37287,3331.850667,3331.856633,1,99955520,99955698,178,0.12816323382989123
37288,3331.857733,3331.902567,1,99955731,99957077,1346,0.19979865117247847
37289,3331.9667,3331.991533,1,99959001,99959745,744,0.11789164923371223
37290,3331.996667,3332.000533,1,99959900,99960015,115,
37291,3332.032967,3332.0492,1,99960989,99961476,487,0.16971515206338625
37292,3332.050467,3332.062967,1,99961514,99961889,375,0.09826895278642628
37293,3332.068733,3332.080967,1,99962061,99962429,368,0.02228831320199961
37294,3332.105967,3332.113067,1,99963179,99963392,213,0.33055287147531565
37295,3332.120367,3332.127933,1,99963611,99963837,226,0.16539035806502553
37296,3332.130667,3332.1403,1,99963920,99964209,289,0.32493119654859753
37297,3332.170933,3332.238033,1,99965127,99967140,2013,0.1583595207909523
37298,3332.2487,3332.269067,1,99967461,99968072,611,-0.0503023837789028
37299,3332.276133,3332.304467,1,99968283,99969134,851,0.028706806919690738
37300,3332.3061,3332.424233,1,99969183,99972726,3543,0.5926205222371427
37301,3332.425233,3332.500367,1,99972756,99975011,2255,0.29312229103079424
37302,3332.5025,3332.5063,1,99975075,99975189,114,0.7515359573959244
37303,3332.5281,3332.5334,1,99975843,99976002,159,0.03813345737796971
37304,3333.395067,3333.3995,1,100001852,100001985,133,0.446331817777574
37305,3333.453733,3333.458633,1,100003611,100003758,147,0.2122508399634166
37306,3333.460067,3333.479567,1,100003802,100004387,585,0.11549691294965611
37307,3333.482567,3333.487,1,100004477,100004610,133,-0.06518087202703261
37308,3333.4892,3333.555167,1,100004676,100006655,1979,0.24440741683469622
37309,3333.557267,3333.562167,1,100006718,100006865,147,0.4164385180934798
37310,3333.57,3333.585033,1,100007100,100007550,450,-0.03377627725332646
37311,3333.594533,3333.643733,1,100007835,100009311,1476,0.03402022467994199
37312,3333.658,3333.6629,1,100009740,100009887,147,0.03635899539255795
37313,3333.663933,3333.685967,1,100009917,100010579,662,0.0007987932162913143
37314,3333.689667,3333.694833,1,100010690,100010844,154,0.18188611006507976
37315,3333.705633,3333.7931,1,100011168,100013793,2625,0.1573238768728719
37316,3333.7953,3333.7997,1,100013859,100013991,132,-0.33818957710822045
37317,3333.808,3333.8235,1,100014240,100014705,465,0.27475067739087927
37318,3333.824867,3333.847967,1,100014746,100015439,693,0.027760391638311538
37319,3333.853133,3333.865767,1,100015593,100015973,380,-0.013348633923849882
37320,3335.044733,3335.047967,1,100051341,100051439,98,
37321,3335.0927,3335.098267,1,100052781,100052948,167,-0.06390712855258603
37322,3335.4887,3335.497667,1,100064661,100064930,269,0.2584225932785947
37323,3335.499933,3335.515067,1,100064997,100065452,455,-0.12581172635474677
37324,3335.538233,3335.545767,1,100066146,100066373,227,0.18405807129323204
37325,3335.588333,3335.614167,1,100067649,100068425,776,0.14498956268507307
37326,3335.6791,3335.6894,1,100070373,100070682,309,-0.08422935268583362
37327,3335.693267,3335.702033,1,100070798,100071060,262,0.44853927633624197
37328,3335.706567,3335.712467,1,100071197,100071374,177,0.13149296315490677
37329,3335.723667,3335.7462,1,100071710,100072386,676,0.1612429853326353
37330,3335.802433,3335.812433,1,100074072,100074372,300,0.281446238996533
37331,3335.8183,3335.833367,1,100074549,100075001,452,0.08717960221828784
37332,3335.858367,3335.869867,1,100075751,100076096,345,0.10669204379234354
37333,3335.8803,3335.896633,1,100076409,100076898,489,-0.048415106898117996
37334,3335.901067,3335.9541,1,100077032,100078623,1591,0.10049278698127796
37335,3335.955533,3335.966167,1,100078665,100078985,320,-0.027209425043430498
37336,3335.969667,3335.9819,1,100079090,100079457,367,-0.0664836357109911
37337,3335.987733,3336.009833,1,100079631,100080294,663,0.11316081194729694
37338,3336.023533,3336.08,1,100080705,100082400,1695,0.11581139857509282
37339,3336.084767,3336.124833,1,100082543,100083744,1201,0.04536675471453106
37340,3336.127333,3336.146133,1,100083819,100084383,564,0.2805665060510744
37341,3336.1523,3336.163367,1,100084569,100084901,332,-0.14226548021012314
37342,3336.618233,3336.624167,1,100098546,100098725,179,0.005997142755733873
37343,3336.629167,3336.638333,1,100098875,100099149,274,0.43113338219164743
37344,3336.6426,3336.647767,1,100099278,100099433,155,0.07172548934158081
37345,3336.658667,3336.67,1,100099760,100100100,340,-0.03622853016079241
37346,3336.673033,3336.7068,1,100100190,100101204,1014,0.11389656619954933
37347,3336.794833,3336.7982,1,100103844,100103946,102,0.47590209724873256
37348,3336.7998,3336.807733,1,100103994,100104231,237,-0.04910614354059956
37349,3336.809733,3336.813567,1,100104291,100104407,116,-0.16288533556765267
37350,3337.438767,3337.445567,1,100123163,100123367,204,0.16853280742770316
37351,3337.6431,3337.654467,1,100129293,100129634,341,0.6542193240338176
37352,3337.691633,3337.6955,1,100130748,100130865,117,
37353,3338.716433,3338.719567,1,100161492,100161587,95,
37354,3338.7276,3338.738433,1,100161828,100162152,324,0.3459994126334021
37355,3338.7777,3338.7936,1,100163331,100163808,477,0.4457005275668802
37356,3338.852333,3338.8557,1,100165569,100165671,102,-0.09493936294334206
37357,3338.878733,3338.882033,1,100166361,100166460,99,0.004493979757994727
37358,3338.8962,3338.935667,1,100166886,100168070,1184,0.16786869052833875
37359,3338.9377,3338.944367,1,100168131,100168331,200,0.16562316174519418
37360,3338.947367,3339.011933,1,100168421,100170357,1936,0.21702954667565708
37361,3339.013267,3339.019967,1,100170398,100170599,201,-0.054599021641577185
37362,3339.059133,3339.0773,1,100171773,100172319,546,0.1711713620245416
37363,3339.081867,3339.105867,1,100172456,100173176,720,0.2585825592581341
37364,3339.1078,3339.116767,1,100173234,100173503,269,0.2389391273936718
37365,3339.1279,3339.132033,1,100173837,100173960,123,0.03582152718787158
37366,3339.147033,3339.153133,1,100174410,100174593,183,0.47618955066734014
37367,3339.1605,3339.1652,1,100174815,100174956,141,0.00394330939448332
37368,3339.176767,3339.1812,1,100175303,100175436,133,0.510986226849951
37369,3339.188933,3339.194967,1,100175667,100175849,182,0.6940693917567169
37370,3339.2014,3339.219167,1,100176042,100176575,533,-0.058585028704110954
37371,3339.220767,3339.233133,1,100176623,100176993,370,0.03961426852262957
37372,3339.2533,3339.256867,1,100177599,100177706,107,0.06695117348718779
37373,3339.2629,3339.268667,1,100177887,100178060,173,-0.06783919216910536
37374,3339.274033,3339.277733,1,100178220,100178331,111,
37375,3339.3373,3339.340333,1,100180119,100180209,90,
37376,3339.3671,3339.3767,1,100181013,100181301,288,0.19955757206839939
37377,3339.3946,3339.398567,1,100181838,100181957,119,
37378,3339.416533,3339.4418,1,100182495,100183254,759,0.06867296334194993
37379,3339.443233,3339.4488,1,100183296,100183464,168,0.01933666770419752
37380,3339.4619,3339.475733,1,100183857,100184271,414,0.4477531244106062
37381,3339.504167,3339.509,1,100185125,100185270,145,0.7877832603291585
37382,3339.510667,3339.518867,1,100185320,100185566,246,0.016230184529358756
37383,3339.522033,3339.531,1,100185660,100185930,270,-0.05506165793274724
37384,3339.532067,3339.5473,1,100185962,100186419,457,0.12917872055754073
37385,3339.5484,3339.592767,1,100186452,100187783,1331,0.13341101259859253
37386,3339.598867,3339.605533,1,100187966,100188165,199,0.21909516768144494
37387,3339.612533,3339.618533,1,100188375,100188555,180,0.7990230195648987
37388,3339.6226,3339.6301,1,100188678,100188903,225,0.6027926721057579
37389,3339.636167,3339.6471,1,100189085,100189413,328,0.693753811371417
37390,3339.650667,3339.661367,1,100189520,100189841,321,0.007191497671474469
37391,3339.6624,3339.679167,1,100189872,100190375,503,0.41262111871243795
37392,3339.681867,3339.690933,1,100190456,100190727,271,0.1360316049219436
37393,3339.692033,3339.6962,1,100190760,100190886,126,0.312714598537397
37394,3339.697533,3339.717733,1,100190925,100191531,606,0.3019542972472346
37395,3339.721633,3339.7301,1,100191648,100191903,255,0.023600512128445394
37396,3340.581867,3340.586567,1,100217456,100217597,141,0.2253764876510566
37397,3340.5919,3340.604433,1,100217757,100218132,375,-0.005218613131105166
37398,3340.6168,3340.677467,1,100218504,100220324,1820,0.1178979129527802
37399,3340.680967,3340.709267,1,100220429,100221278,849,0.4123975412577787
37400,3340.719133,3340.722767,1,100221573,100221683,110,
37401,3340.730267,3340.792333,1,100221908,100223769,1861,0.3560877943862178
37402,3340.794533,3340.879633,1,100223835,100226388,2553,0.1524060600549299
37403,3340.962167,3340.968333,1,100228865,100229049,184,0.11298809652467225
37404,3341.333167,3341.3414,1,100239995,100240242,247,0.18660029535882072
37405,3341.342867,3341.365733,1,100240286,100240971,685,0.07708743033103099
37406,3341.3715,3341.3875,1,100241145,100241625,480,0.03720543312977937
37407,3341.3935,3341.411,1,100241805,100242330,525,0.2752654151632719
37408,3341.422267,3341.4295,1,100242668,100242885,217,-0.005615487593962134
37409,3341.4571,3341.4709,1,100243713,100244127,414,0.19782613183828981
37410,3341.5025,3341.515433,1,100245075,100245462,387,0.21008030359017923
37411,3341.576633,3341.5863,1,100247298,100247589,291,-0.08342950110776517
37412,3341.587567,3341.598367,1,100247627,100247951,324,0.2579983553294103
37413,3341.638967,3341.647667,1,100249169,100249430,261,0.12389300938609615
37414,3341.675733,3341.679933,1,100250271,100250397,126,0.7811770971686677
37415,3341.751767,3341.7562,1,100252553,100252686,133,0.43753244672875474
37416,3341.7613,3341.780633,1,100252839,100253418,579,0.1559990096364581
37417,3341.783067,3341.869267,1,100253492,100256078,2586,0.19786036489597705
37418,3341.871567,3341.904033,1,100256147,100257120,973,0.053791892167788395
37419,3341.908867,3341.9138,1,100257266,100257414,148,0.10710597000870173
37420,3341.921933,3341.964067,1,100257657,100258922,1265,0.27469230363317776
37421,3341.966767,3342.0339,1,100259003,100261017,2014,0.21791921050907592
37422,3342.544367,3342.5485,1,100276331,100276455,124,-0.04427251166221928
37423,3342.5524,3342.571333,1,100276572,100277139,567,-0.01021549229891566
37424,3342.595233,3342.6012,1,100277856,100278036,180,0.5913947520745951
37425,3342.625133,3342.642733,1,100278753,100279281,528,0.15447332883809692
37426,3342.6891,3342.6935,1,100280673,100280805,132,-0.028200355343200905
37427,3342.7096,3342.713733,1,100281288,100281411,123,0.37461310882183546
37428,3342.995167,3342.998733,1,100289855,100289961,106,0.3394346083361635
37429,3343.010967,3343.0516,1,100290329,100291548,1219,0.09544678109435417
37430,3343.079167,3343.0843,1,100292375,100292529,154,0.178808871527816
37431,3343.095633,3343.1023,1,100292868,100293069,201,0.15202063590908424
37432,3343.1037,3343.1093,1,100293111,100293279,168,0.25466091106553723
37433,3343.1271,3343.1503,1,100293813,100294509,696,0.13583756604674377
37434,3343.1784,3343.202333,1,100295352,100296069,717,0.07664121588599061
37435,3343.2034,3343.2126,1,100296102,100296378,276,0.129850976955661
37436,3343.217267,3343.222633,1,100296518,100296678,160,-0.06823030987573599
37437,3343.264933,3343.2752,1,100297947,100298256,309,0.19580114390330292
37438,3343.2798,3343.2857,1,100298394,100298571,177,0.0076228377469687155
37439,3343.357933,3343.377767,1,100300737,100301333,596,0.34013916727123994
37440,3343.378833,3343.3853,1,100301364,100301559,195,-0.03710040325877686
37441,3343.437467,3343.463233,1,100303124,100303896,772,0.0505922017408359
37442,3343.496667,3343.514667,1,100304900,100305440,540,0.16922543781736474
37443,3343.515933,3343.530033,1,100305477,100305900,423,0.6116901253660258
37444,3343.533667,3343.550967,1,100306010,100306529,519,0.3690633103891981
37445,3343.5532,3343.5566,1,100306596,100306698,102,
37446,3343.581,3343.591867,1,100307430,100307756,326,0.2359272928944013
37447,3343.599967,3343.6232,1,100307999,100308696,697,0.3007469157189236
37448,3343.6305,3343.6447,1,100308915,100309341,426,0.028899483359709294
37449,3343.6457,3343.652967,1,100309371,100309589,218,-0.10565432312819746
37450,3343.6861,3343.689133,1,100310583,100310673,90,-0.19879226373341144
37451,3343.751467,3343.7545,1,100312544,100312635,91,-0.0001324560461629833
37452,3343.8694,3343.872467,1,100316082,100316174,92,
37453,3344.431867,3344.437267,1,100332956,100333118,162,0.41731531602358074
37454,3344.4548,3344.458333,1,100333644,100333749,105,
37455,3347.859433,3347.863567,1,100435782,100435907,125,0.6069878439691683
37456,3348.5507,3348.570333,1,100456521,100457109,588,0.15951862154058818
37457,3348.6048,3348.610133,1,100458144,100458303,159,
37458,3348.611367,3348.619133,1,100458341,100458573,232,0.4991633451354741
37459,3348.660933,3348.674,1,100459827,100460220,393,0.09187545309617481
37460,3348.696133,3348.7032,1,100460883,100461096,213,0.31826575808036545
37461,3350.350333,3350.3545,1,100510509,100510635,126,0.6688290803150689
37462,3351.210867,3351.215933,1,100536326,100536477,151,0.27540832915990554
37463,3352.088133,3352.094967,1,100562643,100562849,206,0.18271227391152736
37464,3352.095967,3352.114767,1,100562879,100563443,564,0.20953852782574958
37465,3352.121433,3352.22,1,100563642,100566600,2958,0.3307595505647393
37466,3352.232733,3352.254067,1,100566981,100567622,641,0.08515765080716951
37467,3352.255533,3352.345467,1,100567665,100570364,2699,0.20687686026870425
37468,3352.3507,3352.356333,1,100570521,100570689,168,
37469,3352.359467,3352.369333,1,100570784,100571079,295,-0.012078286064893548
37470,3352.372967,3352.3924,1,100571189,100571772,583,-0.11130208227918784
37471,3352.395067,3352.398967,1,100571852,100571969,117,-0.39761650478402005
37472,3352.929667,3352.934833,1,100587890,100588044,154,-0.08192511538835763
37473,3352.9402,3352.9444,1,100588206,100588332,126,0.2765153535601593
37474,3352.981733,3353.006633,1,100589451,100590198,747,0.27726379477126606
37475,3353.010367,3353.026067,1,100590311,100590782,471,0.4624028533641704
37476,3353.028467,3353.035067,1,100590854,100591052,198,0.20546416679001633
37477,3353.044767,3353.0492,1,100591343,100591476,133,0.01658479116278648
37478,3353.0733,3353.085633,1,100592199,100592568,369,0.04855148194080412
37479,3353.136933,3353.145067,1,100594107,100594352,245,0.007346445365746688
37480,3353.364,3353.3688,1,100600920,100601064,144,0.3794386847529725
37481,3354.3297,3354.345767,1,100629891,100630373,482,0.3098239544145172
37482,3354.346833,3354.359933,1,100630404,100630797,393,0.2645773403516008
37483,3354.428433,3354.449433,1,100632852,100633482,630,0.21454207291574556
37484,3354.519433,3354.527167,1,100635582,100635815,233,
37485,3354.5288,3354.538667,1,100635864,100636160,296,0.04371060733657376
37486,3354.540133,3354.562767,1,100636203,100636883,680,0.17696398262148327
37487,3354.564067,3354.593967,1,100636922,100637819,897,0.20458344739108147
37488,3354.604033,3354.6079,1,100638120,100638237,117,-0.06798816873805476
37489,3354.6157,3354.622633,1,100638471,100638678,207,-0.06312815988424662
37490,3354.627633,3354.647567,1,100638828,100639427,599,0.11290089004427524
37491,3354.657133,3354.6634,1,100639713,100639902,189,0.17212837672166603
37492,3354.673267,3354.6776,1,100640198,100640328,130,0.2669455803914351
37493,3354.687567,3354.701833,1,100640627,100641054,427,0.020608528011204347
37494,3354.703067,3354.725233,1,100641092,100641756,664,0.10863470614364973
37495,3354.738333,3354.742233,1,100642149,100642266,117,0.023377488234446707
37496,3354.831833,3354.835467,1,100644954,100645064,110,0.557784185870271
37497,3354.884867,3354.8921,1,100646546,100646763,217,0.3024066974975682
37498,3354.901767,3354.918267,1,100647053,100647548,495,0.18035782861821226
37499,3354.924133,3354.9873,1,100647723,100649619,1896,0.12727409649141042
37500,3354.9886,3354.991633,1,100649658,100649748,90,
37501,3354.993433,3355.015967,1,100649802,100650479,677,-0.07690604644065606
37502,3355.022633,3355.033033,1,100650678,100650990,312,0.1301569484276838
37503,3355.042933,3355.055467,1,100651287,100651664,377,-0.07023985458843063
37504,3355.060533,3355.072833,1,100651815,100652184,369,0.012394492373136657
37505,3355.078267,3355.0971,1,100652348,100652913,565,-0.046275178633227845
37506,3355.1056,3355.110867,1,100653168,100653326,158,0.037937524783497927
37507,3355.119067,3355.124967,1,100653572,100653749,177,0.14416254255837874
37508,3355.140233,3355.147833,1,100654206,100654434,228,0.2332520157187923
37509,3355.149067,3355.154733,1,100654472,100654641,169,0.17747523590496328
37510,3355.156567,3355.184767,1,100654697,100655543,846,0.0452612707921763
37511,3355.193833,3355.198133,1,100655814,100655943,129,-0.09954532294317955
37512,3355.205633,3355.216967,1,100656168,100656509,341,0.02222147230996122
37513,3355.222633,3355.240833,1,100656678,100657224,546,0.20316483807342903
37514,3355.2582,3355.354833,1,100657746,100660644,2898,0.18184773524932302
37515,3355.367133,3355.3796,1,100661013,100661388,375,0.10127181450550073
37516,3355.3997,3355.407333,1,100661991,100662219,228,-0.07807254273171384
37517,3355.4209,3355.439667,1,100662627,100663190,563,0.13737360594789513
37518,3355.471033,3355.4831,1,100664130,100664493,363,0.07811868619726318
37519,3355.497167,3355.509767,1,100664915,100665293,378,-0.012616229860543933
37520,3355.5272,3355.534633,1,100665816,100666038,222,-0.0304362490412921
37521,3355.544033,3355.547233,1,100666320,100666416,96,0.12496742086582013
37522,3355.554633,3355.580433,1,100666638,100667412,774,0.05673929589989534
37523,3355.680833,3355.709967,1,100670424,100671299,875,0.24024951644052675
37524,3355.721033,3355.782467,1,100671630,100673474,1844,0.22196868022260144
37525,3355.788067,3355.8139,1,100673642,100674417,775,-0.07261148656598801
37526,3355.823667,3355.834833,1,100674710,100675044,334,0.13015301689323563
37527,3355.837667,3355.883233,1,100675130,100676496,1366,-0.020139824033739366
37528,3355.891933,3355.96,1,100676757,100678800,2043,0.058423729410057794
37529,3355.9634,3355.967533,1,100678902,100679025,123,0.5899105421316877
37530,3356.468,3356.471333,1,100694040,100694139,99,-0.1989805686053201
37531,3356.4726,3356.4764,1,100694178,100694292,114,0.0576501272003406
37532,3356.477967,3356.482867,1,100694339,100694486,147,-0.11003386612057377
37533,3356.484067,3356.501833,1,100694522,100695054,532,0.02099062386127142
37534,3356.519533,3356.527467,1,100695585,100695824,239,0.12329495518195051
37535,3356.5308,3356.5388,1,100695924,100696164,240,-0.0056358972516368615
37536,3356.542433,3356.549933,1,100696272,100696497,225,0.07548705952501633
37537,3356.5546,3356.5598,1,100696638,100696794,156,0.14357926423014053
37538,3356.572367,3356.5773,1,100697171,100697319,148,0.34015260295871214
37539,3356.597733,3356.613733,1,100697931,100698411,480,0.10244942243858075
37540,3356.659933,3356.6726,1,100699797,100700178,381,0.23547366280665247
37541,3356.682033,3356.687433,1,100700460,100700622,162,0.4466871163942401
37542,3356.693667,3356.6972,1,100700810,100700916,106,
37543,3356.7238,3356.732433,1,100701714,100701972,258,0.3148092163260466
37544,3356.757,3356.7665,1,100702710,100702995,285,0.1523573779392905
37545,3356.768867,3356.787733,1,100703066,100703631,565,0.1894364345577849
37546,3357.117267,3357.120433,1,100713518,100713612,94,-0.07706373107320943
37547,3357.1347,3357.151667,1,100714041,100714550,509,0.22977587257234028
37548,3357.170767,3357.1738,1,100715123,100715214,91,
37549,3357.1861,3357.206067,1,100715583,100716182,599,0.27288348099962306
37550,3357.218367,3357.237333,1,100716551,100717119,568,0.31898841195878735
37551,3357.238333,3357.259467,1,100717149,100717784,635,0.10469235922184049
37552,3357.260767,3357.2657,1,100717823,100717971,148,0.04330811523714663
37553,3359.703767,3359.796267,1,100791113,100793888,2775,0.2585716972277606
37554,3359.7998,3359.809,1,100793994,100794270,276,0.013677665749306797
37555,3359.816633,3359.8291,1,100794498,100794873,375,0.07310871457593368
37556,3359.8311,3359.871,1,100794933,100796130,1197,-0.03469352134458719
37557,3359.876667,3359.890333,1,100796300,100796709,409,0.14496868654038658
37558,3359.8961,3359.9743,1,100796883,100799229,2346,0.2107884483396026
37559,3361.434633,3361.468167,1,100843038,100844045,1007,0.2855748528169971
37560,3361.469533,3361.5428,1,100844085,100846284,2199,0.3272263658920877
37561,3361.549933,3361.5722,1,100846497,100847166,669,-0.025221708378470334
37562,3361.578933,3361.621167,1,100847367,100848635,1268,0.055734851116501255
37563,3361.624533,3361.629967,1,100848735,100848899,164,0.013103907393123398
37564,3361.6405,3361.649767,1,100849215,100849493,278,-0.00045486489341341175
37565,3361.652167,3361.7056,1,100849565,100851168,1603,0.003785303751396354
37566,3361.707733,3361.7216,1,100851231,100851648,417,0.1174920267476801
37567,3361.7257,3361.7948,1,100851771,100853844,2073,0.15522410680268253
37568,3364.132667,3364.146067,1,100923980,100924382,402,0.18430953676670223
37569,3364.147367,3364.158567,1,100924421,100924757,336,0.4255683744532978
37570,3364.1608,3364.167,1,100924824,100925010,186,0.7564686365059533
37571,3364.168333,3364.1738,1,100925049,100925214,165,0.48698425781877247
37572,3364.1883,3364.238767,1,100925649,100927163,1514,0.1480610640100991
37573,3364.3458,3364.3705,1,100930374,100931115,741,0.044560313381078236
37574,3364.372633,3364.379733,1,100931178,100931391,213,0.1967482178522849
37575,3364.3888,3364.416933,1,100931664,100932507,843,0.11898879331454482
37576,3364.453633,3364.484267,1,100933608,100934528,920,0.30841076460481753
37577,3364.488733,3364.511867,1,100934661,100935356,695,0.15298785953739125
37578,3364.532033,3364.536233,1,100935960,100936086,126,0.023082638956486438
37579,3364.6047,3364.6273,1,100938141,100938819,678,0.3829115637543468
37580,3364.638,3364.6518,1,100939140,100939554,414,0.06856434739186386
37581,3364.653067,3364.7722,1,100939592,100943166,3574,0.5219841546253415
37582,3364.7751,3364.7887,1,100943253,100943661,408,-0.0003253560901902363
37583,3364.805533,3364.838833,1,100944165,100945164,999,0.11920664188695039
37584,3364.853167,3364.8582,1,100945595,100945746,151,0.12801590495086407
37585,3364.864833,3364.915367,1,100945944,100947461,1517,0.15227688758153607
37586,3364.944067,3364.963833,1,100948322,100948914,592,-0.030738381426059183
37587,3364.9727,3364.979033,1,100949181,100949370,189,0.3915755223197623
37588,3365.029367,3365.037233,1,100950881,100951116,235,0.1896208963629799
37589,3365.799667,3365.822,1,100973990,100974660,670,-0.017122490932869643
37590,3365.825233,3365.832833,1,100974756,100974984,228,0.3450779750744772
37591,3365.893533,3365.922167,1,100976805,100977665,860,0.5652778938863058
37592,3365.9403,3365.956033,1,100978209,100978680,471,0.23144023191566804
37593,3365.9578,3365.980267,1,100978734,100979408,674,0.08405922568338366
37594,3366.382933,3366.387633,1,100991487,100991628,141,0.22004996767356508
37595,3369.318867,3369.322567,1,101079566,101079677,111,0.2569246088434232
37596,3369.334733,3369.338467,1,101080041,101080154,113,0.5911440719041682
37597,3371.462633,3371.4825,1,101143878,101144475,597,0.32963589840050334
37598,3371.485767,3371.490233,1,101144573,101144706,133,0.5711837557021678
37599,3371.492033,3371.495067,1,101144760,101144852,92,0.47618118253780634
37600,3371.496233,3371.503467,1,101144886,101145104,218,0.5816306873521675
37601,3371.504633,3371.5083,1,101145138,101145249,111,0.3875027448348968
37602,3371.5118,3371.5231,1,101145354,101145693,339,0.579391890829766
37603,3371.5245,3371.5333,1,101145735,101145999,264,0.5936760494559287
37604,3371.54,3371.558333,1,101146200,101146749,549,0.520085856399456
37605,3371.583267,3371.5903,1,101147498,101147709,211,0.6335422535066039
37606,3371.622067,3371.636333,1,101148662,101149089,427,0.7363767597761139
37607,3371.6638,3371.699067,1,101149914,101150972,1058,0.712339991875808
37608,3371.724733,3371.7334,1,101151741,101152002,261,0.6363402144980226
37609,3371.7358,3371.7588,1,101152074,101152764,690,0.6381684081422929
37610,3371.771333,3371.819967,1,101153139,101154599,1460,0.6711675812570198
37611,3371.839033,3371.844133,1,101155170,101155323,153,0.7303093761387338
37612,3371.846033,3371.8581,1,101155380,101155743,363,0.74684054581479
37613,3371.874433,3371.8865,1,101156232,101156595,363,0.7099505286235419
37614,3371.8951,3371.917133,1,101156853,101157513,660,0.7791960552200905
37615,3371.998433,3372.010567,1,101159952,101160317,365,0.3184628904709874
37616,3372.016733,3372.023433,1,101160501,101160702,201,0.1380367023413479
37617,3372.0365,3372.040633,1,101161095,101161218,123,0.08324077054238495
37618,3372.043533,3372.059433,1,101161305,101161782,477,0.23394696125938252
37619,3372.0663,3372.077933,1,101161989,101162337,348,0.6308097028086385
37620,3372.130767,3372.144533,1,101163923,101164335,412,0.6265847182117809
37621,3372.241233,3372.245667,1,101167236,101167370,134,0.6783211373932556
37622,3372.2467,3372.250867,1,101167401,101167526,125,0.2873158481067443
37623,3372.554267,3372.7843,1,101176628,101183529,6901,0.7821155449198667
37624,3372.797733,3372.864633,1,101183931,101185938,2007,0.7354063004620032
37625,3372.867033,3372.885467,1,101186010,101186564,554,0.8136839518867071
37626,3372.8873,3372.9021,1,101186619,101187063,444,0.7765617629572672
37627,3374.7481,3374.7519,1,101242443,101242557,114,
37628,3374.757733,3374.7611,1,101242731,101242833,102,0.0459462850428472
37629,3374.7866,3374.791767,1,101243598,101243753,155,-0.18707984269843458
37630,3374.7928,3374.796767,1,101243784,101243903,119,0.09802698655054398
37631,3375.268767,3375.297267,1,101258063,101258918,855,0.20895363641012302
37632,3375.3712,3375.392767,1,101261136,101261783,647,0.3421549594829741
37633,3375.397567,3375.4006,1,101261927,101262018,91,0.2847988253450186
37634,3375.4702,3375.476,1,101264106,101264280,174,-0.085378980646287
37635,3375.484,3375.490433,1,101264520,101264712,192,-0.15424519772456352
37636,3375.505367,3375.512133,1,101265161,101265363,202,0.20677597688932683
37637,3378.349,3378.358067,1,101350470,101350742,272,0.6375436029822326
37638,3378.3805,3378.384,1,101351415,101351520,105,0.16345511496582577
37639,3378.410833,3378.427833,1,101352324,101352834,510,0.6142377853005556
37640,3378.478567,3378.493067,1,101354357,101354792,435,0.6234374140220892
37641,3378.497267,3378.5186,1,101354918,101355558,640,0.8598659342978706
37642,3378.546933,3378.5527,1,101356407,101356581,174,0.66771396860618
37643,3378.554267,3378.562567,1,101356628,101356877,249,0.6871974828203438
37644,3378.5891,3378.595867,1,101357673,101357876,203,0.7170479918152614
37645,3378.602267,3378.616333,1,101358068,101358489,421,0.5915627636573406
37646,3378.778067,3378.788567,1,101363342,101363657,315,0.7287688693443897
37647,3378.837767,3378.841233,1,101365133,101365236,103,0.7615820037329732
37648,3379.406767,3379.4192,1,101382203,101382576,373,0.09826042501991479
37649,3379.4203,3379.4288,1,101382609,101382864,255,0.2361818135001159
37650,3379.4474,3379.458133,1,101383422,101383743,321,0.042139425246112666
37651,3379.491333,3379.5071,1,101384739,101385213,474,-0.0380021436014142
37652,3379.517467,3379.5372,1,101385524,101386116,592,0.04018842619710973
37653,3379.659967,3379.6668,1,101389799,101390004,205,0.6819561330781834
37654,3379.678233,3379.6934,1,101390346,101390802,456,0.8059559207873181
37655,3380.669467,3380.725967,1,101420084,101421779,1695,0.07056742796578583
37656,3380.747767,3380.8485,1,101422433,101425455,3022,0.22186124172846658
37657,3380.869033,3380.875167,1,101426070,101426255,185,0.2367931422390662
37658,3380.882633,3380.887567,1,101426478,101426627,149,0.2133197393899048
37659,3380.893867,3380.930367,1,101426816,101427911,1095,0.4490482523344041
37660,3380.949333,3380.973167,1,101428479,101429195,716,-0.04960615025437673
37661,3380.981833,3381.0018,1,101429454,101430054,600,0.1891560774854366
37662,3381.077667,3381.085033,1,101432330,101432550,220,-0.0014420337622003466
37663,3382.2609,3382.264033,1,101467827,101467920,93,0.3945610606694626
37664,3382.2901,3382.295433,1,101468703,101468862,159,0.07854383363507081
37665,3382.3532,3382.368433,1,101470596,101471052,456,0.4112890296694888
37666,3385.468367,3385.480267,1,101564051,101564408,357,0.30695109139791443
37667,3385.547033,3385.562267,1,101566410,101566868,458,0.18230149635882104
37668,3385.6025,3385.607867,1,101568075,101568236,161,0.5552614356724984
37669,3385.685867,3385.6992,1,101570576,101570976,400,0.35690379191412336
37670,3385.712533,3385.723033,1,101571375,101571690,315,0.1535745840716509
37671,3385.724533,3385.7429,1,101571735,101572287,552,0.4125534992118019
37672,3385.786767,3385.791267,1,101573603,101573738,135,0.7452044664984374
37673,3386.397967,3386.4032,1,101591939,101592096,157,-0.19572407655211688
37674,3387.150833,3387.1768,1,101614524,101615304,780,0.33810934664535125
37675,3387.190467,3387.203,1,101615714,101616090,376,0.1178711098799781
37676,3387.2579,3387.276667,1,101617737,101618300,563,0.0508376233253363
37677,3387.2836,3387.290733,1,101618508,101618721,213,0.040924077926754995
37678,3387.2991,3387.304333,1,101618973,101619129,156,0.11413500459998571
37679,3387.342633,3387.347033,1,101620278,101620410,132,0.3740727541993601
37680,3387.4361,3387.448667,1,101623083,101623460,377,0.18288901710877478
37681,3387.4553,3387.476567,1,101623659,101624297,638,0.2864535494992493
37682,3387.482,3387.4888,1,101624460,101624664,204,-0.1637847594958589
37683,3387.494967,3387.565433,1,101624849,101626962,2113,0.3117944240203386
37684,3387.5668,3387.583167,1,101627004,101627495,491,0.08581667318549764
37685,3387.600767,3387.6921,1,101628023,101630763,2740,0.11302057381167233
37686,3387.699033,3387.702033,1,101630970,101631060,90,
37687,3387.707767,3387.7116,1,101631233,101631348,115,0.6185578740868142
37688,3387.715667,3387.733733,1,101631470,101632011,541,0.10300795173030976
37689,3388.645667,3388.657633,1,101659370,101659728,358,0.13732356609301383
37690,3388.673867,3388.682933,1,101660216,101660487,271,0.33473350529592205
37691,3389.114967,3389.138233,1,101673449,101674146,697,0.5814558598667049
37692,3389.1605,3389.2075,1,101674815,101676225,1410,0.6481562132714624
37693,3389.225633,3389.2615,1,101676768,101677845,1077,0.7092543750937003
37694,3389.275333,3389.280233,1,101678259,101678406,147,0.777688956113589
37695,3389.281567,3389.2892,1,101678447,101678676,229,0.7626511820044325
37696,3389.2912,3389.3162,1,101678736,101679486,750,0.7137172198388457
37697,3389.325867,3389.335967,1,101679776,101680079,303,0.4897460811700994
37698,3389.4774,3389.4808,1,101684322,101684424,102,0.25258746375849084
37699,3392.603733,3392.609933,1,101778111,101778297,186,0.4074984231105407
37700,3392.6175,3392.6278,1,101778525,101778834,309,0.3298208703134662
37701,3394.404333,3394.407733,1,101832129,101832231,102,0.5737734229880194
37702,3394.421233,3394.440567,1,101832636,101833217,581,0.5622246515443758
37703,3394.4862,3394.5072,1,101834586,101835216,630,0.7651886299454485
37704,3394.549433,3394.598333,1,101836482,101837949,1467,0.6536550420326087
37705,3394.6247,3394.6287,1,101838741,101838861,120,0.4873451417957402
37706,3394.633667,3394.659533,1,101839010,101839785,775,0.7221558623422137
37707,3394.669367,3394.719633,1,101840081,101841588,1507,0.6195236090063021
37708,3394.7422,3394.762167,1,101842266,101842865,599,0.7273382697220306
37709,3394.779067,3394.794333,1,101843372,101843829,457,0.7658841978964092
37710,3394.799733,3394.816967,1,101843991,101844509,518,0.6946368226632553
37711,3394.9758,3394.9791,1,101849274,101849373,99,0.5837587361545893
37712,3394.9902,3395.0765,1,101849706,101852295,2589,0.158503450330565
37713,3395.078733,3395.0934,1,101852361,101852802,441,0.11303767725580695
37714,3395.095033,3395.098133,1,101852850,101852943,93,
37715,3395.113867,3395.1222,1,101853416,101853666,250,0.41423448040223787
37716,3395.125233,3395.158667,1,101853756,101854760,1004,0.2926489118423466
37717,3395.1745,3395.193533,1,101855235,101855805,570,0.14623645518929548
37718,3395.5874,3395.5946,1,101867622,101867838,216,0.715240489054595
37719,3395.603,3395.639467,1,101868090,101869184,1094,0.6134477987408986
37720,3395.643633,3395.7186,1,101869308,101871558,2250,0.6038268918676749
37721,3395.723967,3395.745033,1,101871719,101872350,631,0.6718281574901812
37722,3395.7462,3395.811667,1,101872386,101874350,1964,0.6329865374719915
37723,3395.8257,3395.846833,1,101874771,101875404,633,0.6079608839706302
37724,3395.848967,3395.8749,1,101875469,101876247,778,0.5728428092002286
37725,3395.910167,3395.916767,1,101877305,101877503,198,0.353033112336219
37726,3395.9213,3395.938267,1,101877639,101878148,509,0.6145617453271298
37727,3395.957733,3395.978967,1,101878731,101879369,638,0.7069027482222727
37728,3396.123867,3396.1283,1,101883716,101883849,133,0.28485687689628764
37729,3396.1328,3396.135967,1,101883984,101884079,95,0.18501731048004116
37730,3397.2264,3397.2362,1,101916792,101917086,294,0.44813558673792603
37731,3397.245033,3397.3178,1,101917350,101919534,2184,0.18607222993677702
37732,3397.379233,3397.389967,1,101921376,101921699,323,0.21206296460561927
37733,3397.391033,3397.399,1,101921730,101921970,240,0.22418072108002002
37734,3397.400733,3397.426567,1,101922021,101922797,776,0.5276413487120906
37735,3397.435633,3397.458067,1,101923068,101923742,674,0.2615636697869108
37736,3397.462133,3397.468733,1,101923863,101924061,198,0.19601005787432174
37737,3397.473,3397.481167,1,101924190,101924435,245,-0.004208662099185845
37738,3397.5312,3397.545533,1,101925936,101926365,429,0.38235211781293643
37739,3397.557167,3397.5722,1,101926715,101927166,451,0.45376966836432386
37740,3397.5734,3397.579767,1,101927202,101927393,191,0.6876061361373996
37741,3397.581767,3397.587933,1,101927453,101927637,184,0.43876451365973884
37742,3397.589233,3397.5987,1,101927676,101927961,285,0.058446665246104576
37743,3397.5999,3397.606267,1,101927997,101928188,191,-0.19722886235835965
37744,3397.7448,3397.7505,1,101932344,101932515,171,0.07187453662511922
37745,3397.7775,3397.793433,1,101933325,101933802,477,0.20288007647586095
37746,3397.836833,3397.870633,1,101935104,101936118,1014,0.005259106901465885
37747,3397.871033,3397.9012,1,101936130,101937036,906,-0.10003332409980967
37748,3397.913867,3397.9369,1,101937416,101938107,691,-0.004510539154039902
37749,3397.939667,3397.979833,1,101938190,101939394,1204,0.009713041768916577
37750,3398.0072,3398.015767,1,101940216,101940473,257,0.005977955493677958
37751,3398.019567,3398.046933,1,101940587,101941407,820,-0.0433905072035139
37752,3398.060267,3398.084867,1,101941808,101942546,738,-0.03907832399589398
37753,3398.0865,3398.091267,1,101942595,101942738,143,-0.26309140460217934
37754,3398.097367,3398.124367,1,101942921,101943731,810,-0.050984920875949344
37755,3398.127933,3398.1317,1,101943837,101943951,114,-0.16318522022489207
37756,3398.139333,3398.166133,1,101944179,101944983,804,-0.03169834084696314
37757,3398.177233,3398.2007,1,101945316,101946021,705,0.06376989009271641
37758,3398.239767,3398.2438,1,101947193,101947314,121,-0.25225498967235715
37759,3398.254267,3398.331133,1,101947628,101949933,2305,-0.04110391172616699
37760,3398.335267,3398.3615,1,101950058,101950845,787,-0.062202832273012154
37761,3398.3738,3398.401733,1,101951214,101952051,837,-0.016616301385985563
37762,3398.438133,3398.441533,1,101953143,101953245,102,0.44825531026164195
37763,3398.4539,3398.48,1,101953617,101954400,783,-0.06893729785184376
37764,3398.482067,3398.4861,1,101954462,101954583,121,-0.16013871154400616
37765,3398.492133,3398.525533,1,101954763,101955765,1002,-0.013320780189414863
37766,3398.5322,3398.5622,1,101955966,101956866,900,0.01051686502748818
37767,3398.575767,3398.6017,1,101957273,101958051,778,0.03249928820723388
37768,3398.604333,3398.607733,1,101958129,101958231,102,
37769,3398.6128,3398.644233,1,101958384,101959326,942,0.03617146725933667
37770,3398.656133,3398.684267,1,101959683,101960528,845,0.059630324553923
37771,3398.693867,3398.724,1,101960816,101961720,904,0.3184382056937787
37772,3398.7376,3398.769367,1,101962128,101963081,953,-0.014507804082160415
37773,3398.777667,3398.8073,1,101963330,101964219,889,0.011651358182938712
37774,3398.8091,3398.812533,1,101964273,101964375,102,
37775,3398.823167,3398.8517,1,101964695,101965551,856,-0.04749652421543766
37776,3398.8533,3398.858667,1,101965599,101965760,161,-0.16676106623425013
37777,3398.8604,3398.8922,1,101965812,101966766,954,-0.05401443217857419
37778,3398.894867,3398.936267,1,101966846,101968088,1242,-0.05178841193134136
37779,3398.9436,3398.971267,1,101968308,101969138,830,-0.027603314010667082
37780,3398.990767,3399.016233,1,101969723,101970486,763,-0.07111035758275355
37781,3399.030833,3399.056567,1,101970924,101971697,773,0.1081572755088863
37782,3399.069033,3399.101533,1,101972070,101973045,975,0.1157227669978784
37783,3399.115567,3399.139233,1,101973467,101974176,709,0.11188376331416228
37784,3399.154167,3399.182333,1,101974625,101975469,844,0.2482365776148588
37785,3399.195067,3399.2291,1,101975852,101976873,1021,0.013639647010990309
37786,3399.2449,3399.2504,1,101977347,101977512,165,0.13133315282575297
37787,3399.2516,3399.269767,1,101977548,101978093,545,-0.09150667060871055
37788,3399.2834,3399.308833,1,101978502,101979264,762,0.349614187721912
37789,3399.321867,3399.4061,1,101979656,101982183,2527,-0.06545101167352303
37790,3399.408233,3399.446867,1,101982246,101983406,1160,0.022404888450930187
37791,3399.4544,3399.4838,1,101983632,101984514,882,-0.05675701888743023
37792,3399.4995,3399.5292,1,101984985,101985876,891,-0.10279750877446736
37793,3399.542433,3399.568667,1,101986272,101987060,788,0.0030617875245412454
37794,3399.580967,3399.615533,1,101987429,101988465,1036,-0.05217111058922868
37795,3399.628833,3399.6575,1,101988864,101989725,861,-0.022294009571566187
37796,3399.659,3399.662533,1,101989770,101989875,105,-0.21113281887474217
37797,3399.672467,3399.7028,1,101990174,101991084,910,0.0026649799951200116
37798,3399.719733,3399.7434,1,101991591,101992302,711,-0.0012489786754854679
37799,3399.754933,3399.788533,1,101992647,101993655,1008,0.04476580842173335
37800,3399.8068,3399.834233,1,101994204,101995026,822,0.0036419662317897735
37801,3399.842567,3399.924133,1,101995277,101997723,2446,-0.07334261150967228
37802,3399.935633,3399.970467,1,101998068,101999114,1046,0.26586427049827216
37803,3400.686133,3400.719433,1,102020583,102021582,999,0.1324775056816971
37804,3400.720433,3400.724333,1,102021612,102021729,117,0.2813914424980874
37805,3400.725967,3400.748967,1,102021779,102022469,690,0.25681537854642345
37806,3400.755533,3400.7659,1,102022665,102022977,312,0.2603777468610291
37807,3400.792533,3400.800367,1,102023775,102024011,236,0.5169999195545709
37808,3400.813867,3400.835133,1,102024416,102025053,637,0.2839014092305075
37809,3400.844267,3400.857767,1,102025328,102025733,405,0.2201344346216888
37810,3400.868267,3400.872467,1,102026048,102026174,126,0.32418275092624654
37811,3400.886167,3400.890233,1,102026585,102026706,121,0.5907934047835772
37812,3400.891767,3400.895267,1,102026753,102026858,105,0.12617840833928357
37813,3400.900133,3400.904267,1,102027003,102027128,125,-0.2310442698418766
37814,3400.9133,3400.919233,1,102027399,102027576,177,0.4098209555115553
37815,3400.926333,3400.9321,1,102027789,102027963,174,0.375990461406119
37816,3400.9396,3401.002433,1,102028188,102030072,1884,0.151201928669018
37817,3401.0192,3401.032667,1,102030576,102030980,404,0.37331759669432657
37818,3401.034867,3401.068133,1,102031046,102032043,997,0.3837463427485678
37819,3401.069667,3401.121233,1,102032090,102033636,1546,0.1744371333084095
37820,3401.128,3401.134567,1,102033840,102034037,197,0.6746963622851078
37821,3401.137,3401.164467,1,102034110,102034934,824,0.12362025573774688
37822,3401.165833,3401.185467,1,102034974,102035564,590,0.4948199792148149
37823,3401.2009,3401.2052,1,102036027,102036156,129,
37824,3401.4201,3401.424433,1,102042603,102042732,129,-0.16832642564370734
37825,3401.434567,3401.452567,1,102043037,102043577,540,0.3253465894802843
37826,3401.4564,3401.501967,1,102043692,102045059,1367,-0.010185965782385696
37827,3401.518133,3401.534333,1,102045543,102046029,486,0.14576542973218204
37828,3401.536867,3401.5621,1,102046106,102046863,757,0.2299100872902753
37829,3401.563133,3401.567033,1,102046893,102047010,117,-0.210988503601223
37830,3401.578967,3401.586667,1,102047369,102047600,231,0.11060395443857919
37831,3401.636467,3401.667367,1,102049094,102050021,927,-0.057877372644568006
37832,3401.685233,3401.6914,1,102050556,102050742,186,
37833,3401.703,3401.7095,1,102051090,102051285,195,-0.3814304369076696
37834,3401.716367,3401.732267,1,102051491,102051968,477,-0.0383697115635516
37835,3401.733467,3401.7365,1,102052004,102052095,91,
37836,3401.751867,3401.761433,1,102052556,102052842,286,0.7642284537167688
37837,3401.762567,3401.7665,1,102052877,102052995,118,0.20190215735657163
37838,3401.792333,3401.798967,1,102053769,102053969,200,0.025076543041713736
37839,3401.835467,3401.838967,1,102055064,102055169,105,0.4315593281327327
37840,3401.856067,3401.868633,1,102055682,102056058,376,-0.07081584605795715
37841,3401.869867,3401.8761,1,102056096,102056283,187,-0.14511464073526026
37842,3401.878633,3401.882633,1,102056358,102056478,120,
37843,3401.912533,3401.9338,1,102057375,102058014,639,0.04755329710988924
37844,3401.935733,3401.9519,1,102058071,102058557,486,0.04069965496324969
37845,3401.957767,3401.9833,1,102058733,102059499,766,0.10135625855878691
37846,3402.041833,3402.0494,1,102061254,102061482,228,0.06279929597696554
37847,3402.0972,3402.1171,1,102062916,102063513,597,-0.03280073461467709
37848,3402.1181,3402.140633,1,102063543,102064218,675,-0.020671532067069072
37849,3402.143933,3402.149367,1,102064317,102064481,164,0.34454184749017064
37850,3402.150933,3402.164667,1,102064527,102064940,413,-0.10214895315616773
37851,3402.277567,3402.2833,1,102068327,102068499,172,0.012261628032724943
37852,3402.287833,3402.308733,1,102068634,102069261,627,0.5180180526027172
37853,3402.314233,3402.321733,1,102069426,102069651,225,0.6094798923671502
37854,3402.325967,3402.334233,1,102069779,102070026,247,0.0037782696234572736
37855,3402.3552,3402.3606,1,102070656,102070818,162,0.46998426051558934
37856,3402.361967,3402.378067,1,102070859,102071342,483,-0.015539389328477083
37857,3402.3801,3402.407667,1,102071403,102072230,827,-0.07892618498925062
37858,3402.4288,3402.4403,1,102072864,102073209,345,-0.10290200244755113
37859,3402.442433,3402.4888,1,102073272,102074664,1392,-0.06776365863229236
37860,3402.492967,3402.5036,1,102074789,102075108,319,0.37630852175047574
37861,3402.513333,3402.525467,1,102075399,102075764,365,0.140589859750612
37862,3402.533733,3402.5479,1,102076011,102076437,426,0.24668331179520153
37863,3404.188233,3404.194433,1,102125646,102125832,186,0.2542838512702224
37864,3404.214,3404.2608,1,102126420,102127824,1404,0.28725517696921404
37865,3404.2677,3404.354,1,102128031,102130620,2589,0.235622535118283
37866,3404.360067,3404.363167,1,102130802,102130895,93,0.27839669579498105
37867,3404.8032,3404.806467,1,102144096,102144194,98,0.46818857850996914
37868,3404.8128,3404.8593,1,102144384,102145779,1395,0.49581203038893407
37869,3404.8621,3404.866433,1,102145863,102145992,129,0.33840429916143266
37870,3405.1388,3405.145,1,102154164,102154350,186,0.7517657810582207
37871,3405.1474,3405.154,1,102154422,102154620,198,0.06222926542466045
37872,3405.348467,3405.477667,1,102160454,102164330,3876,0.7842031587052052
37873,3406.0891,3406.093633,1,102182673,102182808,135,-0.03939383718813263
37874,3406.0968,3406.240767,1,102182904,102187223,4319,0.8044647037510078
37875,3407.065633,3407.072367,1,102211968,102212171,203,0.7469008919094716
37876,3407.100967,3407.139133,1,102213029,102214173,1144,0.6638628418699449
37877,3407.170667,3407.1744,1,102215120,102215232,112,0.5199324235275647
37878,3407.1815,3407.198133,1,102215445,102215943,498,0.6333174948896609
37879,3407.2159,3407.232767,1,102216477,102216983,506,0.5864489534199531
37880,3407.282533,3407.286033,1,102218475,102218580,105,0.6343737197351655
37881,3407.287467,3407.2976,1,102218624,102218928,304,0.6316696961384854
37882,3407.321933,3407.329367,1,102219657,102219881,224,0.6419074671760853
37883,3407.335,3407.3468,1,102220050,102220404,354,0.6855666459310585
37884,3407.4051,3407.41,1,102222153,102222300,147,-0.18740772355210697
37885,3407.415467,3407.423833,1,102222464,102222714,250,0.1807929776063067
37886,3407.4378,3407.4468,1,102223134,102223404,270,0.1070707092360748
37887,3407.506467,3407.7189,1,102225194,102231567,6373,0.8147969638933409
37888,3407.7219,3407.778333,1,102231657,102233349,1692,0.8359875140350794
37889,3407.788033,3407.804333,1,102233640,102234129,489,0.7656313867885741
37890,3407.807467,3407.818967,1,102234224,102234569,345,0.6567340226495669
37891,3408.218467,3408.4514,1,102246554,102253542,6988,0.7885656899049159
37892,3408.47,3408.536367,1,102254100,102256091,1991,0.8219052679663823
37893,3408.538733,3408.586333,1,102256161,102257589,1428,0.7270656942245468
37894,3408.985333,3408.9917,1,102269559,102269751,192,0.635766238477284
37895,3408.994267,3409.008067,1,102269828,102270242,414,0.6894965440345551
37896,3409.031067,3409.042333,1,102270932,102271269,337,0.6018731693558187
37897,3409.057133,3409.135267,1,102271713,102274058,2345,0.7830430581579084
37898,3409.1448,3409.1481,1,102274344,102274443,99,0.5313886850654389
37899,3409.152467,3409.159333,1,102274574,102274779,205,0.8041279005685985
37900,3409.161067,3409.330067,1,102274832,102279902,5070,0.7674515549563561
37901,3409.7408,3409.745933,1,102292224,102292377,153,0.46009887700218455
37902,3409.762333,3409.7679,1,102292869,102293037,168,0.5604579926503453
37903,3409.805967,3409.8219,1,102294179,102294657,478,0.8269654478709351
37904,3409.823267,3409.8348,1,102294698,102295044,346,0.578330858687731
37905,3409.853633,3409.863633,1,102295608,102295908,300,0.6939237062403637
37906,3409.868567,3409.876267,1,102296057,102296288,231,0.7861256787483742
37907,3409.9135,3409.9167,1,102297405,102297501,96,0.5211134077752058
37908,3409.9319,3409.939633,1,102297957,102298188,231,0.7111080730257597
37909,3409.962333,3409.9997,1,102298869,102299991,1122,0.643909723823421
37910,3410.040333,3410.049067,1,102301209,102301472,263,0.6315736256738053
37911,3410.084,3410.0935,1,102302520,102302805,285,0.6545194571123135
37912,3410.156167,3410.1626,1,102304685,102304878,193,-0.22915446777022805
37913,3410.219867,3410.224633,1,102306596,102306738,142,0.670545526877567
37914,3410.2266,3410.342067,1,102306798,102310262,3464,0.7746859417500152
37915,3410.362067,3410.484833,1,102310862,102314544,3682,0.8144646449262921
37916,3410.4863,3410.547233,1,102314589,102316416,1827,0.7940878722744533
37917,3410.550467,3410.571,1,102316514,102317130,616,0.7319118093588117
37918,3410.5766,3410.6281,1,102317298,102318843,1545,0.7905106078698725
37919,3410.636033,3410.641533,1,102319080,102319245,165,0.054567329496152936
37920,3411.045367,3411.050367,1,102331361,102331511,150,0.5313433073737381
37921,3411.072333,3411.0964,1,102332169,102332892,723,0.8604594551616621
37922,3411.1139,3411.1252,1,102333417,102333756,339,0.8697377859180986
37923,3411.173767,3411.1924,1,102335213,102335772,559,0.871782648335079
37924,3411.214567,3411.330333,1,102336437,102339909,3472,0.7073358952387997
37925,3411.335133,3411.354867,1,102340053,102340646,593,0.6562427687421355
37926,3411.357,3411.4087,1,102340710,102342261,1551,0.7540072174647897
37927,3411.417233,3411.438933,1,102342516,102343167,651,0.6690840449469893
37928,3411.450767,3411.463833,1,102343523,102343914,391,0.8064535761442154
37929,3411.4958,3411.498867,1,102344874,102344966,92,0.6172209667622844
37930,3411.500033,3411.5035,1,102345000,102345105,105,0.06088933992007066
37931,3411.8293,3411.834833,1,102354879,102355044,165,0.554613262546773
37932,3411.8375,3411.972033,1,102355125,102359160,4035,0.8293476575199418
37933,3411.974667,3411.990767,1,102359240,102359723,483,0.720868838181016
37934,3411.9941,3412.010467,1,102359823,102360314,491,0.8072287905638698
37935,3412.0166,3412.0898,1,102360498,102362694,2196,0.8302486074433278
37936,3412.094233,3412.17,1,102362826,102365100,2274,0.7474232254443812
37937,3412.172367,3412.279467,1,102365171,102368384,3213,0.7582172299459871
37938,3412.280967,3412.296567,1,102368429,102368897,468,0.8846551830457564
37939,3412.3671,3412.4585,1,102371013,102373755,2742,0.7770982296222079
37940,3412.468467,3412.4731,1,102374054,102374193,139,-0.26588261082898557
37941,3413.024933,3413.028433,1,102390747,102390852,105,0.32560021880553686
37942,3413.034967,3413.0381,1,102391049,102391143,94,0.7528899282815795
37943,3413.0392,3413.086067,1,102391176,102392582,1406,0.7937445339265489
37944,3413.091733,3413.101067,1,102392751,102393032,281,-0.3383044840982693
37945,3413.573667,3413.603167,1,102407210,102408095,885,0.5542525602897014
37946,3413.605133,3413.6914,1,102408153,102410742,2589,0.786153557008901
37947,3414.0804,3414.085633,1,102422412,102422568,156,0.6579625590396141
37948,3414.0965,3414.1011,1,102422895,102423033,138,0.6186674271761926
37949,3414.102233,3414.105467,1,102423066,102423164,98,0.4025976220864696
37950,3414.106633,3414.115433,1,102423198,102423462,264,0.6189711450377681
37951,3414.148567,3414.164133,1,102424457,102424923,466,0.8282001303504739
37952,3414.241133,3414.249433,1,102427233,102427482,249,0.7046466602560283
37953,3414.250467,3414.2567,1,102427514,102427701,187,0.4627988624769425
37954,3414.285167,3414.288967,1,102428555,102428669,114,0.46828910469480023
37955,3414.291267,3414.308333,1,102428738,102429249,511,0.6221385036374681
37956,3414.309367,3414.330967,1,102429281,102429929,648,0.7832022195278069
37957,3414.366267,3414.380367,1,102430988,102431411,423,0.6110243271813102
37958,3414.399533,3414.429167,1,102431985,102432875,890,0.6648360010856851
37959,3414.4581,3414.467167,1,102433743,102434015,272,-0.12388793108905224
37960,3414.474767,3414.4934,1,102434243,102434802,559,0.15596667502204556
37961,3414.4965,3414.500067,1,102434895,102435002,107,
37962,3414.504133,3414.509167,1,102435123,102435275,152,-0.0920388481082318
37963,3414.5252,3414.528233,1,102435756,102435846,90,-0.31586213330084806
37964,3414.537133,3414.6391,1,102436113,102439173,3060,0.7148281183732486
37965,3414.642867,3414.6733,1,102439286,102440199,913,0.7265038619669675
37966,3414.6988,3414.7039,1,102440964,102441117,153,0.4780497589751389
37967,3414.7064,3414.815,1,102441192,102444450,3258,0.7803381462247577
37968,3415.149933,3415.180433,1,102454497,102455412,915,0.6102513358985243
37969,3415.227833,3415.2459,1,102456834,102457377,543,0.7315399170095274
37970,3415.247,3415.264633,1,102457410,102457938,528,0.5496220076416982
37971,3415.265667,3415.2707,1,102457970,102458121,151,0.5219499970255863
37972,3415.272,3415.282967,1,102458160,102458489,329,0.7830990917002343
37973,3415.2896,3415.306033,1,102458688,102459180,492,0.5001606484505902
37974,3415.3344,3415.3473,1,102460032,102460419,387,0.760464102447867
37975,3415.350533,3415.3896,1,102460515,102461688,1173,0.6997688511555317
37976,3415.404533,3415.417633,1,102462135,102462528,393,0.6864159313151414
37977,3415.420067,3415.441133,1,102462602,102463233,631,0.5642110762837226
37978,3415.489933,3415.572133,1,102464697,102467163,2466,0.5031168641978107
37979,3415.586033,3415.5944,1,102467580,102467832,252,0.00845766220394308
37980,3415.6142,3415.682533,1,102468426,102470475,2049,0.6388292413592022
37981,3415.700833,3415.7079,1,102471024,102471237,213,0.4716830779675199
37982,3415.9738,3416.268067,1,102479214,102488042,8828,0.7624647320150721
37983,3416.274333,3416.2794,1,102488229,102488382,153,0.3409156274935868
37984,3416.744733,3416.748,1,102502341,102502440,99,0.6145609995966569
37985,3416.7559,3416.762567,1,102502677,102502877,200,0.6218216614821124
37986,3416.820467,3416.828567,1,102504614,102504857,243,0.8102490106943993
37987,3416.830367,3416.838933,1,102504911,102505167,256,0.32695871191696235
37988,3416.878533,3416.912533,1,102506355,102507375,1020,0.8117399851507398
37989,3416.922067,3416.9976,1,102507662,102509928,2266,0.6316188205339955
37990,3417.0108,3417.103633,1,102510324,102513108,2784,0.7469759946690325
37991,3417.1215,3417.207267,1,102513645,102516218,2573,0.71758622435577
37992,3417.2256,3417.237067,1,102516768,102517112,344,0.1754544173725675
37993,3417.238067,3417.2423,1,102517142,102517269,127,0.787248962041546
37994,3417.250667,3417.254367,1,102517520,102517631,111,0.4413749218248362
37995,3417.2554,3417.2658,1,102517662,102517974,312,-0.0714853407006261
37996,3417.667167,3417.672,1,102530015,102530160,145,-0.4390539790266176
37997,3417.6793,3417.830733,1,102530379,102534921,4542,0.7285051902287177
37998,3417.8354,3417.8417,1,102535062,102535251,189,0.5751602170756043
37999,3417.8512,3417.871367,1,102535536,102536141,605,0.8339103995095947
38000,3417.873433,3417.9131,1,102536202,102537393,1191,0.6446598900922385
38001,3417.9353,3418.130633,1,102538059,102543918,5859,0.767773578889889
38002,3418.595133,3418.626233,1,102557853,102558786,933,0.7255068726860785
38003,3418.642133,3418.6532,1,102559263,102559596,333,0.6608692430889114
38004,3418.670233,3418.697467,1,102560106,102560924,818,0.7784526979837019
38005,3418.699733,3418.703133,1,102560991,102561093,102,0.6412674067699826
38006,3418.704567,3418.713133,1,102561137,102561393,256,0.6369296095841606
38007,3418.718333,3418.730033,1,102561549,102561900,351,0.6672380625616666
38008,3418.736367,3418.743367,1,102562091,102562301,210,0.3482661596064394
38009,3418.761567,3418.793933,1,102562847,102563817,970,0.4999852143644403
38010,3418.7972,3418.803967,1,102563916,102564119,203,0.3158762450211979
38011,3418.8094,3418.865433,1,102564282,102565962,1680,0.5202472092191851
38012,3418.868967,3418.883167,1,102566069,102566495,426,-0.021816337070477518
38013,3418.8934,3418.8975,1,102566802,102566925,123,0.47124771336867843
38014,3418.904967,3418.928633,1,102567149,102567858,709,0.4486151536094522
38015,3418.982033,3418.987233,1,102569460,102569616,156,
38016,3419.0126,3419.0196,1,102570378,102570588,210,-0.15371164673596424
38017,3419.577767,3419.6516,1,102587333,102589548,2215,0.81799481399958
38018,3420.063033,3420.070533,1,102601890,102602115,225,0.6574983300235987
38019,3420.1016,3420.1057,1,102603048,102603171,123,0.37175149865060925
38020,3420.1424,3420.148433,1,102604272,102604452,180,0.6995946288152756
38021,3420.180233,3420.186667,1,102605406,102605600,194,0.501463460959231
38022,3420.1928,3420.204233,1,102605784,102606126,342,0.42924349417033314
38023,3420.26,3420.271533,1,102607800,102608145,345,0.6206515806938214
38024,3420.294633,3420.301033,1,102608838,102609030,192,0.5263948312748086
38025,3420.305733,3420.323167,1,102609171,102609695,524,0.5916297311572327
38026,3420.336833,3420.346067,1,102610104,102610382,278,0.03971827915215669
38027,3420.372967,3420.3774,1,102611189,102611322,133,0.43231166334079607
38028,3420.418867,3420.423067,1,102612566,102612692,126,-0.12897015623240302
38029,3420.4253,3420.430033,1,102612759,102612900,141,0.5505762380061846
38030,3420.4343,3420.5432,1,102613029,102616296,3267,0.6888111993376168
38031,3420.554133,3420.729567,1,102616623,102621887,5264,0.7714845451380148
38032,3420.732567,3420.749833,1,102621977,102622494,517,0.7546782509978441
38033,3420.751467,3420.7775,1,102622544,102623325,781,0.5790021627932379
38034,3420.801533,3420.812533,1,102624045,102624375,330,-0.14403859440694902
38035,3421.021933,3421.025833,1,102630657,102630774,117,0.4218339592176594
38036,3421.099133,3421.1073,1,102632973,102633219,246,0.447872593246835
38037,3421.1112,3421.180533,1,102633336,102635415,2079,0.6504411622068007
38038,3421.182367,3421.186267,1,102635471,102635588,117,0.6720353265787555
38039,3421.2051,3421.295567,1,102636153,102638867,2714,0.680818240984977
38040,3421.311933,3421.350667,1,102639357,102640520,1163,0.4143598169681405
38041,3421.393933,3421.417,1,102641817,102642510,693,0.5447525290959735
38042,3421.463767,3421.485767,1,102643913,102644573,660,0.6318000554539849
38043,3421.5002,3421.6214,1,102645006,102648642,3636,0.657331041005318
38044,3421.623833,3421.681033,1,102648714,102650430,1716,0.6971859457379006
38045,3421.6919,3421.706067,1,102650757,102651182,425,0.6982472694347356
38046,3421.710233,3421.722467,1,102651306,102651674,368,0.6714397117234221
38047,3421.804033,3421.811533,1,102654120,102654345,225,0.2830841387554099
38048,3422.0429,3422.1934,1,102661287,102665802,4515,0.7202301750107993
38049,3422.1983,3422.207133,1,102665949,102666213,264,0.05617755746938134
38050,3422.209233,3422.214833,1,102666276,102666444,168,0.3271523341417166
38051,3422.219133,3422.319767,1,102666573,102669593,3020,0.8034614536985492
38052,3422.323367,3422.360333,1,102669701,102670809,1108,0.6546391964822231
38053,3422.366767,3422.3876,1,102671003,102671628,625,0.6485808125263478
38054,3422.3888,3422.3922,1,102671664,102671766,102,0.2876013120720867
38055,3422.394,3422.4421,1,102671820,102673263,1443,0.7457510976269851
38056,3422.450733,3422.475733,1,102673521,102674271,750,0.6979305909671362
38057,3422.481,3422.495,1,102674430,102674850,420,0.7119383942472353
38058,3422.5246,3422.530533,1,102675738,102675915,177,-0.317123583717055
38059,3422.5401,3422.554767,1,102676203,102676643,440,0.026828022705844442
38060,3422.559967,3422.5679,1,102676799,102677037,238,0.2472938680546868
38061,3422.766733,3422.792733,1,102683001,102683781,780,0.7576778865203824
38062,3422.794133,3422.8354,1,102683823,102685062,1239,0.8236180481631791
38063,3422.838233,3422.933133,1,102685146,102687993,2847,0.8122922674209662
38064,3422.948933,3423.180967,1,102688467,102695429,6962,0.7494236967995567
38065,3423.182733,3423.189967,1,102695481,102695699,218,-0.03158655585844229
38066,3423.501267,3423.510867,1,102705038,102705326,288,0.5380341243041545
38067,3423.522167,3423.589833,1,102705665,102707694,2029,0.5981665631274957
38068,3423.591533,3423.623933,1,102707745,102708717,972,0.49485459263123877
38069,3423.639367,3423.712167,1,102709181,102711365,2184,0.7630084976656493
38070,3423.733633,3423.813133,1,102712008,102714393,2385,0.7879024727753711
38071,3423.832467,3423.846067,1,102714974,102715382,408,0.10100987185651342
38072,3423.868967,3423.8934,1,102716069,102716802,733,0.5646249048005834
38073,3423.910833,3423.985433,1,102717324,102719562,2238,0.7794294432301893
38074,3423.9995,3424.0047,1,102719985,102720141,156,0.11692349117947533
38075,3424.0061,3424.014067,1,102720183,102720422,239,0.09728284862110329
38076,3424.025367,3424.030467,1,102720761,102720914,153,
38077,3424.2812,3424.3327,1,102728436,102729981,1545,0.8292438142735665
38078,3424.3342,3424.351433,1,102730026,102730542,516,0.8279067443762034
38079,3424.3526,3424.378833,1,102730578,102731364,786,0.7948820887511464
38080,3424.408933,3424.413167,1,102732267,102732395,128,0.2191760166129322
38081,3424.415767,3424.420633,1,102732473,102732618,145,0.32309394645449907
38082,3424.424833,3424.428967,1,102732744,102732869,125,0.26224969451608976
38083,3424.4308,3424.433867,1,102732924,102733016,92,
38084,3424.5024,3424.508567,1,102735072,102735257,185,0.19370096292334626
38085,3424.5099,3424.518267,1,102735297,102735548,251,0.16158782958989912
38086,3424.524433,3424.543667,1,102735732,102736310,578,0.15489540676394198
38087,3424.547167,3424.554267,1,102736415,102736628,213,0.5010387652156222
38088,3424.560567,3424.592733,1,102736817,102737781,964,0.13319827411269755
38089,3424.595133,3424.616067,1,102737853,102738482,629,0.22062578717608936
38090,3424.640567,3424.7119,1,102739217,102741357,2140,0.7100221606536552
38091,3424.7148,3424.8145,1,102741444,102744435,2991,0.8291155951634421
38092,3424.831333,3424.841633,1,102744939,102745248,309,0.006947290733774878
38093,3424.8521,3424.863967,1,102745563,102745919,356,0.23108053243420898
38094,3424.926333,3424.930333,1,102747789,102747909,120,
38095,3424.931433,3424.935667,1,102747942,102748070,128,0.736181531398636
38096,3424.9369,3424.951,1,102748107,102748530,423,0.5376544145330936
38097,3424.952933,3424.957367,1,102748587,102748721,134,0.02100682816368012
38098,3424.958467,3424.967733,1,102748754,102749031,277,0.3571534055619447
38099,3424.972867,3424.980933,1,102749186,102749427,241,0.6673891743632918
38100,3424.981933,3424.9854,1,102749457,102749562,105,0.44887542392899205
38101,3424.986833,3425.037633,1,102749604,102751128,1524,0.03768395890798835
38102,3425.052233,3425.057933,1,102751566,102751737,171,0.8114693127826883
38103,3425.0661,3425.072167,1,102751983,102752165,182,0.681727218029696
38104,3425.073267,3425.164633,1,102752198,102754938,2740,0.7441946928193872
38105,3425.1768,3425.206733,1,102755304,102756201,897,0.8047762483405363
38106,3425.210833,3425.2686,1,102756324,102758058,1734,0.8380083688128976
38107,3425.280633,3425.3222,1,102758418,102759666,1248,0.7327847038171237
38108,3425.3249,3425.328567,1,102759747,102759857,110,0.14241749498861012
38109,3425.348933,3425.362233,1,102760467,102760866,399,0.10428731508696659
38110,3425.377833,3425.492033,1,102761334,102764760,3426,0.7997355276916519
38111,3425.502933,3425.5078,1,102765087,102765234,147,0.025460534290537674
38112,3425.509467,3425.512733,1,102765284,102765381,97,
38113,3425.514467,3425.5177,1,102765434,102765531,97,0.458542912120686
38114,3425.620433,3425.623433,1,102768612,102768702,90,
38115,3425.677533,3425.684667,1,102770325,102770540,215,0.3729028753462042
38116,3425.702533,3425.708233,1,102771075,102771246,171,0.36228607593857565
38117,3425.7689,3425.9752,1,102773067,102779256,6189,0.8294713890314904
38118,3426.5093,3426.5162,1,102795279,102795486,207,0.7307973105733593
38119,3426.5205,3426.5327,1,102795615,102795981,366,0.5868002590234199
38120,3426.536233,3426.5402,1,102796086,102796206,120,0.581648284173042
38121,3426.568267,3426.5841,1,102797048,102797523,475,0.6099207203408028
38122,3426.670467,3426.691067,1,102800114,102800732,618,0.5715976157235602
38123,3426.726767,3426.7478,1,102801803,102802434,631,0.6110367148013153
38124,3426.7843,3426.789133,1,102803529,102803673,144,0.5243476266833982
38125,3426.796033,3426.8156,1,102803880,102804468,588,0.5320792236414876
38126,3426.833033,3426.845533,1,102804990,102805365,375,0.351218328372178
38127,3426.9009,3426.905267,1,102807027,102807158,131,0.5185050859948602
38128,3426.9094,3426.9174,1,102807282,102807522,240,0.6232838188960005
38129,3426.953367,3426.9571,1,102808601,102808713,112,0.3695807860444553
38130,3427.4777,3427.486667,1,102824331,102824600,269,0.6649553647041554
38131,3427.493033,3427.606967,1,102824790,102828209,3419,0.7969274655411618
38132,3427.9706,3427.975233,1,102839118,102839256,138,0.4240111126787551
38133,3427.9792,3427.9829,1,102839376,102839487,111,0.653291281474827
38134,3427.9939,3428.060733,1,102839817,102841821,2004,0.6295325419844982
38135,3428.063133,3428.066933,1,102841893,102842007,114,0.4143403527538075
38136,3428.076733,3428.106267,1,102842301,102843188,887,0.5886639300133311
38137,3428.1369,3428.141033,1,102844107,102844230,123,0.49155916636857533
38138,3428.146633,3428.1666,1,102844398,102844998,600,0.5691557453717716
38139,3428.181233,3428.1846,1,102845436,102845538,102,0.2993025208651428
38140,3428.227133,3428.236033,1,102846813,102847080,267,0.42705105818283545
38141,3428.238033,3428.2748,1,102847140,102848244,1104,0.13020466752282614
38142,3428.2775,3428.287267,1,102848325,102848618,293,0.07426849630864786
38143,3428.3081,3428.357467,1,102849243,102850724,1481,0.693777588831105
38144,3428.3595,3428.4063,1,102850785,102852189,1404,0.7420938083334028
38145,3428.4132,3428.450733,1,102852396,102853521,1125,0.7267427561549111
38146,3428.4577,3428.536967,1,102853731,102856109,2378,0.7988179110348615
38147,3428.538967,3428.561133,1,102856169,102856833,664,0.7083093703629871
38148,3428.6199,3428.624833,1,102858597,102858744,147,0.12650031771230258
38149,3428.630433,3428.6384,1,102858912,102859152,240,0.2065869048376439
38150,3428.639867,3428.643167,1,102859196,102859295,99,
38151,3428.688,3428.696733,1,102860640,102860901,261,0.4911357093623614
38152,3428.7003,3428.7907,1,102861009,102863721,2712,0.5535946419117105
38153,3428.835167,3428.844,1,102865055,102865320,265,0.32061676393018057
38154,3428.920933,3428.929833,1,102867627,102867894,267,0.5572239529183368
38155,3428.943433,3428.952367,1,102868302,102868571,269,0.7607818438679753
38156,3428.954233,3429.0081,1,102868626,102870243,1617,0.8012758278824073
38157,3429.009867,3429.042733,1,102870296,102871281,985,0.8544273227162849
38158,3429.080967,3429.086233,1,102872429,102872586,157,-0.29753266426635266
38159,3429.281267,3429.484367,1,102878438,102884531,6093,0.6131455812247784
38160,3429.784767,3429.790433,1,102893543,102893712,169,0.6084848581740661
38161,3429.809167,3429.900567,1,102894275,102897017,2742,0.6898234857596334
38162,3429.9276,3429.9311,1,102897828,102897933,105,0.2181297340215888
38163,3429.9367,3429.9806,1,102898101,102899418,1317,0.8215329437109387
38164,3429.994833,3430.010233,1,102899844,102900306,462,0.6931400226662132
38165,3430.0195,3430.035733,1,102900585,102901071,486,0.6302483388566458
38166,3430.0519,3430.064367,1,102901557,102901931,374,0.05436961062088027
38167,3430.0672,3430.071133,1,102902016,102902133,117,
38168,3430.0727,3430.0877,1,102902181,102902631,450,0.3642135020992895
38169,3430.095933,3430.101867,1,102902877,102903056,179,-0.06167178945745199
38170,3430.267833,3430.503133,1,102908034,102915093,7059,0.8267684617928702
38171,3430.5211,3430.5815,1,102915633,102917445,1812,0.748537592849309
38172,3430.5854,3430.669867,1,102917562,102920096,2534,0.8321055386122375
38173,3430.6859,3430.689833,1,102920577,102920694,117,0.08703039215527121
38174,3430.707,3430.712167,1,102921210,102921365,155,0.07499726246231204
38175,3430.715133,3430.727367,1,102921453,102921821,368,0.1393454096236056
38176,3431.4777,3431.4867,1,102944331,102944601,270,0.6852326427266558
38177,3431.490667,3431.5083,1,102944720,102945249,529,0.4701192415741547
38178,3431.547433,3431.561567,1,102946422,102946847,425,0.6985289218260683
38179,3431.7129,3431.727533,1,102951387,102951825,438,0.4593568655003197
38180,3431.789567,3431.7958,1,102953687,102953874,187,0.6065761510836302
38181,3432.071,3432.076033,1,102962130,102962280,150,0.5490664397438041
38182,3432.078267,3432.0826,1,102962348,102962478,130,0.42949771999791003
38183,3432.0967,3432.109633,1,102962901,102963288,387,0.6589719711997871
38184,3432.169267,3432.1767,1,102965078,102965301,223,0.8160900668036524
38185,3432.183633,3432.215667,1,102965508,102966470,962,0.6279841305305214
38186,3432.2339,3432.255467,1,102967017,102967664,647,0.7900422149362079
38187,3432.2651,3432.280767,1,102967953,102968423,470,0.5982146364016757
38188,3432.282467,3432.296967,1,102968474,102968909,435,0.5145176347325348
38189,3432.3061,3432.350667,1,102969183,102970520,1337,0.7743244059181629
38190,3432.3551,3432.3857,1,102970653,102971571,918,0.5994625102845605
38191,3432.5157,3432.519933,1,102975471,102975597,126,0.4492710828304927
38192,3432.529667,3432.648033,1,102975890,102979440,3550,0.8239836619646553
38193,3433.186567,3433.1939,1,102995597,102995817,220,0.5949667719162182
38194,3433.211033,3433.231133,1,102996330,102996933,603,0.4240583799504843
38195,3433.2397,3433.2429,1,102997191,102997287,96,0.5895692510685628
38196,3433.2442,3433.252967,1,102997326,102997589,263,0.8148456560582409
38197,3433.3034,3433.3226,1,102999102,102999678,576,0.8606569537449286
38198,3433.346167,3433.358033,1,103000385,103000740,355,0.3604519917661659
38199,3433.359367,3433.4039,1,103000781,103002117,1336,0.8131168735377219
38200,3433.430867,3433.457933,1,103002926,103003737,811,0.5322964021920331
38201,3433.718267,3433.824733,1,103011548,103014741,3193,0.8247526577263595
38202,3434.2835,3434.2908,1,103028505,103028724,219,0.6570652290865677
38203,3434.302333,3434.310133,1,103029069,103029303,234,0.4942739440911729
38204,3434.321833,3434.375333,1,103029654,103031259,1605,0.700294821174058
38205,3434.3924,3434.4222,1,103031772,103032666,894,0.6552360088487097
38206,3434.432333,3434.4366,1,103032969,103033098,129,0.5539201175889356
38207,3434.4462,3434.484,1,103033386,103034520,1134,0.568655288939256
38208,3434.4969,3434.515767,1,103034907,103035473,566,0.43626259029142617
38209,3434.527733,3434.5327,1,103035831,103035981,150,-0.007636696839495387
38210,3434.565267,3434.5818,1,103036958,103037454,496,0.6334136150296993
38211,3434.619167,3434.622233,1,103038575,103038666,91,0.19866333783228948
38212,3434.724167,3434.855767,1,103041725,103045673,3948,0.8284893354535332
38213,3435.094467,3435.1006,1,103052834,103053018,184,0.5228593021972905
38214,3435.104867,3435.221133,1,103053146,103056633,3487,0.8086417527115187
38215,3435.2298,3435.257333,1,103056894,103057719,825,0.8094133022895303
38216,3435.280067,3435.326833,1,103058402,103059804,1402,0.8110974815466424
38217,3435.348367,3435.371733,1,103060451,103061151,700,0.7918623924267618
38218,3435.4161,3435.427333,1,103062483,103062819,336,0.42793277481447023
38219,3435.428833,3435.4328,1,103062864,103062984,120,0.47572783890957815
38220,3435.619,3435.72,1,103068570,103071600,3030,0.8416377153211971
38221,3435.9852,3436.1181,1,103079556,103083543,3987,0.7982987478030228
38222,3436.124967,3436.127967,1,103083749,103083839,90,-0.19416525044486418
38223,3436.1397,3436.2254,1,103084191,103086762,2571,0.7511227632977242
38224,3436.666067,3436.6696,1,103099982,103100088,106,0.6910854504463844
38225,3436.7159,3436.7392,1,103101477,103102176,699,0.7278615730349742
38226,3436.7671,3436.775667,1,103103013,103103270,257,0.5765829269874626
38227,3436.777133,3436.8239,1,103103313,103104717,1404,0.6601527195399881
38228,3436.854033,3436.8634,1,103105620,103105902,282,0.4540984729804961
38229,3436.866433,3436.887233,1,103105992,103106616,624,0.7352697737020065
38230,3436.907533,3436.9216,1,103107225,103107648,423,0.5475601681167576
38231,3436.923867,3436.9547,1,103107716,103108641,925,0.6243438786937122
38232,3436.975533,3436.992633,1,103109265,103109778,513,0.7151284222268229
38233,3437.012533,3437.0279,1,103110375,103110837,462,0.691764634334216
38234,3437.034067,3437.046,1,103111022,103111380,358,0.6275112602573198
38235,3437.077067,3437.083667,1,103112312,103112510,198,0.44407584600190214
38236,3437.092467,3437.096067,1,103112774,103112882,108,0.10154894757726579
38237,3437.0975,3437.1236,1,103112925,103113708,783,0.09890907891567532
38238,3437.126367,3437.131833,1,103113791,103113954,163,0.0905614046652545
38239,3437.1335,3437.136833,1,103114005,103114104,99,
38240,3437.1584,3437.267833,1,103114752,103118034,3282,0.8030391803437307
38241,3437.2745,3437.3859,1,103118235,103121577,3342,0.8341353238322046
38242,3437.4187,3437.423367,1,103122561,103122701,140,0.7249769073457232
38243,3437.475933,3437.480733,1,103124277,103124421,144,0.5201032797816931
38244,3437.6717,3437.829267,1,103130151,103134878,4727,0.7404316986187706
38245,3437.8314,3437.835,1,103134942,103135050,108,-0.2979047482051172
38246,3437.845233,3437.864533,1,103135356,103135935,579,0.7554660163664273
38247,3437.8776,3437.906467,1,103136328,103137194,866,0.5744593504799368
38248,3437.9263,3438.0056,1,103137789,103140168,2379,0.6929999173274021
38249,3438.023633,3438.0932,1,103140708,103142796,2088,0.7905132839027762
38250,3438.1037,3438.107333,1,103143111,103143219,108,-0.24153330934044462
38251,3438.138933,3438.145433,1,103144167,103144362,195,0.15540812722075334
38252,3438.1599,3438.1643,1,103144797,103144929,132,0.35827824250890805
38253,3438.5007,3438.510933,1,103155021,103155327,306,0.5444946372583602
38254,3438.512067,3438.541767,1,103155362,103156253,891,0.5680021822648286
38255,3438.557767,3438.575033,1,103156733,103157250,517,0.5046638987378408
38256,3438.602267,3438.6101,1,103158068,103158303,235,0.8247367241834649
38257,3438.625267,3438.636867,1,103158758,103159106,348,0.5715279153024213
38258,3438.671333,3438.677767,1,103160139,103160333,194,0.39808581114176994
38259,3438.6926,3438.701233,1,103160778,103161036,258,-0.05742180619292964
38260,3438.7028,3438.729867,1,103161084,103161896,812,0.314487673138061
38261,3438.776033,3438.849567,1,103163280,103165487,2207,0.6858186612479255
38262,3438.854633,3438.859667,1,103165638,103165790,152,0.4973836360980475
38263,3438.864667,3438.867833,1,103165940,103166034,94,0.33354292748458175
38264,3438.876867,3438.890567,1,103166306,103166717,411,0.5819353282167548
38265,3438.893567,3438.900133,1,103166807,103167003,196,0.2787114612893225
38266,3438.9013,3438.968633,1,103167039,103169058,2019,0.7271043119489876
38267,3438.981967,3439.0206,1,103169459,103170618,1159,0.6811283666198266
38268,3439.022367,3439.028433,1,103170671,103170852,181,0.09617245043110785
38269,3439.048133,3439.051967,1,103171443,103171559,116,0.48534980514345605
38270,3439.0628,3439.0848,1,103171884,103172544,660,0.6058779660659284
38271,3439.108033,3439.122633,1,103173240,103173678,438,-0.13838828581010248
38272,3439.124667,3439.132433,1,103173740,103173972,232,-0.044585735744606385
38273,3439.137333,3439.148733,1,103174119,103174461,342,0.05176288817349143
38274,3439.151367,3439.166133,1,103174541,103174983,442,0.15648378711889574
38275,3439.183,3439.190067,1,103175490,103175702,212,0.24094548883315015
38276,3439.1913,3439.395633,1,103175739,103181868,6129,0.8123194536997078
38277,3439.417333,3439.421267,1,103182519,103182638,119,0.5005969678866827
38278,3439.4411,3439.4474,1,103183233,103183422,189,0.2399466787749956
38279,3439.474767,3439.569333,1,103184243,103187079,2836,0.8066827486937799
38280,3439.588933,3439.5925,1,103187667,103187775,108,-0.08679428864786046
38281,3439.9831,3439.989167,1,103199493,103199675,182,0.5816565069596527
38282,3440.0039,3440.056567,1,103200117,103201697,1580,0.6836170995591844
38283,3440.0597,3440.079333,1,103201791,103202379,588,0.6242275828148964
38284,3440.0831,3440.0907,1,103202493,103202721,228,0.5227734874417523
38285,3440.109133,3440.193733,1,103203273,103205811,2538,0.6952332474613282
38286,3440.1966,3440.211733,1,103205898,103206351,453,0.6414805834982221
38287,3440.213333,3440.216967,1,103206399,103206509,110,0.10635415131975018
38288,3440.2205,3440.224833,1,103206615,103206744,129,0.890044357934576
38289,3440.230533,3440.241367,1,103206915,103207241,326,0.6905884866260381
38290,3440.246433,3440.260833,1,103207392,103207824,432,0.34994294906104
38291,3440.2746,3440.326,1,103208238,103209780,1542,0.649719262016678
38292,3440.339333,3440.355933,1,103210179,103210677,498,0.4652427163100155
38293,3440.358733,3440.369067,1,103210761,103211072,311,0.13927743699067208
38294,3440.384567,3440.388733,1,103211537,103211661,124,0.7084248225693237
38295,3440.396767,3440.426167,1,103211903,103212785,882,-0.0006089830193344124
38296,3440.436033,3440.446967,1,103213080,103213409,329,0.11902343317266417
38297,3440.462767,3440.465767,1,103213883,103213973,90,0.12708704189807363
38298,3440.541067,3440.679167,1,103216232,103220375,4143,0.7774753018953711
38299,3440.690133,3440.696067,1,103220703,103220882,179,-0.17771314024592114
38300,3440.7113,3440.716333,1,103221339,103221489,150,0.09471073199763524
38301,3440.7212,3440.810367,1,103221636,103224311,2675,0.8051596745804808
38302,3441.079267,3441.0993,1,103232378,103232979,601,0.6614331182063989
38303,3441.101433,3441.137067,1,103233042,103234112,1070,0.7797476721265383
38304,3441.1382,3441.1427,1,103234146,103234281,135,-0.06320991877253421
38305,3441.144433,3441.192967,1,103234332,103235789,1457,0.499612870057718
38306,3441.209733,3441.213133,1,103236291,103236393,102,0.18269430043707344
38307,3441.2142,3441.219433,1,103236426,103236582,156,-0.4550229719560791
38308,3441.306433,3441.507767,1,103239192,103245233,6041,0.8107194694661278
38309,3441.508767,3441.516733,1,103245263,103245501,238,0.5664932327220193
38310,3441.5393,3441.555567,1,103246179,103246667,488,0.05721359009289332
38311,3441.556633,3441.5609,1,103246698,103246827,129,
38312,3441.5658,3441.5733,1,103246974,103247199,225,0.20809128599106702
38313,3441.7292,3441.758133,1,103251876,103252743,867,0.6735061756532824
38314,3442.036933,3442.040033,1,103261107,103261200,93,-0.3665827495921473
38315,3442.062367,3442.093233,1,103261871,103262796,925,0.7611324304061707
38316,3442.107933,3442.202133,1,103263237,103266063,2826,0.7603948113643385
38317,3442.2063,3442.2925,1,103266189,103268775,2586,0.7746398522873879
38318,3442.303133,3442.330633,1,103269093,103269918,825,0.686616765303819
38319,3442.376333,3442.495233,1,103271289,103274856,3567,0.8026491165286495
38320,3442.506367,3442.5123,1,103275191,103275369,178,-0.06518163310915291
38321,3442.515767,3442.5212,1,103275473,103275636,163,0.6513684377503723
38322,3442.5356,3442.5415,1,103276068,103276245,177,-0.2158701898582294
38323,3442.5474,3442.551833,1,103276422,103276554,132,-0.2066797289555282
38324,3442.706733,3442.756733,1,103281201,103282701,1500,0.8285721923846272
38325,3442.7668,3442.811733,1,103283004,103284351,1347,0.6423946446686426
38326,3442.839533,3442.8436,1,103285185,103285308,123,-0.0096540762978899
38327,3442.8516,3442.856467,1,103285548,103285694,146,0.0749781514339461
38328,3442.8583,3442.8661,1,103285749,103285983,234,0.054554547343846266
38329,3442.8768,3442.8837,1,103286304,103286511,207,0.5627780136092978
38330,3442.886133,3443.0512,1,103286583,103291536,4953,0.8246104347195138
38331,3443.074967,3443.087933,1,103292249,103292637,388,0.16864631137033403
38332,3443.2992,3443.3028,1,103298976,103299084,108,0.6973101683645874
38333,3443.312667,3443.365367,1,103299380,103300961,1581,0.7677525804973978
38334,3443.3702,3443.427533,1,103301106,103302825,1719,0.6634177366761711
38335,3443.4314,3443.532733,1,103302942,103305981,3039,0.814910265627896
38336,3443.535233,3443.552333,1,103306056,103306569,513,0.4941889300860637
38337,3443.559133,3443.651367,1,103306773,103309541,2768,0.7858685401553845
38338,3443.6553,3443.6806,1,103309659,103310418,759,0.6682830280160729
38339,3443.6829,3443.7818,1,103310487,103313454,2967,0.7495765233018158
38340,3443.792067,3443.795233,1,103313762,103313856,94,0.5847414309960847
38341,3443.796467,3443.803433,1,103313894,103314102,208,-0.12259742127762423
38342,3443.8061,3443.809367,1,103314183,103314281,98,-0.3391550193873893
38343,3444.244,3444.301567,1,103327320,103329047,1727,0.7825919777163111
38344,3444.3173,3444.3203,1,103329519,103329609,90,0.3761072909307572
38345,3444.3296,3444.3364,1,103329888,103330092,204,0.03584895209995435
38346,3444.750133,3444.764533,1,103342503,103342935,432,-0.19728492252897853
38347,3444.7673,3444.779833,1,103343019,103343394,375,0.3042345232567097
38348,3444.8105,3444.8526,1,103344315,103345578,1263,0.7918504304504537
38349,3444.857733,3444.8786,1,103345731,103346358,627,0.42450935006589663
38350,3444.9198,3444.940633,1,103347594,103348218,624,0.6930350523113392
38351,3444.964367,3444.970467,1,103348931,103349114,183,0.3461847931933828
38352,3444.9729,3445.0218,1,103349187,103350654,1467,0.7388080777716993
38353,3445.046467,3445.066367,1,103351394,103351991,597,0.7716838729371011
38354,3445.085533,3445.1017,1,103352565,103353051,486,0.7627105064697516
38355,3445.105867,3445.118367,1,103353176,103353551,375,0.7531093341395279
38356,3445.140433,3445.1462,1,103354212,103354386,174,0.002359863857253205
38357,3445.153867,3445.1961,1,103354616,103355883,1267,0.241973250333171
38358,3445.2105,3445.2175,1,103356315,103356525,210,0.22145822143800567
38359,3445.220567,3445.280267,1,103356617,103358408,1791,0.815774018108412
38360,3445.2879,3445.331933,1,103358637,103359957,1320,0.8032754889884575
38361,3445.348733,3445.3827,1,103360461,103361481,1020,0.22063921641450587
38362,3445.3909,3445.403467,1,103361727,103362104,377,0.16416437006398277
38363,3445.407167,3445.517767,1,103362215,103365533,3318,0.8270045947655467
38364,3445.5399,3445.634867,1,103366197,103369046,2849,0.7775519675755084
38365,3445.665033,3445.675767,1,103369950,103370273,323,0.009028492713387548
38366,3446.324133,3446.330333,1,103389723,103389909,186,0.5340351498855306
38367,3446.333633,3446.336767,1,103390008,103390103,95,0.6863429241441056
38368,3446.341933,3446.3482,1,103390257,103390446,189,0.4951437254330781
38369,3446.362133,3446.4128,1,103390863,103392384,1521,0.709715373769816
38370,3446.434933,3446.497067,1,103393047,103394912,1865,0.7778532004573513
38371,3446.502,3446.5748,1,103395060,103397244,2184,0.7056876335444965
38372,3446.588567,3446.623933,1,103397657,103398717,1060,0.7255491262242706
38373,3446.639867,3446.675467,1,103399196,103400264,1068,0.8053823858531237
38374,3446.6908,3446.6971,1,103400724,103400913,189,0.6231387700628445
38375,3446.7083,3446.715667,1,103401249,103401470,221,0.3315983835353671
38376,3446.737033,3446.776967,1,103402110,103403309,1199,0.04316647885752373
38377,3446.779867,3446.7876,1,103403396,103403628,232,0.013075732766289996
38378,3446.803133,3446.914133,1,103404093,103407423,3330,0.8027935774546684
38379,3446.916367,3446.922533,1,103407491,103407675,184,0.6922159472744763
38380,3446.9365,3446.9481,1,103408095,103408443,348,0.0959431504413915
38381,3446.9491,3446.9524,1,103408473,103408572,99,-0.10819866948162074
38382,3446.9727,3446.994233,1,103409181,103409826,645,0.15505730395425907
38383,3447.054633,3447.1846,1,103411638,103415538,3900,0.7833719205307063
38384,3447.187133,3447.196167,1,103415613,103415885,272,0.35665033995508355
38385,3447.218267,3447.225767,1,103416548,103416773,225,-0.03639632738715744
38386,3447.510833,3447.5144,1,103425324,103425432,108,0.3407479410484862
38387,3447.5203,3447.6589,1,103425609,103429767,4158,0.7358024327623158
38388,3447.676967,3447.805567,1,103430309,103434167,3858,0.7197361489945445
38389,3447.816967,3447.840767,1,103434509,103435223,714,0.03010141561112489
38390,3447.843567,3447.8568,1,103435307,103435704,397,-0.3207689558080867
38391,3447.858167,3447.8666,1,103435745,103435998,253,-0.49850629685515324
38392,3447.9271,3448.1046,1,103437813,103443138,5325,0.8259426302892351
38393,3448.110767,3448.1357,1,103443323,103444071,748,0.80331107061386
38394,3448.137,3448.1781,1,103444110,103445343,1233,0.7260506055422793
38395,3448.1804,3448.183667,1,103445412,103445510,98,-0.08230807623969603
38396,3448.187167,3448.311033,1,103445615,103449330,3715,0.8539196015989509
38397,3448.3308,3448.335533,1,103449924,103450065,141,0.783823595226939
38398,3448.339467,3448.358233,1,103450184,103450746,562,0.07083913551781064
38399,3448.359633,3448.374533,1,103450788,103451235,447,0.32746483190137465
38400,3448.384433,3448.390433,1,103451532,103451712,180,-0.0034028919201454
38401,3449.066433,3449.070133,1,103471992,103472103,111,0.40055093479258325
38402,3449.074933,3449.158333,1,103472247,103474749,2502,0.8357234255267131
38403,3449.1597,3449.162767,1,103474791,103474883,92,-0.012446568671092633
38404,3449.1723,3449.177967,1,103475169,103475339,170,-0.037484407309426794
38405,3449.470433,3449.475633,1,103484112,103484268,156,0.7817744855519255
38406,3449.476733,3449.5698,1,103484301,103487094,2793,0.6694889733116264
38407,3449.576633,3449.597667,1,103487298,103487930,632,0.7214131669839458
38408,3449.6126,3449.694633,1,103488378,103490838,2460,0.7414338218780459
38409,3449.7005,3449.717567,1,103491015,103491527,512,0.5571573923398704
38410,3449.719267,3449.723267,1,103491578,103491698,120,0.24233860975378604
38411,3449.725767,3449.774133,1,103491773,103493223,1450,0.5794916191573449
38412,3449.777567,3449.9009,1,103493327,103497027,3700,0.76344247417074
38413,3449.903467,3449.973,1,103497104,103499190,2086,0.7480645135397929
38414,3449.974733,3449.979067,1,103499241,103499372,131,0.46537619384769124
38415,3449.980733,3450.0686,1,103499421,103502058,2637,0.7585120405976842
38416,3450.083433,3450.086767,1,103502502,103502603,101,0.1312614656312887
38417,3450.112167,3450.116267,1,103503365,103503488,123,-0.32617529395032346
38418,3450.5088,3450.522067,1,103515264,103515662,398,0.5305002131754529
38419,3450.5361,3450.541767,1,103516083,103516253,170,0.5755691593989352
38420,3450.5434,3450.547833,1,103516302,103516434,132,0.1412970317717212
38421,3450.556967,3450.565633,1,103516709,103516968,259,0.4446800823389442
38422,3450.5755,3450.605767,1,103517265,103518173,908,0.6507719935979522
38423,3450.624267,3450.638633,1,103518728,103519158,430,0.5379843839769878
38424,3450.6413,3450.648,1,103519239,103519440,201,0.11612669013544706
38425,3450.6844,3450.688333,1,103520532,103520649,117,0.4194351322445285
38426,3450.697167,3450.714233,1,103520915,103521426,511,0.5854299983644613
38427,3450.732633,3450.751167,1,103521978,103522535,557,0.5706069592379132
38428,3450.7577,3450.774233,1,103522731,103523226,495,0.5088104873433151
38429,3450.796,3450.801867,1,103523880,103524056,176,0.6173897330502085
38430,3450.804033,3450.814667,1,103524120,103524440,320,0.6156109321742131
38431,3450.836067,3450.848,1,103525082,103525440,358,0.5878498444404258
38432,3450.858067,3450.865233,1,103525742,103525956,214,0.501572419297685
38433,3450.888633,3450.894833,1,103526658,103526844,186,0.5817356557817017
38434,3450.901967,3450.94,1,103527059,103528200,1141,0.1254754123671796
38435,3450.9422,3450.952,1,103528266,103528560,294,0.08979424211105452
38436,3450.96,3450.9634,1,103528800,103528902,102,-0.34523122523597244
38437,3450.971067,3450.9872,1,103529132,103529616,484,0.7593209299673389
38438,3450.989933,3451.080633,1,103529697,103532418,2721,0.7608849490922415
38439,3451.096267,3451.099933,1,103532888,103532997,109,0.6893553068796658
38440,3451.314733,3451.319667,1,103539441,103539590,149,0.534316693901397
38441,3451.320733,3451.341133,1,103539621,103540233,612,0.7144472548901584
38442,3451.3428,3451.489567,1,103540284,103544687,4403,0.8073984020079841
38443,3451.511933,3451.6121,1,103545357,103548363,3006,0.7597138991242831
38444,3451.6222,3451.626867,1,103548666,103548806,140,0.06361440138624362
38445,3451.6289,3451.633033,1,103548867,103548990,123,-0.07011096817619286
38446,3451.638233,3451.649333,1,103549146,103549479,333,-0.08473519228105125
38447,3451.982833,3451.998633,1,103559484,103559958,474,0.6698333736986263
38448,3452.0043,3452.0862,1,103560129,103562586,2457,0.8491614414686031
38449,3452.0998,3452.1928,1,103562994,103565784,2790,0.620448557988628
38450,3452.211733,3452.230033,1,103566351,103566900,549,0.7550800462742159
38451,3452.248433,3452.2612,1,103567452,103567836,384,0.7341758205463929
38452,3452.270367,3452.2897,1,103568111,103568691,580,0.4686292783328633
38453,3452.3257,3452.335733,1,103569771,103570071,300,0.1944295661719604
38454,3452.339033,3452.359233,1,103570170,103570776,606,0.24071168672579799
38455,3452.384133,3452.484267,1,103571523,103574528,3005,0.6316761804805006
38456,3452.503,3452.536333,1,103575090,103576089,999,0.6734977337480031
38457,3452.542633,3452.619367,1,103576278,103578581,2303,0.7105864956201048
38458,3452.6204,3452.644233,1,103578612,103579326,714,0.8330362075231953
38459,3452.664733,3452.6748,1,103579941,103580244,303,0.6807044046708279
38460,3452.688067,3452.698767,1,103580642,103580963,321,0.014708498403071913
38461,3452.7001,3452.716733,1,103581003,103581501,498,0.15517832555064462
38462,3452.7179,3452.723033,1,103581537,103581690,153,0.40144112462455933
38463,3452.731067,3452.854167,1,103581932,103585625,3693,0.8428693408260686
38464,3452.950433,3452.968067,1,103588512,103589042,530,0.6832815888149651
38465,3453.229133,3453.237567,1,103596873,103597127,254,0.1601791825170266
38466,3453.241333,3453.305133,1,103597239,103599153,1914,0.8068502979652523
38467,3453.3104,3453.432367,1,103599312,103602971,3659,0.8251898581245491
38468,3453.4336,3453.4455,1,103603008,103603365,357,0.5292986872856522
38469,3453.471133,3453.542567,1,103604133,103606277,2144,0.6410464077267285
38470,3453.5483,3453.6539,1,103606449,103609617,3168,0.7865193465869227
38471,3453.6816,3453.686867,1,103610448,103610606,158,-0.1412050138509947
38472,3454.301733,3454.311,1,103629051,103629330,279,0.7051147646395974
38473,3454.316367,3454.335267,1,103629491,103630058,567,0.6318973617713974
38474,3454.3892,3454.401933,1,103631676,103632057,381,0.7036169295348436
38475,3454.423067,3454.440267,1,103632692,103633208,516,0.3955399264034839
38476,3454.443233,3454.481867,1,103633296,103634456,1160,0.5905034691244084
38477,3454.5114,3454.5273,1,103635342,103635819,477,0.7638067404189055
38478,3454.551467,3454.5819,1,103636544,103637457,913,0.7235546176314924
38479,3454.619567,3454.630367,1,103638587,103638911,324,0.6041431638445264
38480,3454.632533,3454.6394,1,103638975,103639182,207,-0.0699278416501759
38481,3454.644067,3454.6614,1,103639322,103639842,520,0.039711544928114066
38482,3454.667867,3454.675367,1,103640036,103640261,225,0.20152515852295033
38483,3454.700533,3454.824833,1,103641015,103644744,3729,0.7482949510895625
38484,3454.839167,3454.8589,1,103645175,103645767,592,0.513082143465817
38485,3454.8599,3454.863167,1,103645797,103645895,98,
38486,3454.871767,3454.8865,1,103646153,103646595,442,0.12052892720014274
38487,3454.889733,3454.901967,1,103646691,103647059,368,0.3666580879222335
38488,3454.903433,3454.912733,1,103647102,103647381,279,0.08976273718307728
38489,3454.932733,3454.957,1,103647981,103648710,729,0.6975543340326517
38490,3454.958767,3455.113367,1,103648763,103653401,4638,0.8587229463584372
38491,3455.117433,3455.179767,1,103653522,103655393,1871,0.6104451037215441
38492,3455.1809,3455.188867,1,103655427,103655666,239,0.7681532131772195
38493,3455.210067,3455.329633,1,103656302,103659888,3586,0.7267411722225783
38494,3455.3859,3455.389733,1,103661577,103661691,114,-0.31991466018312353
38495,3455.393267,3455.399267,1,103661798,103661978,180,-0.3325183648308621
38496,3455.5248,3455.545533,1,103665744,103666365,621,0.6293581594742257
38497,3455.547133,3455.582233,1,103666413,103667466,1053,0.8518172477487627
38498,3455.593233,3455.638567,1,103667796,103669157,1361,0.7693321736785425
38499,3455.6578,3455.671367,1,103669734,103670141,407,-0.011241915813665406
38500,3455.687767,3455.692767,1,103670633,103670783,150,0.5550773360024469
38501,3455.694933,3455.699733,1,103670847,103670991,144,-0.20573264382538062
38502,3455.974033,3455.997867,1,103679220,103679936,716,0.6620551363352093
38503,3456.0343,3456.051733,1,103681029,103681551,522,0.6514978264827532
38504,3456.063367,3456.070567,1,103681901,103682117,216,0.5149645647552702
38505,3456.107933,3456.115767,1,103683237,103683473,236,0.20232653339047985
38506,3456.117267,3456.1364,1,103683518,103684092,574,0.41118347455456744
38507,3456.1658,3456.185067,1,103684974,103685552,578,0.7141511399391336
38508,3456.202667,3456.258067,1,103686080,103687742,1662,0.6080764114385819
38509,3456.269167,3456.291367,1,103688075,103688741,666,0.6211986708936128
38510,3456.3079,3456.346733,1,103689237,103690401,1164,0.5091761190020053
38511,3456.358133,3456.361633,1,103690743,103690848,105,0.03875185417237345
38512,3456.371367,3456.3904,1,103691141,103691712,571,0.582254112302115
38513,3456.432833,3456.469967,1,103692984,103694099,1115,0.11919084302995746
38514,3456.487267,3456.4904,1,103694618,103694712,94,0.5464533973865285
38515,3456.494067,3456.614267,1,103694822,103698428,3606,0.8394408308490181
38516,3456.6598,3456.7951,1,103699794,103703853,4059,0.799532197353782
38517,3456.821267,3456.836533,1,103704638,103705095,457,0.11165770333990076
38518,3457.327167,3457.3355,1,103719815,103720065,250,0.7279784627262836
38519,3457.3372,3457.3752,1,103720116,103721256,1140,0.7644422021766526
38520,3457.403233,3457.408033,1,103722096,103722240,144,0.84878966799431
38521,3457.409567,3457.4207,1,103722287,103722621,334,0.7567480940286755
38522,3457.435367,3457.4566,1,103723061,103723698,637,0.4706288392671211
38523,3457.458967,3457.5059,1,103723769,103725177,1408,0.5485839287648948
38524,3457.530967,3457.5486,1,103725929,103726458,529,0.65676343858418
38525,3457.5694,3457.584433,1,103727082,103727532,450,0.7297280644867231
38526,3457.585667,3457.600333,1,103727570,103728009,439,0.7007238946360064
38527,3457.625633,3457.661633,1,103728768,103729848,1080,0.12050053117782322
38528,3457.674667,3457.684967,1,103730240,103730549,309,0.09229626663320599
38529,3457.7173,3457.778433,1,103731519,103733352,1833,0.6083905902365405
38530,3457.780067,3457.825867,1,103733402,103734776,1374,0.75560033255117
38531,3457.8442,3457.849867,1,103735326,103735496,170,-0.03831488206519793
38532,3457.8551,3457.871933,1,103735653,103736157,504,0.16824459812826914
38533,3457.882067,3457.887533,1,103736462,103736625,163,0.060293734992976654
38534,3457.889467,3458.009367,1,103736684,103740281,3597,0.8642889919566457
38535,3458.231833,3458.3854,1,103746954,103751562,4608,0.7864615002986781
38536,3458.3918,3458.400667,1,103751754,103752020,266,-0.12474783817401572
38537,3458.403233,3458.407433,1,103752096,103752222,126,
38538,3458.415267,3458.420033,1,103752458,103752600,142,
38539,3459.122333,3459.163733,1,103773669,103774911,1242,0.6199282846891395
38540,3459.178633,3459.199,1,103775358,103775970,612,0.6597077202212775
38541,3459.2282,3459.2313,1,103776846,103776939,93,0.7629509927733289
38542,3459.251067,3459.265533,1,103777532,103777965,433,0.7491119166708285
38543,3459.446833,3459.495667,1,103783404,103784870,1466,0.8158448586973907
38544,3459.5055,3459.515167,1,103785165,103785455,290,0.44746305007730863
38545,3459.516167,3459.541233,1,103785485,103786236,751,0.7814645584188715
38546,3459.5696,3459.572833,1,103787088,103787184,96,
38547,3459.58,3459.608367,1,103787400,103788251,851,0.183783653799528
38548,3459.7183,3459.838733,1,103791549,103795161,3612,0.7966089121149281
38549,3459.841033,3459.849267,1,103795230,103795478,248,-0.04842680964232321
38550,3459.872967,3459.876267,1,103796189,103796288,99,
38551,3460.306433,3460.346533,1,103809192,103810395,1203,0.6682748809879071
38552,3460.363467,3460.3848,1,103810904,103811544,640,0.7217340102986809
38553,3460.407633,3460.417067,1,103812228,103812512,284,0.7293434037347806
38554,3460.635633,3460.730667,1,103819068,103821920,2852,0.8366336495522112
38555,3460.758333,3460.7615,1,103822749,103822845,96,0.5100436047615164
38556,3460.7691,3460.778067,1,103823073,103823342,269,-0.049508722478133725
38557,3460.782,3460.788267,1,103823460,103823648,188,0.40623038988586446
38558,3460.9483,3460.955433,1,103828449,103828662,213,0.5994338925256404
38559,3460.957,3461.133167,1,103828710,103833995,5285,0.7646228277791889
38560,3461.142933,3461.2878,1,103834287,103838634,4347,0.7781884654317751
38561,3461.289867,3461.3307,1,103838696,103839921,1225,0.7849632418848013
38562,3461.347267,3461.351167,1,103840418,103840535,117,0.2499259552894247
38563,3461.359467,3461.443367,1,103840784,103843301,2517,0.814142434951801
38564,3461.4675,3461.474233,1,103844025,103844226,201,
38565,3461.475233,3461.479,1,103844256,103844370,114,0.4299719273522793
38566,3461.6923,3461.747033,1,103850769,103852410,1641,0.7719767296920901
38567,3461.753067,3461.799333,1,103852592,103853979,1387,0.7921319318786504
38568,3461.812133,3461.815433,1,103854363,103854462,99,0.5147508387679263
38569,3461.8286,3461.844433,1,103854858,103855332,474,0.027139047707473038
38570,3462.165367,3462.2988,1,103864961,103868964,4003,0.8058124714597684
38571,3462.303767,3462.384333,1,103869113,103871529,2416,0.7643368401508325
38572,3462.4029,3462.467133,1,103872087,103874013,1926,0.829768333186188
38573,3462.4742,3462.515667,1,103874226,103875470,1244,0.7550664105937586
38574,3462.550067,3462.559167,1,103876502,103876775,273,0.20611559738810323
38575,3462.560367,3462.586233,1,103876811,103877586,775,0.014688539598536016
38576,3462.684067,3462.710367,1,103880522,103881311,789,-0.3986955293758506
38577,3462.718467,3462.746233,1,103881554,103882386,832,-0.12159114222760078
38578,3462.752333,3462.760833,1,103882569,103882824,255,-0.45462961636124255
38579,3462.7973,3462.8057,1,103883919,103884171,252,0.6312237028520544
38580,3462.812867,3462.996767,1,103884386,103889903,5517,0.812769190445741
38581,3463.010567,3463.222233,1,103890317,103896666,6349,0.7067949766348385
38582,3463.246533,3463.251167,1,103897395,103897535,140,-0.23197061651895792
38583,3463.252567,3463.2594,1,103897577,103897782,205,-0.1623355161125155
38584,3463.8925,3463.896267,1,103916775,103916888,113,0.5566198796534102
38585,3463.934767,3463.9706,1,103918043,103919118,1075,0.20877880593380088
38586,3463.990733,3464.013933,1,103919721,103920417,696,0.5772478843198574
38587,3464.048533,3464.055333,1,103921455,103921659,204,0.47681041817307535
38588,3464.059733,3464.079567,1,103921791,103922387,596,0.5061820548169279
38589,3464.097333,3464.1131,1,103922919,103923393,474,0.5056559520921329
38590,3464.128133,3464.133067,1,103923843,103923992,149,0.16492887660767241
38591,3464.134133,3464.144267,1,103924023,103924328,305,-0.07783861338350824
38592,3464.164233,3464.183167,1,103924926,103925495,569,0.6080171337471095
38593,3464.2037,3464.217167,1,103926111,103926515,404,0.5619862725927669
38594,3464.224733,3464.231367,1,103926741,103926941,200,0.5628440138957598
38595,3464.260067,3464.263833,1,103927802,103927914,112,0.30706672104797783
38596,3464.268967,3464.315967,1,103928069,103929479,1410,0.19372590298330158
38597,3464.329333,3464.3327,1,103929879,103929981,102,0.028046592128146825
38598,3464.336967,3464.3401,1,103930109,103930203,94,
38599,3464.3434,3464.4485,1,103930302,103933455,3153,0.79680843268158
38600,3464.473933,3464.490033,1,103934217,103934700,483,0.06733876102323597
38601,3464.491533,3464.502333,1,103934745,103935069,324,0.1932377445721097
38602,3464.519567,3464.678733,1,103935587,103940361,4774,0.8249167447077572
38603,3465.0644,3465.141433,1,103951932,103954242,2310,0.7911435869586929
38604,3465.158133,3465.162767,1,103954743,103954883,140,0.20816490680787308
38605,3465.6557,3465.668267,1,103969671,103970048,377,0.6372631186090245
38606,3465.701133,3465.713167,1,103971033,103971395,362,0.5769247652165798
38607,3465.716567,3465.8181,1,103971497,103974543,3046,0.6092975188066709
38608,3465.8229,3465.829,1,103974687,103974870,183,0.27302324282681145
38609,3465.8321,3465.875467,1,103974963,103976264,1301,0.7792427524665155
38610,3465.8993,3465.932133,1,103976979,103977963,984,0.6128963843600709
38611,3465.942533,3465.998733,1,103978275,103979961,1686,0.21763467073672213
38612,3466.014167,3466.062433,1,103980425,103981872,1447,0.8033124527545332
38613,3466.0711,3466.084267,1,103982133,103982528,395,0.6765980158139783
38614,3466.1107,3466.1226,1,103983321,103983678,357,0.21834333931343203
38615,3466.1237,3466.1445,1,103983711,103984335,624,0.19232233601839963
38616,3466.146067,3466.149467,1,103984382,103984484,102,
38617,3466.199267,3466.2136,1,103985978,103986408,430,0.7407012425575983
38618,3466.2151,3466.256767,1,103986453,103987703,1250,0.8345484883695455
38619,3466.257933,3466.299,1,103987737,103988970,1233,0.8382842486318745
38620,3466.3043,3466.308333,1,103989129,103989249,120,
38621,3466.3331,3466.352767,1,103989993,103990583,590,0.2696401461970201
38622,3466.531767,3466.810733,1,103995953,104004321,8368,0.7883585136271067
38623,3466.830067,3466.834033,1,104004902,104005020,118,-0.5410329872281842
38624,3466.8357,3466.84,1,104005071,104005200,129,-0.06164580416003596
38625,3466.845533,3466.850767,1,104005365,104005523,158,-0.1995795156837023
38626,3466.961467,3467.009567,1,104008844,104010287,1443,0.7372645028037655
38627,3467.011,3467.027767,1,104010330,104010833,503,0.8578644782735646
38628,3467.030233,3467.088433,1,104010906,104012652,1746,0.7384328376759902
38629,3467.095433,3467.2774,1,104012862,104018322,5460,0.8028557593134967
38630,3467.281233,3467.3161,1,104018436,104019483,1047,0.7158819453618717
38631,3467.345,3467.3554,1,104020350,104020662,312,0.1104635775502429
38632,3467.689433,3467.717733,1,104030682,104031531,849,0.6782377180912059
38633,3467.728367,3467.781133,1,104031851,104033433,1582,0.6860178351210877
38634,3467.789967,3467.828067,1,104033699,104034842,1143,0.6526271656968383
38635,3467.844633,3467.8872,1,104035338,104036616,1278,0.5751501251456219
38636,3467.8973,3467.908767,1,104036919,104037263,344,0.63128795522591
38637,3467.9524,3467.9601,1,104038572,104038803,231,0.1752087168020368
38638,3467.964,3467.983167,1,104038920,104039495,575,0.21331571618220216
38639,3467.984533,3467.992633,1,104039535,104039778,243,0.2341403176340261
38640,3468.021733,3468.035267,1,104040651,104041058,407,0.7907491586223662
38641,3468.037733,3468.127133,1,104041131,104043813,2682,0.8036354740888345
38642,3468.1477,3468.1533,1,104044431,104044599,168,-0.18585824848527238
38643,3468.154633,3468.1634,1,104044638,104044902,264,-0.19768488138375875
38644,3468.172533,3468.334667,1,104045175,104050040,4865,0.8444710664496833
38645,3468.970367,3468.981567,1,104069111,104069447,336,0.5900724970652048
38646,3468.988967,3468.993433,1,104069669,104069802,133,0.21867600516498673
38647,3469.046033,3469.058067,1,104071380,104071742,362,0.9035681274680614
38648,3469.076033,3469.08,1,104072280,104072400,120,0.4758860905281583
38649,3469.133367,3469.1427,1,104074001,104074281,280,0.7584431092077217
38650,3469.145133,3469.151433,1,104074353,104074542,189,0.6672277042806599
38651,3469.1746,3469.222733,1,104075238,104076681,1443,0.38699679502745626
38652,3469.259133,3469.2723,1,104077773,104078169,396,0.6730820963506826
38653,3469.298,3469.3068,1,104078940,104079204,264,0.5983916748894904
38654,3469.312233,3469.322967,1,104079366,104079689,323,0.45740973637871074
38655,3469.3554,3469.366567,1,104080662,104080997,335,-0.1262522804000855
38656,3469.3749,3469.381633,1,104081247,104081448,201,0.16335853347538856
38657,3469.398067,3469.42,1,104081942,104082600,658,0.12096249196865466
38658,3469.460233,3469.539167,1,104083806,104086175,2369,0.757686402645253
38659,3469.5435,3469.568767,1,104086305,104087063,758,0.7188543157084462
38660,3469.587767,3469.593867,1,104087633,104087816,183,-0.13194252748210314
38661,3469.599167,3469.605633,1,104087975,104088168,193,0.06667010879271021
38662,3469.617467,3469.637767,1,104088524,104089133,609,0.07157842652410096
38663,3469.7208,3469.838267,1,104091624,104095148,3524,0.7854807238391126
38664,3469.851767,3469.8599,1,104095553,104095797,244,-0.24145532596336977
38665,3469.863067,3469.866633,1,104095892,104095998,106,0.320800463230146
38666,3470.0915,3470.118,1,104102745,104103540,795,0.7958579957572418
38667,3470.119533,3470.168167,1,104103585,104105045,1460,0.8504061933490809
38668,3470.169533,3470.284867,1,104105085,104108546,3461,0.8471227958349947
38669,3470.3079,3470.3345,1,104109237,104110035,798,0.7425102470401969
38670,3470.340267,3470.507833,1,104110208,104115234,5026,0.6174945317530676
38671,3470.5125,3470.517967,1,104115375,104115539,164,0.5749482912402377
38672,3470.542867,3470.547033,1,104116286,104116410,124,0.5837660529297101
38673,3470.550933,3470.560267,1,104116527,104116808,281,0.33812235835383675
38674,3471.3849,3471.418133,1,104141547,104142543,996,0.058195136607136606
38675,3471.453,3471.465033,1,104143590,104143950,360,0.6502023240231045
38676,3471.484933,3471.4925,1,104144547,104144775,228,0.6477378113554182
38677,3471.518667,3471.529033,1,104145560,104145870,310,0.5517415395130074
38678,3471.533767,3471.553967,1,104146013,104146619,606,0.4934496733021858
38679,3471.555467,3471.5621,1,104146664,104146863,199,0.57376967411427
38680,3471.566433,3471.5702,1,104146992,104147106,114,-0.24708080289770953
38681,3471.571467,3471.659833,1,104147144,104149794,2650,0.7964529039350116
38682,3471.6787,3471.685133,1,104150361,104150553,192,0.22420220195058377
38683,3471.690567,3471.698667,1,104150717,104150960,243,0.21491127152125664
38684,3472.185667,3472.200233,1,104165570,104166006,436,0.4780943218897275
38685,3472.205933,3472.248333,1,104166177,104167449,1272,0.8096919512609435
38686,3472.257233,3472.291667,1,104167716,104168750,1034,0.7857820783332614
38687,3472.310867,3472.325567,1,104169326,104169767,441,0.0503039165509813
38688,3472.329967,3472.3461,1,104169899,104170383,484,-0.029146838364006455
38689,3472.359233,3472.3649,1,104170776,104170947,171,-0.056426728409811146
38690,3472.454733,3472.469667,1,104173641,104174090,449,0.41651358073648265
38691,3472.4968,3472.617233,1,104174904,104178516,3612,0.8245525037810956
38692,3472.840333,3472.866633,1,104185209,104185998,789,0.6344533957659954
38693,3472.868867,3472.875867,1,104186066,104186276,210,0.11565912548702006
38694,3473.094,3473.2053,1,104192820,104196159,3339,0.6230551653075185
38695,3473.231367,3473.2616,1,104196941,104197848,907,0.625109566815028
38696,3473.2691,3473.3372,1,104198073,104200116,2043,0.6901354660053463
38697,3473.339867,3473.355467,1,104200196,104200664,468,0.6566897895461506
38698,3473.3636,3473.451367,1,104200908,104203541,2633,0.7914860438143297
38699,3473.467633,3473.471233,1,104204028,104204136,108,0.2457745904766864
38700,3473.473267,3473.477733,1,104204198,104204331,133,0.0817607606109849
38701,3473.478767,3473.484267,1,104204363,104204528,165,0.3800323759891381
38702,3474.296233,3474.301133,1,104228886,104229033,147,0.6363638957893017
38703,3474.3027,3474.323767,1,104229081,104229713,632,0.5774604787928365
38704,3474.353533,3474.3705,1,104230605,104231115,510,0.599365245627734
38705,3474.376033,3474.4019,1,104231280,104232057,777,0.7098736828466261
38706,3474.445933,3474.458,1,104233377,104233740,363,0.6175483669955579
38707,3474.469833,3474.484933,1,104234094,104234547,453,0.6396933030019698
38708,3474.519933,3474.526,1,104235597,104235780,183,0.3996699442586209
38709,3474.5293,3474.5455,1,104235879,104236365,486,0.7107106122425509
38710,3474.5664,3474.5845,1,104236992,104237535,543,0.5034389180478435
38711,3474.642133,3474.6621,1,104239263,104239863,600,0.7576276890587499
38712,3474.686233,3474.697267,1,104240586,104240918,332,0.5923225635586232
38713,3474.707733,3474.717833,1,104241231,104241534,303,0.6235283237613748
38714,3474.932167,3474.999567,1,104247965,104249987,2022,0.8125249329583326
38715,3475.001467,3475.059633,1,104250044,104251788,1744,0.8351609340200105
38716,3475.062033,3475.118233,1,104251860,104253546,1686,0.7622267816367713
38717,3475.119667,3475.129833,1,104253590,104253894,304,0.2807100909268929
38718,3475.148733,3475.211767,1,104254461,104256353,1892,0.7754730237429162
38719,3475.218133,3475.235167,1,104256543,104257055,512,0.692776250727293
38720,3475.238133,3475.249467,1,104257143,104257484,341,0.5380225149526555
38721,3475.275233,3475.278933,1,104258256,104258367,111,-0.23844152487620002
38722,3475.2934,3475.2969,1,104258802,104258907,105,-0.2138983336815177
38723,3475.3349,3475.338333,1,104260047,104260149,102,0.018454339067664343
38724,3475.3402,3475.409867,1,104260206,104262296,2090,0.43411669292213956
38725,3475.424167,3475.428467,1,104262725,104262854,129,0.5861120334717913
38726,3475.433867,3475.651167,1,104263016,104269535,6519,0.82766850898086
38727,3475.674133,3475.699533,1,104270223,104270985,762,0.7511240199127817
38728,3475.7046,3475.7601,1,104271138,104272803,1665,0.7474537221699218
38729,3475.769267,3475.806233,1,104273078,104274186,1108,0.6703454401847632
38730,3475.854067,3475.862567,1,104275622,104275877,255,0.15093328318324722
38731,3475.864733,3475.873467,1,104275941,104276204,263,0.044314175657414634
38732,3475.878533,3475.897467,1,104276355,104276924,569,0.20549750380926568
38733,3475.899833,3475.9083,1,104276994,104277249,255,0.10409977649083157
38734,3476.1052,3476.136567,1,104283156,104284097,941,0.6902509990097438
38735,3476.3968,3476.485267,1,104291904,104294558,2654,0.8078797919496563
38736,3476.490267,3476.5967,1,104294708,104297901,3193,0.7946932689976886
38737,3476.602233,3476.6187,1,104298066,104298561,495,0.5455330938309266
38738,3476.6219,3476.653067,1,104298657,104299592,935,0.7152384038178384
38739,3476.656933,3476.844667,1,104299707,104305340,5633,0.7679583150782805
38740,3476.853167,3476.8613,1,104305595,104305839,244,0.09288317978075959
38741,3476.8823,3476.8928,1,104306469,104306784,315,-0.2000912221885881
38742,3476.9477,3477.055833,1,104308431,104311674,3243,0.7980358230287914
38743,3477.058467,3477.070333,1,104311754,104312109,355,-0.03829804100682282
38744,3477.775433,3477.792267,1,104333262,104333768,506,0.6320033276972055
38745,3477.793267,3477.8159,1,104333798,104334477,679,0.6500320110767379
38746,3477.8346,3477.853,1,104335038,104335590,552,0.6868441461267678
38747,3478.0677,3478.1646,1,104342031,104344938,2907,0.8002077322844178
38748,3478.180033,3478.185867,1,104345400,104345576,176,0.5056797454980921
38749,3478.198133,3478.202167,1,104345943,104346065,122,0.3383793228632384
38750,3478.2032,3478.2095,1,104346096,104346285,189,0.23299379792428115
38751,3478.234,3478.239567,1,104347020,104347187,167,0.5140938897577023
38752,3478.2409,3478.277367,1,104347227,104348321,1094,0.8245192560868859
38753,3478.2784,3478.404867,1,104348352,104352146,3794,0.8469762795107891
38754,3479.159467,3479.1658,1,104374784,104374974,190,0.6730056338482322
38755,3479.183033,3479.200167,1,104375490,104376005,515,0.6151975548519373
38756,3479.2278,3479.258533,1,104376834,104377755,921,0.7455697014046748
38757,3479.288967,3479.3086,1,104378669,104379258,589,0.5658657426390447
38758,3479.358333,3479.368267,1,104380749,104381048,299,0.31650934981709716
38759,3479.392933,3479.4055,1,104381787,104382165,378,0.5971323008333452
38760,3479.455733,3479.4715,1,104383671,104384145,474,0.7466539622648681
38761,3479.500533,3479.5072,1,104385015,104385216,201,0.6694728503893219
38762,3479.5148,3479.5228,1,104385444,104385684,240,0.4147189818269646
38763,3479.7689,3479.774433,1,104393067,104393232,165,0.5880692462440934
38764,3479.777033,3479.842267,1,104393310,104395268,1958,0.8349754732153348
38765,3479.843433,3479.902133,1,104395302,104397063,1761,0.7923951322085849
38766,3479.9105,3479.962467,1,104397315,104398874,1559,0.7842600184576024
38767,3479.963967,3479.995667,1,104398919,104399870,951,0.7987107667044693
38768,3479.997033,3480.011367,1,104399910,104400341,431,0.5517025428265578
38769,3480.034667,3480.088967,1,104401040,104402669,1629,0.7716048729426027
38770,3480.101033,3480.117367,1,104403030,104403521,491,0.6128636102923571
38771,3480.121467,3480.1419,1,104403644,104404257,613,0.4460133450643277
38772,3480.158067,3480.1623,1,104404742,104404869,127,-0.31290078594327586
38773,3480.163467,3480.197267,1,104404904,104405918,1014,-0.045509846844729716
38774,3480.222567,3480.3717,1,104406677,104411151,4474,0.8120647336784775
38775,3480.374333,3480.4647,1,104411229,104413941,2712,0.7814759340022168
38776,3480.480433,3480.4839,1,104414412,104414517,105,-0.21775355449549672
38777,3480.647933,3480.835733,1,104419437,104425071,5634,0.790975661153023
38778,3480.8741,3480.878767,1,104426223,104426363,140,0.5398462309169235
38779,3481.1687,3481.185167,1,104435061,104435555,494,0.7046926273358467
38780,3481.197933,3481.253667,1,104435937,104437610,1673,0.6839608569456707
38781,3481.257733,3481.2672,1,104437731,104438016,285,0.3188054829570963
38782,3481.285033,3481.325833,1,104438550,104439774,1224,0.7767014721628774
38783,3481.343733,3481.381767,1,104440311,104441453,1142,0.7664890555703264
38784,3481.3961,3481.407,1,104441883,104442210,327,0.38935644620191595
38785,3481.438033,3481.442067,1,104443140,104443262,122,-0.18179962344111897
38786,3481.448967,3481.456033,1,104443469,104443680,211,-0.17503353587201628
38787,3481.458867,3481.4625,1,104443766,104443875,109,-0.18827218600973084
38788,3481.4865,3481.4928,1,104444595,104444784,189,0.008341738869105412
38789,3481.5366,3481.589033,1,104446098,104447670,1572,0.8050366828087486
38790,3481.594567,3481.637667,1,104447837,104449130,1293,0.8053397504541007
38791,3481.6532,3481.662867,1,104449596,104449886,290,-0.09435214652769294
38792,3481.6715,3481.6749,1,104450145,104450247,102,-0.007808525220771675
38793,3481.681067,3481.6896,1,104450432,104450688,256,0.1858080045844757
38794,3481.694533,3481.698167,1,104450835,104450945,110,-0.039562712831604535
38795,3481.714233,3481.723633,1,104451426,104451708,282,0.015119847383853498
38796,3481.724733,3481.73,1,104451741,104451900,159,0.043973692567923134
38797,3481.731367,3481.766267,1,104451941,104452988,1047,0.11576243352050518
38798,3481.7703,3481.776033,1,104453109,104453280,171,0.7044127765237375
38799,3481.7772,3481.9656,1,104453316,104458968,5652,0.8222343388826706
38800,3482.4739,3482.500133,1,104474217,104475003,786,0.5872325097948851
38801,3482.502333,3482.507333,1,104475069,104475219,150,0.5178798085257682
38802,3482.5187,3482.570067,1,104475561,104477102,1541,0.7489253562582443
38803,3482.5733,3482.635867,1,104477199,104479076,1877,0.6664101325948028
38804,3482.643533,3482.649967,1,104479305,104479499,194,0.5643114032712296
38805,3482.658433,3482.672833,1,104479752,104480184,432,0.6750002066044609
38806,3482.6743,3482.6869,1,104480229,104480607,378,0.537815663896818
38807,3482.719433,3482.736767,1,104481582,104482103,521,0.0067485927786304165
38808,3482.738667,3482.7699,1,104482160,104483097,937,0.07769668867191247
38809,3482.7752,3482.779233,1,104483256,104483376,120,-0.28280324585853545
38810,3482.789333,3482.945067,1,104483679,104488352,4673,0.7236104561150587
38811,3482.951867,3483.096,1,104488556,104492880,4324,0.7664279768826516
38812,3483.111833,3483.120567,1,104493354,104493617,263,0.14736964808825498
38813,3483.138467,3483.1423,1,104494154,104494269,115,-0.4439551608903313
38814,3483.143567,3483.149467,1,104494307,104494484,177,-0.011540414079862713
38815,3483.521033,3483.5279,1,104505630,104505837,207,0.6137028914123959
38816,3483.5313,3483.5351,1,104505939,104506053,114,0.4264472860932782
38817,3483.5602,3483.575733,1,104506806,104507271,465,0.7328174280957829
38818,3483.5932,3483.610567,1,104507796,104508317,521,0.8075127806796752
38819,3483.642033,3483.6894,1,104509260,104510682,1422,0.5698517489681151
38820,3483.7183,3483.722567,1,104511549,104511677,128,-0.013486475801006923
38821,3483.773167,3483.780233,1,104513195,104513406,211,0.7698880140881699
38822,3483.784267,3483.791467,1,104513528,104513744,216,0.6283834301798403
38823,3483.8185,3483.821733,1,104514555,104514651,96,-0.0029247067692793846
38824,3483.825367,3483.8422,1,104514761,104515266,505,0.6891165040351075
38825,3483.8448,3483.868333,1,104515344,104516049,705,0.8392188259247455
38826,3483.9001,3483.906767,1,104517003,104517203,200,0.6749267545367599
38827,3483.907833,3483.916133,1,104517234,104517483,249,0.8066376326753374
38828,3483.940733,3483.955,1,104518221,104518650,429,0.6133997847223496
38829,3483.9603,3483.975467,1,104518809,104519264,455,0.7450340614034783
38830,3483.978733,3483.982567,1,104519361,104519477,116,0.05065960055116823
38831,3484.010567,3484.0271,1,104520317,104520813,496,-0.06873011142609649
38832,3484.028633,3484.0513,1,104520858,104521539,681,0.18912487044571144
38833,3484.055167,3484.061167,1,104521655,104521835,180,0.050209900629429066
38834,3484.087633,3484.1054,1,104522628,104523162,534,0.7647671004941531
38835,3484.107267,3484.206,1,104523218,104526180,2962,0.8100981784893168
38836,3484.225567,3484.261133,1,104526767,104527833,1066,0.0033373511554402936
38837,3484.2689,3484.274533,1,104528067,104528235,168,0.2024819593858062
38838,3484.298133,3484.471467,1,104528943,104534144,5201,0.7904730056200652
38839,3484.515567,3484.520967,1,104535467,104535629,162,0.34173337125091835
38840,3484.522167,3484.5261,1,104535665,104535783,118,0.5681114312247432
38841,3484.997933,3485.005967,1,104549937,104550179,242,0.5691612873347472
38842,3485.008167,3485.021667,1,104550245,104550650,405,0.552863154976506
38843,3485.0235,3485.0268,1,104550705,104550804,99,0.044062811514764134
38844,3485.027933,3485.041567,1,104550837,104551247,410,0.41444291862044486
38845,3485.043067,3485.069767,1,104551292,104552093,801,0.4536831628519259
38846,3485.071167,3485.092467,1,104552135,104552774,639,0.5777922500199478
38847,3485.404,3485.500433,1,104562120,104565012,2892,0.8108148912697579
38848,3486.105933,3486.116867,1,104583177,104583506,329,0.9064254576232291
38849,3486.2108,3486.231367,1,104586324,104586941,617,0.39103830142793794
38850,3486.2759,3486.286767,1,104588277,104588603,326,0.6987541534519368
38851,3486.3538,3486.365267,1,104590614,104590958,344,0.5797472481629924
38852,3486.395433,3486.407033,1,104591862,104592210,348,0.5817566716667557
38853,3486.557533,3486.655733,1,104596725,104599671,2946,0.7751360345389101
38854,3486.6886,3486.692667,1,104600658,104600780,122,0.4092687247820349
38855,3486.735233,3486.8524,1,104602056,104605572,3516,0.8499882811135036
38856,3487.691333,3487.6991,1,104630739,104630973,234,0.5890559180086316
38857,3487.721633,3487.741167,1,104631648,104632235,587,0.6355848451014445
38858,3487.769733,3487.810467,1,104633091,104634314,1223,0.7171024760721562
38859,3487.815733,3487.844067,1,104634471,104635322,851,0.5795923348751887
38860,3487.8466,3487.871367,1,104635398,104636141,743,0.8035237219256592
38861,3487.876233,3487.925967,1,104636286,104637779,1493,0.5933552176571701
38862,3487.945,3487.9552,1,104638350,104638656,306,0.6674942453003478
38863,3487.9579,3487.987033,1,104638737,104639610,873,0.6730623842794825
38864,3487.989933,3488.0157,1,104639697,104640471,774,0.6534467242856026
38865,3488.021333,3488.0441,1,104640639,104641323,684,0.42467068041611544
38866,3488.065367,3488.103367,1,104641961,104643101,1140,0.8042303044980694
38867,3488.118667,3488.140267,1,104643560,104644208,648,0.7747253796338047
38868,3488.1513,3488.1568,1,104644539,104644704,165,0.08828747014641193
38869,3488.165867,3488.221933,1,104644976,104646657,1681,0.0719667361531026
38870,3488.250167,3488.3529,1,104647505,104650587,3082,0.7871715803637864
38871,3488.375367,3488.3962,1,104651261,104651886,625,0.004775132141982006
38872,3488.397733,3488.426467,1,104651931,104652794,863,0.2577239443798881
38873,3488.5816,3488.7565,1,104657448,104662695,5247,0.8453599454520005
38874,3488.765467,3488.814667,1,104662964,104664440,1476,0.7936055893668591
38875,3488.839633,3488.865867,1,104665188,104665976,788,0.7342653790118276
38876,3488.909367,3488.980733,1,104667281,104669421,2140,0.7978536291182099
38877,3488.992467,3488.996667,1,104669774,104669900,126,-0.09628451930322533
38878,3488.999433,3489.019233,1,104669982,104670576,594,0.21010028637594122
38879,3489.655267,3489.665967,1,104689658,104689979,321,0.7252834116220019
38880,3489.667867,3489.696667,1,104690036,104690900,864,0.6240933593070768
38881,3489.7153,3489.737633,1,104691459,104692128,669,0.7222323877107932
38882,3489.7692,3489.773,1,104693076,104693190,114,0.739992490860892
38883,3489.920467,3490.147633,1,104697614,104704428,6814,0.7693975972641497
38884,3490.1677,3490.170833,1,104705031,104705124,93,0.08965459441844738
38885,3490.174433,3490.185167,1,104705232,104705555,323,-0.05217900610926754
38886,3490.186233,3490.190267,1,104705586,104705708,122,0.11321195394870487
38887,3490.404633,3490.452233,1,104712138,104713566,1428,0.7904071159262632
38888,3490.4644,3490.5078,1,104713932,104715234,1302,0.8675048913407436
38889,3490.522767,3490.535733,1,104715683,104716071,388,-0.07331366002094429
38890,3490.542,3490.5459,1,104716260,104716377,117,
38891,3490.547933,3490.562333,1,104716437,104716869,432,0.11824551690203161
38892,3490.8137,3490.8307,1,104724411,104724921,510,0.643789146035992
38893,3491.083633,3491.122333,1,104732508,104733669,1161,0.7131273301518433
38894,3491.126167,3491.248333,1,104733785,104737449,3664,0.6332184673386566
38895,3491.250867,3491.312033,1,104737526,104739360,1834,0.6880350086587375
38896,3491.316633,3491.403233,1,104739498,104742096,2598,0.7207616456275595
38897,3491.404233,3491.408467,1,104742126,104742254,128,0.553424727224811
38898,3491.4124,3491.4315,1,104742372,104742945,573,0.4078847840949773
38899,3491.463633,3491.4707,1,104743908,104744121,213,0.17673474928042007
38900,3491.4793,3491.483767,1,104744379,104744513,134,-0.1056528622812188
38901,3491.4889,3491.493633,1,104744667,104744808,141,-0.14392825767309972
38902,3491.495233,3491.6298,1,104744856,104748894,4038,0.7910351885914385
38903,3491.645167,3491.6483,1,104749355,104749449,94,0.5403705815322599
38904,3491.650433,3491.6623,1,104749512,104749869,357,-0.11786385993639961
38905,3491.683733,3491.687867,1,104750511,104750636,125,0.10009940814170258
38906,3492.2405,3492.249133,1,104767215,104767473,258,0.7944583888271157
38907,3492.261367,3492.264367,1,104767841,104767931,90,
38908,3492.271333,3492.2749,1,104768139,104768247,108,0.6462784237762516
38909,3492.319367,3492.323133,1,104769581,104769693,112,0.4998715768233265
38910,3492.3742,3492.384,1,104771226,104771520,294,0.5624801590271128
38911,3492.442833,3492.4516,1,104773284,104773548,264,0.7310902873845496
38912,3492.475833,3492.484033,1,104774274,104774520,246,0.24862532177059757
38913,3492.487267,3492.497067,1,104774618,104774912,294,0.5945833951347299
38914,3492.622033,3492.6919,1,104778660,104780757,2097,0.785860055825466
38915,3492.6929,3492.780633,1,104780787,104783418,2631,0.7716822992276433
38916,3492.8007,3492.859233,1,104784021,104785776,1755,0.7907369938112658
38917,3493.2249,3493.254133,1,104796747,104797623,876,0.6201894345771133
38918,3493.2909,3493.3028,1,104798727,104799084,357,0.6956015683191517
38919,3493.333333,3493.337967,1,104799999,104800139,140,0.8195474459995952
38920,3493.550533,3493.6535,1,104806515,104809605,3090,0.45437410748274065
38921,3493.668933,3493.6789,1,104810067,104810367,300,0.023474757242635882
38922,3493.682633,3493.6913,1,104810478,104810739,261,-0.07822604158308805
38923,3493.693133,3493.699733,1,104810793,104810991,198,0.5722987363193729
38924,3493.7046,3493.820967,1,104811138,104814629,3491,0.8680081691082764
38925,3493.822233,3493.827633,1,104814666,104814828,162,-0.28066780906432065
38926,3494.421567,3494.429667,1,104832647,104832890,243,0.6070127680658162
38927,3494.432267,3494.4493,1,104832968,104833479,511,0.5758074176421204
38928,3494.459567,3494.51,1,104833787,104835300,1513,0.7477851145991655
38929,3494.525733,3494.563067,1,104835771,104836892,1121,0.7484798094621461
38930,3494.580733,3494.6223,1,104837421,104838669,1248,0.6158471365783028
38931,3494.623533,3494.6402,1,104838705,104839206,501,0.5253664687059751
38932,3494.692767,3494.710467,1,104840783,104841314,531,-0.05676379773046297
38933,3494.714567,3494.7276,1,104841437,104841828,391,-0.05199850277205956
38934,3494.739467,3494.759,1,104842184,104842770,586,0.6879671591208518
38935,3494.760833,3494.796433,1,104842824,104843892,1068,0.8428368751115044
38936,3494.801233,3494.8521,1,104844036,104845563,1527,0.8354375860158471
38937,3494.867867,3494.879933,1,104846036,104846397,361,-0.15143936282508835
38938,3494.899467,3494.903333,1,104846984,104847099,115,-0.050202276361810495
38939,3494.908967,3494.913033,1,104847269,104847390,121,0.2014306605382502
38940,3494.922333,3494.9298,1,104847669,104847894,225,0.062152412689784754
38941,3494.9385,3494.9442,1,104848155,104848326,171,-0.3249084140232197
38942,3494.963267,3494.967367,1,104848898,104849021,123,-0.1951461095953876
38943,3494.9714,3494.993333,1,104849142,104849799,657,0.20633921432086258
38944,3495.003333,3495.009033,1,104850099,104850270,171,0.659326904665126
38945,3495.0142,3495.2208,1,104850426,104856624,6198,0.7659337325910364
38946,3495.266033,3495.276767,1,104857980,104858303,323,-0.015688635667719067
38947,3496.041367,3496.0504,1,104881241,104881512,271,0.6968226445758808
38948,3496.053867,3496.067533,1,104881616,104882025,409,0.585163150894187
38949,3496.100933,3496.1193,1,104883027,104883579,552,0.459089514416024
38950,3496.731467,3496.734767,1,104901944,104902043,99,0.6001319781205122
38951,3496.760133,3496.765,1,104902803,104902950,147,0.6415734859784548
38952,3496.767533,3496.771367,1,104903025,104903141,116,-0.0980469942978198
38953,3496.772767,3496.779067,1,104903183,104903372,189,0.4768785290323289
38954,3496.8108,3496.823233,1,104904324,104904696,372,0.8764042194593188
38955,3496.8557,3496.866433,1,104905671,104905992,321,0.7549345125971509
38956,3496.888267,3496.931767,1,104906648,104907953,1305,0.5853764889229307
38957,3496.953367,3496.968333,1,104908601,104909049,448,0.43921407752023384
38958,3497.0981,3497.1042,1,104912943,104913126,183,0.43673098044831793
38959,3497.1215,3497.198833,1,104913645,104915964,2319,0.7953056077824485
38960,3497.208433,3497.256967,1,104916252,104917709,1457,0.8124868532027562
38961,3497.272167,3497.2959,1,104918165,104918877,712,0.5484524951796313
38962,3497.306867,3497.310433,1,104919206,104919312,106,0.5640557090688307
38963,3497.3363,3497.3492,1,104920089,104920476,387,0.009845075164580443
38964,3497.6014,3497.626433,1,104928042,104928792,750,0.7961801784034276
38965,3497.6288,3497.666633,1,104928864,104929998,1134,0.8290327960981321
38966,3497.6695,3497.817967,1,104930085,104934539,4454,0.7736715855685969
38967,3497.846867,3497.869833,1,104935406,104936094,688,0.5531623402402528
38968,3497.8746,3497.9371,1,104936238,104938113,1875,0.31605364508104083
38969,3497.940667,3497.956733,1,104938220,104938701,481,-0.03246515560502365
38970,3497.967267,3498.041367,1,104939018,104941241,2223,0.7707498635870712
38971,3498.049567,3498.057633,1,104941487,104941728,241,0.11655831083604673
38972,3498.0834,3498.087833,1,104942502,104942634,132,0.404621094430706
38973,3498.916867,3498.922633,1,104967506,104967678,172,0.41808968888887255
38974,3498.966967,3498.980067,1,104969009,104969402,393,0.6364976163564048
38975,3498.990333,3498.9977,1,104969709,104969931,222,0.3379707004725981
38976,3499.0412,3499.059433,1,104971236,104971782,546,0.7211451671052571
38977,3499.0824,3499.0969,1,104972472,104972907,435,0.5255672965082417
38978,3499.151767,3499.157233,1,104974553,104974716,163,0.5798778710300526
38979,3499.158967,3499.1708,1,104974769,104975124,355,0.6417223640667813
38980,3499.197567,3499.201767,1,104975927,104976053,126,0.8182960548026174
38981,3499.212133,3499.217667,1,104976363,104976530,167,0.655188019468197
38982,3499.4188,3499.492333,1,104982564,104984769,2205,0.7369423221581267
38983,3499.495967,3499.543133,1,104984879,104986293,1414,0.8052609733729196
38984,3499.558067,3499.565233,1,104986742,104986956,214,0.7019381506297189
38985,3499.572033,3499.5917,1,104987160,104987751,591,0.014569971442383294
38986,3499.854467,3499.896133,1,104995634,104996883,1249,0.7735684597134236
38987,3500.1665,3500.1769,1,105004995,105005307,312,0.8422315649700972
38988,3500.178033,3500.2099,1,105005340,105006297,957,0.6578109715884836
38989,3500.2115,3500.218467,1,105006345,105006554,209,0.35587483832096195
38990,3500.2303,3500.251567,1,105006909,105007547,638,0.6855919966794322
38991,3500.290667,3500.320367,1,105008720,105009611,891,0.7640360666710349
38992,3500.3235,3500.370367,1,105009705,105011111,1406,0.7283237882001012
38993,3500.3716,3500.3799,1,105011148,105011397,249,0.4328614144494771
38994,3500.380967,3500.399533,1,105011429,105011985,556,0.7413088032196231
38995,3500.402567,3500.411133,1,105012077,105012333,256,0.45600330347213575
38996,3500.439867,3500.455833,1,105013196,105013674,478,0.8144217115917847
38997,3500.457,3500.493267,1,105013710,105014798,1088,0.7941491636933875
38998,3500.504933,3500.519633,1,105015147,105015588,441,0.5602021057872717
38999,3500.530733,3500.533833,1,105015921,105016014,93,-0.18686577643566946
39000,3500.5654,3500.571967,1,105016962,105017159,197,-0.15494367042441093
39001,3500.594033,3500.708167,1,105017820,105021245,3425,0.77484824466966
39002,3500.718633,3500.722067,1,105021558,105021662,104,-0.03270862403098011
39003,3500.724133,3500.733667,1,105021723,105022010,287,0.30253874773398354
39004,3500.742867,3500.750167,1,105022286,105022505,219,0.4184209812801159
39005,3500.846233,3500.849467,1,105025386,105025484,98,0.7529246679667809
39006,3500.855167,3500.9072,1,105025655,105027216,1561,0.8207667316111441
39007,3500.909133,3500.921167,1,105027273,105027635,362,0.8369396327409349
39008,3500.923533,3500.954067,1,105027705,105028622,917,0.7501832069613038
39009,3500.963133,3500.975,1,105028893,105029250,357,0.46949543375147323
39010,3500.984267,3500.988767,1,105029528,105029663,135,-0.013986752935201428
39011,3500.990733,3500.9964,1,105029721,105029892,171,0.04042407885183459
39012,3500.9987,3501.009133,1,105029961,105030273,312,0.20774334062141875
39013,3501.0132,3501.018633,1,105030396,105030558,162,0.2327679988614913
39014,3501.034167,3501.198833,1,105031025,105035964,4939,0.8442243914936839
39015,3501.620633,3501.630833,1,105048618,105048924,306,0.5869164390312457
39016,3501.6587,3501.668367,1,105049761,105050051,290,0.7449877624517497
39017,3501.6813,3501.698467,1,105050439,105050954,515,0.5849798483501703
39018,3501.732567,3501.746067,1,105051977,105052382,405,0.5909844429871182
39019,3501.7521,3501.768767,1,105052563,105053063,500,0.6905201041928943
39020,3501.8031,3501.825333,1,105054093,105054759,666,0.8182098848272567
39021,3501.853333,3501.8595,1,105055599,105055785,186,0.15526932915952402
39022,3501.9151,3501.923267,1,105057453,105057698,245,0.8289175170797333
39023,3501.925567,3501.933333,1,105057767,105057999,232,0.5941699090596455
39024,3501.9671,3501.984133,1,105059013,105059523,510,0.6947965879790993
39025,3501.9914,3502.0103,1,105059742,105060309,567,0.11241680016937658
39026,3502.039067,3502.056667,1,105061172,105061700,528,0.7567481706319266
39027,3502.0836,3502.099667,1,105062508,105062990,482,0.7391178202168297
39028,3502.103633,3502.119167,1,105063108,105063575,467,0.6707987054096104
39029,3502.146033,3502.157533,1,105064380,105064725,345,0.4852018378667026
39030,3502.1596,3502.170667,1,105064788,105065120,332,0.10453518988713434
39031,3502.175433,3502.210833,1,105065262,105066324,1062,0.23189590810898372
39032,3502.261733,3502.3492,1,105067851,105070476,2625,0.7110108370817306
39033,3502.350533,3502.3765,1,105070515,105071295,780,0.6514209881762626
39034,3502.5354,3502.566533,1,105076062,105076995,933,0.10766237326007544
39035,3502.568333,3502.6316,1,105077049,105078948,1899,0.6534041046472544
39036,3502.632967,3502.6813,1,105078989,105080439,1450,0.6233721452319158
39037,3502.684933,3502.688233,1,105080547,105080646,99,0.7861823660208294
39038,3502.689967,3502.754167,1,105080699,105082625,1926,0.8164575356188108
39039,3502.7576,3502.786833,1,105082728,105083604,876,0.7143002259124649
39040,3502.8036,3502.831833,1,105084108,105084954,846,0.6966864417525487
39041,3502.837567,3502.8508,1,105085127,105085524,397,0.6128622572292098
39042,3502.853467,3502.8712,1,105085604,105086136,532,0.05491526849165298
39043,3502.872467,3502.9323,1,105086174,105087969,1795,0.299049672092076
39044,3502.959467,3503.035367,1,105088784,105091061,2277,0.7414374395588703
39045,3503.0442,3503.0697,1,105091326,105092091,765,0.6385561514896465
39046,3503.1054,3503.122267,1,105093162,105093668,506,0.33901649243898513
39047,3503.1317,3503.1459,1,105093951,105094377,426,0.1206363844726058
39048,3503.168867,3503.179033,1,105095066,105095370,304,0.3736559965215915
39049,3503.222067,3503.231367,1,105096662,105096941,279,0.5908619509490937
39050,3503.242133,3503.272533,1,105097263,105098175,912,0.42706962752527433
39051,3503.287667,3503.3139,1,105098630,105099417,787,0.010217540051785946
39052,3503.3176,3503.3267,1,105099528,105099801,273,0.12305006167540805
39053,3503.342967,3503.351467,1,105100289,105100544,255,0.7163027634402108
39054,3503.353333,3503.363733,1,105100599,105100911,312,0.817380889490351
39055,3503.369267,3503.399633,1,105101078,105101988,910,0.7489121441282871
39056,3503.401167,3503.535467,1,105102035,105106064,4029,0.7120460038095168
39057,3503.561867,3503.5783,1,105106856,105107349,493,0.7646422829318517
39058,3503.601567,3503.6089,1,105108047,105108267,220,0.560245185450859
39059,3503.614633,3503.622367,1,105108438,105108671,233,0.17234301753466755
39060,3503.623833,3503.635533,1,105108714,105109065,351,0.06797441773496046
39061,3503.6368,3503.657767,1,105109104,105109733,629,0.08862759795141578
39062,3503.7366,3503.743,1,105112098,105112290,192,0.6586397564060571
39063,3503.744033,3503.7477,1,105112320,105112431,111,-0.01942562889136835
39064,3503.802233,3503.812033,1,105114066,105114360,294,0.5631353219684696
39065,3503.840233,3503.8447,1,105115206,105115341,135,-0.04638349892205951
39066,3503.981,3503.985833,1,105119430,105119574,144,0.5728562803657743
39067,3503.993967,3504.0112,1,105119819,105120336,517,0.6580960152459812
39068,3504.013133,3504.107767,1,105120393,105123233,2840,0.7742259856148621
39069,3504.323167,3504.365433,1,105129695,105130962,1267,0.6810455098723527
39070,3504.369433,3504.459467,1,105131082,105133784,2702,0.7787780345817831
39071,3504.606233,3504.614433,1,105138186,105138432,246,0.3440166352138759
39072,3504.6302,3504.645033,1,105138906,105139350,444,0.4158697627480114
39073,3504.657167,3504.672467,1,105139715,105140174,459,-0.08295889030752614
39074,3504.681467,3504.694267,1,105140444,105140828,384,0.4585167081897649
39075,3504.7138,3504.731233,1,105141414,105141936,522,0.7044255273007916
39076,3504.734967,3504.7693,1,105142049,105143079,1030,0.7796035457100096
39077,3504.774233,3504.8166,1,105143226,105144498,1272,0.8003618982549545
39078,3504.824667,3504.827733,1,105144740,105144831,91,0.09417271118452693
39079,3504.833167,3504.866033,1,105144995,105145980,985,-0.026871809025615066
39080,3504.868433,3504.8753,1,105146052,105146259,207,0.1392346735293952
39081,3504.9592,3504.9654,1,105148776,105148962,186,0.003349566997442531
39082,3504.974933,3504.998967,1,105149247,105149969,722,0.21340410115194317
39083,3505.0159,3505.033033,1,105150477,105150990,513,-0.019018884492193935
39084,3505.037067,3505.0441,1,105151112,105151323,211,0.11931498581948222
39085,3505.0455,3505.0578,1,105151365,105151734,369,-0.06869442463680925
39086,3505.135133,3505.140967,1,105154053,105154229,176,0.677496202144266
39087,3505.1436,3505.163333,1,105154308,105154899,591,0.6058805780754888
39088,3505.1847,3505.189367,1,105155541,105155681,140,0.7312211769856484
39089,3505.2041,3505.2209,1,105156123,105156627,504,0.6370623028869598
39090,3505.239267,3505.255533,1,105157178,105157665,487,0.5486109860924879
39091,3505.264933,3505.2711,1,105157947,105158133,186,0.45037750275020944
39092,3505.277233,3505.2877,1,105158316,105158631,315,0.6769972622849741
39093,3505.317833,3505.336033,1,105159534,105160080,546,0.6031979940482296
39094,3505.3374,3505.346633,1,105160122,105160398,276,0.44776018675531865
39095,3505.3497,3505.4259,1,105160491,105162777,2286,0.7017892465256674
39096,3505.4708,3505.478333,1,105164124,105164349,225,0.5691978592956645
39097,3505.4822,3505.537733,1,105164466,105166131,1665,0.09314368997210912
39098,3505.542767,3505.547967,1,105166283,105166439,156,-0.1783401274415855
39099,3505.5494,3505.668633,1,105166482,105170058,3576,0.8034945203961879
39100,3505.681833,3505.685467,1,105170454,105170564,110,0.2914932468124605
39101,3505.694733,3505.7111,1,105170841,105171333,492,0.05512304803574333
39102,3506.1762,3506.182733,1,105185286,105185481,195,0.6082577308976552
39103,3506.198733,3506.254167,1,105185961,105187625,1664,0.6589803802974368
39104,3506.263267,3506.2744,1,105187898,105188232,334,0.41368289719062357
39105,3506.279867,3506.294867,1,105188396,105188846,450,0.6562631088121518
39106,3506.301367,3506.324933,1,105189041,105189747,706,0.6144815328255033
39107,3506.355267,3506.3875,1,105190658,105191625,967,0.6394992233526867
39108,3506.402733,3506.4212,1,105192081,105192636,555,0.5618780232955503
39109,3506.4717,3506.490033,1,105194151,105194700,549,0.6365682277225325
39110,3506.513067,3506.5213,1,105195392,105195639,247,0.5590715647721647
39111,3506.530967,3506.535667,1,105195929,105196070,141,0.38679018361172257
39112,3506.565533,3506.5761,1,105196965,105197283,318,0.7171386497312262
39113,3506.5824,3506.5976,1,105197472,105197928,456,-0.0036591234892045183
39114,3506.600267,3506.6296,1,105198008,105198888,880,0.27770668587926944
39115,3506.651467,3506.773233,1,105199544,105203196,3652,0.8129691872587264
39116,3506.843533,3506.9676,1,105205305,105209028,3723,0.764178772718556
39117,3506.9728,3506.977267,1,105209184,105209318,134,0.1365833503578768
39118,3506.985867,3506.9902,1,105209576,105209706,130,-0.4738784293290584
39119,3507.022533,3507.025567,1,105210675,105210767,92,-0.33994970856508744
39120,3507.268967,3507.275367,1,105218069,105218261,192,0.7586141283182998
39121,3507.2785,3507.286233,1,105218355,105218586,231,0.5355285909450413
39122,3507.290433,3507.3839,1,105218712,105221517,2805,0.683492367479419
39123,3507.386433,3507.393333,1,105221592,105221799,207,0.6157636070179865
39124,3507.407833,3507.462933,1,105222234,105223887,1653,0.7497522126008141
39125,3507.474633,3507.491733,1,105224238,105224751,513,0.7167014064377197
39126,3507.495633,3507.510567,1,105224868,105225317,449,0.6210978680311249
39127,3507.513567,3507.516733,1,105225407,105225501,94,-0.3727685615722805
39128,3507.544933,3507.5581,1,105226347,105226743,396,-0.05967713453860422
39129,3507.562633,3507.573533,1,105226878,105227205,327,-0.17355853719518644
39130,3508.098067,3508.101667,1,105242942,105243050,108,0.7157976545300191
39131,3508.109033,3508.264067,1,105243270,105247922,4652,0.7374871858011458
39132,3508.2914,3508.296367,1,105248742,105248891,149,0.1339360429890737
39133,3508.349033,3508.369933,1,105250470,105251097,627,0.6345109184794956
39134,3508.377333,3508.3972,1,105251319,105251916,597,0.7384375238793307
39135,3508.3985,3508.424267,1,105251955,105252728,773,0.6655502450596623
39136,3508.457967,3508.467433,1,105253739,105254022,283,0.555319373343426
39137,3508.483267,3508.491667,1,105254498,105254750,252,-0.03339425924090881
39138,3508.493467,3508.497767,1,105254804,105254933,129,0.061177875992163545
39139,3508.500133,3508.520867,1,105255003,105255626,623,0.12386509418784551
39140,3508.536,3508.541133,1,105256080,105256233,153,-0.28129055026581085
39141,3508.544767,3508.5603,1,105256343,105256809,466,0.6995901796352519
39142,3508.561933,3508.6678,1,105256857,105260034,3177,0.7708879469728567
39143,3508.6934,3508.7105,1,105260802,105261315,513,0.7572324771967461
39144,3508.7193,3508.7837,1,105261579,105263511,1932,0.798773076121139
39145,3508.808533,3508.8131,1,105264255,105264393,138,0.5107852193350652
39146,3508.831433,3508.8375,1,105264942,105265125,183,-0.003752451983520338
39147,3508.842133,3508.874333,1,105265263,105266229,966,0.02081631053817228
39148,3508.880467,3508.886667,1,105266414,105266600,186,0.5528368515063574
39149,3508.890633,3509.036433,1,105266718,105271092,4374,0.6918326088710823
39150,3509.048,3509.077433,1,105271440,105272322,882,0.6001624073680188
39151,3509.0812,3509.1245,1,105272436,105273735,1299,0.7943150533093889
39152,3509.126,3509.187133,1,105273780,105275613,1833,0.7725168204576006
39153,3509.195133,3509.226633,1,105275853,105276798,945,0.7791315279242534
39154,3509.2396,3509.286767,1,105277188,105278603,1415,0.030660074635245876
39155,3509.308367,3509.33,1,105279251,105279900,649,0.7041714378798732
39156,3509.3312,3509.440867,1,105279936,105283226,3290,0.8161363307545693
39157,3509.462233,3509.5565,1,105283866,105286695,2829,0.7342840257612355
39158,3509.578833,3509.583333,1,105287364,105287499,135,0.23223131231734334
39159,3509.597133,3509.6021,1,105287913,105288063,150,-0.10306280729548185
39160,3510.238333,3510.2814,1,105307149,105308442,1293,0.6401712445933769
39161,3510.2825,3510.288933,1,105308475,105308667,192,0.5110677074702673
39162,3510.290867,3510.313267,1,105308726,105309398,672,0.6613406261844345
39163,3510.318267,3510.321433,1,105309548,105309642,94,0.33507715693353296
39164,3510.329933,3510.3472,1,105309897,105310416,519,0.85801746485447
39165,3510.362933,3510.379,1,105310887,105311370,483,0.7668758972752233
39166,3510.422567,3510.4337,1,105312677,105313011,334,0.374264815575098
39167,3510.440667,3510.450033,1,105313220,105313500,280,0.1612634603286994
39168,3510.4567,3510.4626,1,105313701,105313878,177,-0.12138408672058344
39169,3510.466133,3510.475033,1,105313983,105314250,267,0.18078287900687237
39170,3510.5088,3510.524633,1,105315264,105315738,474,0.719522074982774
39171,3510.5273,3510.5624,1,105315819,105316872,1053,0.8464203658055228
39172,3510.5638,3510.6163,1,105316914,105318489,1575,0.6589185954103138
39173,3510.6327,3510.641933,1,105318981,105319257,276,-0.09974195248770426
39174,3510.662533,3510.7776,1,105319875,105323328,3453,0.8690640981781315
39175,3511.101133,3511.124633,1,105333033,105333738,705,0.7229153083051642
39176,3511.139333,3511.148567,1,105334179,105334457,278,0.1576448292794107
39177,3511.401633,3511.435933,1,105342048,105343077,1029,0.575143160809734
39178,3511.437233,3511.482233,1,105343116,105344466,1350,0.8584216288594069
39179,3511.4901,3511.540167,1,105344703,105346205,1502,0.7958512706496405
39180,3511.564267,3511.7062,1,105346928,105351186,4258,0.7737070511428341
39181,3511.713933,3511.7196,1,105351417,105351588,171,0.03730367763935717
39182,3511.721633,3511.725967,1,105351648,105351779,131,0.04165214606133335
39183,3511.749767,3511.759233,1,105352493,105352776,283,0.05952207017460678
39184,3512.302867,3512.306967,1,105369086,105369209,123,0.42589858950455106
39185,3512.3523,3512.3738,1,105370569,105371214,645,0.8013324159753
39186,3512.398233,3512.409533,1,105371946,105372285,339,0.6389026363231857
39187,3512.411133,3512.4481,1,105372333,105373443,1110,0.6383309196153596
39188,3512.498967,3512.511067,1,105374969,105375332,363,0.5753789440686462
39189,3512.5352,3512.549867,1,105376056,105376496,440,0.4726825737837297
39190,3512.606833,3512.6127,1,105378204,105378381,177,0.731519823781952
39191,3512.6141,3512.624233,1,105378423,105378726,303,0.5966652518302726
39192,3512.648267,3512.654167,1,105379448,105379625,177,0.5924478873633925
39193,3512.6606,3512.676633,1,105379818,105380298,480,0.5804261267554635
39194,3512.7002,3512.713667,1,105381006,105381410,404,-0.01207112078435286
39195,3512.738467,3512.745933,1,105382154,105382377,223,-0.0594773085859458
39196,3512.805333,3512.946633,1,105384159,105388398,4239,0.788863142926595
39197,3512.9758,3513.093833,1,105389274,105392814,3540,0.7085499940252039
39198,3513.096567,3513.181467,1,105392897,105395444,2547,0.7750073551810202
39199,3513.1944,3513.2024,1,105395832,105396072,240,0.07109235425435621
39200,3513.203967,3513.2105,1,105396119,105396315,196,0.09465542882645737
39201,3513.2197,3513.239667,1,105396591,105397190,599,0.1127116459894576
39202,3513.3525,3513.356667,1,105400575,105400700,125,0.8407322489589737
39203,3513.812333,3513.820367,1,105414369,105414611,242,0.7899694238994034
39204,3513.823667,3513.8409,1,105414710,105415227,517,0.59709624132377
39205,3513.851,3513.914567,1,105415530,105417437,1907,0.7406269397724808
39206,3513.915767,3513.9196,1,105417473,105417588,115,0.7029170787938801
39207,3513.9209,3513.979533,1,105417627,105419385,1758,0.540267835780049
39208,3513.991933,3514.008533,1,105419757,105420255,498,0.5954019640113324
39209,3514.014567,3514.020767,1,105420437,105420623,186,0.4477896815328951
39210,3514.0229,3514.069733,1,105420687,105422091,1404,0.650694403718204
39211,3514.073667,3514.086333,1,105422210,105422589,379,0.5339465141571302
39212,3514.0937,3514.173167,1,105422811,105425195,2384,0.7893038616254364
39213,3514.196567,3514.200633,1,105425897,105426018,121,
39214,3514.208033,3514.211933,1,105426240,105426357,117,
39215,3514.612133,3514.6172,1,105438363,105438516,153,0.7267972079245757
39216,3514.633667,3514.676067,1,105439010,105440282,1272,0.8409902053561241
39217,3514.680733,3514.738333,1,105440421,105442149,1728,0.449700381696067
39218,3514.7561,3514.759533,1,105442683,105442785,102,-0.09927473992695175
39219,3514.763067,3514.812533,1,105442892,105444375,1483,0.7461542844099994
39220,3514.820633,3514.836467,1,105444618,105445094,476,0.7385961168414817
39221,3514.839667,3514.856133,1,105445190,105445683,493,0.1952220732408372
39222,3514.8718,3514.876633,1,105446154,105446298,144,-0.13523342414874726
39223,3514.8851,3514.916967,1,105446553,105447509,956,0.12002483577958206
39224,3514.9466,3515.088667,1,105448398,105452660,4262,0.7662811102559411
39225,3515.089767,3515.094733,1,105452693,105452841,148,-0.5220555191638567
39226,3515.105167,3515.1278,1,105453155,105453834,679,0.7864188449591979
39227,3515.135,3515.160933,1,105454050,105454827,777,0.35143163315959264
39228,3515.161967,3515.167,1,105454859,105455010,151,0.44538970456829746
39229,3515.188933,3515.2529,1,105455667,105457587,1920,0.8006507106182666
39230,3515.274,3515.304733,1,105458220,105459141,921,0.7214048545471011
39231,3515.308333,3515.380667,1,105459249,105461420,2171,0.7798566069025251
39232,3515.383467,3515.390133,1,105461504,105461703,199,0.13700346070057898
39233,3515.4082,3515.4119,1,105462246,105462357,111,0.6362195359372542
39234,3515.416233,3515.4241,1,105462486,105462723,237,-0.059903915809131875
39235,3515.431433,3515.446633,1,105462942,105463398,456,0.06687473430642087
39236,3515.4512,3515.456533,1,105463536,105463695,159,-0.09586202021617583
39237,3515.480267,3515.599733,1,105464408,105467991,3583,0.7854259226607524
39238,3515.7494,3515.858667,1,105472482,105475760,3278,0.8038685215571171
39239,3515.875267,3515.8798,1,105476258,105476394,136,-0.09747877730378283
39240,3515.885467,3515.8896,1,105476564,105476688,124,
39241,3516.536367,3516.643933,1,105496091,105499317,3226,0.7023775943994042
39242,3516.6469,3516.7239,1,105499407,105501717,2310,0.6307726815394242
39243,3516.728667,3516.801733,1,105501860,105504051,2191,0.7132837686027634
39244,3516.8138,3516.859533,1,105504414,105505785,1371,0.6712907823242255
39245,3516.8719,3516.910567,1,105506157,105507317,1160,-0.0664713997667659
39246,3516.913833,3516.9292,1,105507414,105507876,462,0.2284530619067719
39247,3516.937633,3516.944167,1,105508128,105508325,197,0.03690985829426446
39248,3516.9472,3517.013033,1,105508416,105510390,1974,0.7473661144919187
39249,3517.015433,3517.145433,1,105510462,105514362,3900,0.7809214220490964
39250,3517.185267,3517.269033,1,105515558,105518070,2512,0.7542579724993246
39251,3517.287433,3517.2925,1,105518622,105518775,153,-0.17252715226854318
39252,3517.3002,3517.3043,1,105519006,105519129,123,0.52117985094382
39253,3517.320167,3517.323767,1,105519605,105519713,108,-0.10409155039198498
39254,3517.529167,3517.546767,1,105525875,105526403,528,0.28303181738652133
39255,3517.549633,3517.584533,1,105526488,105527535,1047,0.1692475405626565
39256,3517.593433,3517.634333,1,105527802,105529029,1227,0.646064723024531
39257,3517.652767,3517.657367,1,105529583,105529721,138,-0.11580875788914809
39258,3517.6585,3517.668833,1,105529755,105530064,309,-0.04538431871688534
39259,3517.672767,3517.698733,1,105530183,105530961,778,0.1331895416163273
39260,3517.824567,3517.849467,1,105534737,105535484,747,0.6279997860709693
39261,3517.8542,3517.913233,1,105535626,105537396,1770,0.6290893578264865
39262,3517.914967,3517.924767,1,105537449,105537743,294,0.3281960170747895
39263,3517.926767,3517.930567,1,105537803,105537917,114,0.5835636265528519
39264,3517.933033,3517.941533,1,105537990,105538245,255,0.021974442453471247
39265,3518.272333,3518.2757,1,105548169,105548271,102,0.4298348236871542
39266,3518.278333,3518.2833,1,105548349,105548499,150,0.5323729052778859
39267,3518.3254,3518.343133,1,105549762,105550293,531,0.6908264958314454
39268,3518.346133,3518.350433,1,105550383,105550512,129,0.7095481746185617
39269,3518.357033,3518.362533,1,105550710,105550875,165,-0.21934549535130993
39270,3518.374833,3518.3814,1,105551244,105551442,198,0.22998681011305483
39271,3518.384633,3518.427,1,105551538,105552810,1272,0.5089519336545452
39272,3518.4566,3518.468333,1,105553698,105554049,351,0.37830883792331105
39273,3518.4695,3518.4863,1,105554085,105554589,504,0.48231003240464676
39274,3518.508133,3518.523533,1,105555243,105555705,462,0.48557657753818
39275,3518.555233,3518.560567,1,105556656,105556817,161,-0.48657071101085125
39276,3518.5709,3518.576367,1,105557127,105557291,164,0.39093172738857745
39277,3518.579867,3518.5881,1,105557396,105557643,247,0.5093487701841247
39278,3518.6127,3518.6219,1,105558381,105558657,276,0.28194842397777314
39279,3518.6289,3518.634967,1,105558867,105559049,182,0.3341484290494168
39280,3518.666933,3518.6795,1,105560007,105560385,378,0.39151144340678656
39281,3518.688133,3518.732133,1,105560643,105561963,1320,0.007595931397703913
39282,3518.786933,3518.8094,1,105563607,105564282,675,0.8063598334182536
39283,3518.810933,3518.899433,1,105564327,105566982,2655,0.732128696123982
39284,3518.9082,3518.939033,1,105567246,105568170,924,0.7903173847769617
39285,3518.942033,3518.9689,1,105568260,105569067,807,0.7169996523798754
39286,3518.9727,3518.9874,1,105569181,105569622,441,0.5322137309274303
39287,3519.010733,3519.0635,1,105570321,105571905,1584,0.7586789269789959
39288,3519.064533,3519.092567,1,105571935,105572777,842,0.6216202910101639
39289,3519.1076,3519.120267,1,105573228,105573608,380,0.4905879134302727
39290,3519.1265,3519.156433,1,105573795,105574692,897,0.04437448943556206
39291,3519.1577,3519.166967,1,105574731,105575009,278,-0.06464015401401024
39292,3519.198867,3519.202933,1,105575966,105576087,121,0.535422836202477
39293,3519.2139,3519.240067,1,105576417,105577202,785,0.4041884838934408
39294,3519.2446,3519.297233,1,105577338,105578916,1578,0.014392926214183876
39295,3519.309333,3519.5774,1,105579279,105587322,8043,0.6618952466752306
39296,3519.5875,3519.5994,1,105587625,105587982,357,0.552477890942883
39297,3519.600433,3519.615733,1,105588012,105588471,459,0.11427155840698613
39298,3519.619367,3519.6289,1,105588581,105588867,286,0.34073501401832557
39299,3519.633,3519.641533,1,105588990,105589245,255,0.32424185070162953
39300,3519.649533,3519.657,1,105589485,105589710,225,0.5257432830482457
39301,3519.659633,3519.6641,1,105589788,105589923,135,0.10233311174043142
39302,3519.6652,3519.677633,1,105589956,105590328,372,0.06163184644285721
39303,3519.693033,3519.798567,1,105590790,105593957,3167,0.43942446178393146
39304,3519.806433,3519.833,1,105594192,105594990,798,0.6796823282082733
39305,3519.838433,3519.894067,1,105595152,105596822,1670,0.7162662857698838
39306,3519.895267,3519.9935,1,105596858,105599805,2947,0.19106898985185072
39307,3519.9967,3520.0092,1,105599901,105600276,375,0.1531096124726399
39308,3520.0204,3520.047467,1,105600612,105601424,812,0.45505224319622817
39309,3520.051033,3520.1871,1,105601530,105605613,4083,0.4636716529375592
39310,3520.2028,3520.214,1,105606084,105606420,336,0.020180217426195045
39311,3520.224733,3520.276333,1,105606741,105608289,1548,0.5001245767350941
39312,3520.2921,3520.307933,1,105608763,105609237,474,0.3168137277560532
39313,3520.313033,3520.327867,1,105609390,105609836,446,-0.11896015139600542
39314,3520.3293,3520.335733,1,105609879,105610071,192,-0.04780945382198594
39315,3520.338533,3520.348933,1,105610155,105610467,312,-0.1220480837652725
39316,3520.5016,3520.5068,1,105615048,105615204,156,0.7068161282574437
39317,3520.535967,3520.551833,1,105616079,105616554,475,0.7034892968223807
39318,3520.576833,3520.581133,1,105617304,105617433,129,0.4267735936795164
39319,3520.586567,3520.605267,1,105617597,105618158,561,0.7547686860403553
39320,3520.606267,3520.612033,1,105618188,105618360,172,0.20864997358618617
39321,3520.613533,3520.638267,1,105618405,105619148,743,0.6118832239863969
39322,3520.644233,3520.666933,1,105619326,105620007,681,0.575770806597526
39323,3520.673033,3520.718333,1,105620190,105621549,1359,0.6829248842512042
39324,3520.720167,3520.801,1,105621605,105624030,2425,0.7291558234976797
39325,3520.809433,3520.816667,1,105624282,105624500,218,0.49770474827618943
39326,3520.8221,3520.853933,1,105624663,105625617,954,0.7296445091308161
39327,3520.8637,3520.955467,1,105625911,105628664,2753,0.6586837271884306
39328,3520.9708,3520.9852,1,105629124,105629556,432,0.9188392853797469
39329,3520.9872,3521.0793,1,105629616,105632379,2763,0.7760925291012326
39330,3521.088767,3521.093333,1,105632663,105632799,136,
39331,3521.095067,3521.107267,1,105632852,105633218,366,0.34152673352045126
39332,3521.1107,3521.130367,1,105633321,105633911,590,0.20338901330172163
39333,3521.1338,3521.144533,1,105634014,105634335,321,0.09633167110830772
39334,3521.1488,3521.169,1,105634464,105635070,606,0.08338489008754452
39335,3521.174667,3521.180767,1,105635240,105635423,183,0.12420512376833225
39336,3521.288267,3521.295,1,105638648,105638850,202,0.21299930377205148
39337,3521.333867,3521.339033,1,105640016,105640170,154,0.1107244013766232
39338,3521.4906,3521.525633,1,105644718,105645768,1050,0.6394652178216496
39339,3521.5313,3521.534767,1,105645939,105646043,104,0.35395544956751424
39340,3521.548433,3521.567667,1,105646452,105647030,578,0.6353337366065032
39341,3521.5765,3521.580033,1,105647295,105647400,105,0.29568181456038134
39342,3521.6304,3521.635633,1,105648912,105649068,156,0.3792394993023428
39343,3521.6468,3521.660133,1,105649404,105649803,399,0.5226501156551981
39344,3521.676467,3521.680867,1,105650294,105650426,132,0.3774352075953709
39345,3521.904333,3522.015767,1,105657129,105660473,3344,0.7934529100299503
39346,3522.022,3522.040667,1,105660660,105661220,560,0.5759495867496737
39347,3522.045367,3522.084633,1,105661361,105662538,1177,0.1211668583618195
39348,3522.086233,3522.1122,1,105662586,105663366,780,0.25117879434984713
39349,3522.159667,3522.164867,1,105664790,105664946,156,0.6116737603346009
39350,3522.167467,3522.1725,1,105665024,105665175,151,0.10310610128085318
39351,3522.179467,3522.277933,1,105665384,105668337,2953,0.07095326511099437
39352,3522.282733,3522.3977,1,105668481,105671931,3450,0.794923263337037
39353,3522.404,3522.4534,1,105672120,105673602,1482,0.7517197039931233
39354,3522.469067,3522.504333,1,105674072,105675129,1057,0.11728689177894298
39355,3522.5072,3522.5328,1,105675216,105675984,768,0.22236847746481775
39356,3522.5749,3522.5849,1,105677247,105677547,300,0.3882156277239994
39357,3522.5927,3522.6269,1,105677781,105678807,1026,0.09021195963407744
39358,3522.636,3522.6548,1,105679080,105679644,564,0.019018321749984912
39359,3522.6566,3522.6769,1,105679698,105680307,609,0.1680945259843537
39360,3522.708067,3522.722433,1,105681242,105681672,430,0.8633851947463242
39361,3522.724767,3522.8241,1,105681743,105684723,2980,0.7694284711945769
39362,3522.853167,3522.860767,1,105685595,105685823,228,0.4466488849392033
39363,3522.873033,3522.8958,1,105686190,105686874,684,0.030971713238284022
39364,3522.897067,3522.908367,1,105686912,105687251,339,0.14903636440907794
39365,3522.9111,3522.924767,1,105687333,105687743,410,-0.104220160579604
39366,3522.927967,3522.943533,1,105687839,105688305,466,-0.1231262300265205
39367,3522.9655,3522.9795,1,105688965,105689385,420,0.3931407621159237
39368,3522.980967,3522.984133,1,105689429,105689523,94,0.4418340088310114
39369,3522.9858,3523.019633,1,105689574,105690588,1014,0.1220139054215718
39370,3523.028533,3523.0413,1,105690855,105691239,384,0.009264948466591042
39371,3523.0442,3523.048233,1,105691326,105691446,120,-0.012896349568187465
39372,3523.050067,3523.071033,1,105691502,105692130,628,-0.0006472692717401538
39373,3523.180633,3523.187933,1,105695418,105695637,219,0.46521173689465484
39374,3523.200467,3523.236733,1,105696014,105697101,1087,0.6170850686856496
39375,3523.261833,3523.358833,1,105697854,105700764,2910,0.7588584273255812
39376,3523.462,3523.534967,1,105703860,105706049,2189,0.658997933790636
39377,3523.536367,3523.5727,1,105706091,105707181,1090,0.735178079255902
39378,3523.610667,3523.615733,1,105708320,105708471,151,-0.24955496475507355
39379,3523.616833,3523.622067,1,105708504,105708662,158,0.5222174785936234
39380,3523.6331,3523.6907,1,105708993,105710721,1728,0.06611494149669751
39381,3523.704867,3523.709567,1,105711146,105711287,141,0.17411396888009395
39382,3523.723867,3523.895567,1,105711716,105716867,5151,0.7935395960771958
39383,3523.896967,3523.906533,1,105716909,105717195,286,0.7945207879012394
39384,3523.912833,3523.932033,1,105717384,105717960,576,0.36327825670845976
39385,3523.937367,3524.0437,1,105718121,105721311,3190,0.7856538874114297
39386,3524.102067,3524.106633,1,105723062,105723198,136,0.24294891682722902
39387,3524.373,3524.379467,1,105731190,105731384,194,0.5248992376509103
39388,3524.417367,3524.437133,1,105732521,105733113,592,0.694183673756903
39389,3524.445867,3524.497933,1,105733376,105734937,1561,0.7223223878865543
39390,3524.509067,3524.5396,1,105735272,105736188,916,0.5661149185208867
39391,3524.554867,3524.6073,1,105736646,105738219,1573,0.33024488939979235
39392,3524.6218,3524.658933,1,105738654,105739767,1113,0.6620835271033815
39393,3524.678567,3524.7062,1,105740357,105741186,829,0.07960182228052612
39394,3524.7091,3524.7359,1,105741273,105742077,804,0.17805116538022653
39395,3524.745433,3524.752867,1,105742362,105742586,224,0.6419051041333199
39396,3524.756933,3524.924233,1,105742707,105747726,5019,0.7462964547572261
39397,3524.9602,3524.9798,1,105748806,105749394,588,0.8902808164155832
39398,3524.982233,3525.049733,1,105749466,105751491,2025,0.762546631817297
39399,3525.053667,3525.057567,1,105751610,105751727,117,0.105212436521457
39400,3525.076133,3525.099333,1,105752283,105752979,696,0.7400636649064054
39401,3525.104,3525.192133,1,105753120,105755763,2643,0.7580244479582242
39402,3525.2238,3525.2274,1,105756714,105756822,108,0.4676543116127257
39403,3525.230467,3525.242633,1,105756914,105757278,364,-0.13483649660521826
39404,3525.252933,3525.256133,1,105757587,105757683,96,-0.2032771283546381
39405,3525.360433,3525.440167,1,105760812,105763205,2393,0.42029479992997093
39406,3525.458467,3525.461933,1,105763754,105763857,103,-0.24543215314863864
39407,3525.591733,3525.604767,1,105767751,105768143,392,0.18319386596393458
39408,3525.605933,3525.644733,1,105768177,105769341,1164,0.7630987292338746
39409,3525.652967,3525.6889,1,105769589,105770667,1078,0.6634681589686882
39410,3525.720567,3525.7312,1,105771617,105771936,319,-0.0539945985573848
39411,3525.735133,3525.738633,1,105772053,105772158,105,0.31248544255642124
39412,3525.745133,3525.748433,1,105772353,105772452,99,-0.07523439969217095
39413,3525.749567,3525.7655,1,105772487,105772965,478,0.4034354532168504
39414,3525.787367,3525.822133,1,105773621,105774663,1042,0.7868407729433543
39415,3525.823333,3525.9496,1,105774699,105778488,3789,0.7754318031872726
39416,3525.961067,3525.9652,1,105778832,105778956,124,-0.3951829658623053
39417,3526.152133,3526.2521,1,105784563,105787563,3000,0.4674025774433333
39418,3526.255767,3526.2601,1,105787673,105787803,130,-0.8732760065835887
39419,3526.293067,3526.2978,1,105788792,105788934,142,0.6561935066173128
39420,3526.3614,3526.3647,1,105790842,105790941,99,
39421,3526.3753,3526.389767,1,105791259,105791693,434,0.6062113720529689
39422,3526.402467,3526.407,1,105792074,105792210,136,0.8125447978035721
39423,3526.4102,3526.434333,1,105792306,105793029,723,0.6269066326490592
39424,3526.4468,3526.4977,1,105793404,105794931,1527,0.7515236546029892
39425,3526.5045,3526.527133,1,105795135,105795813,678,0.6955424401546958
39426,3526.533367,3526.563,1,105796001,105796890,889,0.7402799161012882
39427,3526.575867,3526.713667,1,105797276,105801410,4134,0.7022940097940628
39428,3526.7261,3526.735167,1,105801783,105802055,272,0.461604285732253
39429,3526.736367,3526.7655,1,105802091,105802965,874,0.6301749448243668
39430,3526.7806,3526.784333,1,105803418,105803529,111,-0.13654636550610938
39431,3526.786467,3526.7948,1,105803594,105803844,250,0.3358863839446312
39432,3526.814833,3526.8279,1,105804444,105804837,393,0.6319876173644716
39433,3526.829267,3526.835,1,105804878,105805050,172,-0.1539524738530055
39434,3526.8496,3526.867933,1,105805488,105806037,549,0.4558178835051423
39435,3526.8697,3526.950567,1,105806091,105808517,2426,0.7786979336849448
39436,3526.956033,3526.959333,1,105808680,105808779,99,
39437,3526.960467,3526.9639,1,105808814,105808917,103,
39438,3526.9656,3526.984867,1,105808968,105809546,578,0.22207874972527133
39439,3527.0225,3527.0266,1,105810675,105810798,123,-0.131446856862477
39440,3527.0367,3527.054267,1,105811101,105811628,527,0.746109029992475
39441,3527.0571,3527.1741,1,105811713,105815223,3510,0.7091381848789561
39442,3527.195067,3527.2126,1,105815852,105816378,526,0.7634998439980606
39443,3527.2139,3527.3091,1,105816417,105819273,2856,0.744463240816557
39444,3527.3244,3527.332433,1,105819732,105819972,240,0.441952282462038
39445,3527.346167,3527.489933,1,105820385,105824697,4312,0.6066299430170625
39446,3527.4986,3527.5241,1,105824958,105825723,765,0.614628988519396
39447,3527.525567,3527.534433,1,105825767,105826032,265,0.2018932354537681
39448,3527.542433,3527.5473,1,105826272,105826419,147,0.9100174650671411
39449,3527.551667,3527.559733,1,105826550,105826791,241,0.31202902557506296
39450,3527.561467,3527.6998,1,105826844,105830994,4150,0.36734343170370815
39451,3527.701633,3527.705833,1,105831048,105831174,126,0.06507860494948267
39452,3527.7088,3527.7157,1,105831264,105831471,207,0.25398255227528954
39453,3527.990533,3527.994233,1,105839715,105839826,111,-0.18634101553789129
39454,3528.001867,3528.023133,1,105840056,105840693,637,0.7868764513679234
39455,3528.0244,3528.029533,1,105840732,105840885,153,0.5901530282611466
39456,3528.036033,3528.059733,1,105841080,105841791,711,0.8478013354515663
39457,3528.062467,3528.0779,1,105841874,105842337,463,0.5582855381900562
39458,3528.0829,3528.087333,1,105842487,105842619,132,-0.14928564104243777
39459,3528.1104,3528.116333,1,105843312,105843489,177,0.24354745940437875
39460,3528.126867,3528.157033,1,105843806,105844710,904,0.6858509186547518
39461,3528.160767,3528.184833,1,105844823,105845544,721,0.5972660977095241
39462,3528.1862,3528.254433,1,105845586,105847632,2046,0.7589988631216207
39463,3528.2611,3528.342533,1,105847833,105850275,2442,0.731319542154531
39464,3528.343733,3528.354533,1,105850311,105850635,324,0.605616155865376
39465,3528.357267,3528.362967,1,105850718,105850889,171,-0.17697256512302217
39466,3528.378433,3528.458133,1,105851352,105853743,2391,0.6779999093649478
39467,3528.472933,3528.486967,1,105854187,105854609,422,0.008959983383792535
39468,3528.489,3528.508133,1,105854670,105855243,573,-0.07694953879264602
39469,3528.5988,3528.6344,1,105857964,105859032,1068,0.6569964865375298
39470,3528.636833,3528.7367,1,105859104,105862101,2997,0.49067195057088103
39471,3528.7768,3528.808133,1,105863304,105864243,939,0.0907389175549136
39472,3528.835733,3528.898833,1,105865071,105866964,1893,0.7573095223346182
39473,3528.901167,3528.9048,1,105867035,105867144,109,0.09724066815431805
39474,3528.909967,3528.950867,1,105867299,105868526,1227,0.27524087461251795
39475,3528.959133,3528.980967,1,105868773,105869429,656,-0.0009512679676842614
39476,3528.983033,3528.994433,1,105869490,105869832,342,0.13242273493143417
39477,3529.046967,3529.081,1,105871409,105872430,1021,0.6127267087943876
39478,3529.0855,3529.120533,1,105872565,105873615,1050,0.04173192163497675
39479,3529.1256,3529.130967,1,105873768,105873929,161,-0.10915800910931384
39480,3529.1355,3529.145433,1,105874065,105874362,297,-0.05156750922698865
39481,3529.146833,3529.152633,1,105874404,105874578,174,-0.1652701576973193
39482,3529.161033,3529.296867,1,105874830,105878906,4076,0.7622403925170818
39483,3529.298733,3529.392133,1,105878961,105881763,2802,0.7868483729737322
39484,3529.395833,3529.429433,1,105881874,105882882,1008,0.2414983680232003
39485,3529.444067,3529.487267,1,105883322,105884618,1296,0.051106461157063555
39486,3529.497767,3529.649567,1,105884933,105889487,4554,0.8501142379763451
39487,3529.654667,3529.658967,1,105889640,105889769,129,0.03931170147957134
39488,3529.679567,3529.7009,1,105890387,105891027,640,0.15988714747708432
39489,3529.7038,3529.730267,1,105891114,105891908,794,0.02645149655371998
39490,3529.742633,3529.748467,1,105892278,105892454,176,0.058069666138863656
39491,3529.769667,3529.7967,1,105893090,105893901,811,0.5249200022529343
39492,3529.7995,3529.809467,1,105893985,105894284,299,0.4168706203475908
39493,3529.8176,3529.860867,1,105894528,105895826,1298,-0.05982427898487456
39494,3529.870733,3529.878833,1,105896121,105896364,243,-0.09598769805998125
39495,3529.9098,3529.9653,1,105897294,105898959,1665,0.708093323030659
39496,3529.966633,3530.088133,1,105898998,105902643,3645,0.7971562293414846
39497,3530.094067,3530.1787,1,105902822,105905361,2539,0.7658048496954671
39498,3530.1891,3530.233333,1,105905673,105906999,1326,-0.04825572853858757
39499,3530.2486,3530.2556,1,105907458,105907668,210,0.1697650914992226
39500,3530.288767,3530.305,1,105908663,105909150,487,0.8886814071912528
39501,3530.3081,3530.424967,1,105909243,105912749,3506,0.6531771784507896
39502,3530.446267,3530.454633,1,105913388,105913638,250,-0.12063879666172125
39503,3530.8013,3530.8489,1,105924039,105925467,1428,0.7089080819019887
39504,3530.860933,3530.8843,1,105925827,105926529,702,0.4847066017530451
39505,3530.888067,3530.901067,1,105926642,105927032,390,0.29681293028296557
39506,3530.940067,3530.974867,1,105928202,105929246,1044,0.5096452126166181
39507,3530.988233,3531.000033,1,105929646,105930000,354,0.5644253189112478
39508,3531.026933,3531.030667,1,105930807,105930920,113,-0.021727341116834182
39509,3531.0421,3531.074133,1,105931263,105932223,960,0.07385596737116068
39510,3531.075733,3531.081267,1,105932271,105932438,167,-0.00830637814983468
39511,3531.0853,3531.096233,1,105932559,105932886,327,0.004467641930582875
39512,3531.111433,3531.1146,1,105933342,105933438,96,
39513,3531.1161,3531.119133,1,105933483,105933573,90,0.7279932983323701
39514,3531.122933,3531.2548,1,105933687,105937644,3957,0.7492973053648724
39515,3531.260067,3531.293667,1,105937802,105938810,1008,0.7731556266793639
39516,3531.304533,3531.317567,1,105939135,105939527,392,0.751160781373779
39517,3531.319933,3531.4263,1,105939597,105942789,3192,0.6890661507992683
39518,3531.447,3531.455033,1,105943410,105943650,240,0.08146815674122963
39519,3531.458267,3531.463667,1,105943748,105943910,162,0.27739190507535383
39520,3531.9922,3531.998833,1,105959766,105959964,198,0.3329002567777329
39521,3532.044433,3532.048367,1,105961332,105961451,119,-0.35370369055735634
39522,3532.076467,3532.082633,1,105962294,105962478,184,0.8114433738727796
39523,3532.1033,3532.115833,1,105963099,105963474,375,0.5014060139882383
39524,3532.260033,3532.278,1,105967800,105968340,540,0.3685382613814971
39525,3532.2806,3532.2874,1,105968418,105968622,204,0.24168259531394085
39526,3532.326733,3532.343933,1,105969801,105970317,516,0.5587397386081753
39527,3532.501833,3532.5068,1,105975054,105975204,150,0.5973117338123441
39528,3532.514067,3532.5334,1,105975422,105976002,580,0.2666232833718899
39529,3532.535667,3532.543033,1,105976070,105976290,220,0.5254678257019726
39530,3532.5619,3532.566867,1,105976857,105977006,149,-0.10018361142977206
39531,3532.568667,3532.587567,1,105977060,105977627,567,-0.05340216232280961
39532,3532.9253,3532.947,1,105987759,105988410,651,0.05469433617485129
39533,3532.948033,3533.0139,1,105988440,105990417,1977,0.4402942701983456
39534,3533.0204,3533.035333,1,105990612,105991059,447,-0.1748490757732978
39535,3533.05,3533.0557,1,105991500,105991671,171,0.09093815904994129
39536,3533.109467,3533.125133,1,105993284,105993753,469,0.9306073096240705
39537,3533.127467,3533.1616,1,105993824,105994848,1024,0.815532732626048
39538,3533.164167,3533.167733,1,105994925,105995031,106,0.41138310537716577
39539,3533.169233,3533.208967,1,105995076,105996269,1193,0.8131569323325452
39540,3533.211333,3533.216967,1,105996339,105996509,170,0.5086255184103714
39541,3533.218067,3533.221933,1,105996542,105996657,115,-0.30742765462973365
39542,3533.2328,3533.254633,1,105996984,105997638,654,0.04927237529670392
39543,3533.256733,3533.2611,1,105997701,105997833,132,0.6342910223431335
39544,3533.262433,3533.280933,1,105997872,105998427,555,-0.14106745286757127
39545,3533.299633,3533.418567,1,105998988,106002557,3569,0.8550007339128576
39546,3533.4199,3533.4273,1,106002597,106002819,222,0.17880373600567437
39547,3533.4296,3533.434567,1,106002888,106003037,149,-0.21737565654219979
39548,3533.5788,3533.611067,1,106007364,106008332,968,0.6638850099486235
39549,3533.619467,3533.625333,1,106008584,106008759,175,0.7159418118183812
39550,3534.1292,3534.144,1,106023876,106024320,444,0.6491418789500814
39551,3534.161233,3534.237433,1,106024836,106027122,2286,0.6098247979704947
39552,3534.246733,3534.262067,1,106027401,106027862,461,0.7518802149278998
39553,3534.269,3534.272333,1,106028070,106028169,99,0.046728068317886555
39554,3534.274167,3534.322833,1,106028225,106029684,1459,0.5428632983635682
39555,3534.332433,3534.339133,1,106029972,106030173,201,0.6907076144106491
39556,3534.3433,3534.354233,1,106030299,106030626,327,0.6801220566631493
39557,3534.366633,3534.3766,1,106030998,106031298,300,0.5491615232696239
39558,3534.397867,3534.4519,1,106031936,106033557,1621,0.14279808439149455
39559,3534.458333,3534.462267,1,106033749,106033868,119,-0.16074806712805753
39560,3534.487267,3534.6074,1,106034618,106038222,3604,0.7420418336105974
39561,3534.621733,3534.6353,1,106038651,106039059,408,-0.1518335075681708
39562,3534.637033,3534.6675,1,106039110,106040025,915,0.04519267673234932
39563,3534.6689,3534.676333,1,106040067,106040289,222,-0.0888998392103774
39564,3534.682433,3534.696767,1,106040472,106040903,431,0.005989687375367052
39565,3534.698833,3534.707967,1,106040964,106041239,275,-0.016099140304321826
39566,3534.800833,3534.850733,1,106044024,106045521,1497,0.5885383668117332
39567,3534.854033,3534.864933,1,106045620,106045947,327,0.13193911791144056
39568,3534.870367,3534.8747,1,106046111,106046241,130,-0.10889815605296817
39569,3534.8758,3534.8911,1,106046274,106046733,459,0.2180153898403867
39570,3534.8924,3534.9026,1,106046772,106047078,306,0.3562967666936502
39571,3534.963633,3535.0712,1,106048908,106052136,3228,0.5072320799367326
39572,3535.080067,3535.0907,1,106052402,106052721,319,0.7345731762471804
39573,3535.0964,3535.103833,1,106052892,106053114,222,0.47486579484416674
39574,3535.111867,3535.205067,1,106053356,106056152,2796,0.7041526244825109
39575,3535.206067,3535.376867,1,106056182,106061306,5124,0.6374054070624252
39576,3535.382467,3535.410233,1,106061474,106062306,832,0.5433566055037574
39577,3535.418733,3535.423833,1,106062561,106062714,153,
39578,3535.434467,3535.443233,1,106063034,106063296,262,0.1473987900023144
39579,3535.449,3535.453667,1,106063470,106063610,140,0.5915501267001756
39580,3535.4878,3535.494067,1,106064634,106064822,188,0.5332407183954853
39581,3535.496333,3535.5011,1,106064889,106065033,144,0.4387653119445362
39582,3535.5022,3535.621,1,106065066,106068630,3564,0.8308341621647255
39583,3535.6469,3535.7605,1,106069407,106072815,3408,0.6368375663432174
39584,3535.772867,3535.809367,1,106073186,106074281,1095,0.605166161560323
39585,3535.812133,3535.8821,1,106074363,106076463,2100,0.66368721158617
39586,3535.9073,3535.956433,1,106077219,106078692,1473,0.7557016185688467
39587,3535.965633,3535.989567,1,106078968,106079687,719,0.7598402646171054
39588,3536.022767,3536.029933,1,106080683,106080897,214,-0.12445472974484363
39589,3536.034933,3536.097067,1,106081047,106082912,1865,0.6977540808692793
39590,3536.106133,3536.138,1,106083183,106084140,957,0.4493253805630656
39591,3536.143967,3536.191467,1,106084319,106085744,1425,0.5867392541928885
39592,3536.200267,3536.2045,1,106086008,106086135,127,0.3193508698664998
39593,3536.216967,3536.236467,1,106086509,106087094,585,0.6106102124798334
39594,3536.2688,3536.311667,1,106088064,106089350,1286,-0.06312205429819608
39595,3536.3175,3536.323467,1,106089525,106089704,179,-0.022284430484760892
39596,3536.369567,3536.3989,1,106091087,106091967,880,0.48114890893920553
39597,3536.407033,3536.440633,1,106092210,106093218,1008,0.048051792833155554
39598,3536.442867,3536.644367,1,106093286,106099331,6045,0.6151084814825847
39599,3536.645667,3536.6852,1,106099370,106100556,1186,0.2695180165291038
39600,3536.687767,3536.831633,1,106100633,106104948,4315,0.16988888498562998
39601,3536.833333,3536.845933,1,106104999,106105377,378,-0.416536879274312
39602,3536.8526,3536.862233,1,106105578,106105866,288,0.3818174402649568
39603,3536.865333,3536.878633,1,106105959,106106358,399,0.05201264521252335
39604,3536.8816,3536.885467,1,106106448,106106564,116,0.37014863538729675
39605,3536.8868,3536.890433,1,106106604,106106712,108,0.6858016689292071
39606,3536.894633,3536.997067,1,106106838,106109912,3074,0.40556133717123255
39607,3537.004,3537.0219,1,106110120,106110657,537,0.23666709275152806
39608,3537.0234,3537.026933,1,106110702,106110807,105,0.6957198424264414
39609,3537.042433,3537.099033,1,106111272,106112970,1698,0.4223177586218677
39610,3537.103233,3537.328333,1,106113096,106119849,6753,0.606057414131382
39611,3537.3661,3537.372667,1,106120983,106121180,197,-0.0934998228108753
39612,3537.381,3537.384767,1,106121430,106121543,113,
39613,3537.573267,3537.649567,1,106127198,106129487,2289,0.5302398172884613
39614,3537.6516,3537.690967,1,106129548,106130729,1181,0.4862878617099067
39615,3537.712467,3537.730167,1,106131374,106131905,531,0.4464022675301597
39616,3537.7552,3537.7649,1,106132656,106132947,291,0.4644543759196304
39617,3537.773667,3537.781367,1,106133210,106133441,231,0.4248298791043622
39618,3537.8028,3537.8062,1,106134084,106134186,102,-0.43510746279800144
39619,3537.808533,3537.8496,1,106134255,106135488,1233,-0.015547421972704195
39620,3537.853,3537.8635,1,106135590,106135905,315,-0.18025797672845645
39621,3537.884567,3537.8876,1,106136537,106136628,91,-0.28647918524321475
39622,3537.893367,3537.912733,1,106136801,106137381,580,0.8324370374954632
39623,3537.914133,3537.950433,1,106137423,106138512,1089,0.828152412166567
39624,3537.960433,3538.0025,1,106138812,106140075,1263,0.7652420540573048
39625,3538.018567,3538.0529,1,106140557,106141587,1030,0.041941792032642505
39626,3538.057433,3538.068767,1,106141722,106142063,341,0.003553089962926631
39627,3538.078967,3538.083,1,106142369,106142490,121,0.04332846657033095
39628,3538.141533,3538.3412,1,106144245,106150236,5991,0.7988575141733959
39629,3538.3747,3538.383233,1,106151241,106151496,255,0.22246604801989642
39630,3538.764133,3538.803933,1,106162923,106164117,1194,0.6972334704338236
39631,3538.835633,3538.846633,1,106165068,106165398,330,0.41470522258100384
39632,3538.8511,3538.862633,1,106165533,106165878,345,0.47331987186941366
39633,3538.8641,3538.875,1,106165923,106166250,327,0.5183915073093116
39634,3539.137967,3539.178167,1,106174139,106175345,1206,0.2678359603877019
39635,3539.1879,3539.230233,1,106175637,106176906,1269,0.7366976874882809
39636,3539.235133,3539.260867,1,106177053,106177826,773,0.7131509826968094
39637,3539.263667,3539.317567,1,106177910,106179527,1617,0.7229393421785449
39638,3539.323033,3539.3591,1,106179690,106180773,1083,0.6924791986115558
39639,3539.362467,3539.3761,1,106180874,106181283,409,0.6690187077714967
39640,3539.381767,3539.453967,1,106181453,106183619,2166,0.7222321503925538
39641,3539.466667,3539.4746,1,106184000,106184238,238,0.3701463905349129
39642,3539.4796,3539.5067,1,106184388,106185201,813,0.7218942662473194
39643,3539.5272,3539.580033,1,106185816,106187400,1584,0.021903989912049445
39644,3539.604133,3539.709833,1,106188123,106191294,3171,0.7361908179364612
39645,3539.734533,3539.758833,1,106192035,106192764,729,0.08029116847412776
39646,3539.765533,3539.768567,1,106192965,106193057,92,
39647,3539.7711,3539.8904,1,106193133,106196712,3579,0.6808828131974226
39648,3539.9203,3539.924367,1,106197609,106197731,122,-0.13946489416108257
39649,3539.9283,3539.931433,1,106197849,106197942,93,
39650,3539.973733,3539.978633,1,106199211,106199358,147,0.36578011110958
39651,3539.9817,3540.132533,1,106199451,106203975,4524,0.7567120707691019
39652,3540.149633,3540.171267,1,106204488,106205138,650,0.7900415484837394
39653,3540.181167,3540.230367,1,106205435,106206911,1476,0.7525761721097629
39654,3540.247967,3540.350767,1,106207439,106210523,3084,0.7716664558347135
39655,3540.352733,3540.358,1,106210581,106210740,159,0.6247743376770343
39656,3540.359967,3540.434233,1,106210799,106213026,2227,0.7926226115335548
39657,3540.4361,3540.441133,1,106213083,106213233,150,-0.02215254597905195
39658,3540.451233,3540.4625,1,106213536,106213875,339,0.8677885863136613
39659,3540.465067,3540.5293,1,106213952,106215879,1927,0.8009869447978204
39660,3540.5317,3540.553633,1,106215951,106216608,657,0.6777512032218431
39661,3540.576067,3540.589567,1,106217282,106217687,405,0.013421212356755533
39662,3540.7519,3540.756433,1,106222557,106222692,135,0.5043858712829065
39663,3540.759067,3540.833833,1,106222772,106225014,2242,0.802601124465641
39664,3540.841433,3540.8824,1,106225242,106226472,1230,0.7056749977405913
39665,3540.886067,3540.891567,1,106226582,106226747,165,-0.1831627766694511
39666,3540.907767,3540.967767,1,106227233,106229033,1800,-0.07064281642344314
39667,3540.987067,3541.041733,1,106229612,106231251,1639,0.812280061867708
39668,3541.043,3541.0912,1,106231290,106232736,1446,0.8241099397807025
39669,3541.0959,3541.099933,1,106232877,106232997,120,0.1797336191537419
39670,3541.109633,3541.1148,1,106233288,106233444,156,0.2159461238352972
39671,3541.127933,3541.132167,1,106233837,106233965,128,
39672,3541.133533,3541.166733,1,106234005,106235001,996,-0.03860754584539035
39673,3541.234833,3541.286467,1,106237044,106238594,1550,0.7655901026148605
39674,3541.287667,3541.3824,1,106238630,106241472,2842,0.7759920283561546
39675,3541.384667,3541.3931,1,106241540,106241793,253,0.7785456166742077
39676,3541.408533,3541.4134,1,106242255,106242402,147,0.7022566368606209
39677,3541.425933,3541.478067,1,106242777,106244342,1565,0.14345128695164036
39678,3541.479067,3541.488267,1,106244372,106244648,276,0.40684257834515747
39679,3541.5273,3541.715267,1,106245819,106251458,5639,0.7542311590079916
39680,3541.731467,3541.750467,1,106251944,106252514,570,-0.11323007234255508
39681,3541.753267,3541.761133,1,106252598,106252833,235,0.005349088883383212
39682,3541.793033,3541.796433,1,106253790,106253892,102,0.5409475951907096
39683,3541.799967,3541.888067,1,106253999,106256642,2643,0.7923990599969809
39684,3541.8958,3541.900267,1,106256874,106257008,134,
39685,3541.934233,3541.9376,1,106258026,106258128,102,0.8041835623150825
39686,3541.9637,3541.969867,1,106258911,106259096,185,-0.14858337852596845
39687,3541.990067,3542.1282,1,106259702,106263846,4144,0.7791110245704533
39688,3542.140067,3542.169767,1,106264202,106265093,891,0.7185899889070935
39689,3542.1842,3542.2407,1,106265526,106267221,1695,0.2206635086319611
39690,3542.2511,3542.4169,1,106267533,106272507,4974,0.8006695825225286
39691,3542.428933,3542.484467,1,106272867,106274534,1667,0.04123157907821549
39692,3542.508633,3542.618167,1,106275258,106278545,3287,0.4744532474826372
39693,3542.631533,3542.6584,1,106278945,106279752,807,-0.03593470724872731
39694,3542.6607,3542.683433,1,106279821,106280502,681,0.13840247759773625
39695,3542.692967,3542.698533,1,106280789,106280955,166,0.3557835533784785
39696,3542.701333,3542.855267,1,106281039,106285658,4619,0.7632257499097234
39697,3542.8566,3542.8617,1,106285698,106285851,153,0.7021246321145651
39698,3542.863567,3542.928733,1,106285907,106287861,1954,0.7004880190856646
39699,3542.938567,3543.024133,1,106288157,106290723,2566,0.7482745129343108
39700,3543.029267,3543.0356,1,106290878,106291068,190,0.007514569771705301
39701,3543.0405,3543.0668,1,106291215,106292004,789,0.7659045245128615
39702,3543.086933,3543.132267,1,106292607,106293968,1361,0.02175881117416803
39703,3543.1427,3543.322433,1,106294281,106299672,5391,0.8216074638734291
39704,3543.330733,3543.383167,1,106299921,106301495,1574,0.7892227404983622
39705,3543.395933,3543.4391,1,106301877,106303173,1296,0.8098520014062427
39706,3543.456767,3543.472,1,106303703,106304160,457,-0.09757999453238037
39707,3543.4765,3543.498167,1,106304295,106304945,650,0.19505615190990158
39708,3543.500467,3543.510533,1,106305014,106305315,301,0.5849239136839897
39709,3543.537433,3543.776033,1,106306122,106313280,7158,0.7865496074648027
39710,3543.7888,3543.793967,1,106313664,106313819,155,-0.12949676487286454
39711,3543.8069,3543.8134,1,106314207,106314402,195,-0.02130860005184364
39712,3543.825933,3543.830767,1,106314777,106314923,146,-0.15051709517617035
39713,3543.874,3544.003233,1,106316220,106320096,3876,0.5933480716246435
39714,3544.010333,3544.129033,1,106320309,106323870,3561,0.35682675251164314
39715,3544.137,3544.206967,1,106324110,106326209,2099,0.7273896062197417
39716,3544.224733,3544.286233,1,106326741,106328586,1845,0.7447550119393902
39717,3544.296767,3544.334833,1,106328903,106330044,1141,0.6725882384649032
39718,3544.353767,3544.3744,1,106330613,106331232,619,0.0694494460038375
39719,3544.375767,3544.415567,1,106331273,106332467,1194,0.2060954634161905
39720,3544.437367,3544.605967,1,106333121,106338179,5058,0.837178919585938
39721,3544.607933,3544.663633,1,106338237,106339908,1671,0.7714647863484294
39722,3544.666167,3544.6717,1,106339985,106340151,166,0.6835427339745498
39723,3544.6917,3544.755333,1,106340751,106342659,1908,0.80864674000651
39724,3544.757,3544.7637,1,106342710,106342911,201,0.19108694944103918
39725,3544.777633,3544.8041,1,106343328,106344123,795,0.7442226548502652
39726,3544.809033,3544.899667,1,106344270,106346990,2720,0.7128658715333173
39727,3544.900867,3544.909233,1,106347026,106347276,250,0.3959543498041423
39728,3544.915,3544.9526,1,106347450,106348578,1128,0.06888949654634785
39729,3544.975633,3545.098633,1,106349268,106352958,3690,0.8335887856743907
39730,3545.115033,3545.140767,1,106353450,106354223,773,-0.05710221375879787
39731,3545.141933,3545.170267,1,106354257,106355108,851,-0.040247715800363335
39732,3545.171433,3545.255667,1,106355142,106357670,2528,0.8098706537197916
39733,3545.2567,3545.408667,1,106357701,106362260,4559,0.7688809628841329
39734,3545.435833,3545.441933,1,106363074,106363257,183,-0.08005844193102057
39735,3545.508733,3545.5252,1,106365261,106365756,495,0.7433198455604598
39736,3545.526367,3545.638167,1,106365791,106369145,3354,0.7541437171351709
39737,3545.652667,3545.7191,1,106369580,106371573,1993,0.5849746992515196
39738,3545.724633,3545.761033,1,106371738,106372830,1092,0.17740437974452952
39739,3545.762267,3545.777667,1,106372868,106373330,462,0.250767334925005
39740,3545.783033,3545.790933,1,106373490,106373727,237,0.3525012509940449
39741,3545.792167,3545.807733,1,106373765,106374231,466,-0.10765211292026296
39742,3545.8089,3545.8243,1,106374267,106374729,462,0.24496931972029837
39743,3545.873867,3546.0125,1,106376216,106380375,4159,0.8271588716745956
39744,3546.461733,3546.465233,1,106393851,106393956,105,0.23766888305502767
39745,3546.483967,3546.489433,1,106394519,106394682,163,0.5792005207468152
39746,3546.490733,3546.495267,1,106394721,106394858,137,0.7360118116555354
39747,3546.509533,3546.530733,1,106395285,106395921,636,0.7715933807661256
39748,3546.556067,3546.585867,1,106396682,106397576,894,0.8897512796603735
39749,3546.588967,3546.660533,1,106397669,106399815,2146,0.7365240032130689
39750,3546.665267,3546.747967,1,106399958,106402439,2481,0.7389432289490534
39751,3546.752867,3546.776833,1,106402586,106403304,718,0.6945388277038196
39752,3546.780767,3546.8032,1,106403423,106404096,673,0.7827118123030976
39753,3546.816533,3546.879067,1,106404495,106406372,1877,0.27078374503119484
39754,3546.8982,3547.019233,1,106406946,106410576,3630,0.831822098981141
39755,3547.028267,3547.038667,1,106410848,106411160,312,0.48072563187709916
39756,3547.045067,3547.097533,1,106411352,106412925,1573,-0.04215975436476181
39757,3547.108267,3547.2615,1,106413248,106417845,4597,0.8004312779519516
39758,3547.2741,3547.279233,1,106418223,106418376,153,0.1314991667912882
39759,3547.314067,3547.317233,1,106419422,106419516,94,0.16904917109882284
39760,3547.318967,3547.343367,1,106419569,106420301,732,0.18606167671204615
39761,3547.354333,3547.3594,1,106420629,106420782,153,0.18478997429314922
39762,3547.365733,3547.535433,1,106420971,106426062,5091,0.8314455849346755
39763,3547.536567,3547.622167,1,106426097,106428665,2568,0.8293436861323791
39764,3547.6355,3547.64,1,106429065,106429200,135,0.4284245807314352
39765,3547.6427,3547.694033,1,106429281,106430820,1539,-0.013713274189287148
39766,3547.712933,3547.716067,1,106431387,106431482,95,-0.04640437389327158
39767,3547.717567,3547.866967,1,106431527,106436009,4482,0.8597123171016229
39768,3547.875333,3547.881333,1,106436259,106436439,180,0.20590550622620063
39769,3547.8905,3547.9291,1,106436715,106437873,1158,0.061659625249785195
39770,3547.930367,3547.943367,1,106437911,106438301,390,0.25121885487646817
39771,3547.944367,3547.9573,1,106438331,106438719,388,0.06382390550419699
39772,3547.9851,3548.110933,1,106439553,106443327,3774,0.47188642632368843
39773,3548.1237,3548.181533,1,106443711,106445445,1734,-0.019539706864415248
39774,3548.189833,3548.199267,1,106445694,106445978,284,0.31701385083238126
39775,3548.200533,3548.407167,1,106446015,106452215,6200,0.8198176475773016
39776,3548.408567,3548.590867,1,106452257,106457726,5469,0.8306641635464677
39777,3548.595,3548.602133,1,106457850,106458063,213,-0.06832912759974151
39778,3548.6108,3548.617533,1,106458324,106458525,201,0.0067452858064904935
39779,3548.736533,3548.744067,1,106462095,106462322,227,0.5635342206577226
39780,3548.7466,3548.972233,1,106462398,106469166,6768,0.8230403445859188
39781,3548.999867,3549.003233,1,106469996,106470096,100,-0.30879118147992385
39782,3549.004433,3549.007567,1,106470132,106470227,95,-0.1472695579872655
39783,3549.0736,3549.079,1,106472208,106472370,162,0.1623531863121834
39784,3549.082533,3549.088367,1,106472475,106472651,176,0.22629799782776785
39785,3549.089867,3549.1478,1,106472696,106474434,1738,0.5630073689555816
39786,3549.153933,3549.277567,1,106474617,106478327,3710,0.7494768213801356
39787,3549.296767,3549.491867,1,106478903,106484756,5853,0.7182873763413989
39788,3549.494167,3549.5181,1,106484825,106485543,718,0.32192456864621827
39789,3549.520633,3549.606,1,106485618,106488180,2562,0.8185142639504427
39790,3549.607667,3549.6332,1,106488230,106488996,766,0.6913944424155348
39791,3549.6362,3549.724067,1,106489086,106491722,2636,0.8308480113815787
39792,3549.726433,3549.7517,1,106491792,106492551,759,0.6189854235133969
39793,3549.754967,3549.826533,1,106492649,106494795,2146,0.7645529118628217
39794,3549.835033,3549.850233,1,106495050,106495506,456,0.6419458773988975
39795,3549.8579,3549.869067,1,106495737,106496072,335,0.1626766516521007
39796,3549.8947,3549.907267,1,106496841,106497218,377,-0.11124511984737928
39797,3549.911467,3549.931067,1,106497344,106497932,588,0.1685146531532366
39798,3549.9342,3549.937567,1,106498026,106498127,101,0.5900407608181935
39799,3549.976433,3550.203433,1,106499292,106506102,6810,0.8429141177395655
39800,3550.221533,3550.234267,1,106506645,106507028,383,0.08934306835912266
39801,3550.235533,3550.241433,1,106507065,106507242,177,0.02011529431727992
39802,3550.258267,3550.278067,1,106507748,106508342,594,0.6291847731039684
39803,3550.2954,3550.311267,1,106508862,106509338,476,0.5878014472630356
39804,3550.3136,3550.378133,1,106509408,106511343,1935,0.8176809999411563
39805,3550.38,3550.384667,1,106511400,106511540,140,0.1872039425261291
39806,3550.413767,3550.418133,1,106512413,106512543,130,-0.14780647894223065
39807,3550.474833,3550.4912,1,106514244,106514736,492,0.34209726058547296
39808,3550.492433,3550.589167,1,106514772,106517675,2903,0.6570751725783878
39809,3550.612267,3550.6299,1,106518368,106518897,529,0.09025314849244723
39810,3550.630933,3550.651933,1,106518927,106519557,630,0.2699995925137468
39811,3550.6589,3550.667333,1,106519767,106520019,252,0.5414400015203386
39812,3550.6703,3550.881367,1,106520109,106526441,6332,0.8036507063407294
39813,3550.883767,3550.890167,1,106526513,106526705,192,0.658133754016453
39814,3550.891267,3550.977767,1,106526738,106529333,2595,0.7739841364113897
39815,3550.979467,3551.0447,1,106529384,106531341,1957,0.7049822066554795
39816,3551.0588,3551.103233,1,106531764,106533096,1332,0.8359814657667224
39817,3551.104467,3551.110967,1,106533134,106533329,195,0.36277933562918907
39818,3551.125733,3551.136367,1,106533771,106534091,320,-0.06548397061799205
39819,3551.141067,3551.1741,1,106534232,106535223,991,0.12491045861636997
39820,3551.181,3551.184467,1,106535430,106535534,104,0.19413169778962103
39821,3551.185667,3551.415733,1,106535570,106542471,6901,0.7005711772371492
39822,3551.439567,3551.4501,1,106543187,106543503,316,0.2818393259924974
39823,3551.459133,3551.464667,1,106543773,106543940,167,-0.25567383363016777
39824,3551.4753,3551.605433,1,106544259,106548162,3903,0.8134069063985285
39825,3551.646033,3551.649567,1,106549380,106549487,107,
39826,3551.705367,3551.709967,1,106551161,106551299,138,0.6925913753968169
39827,3551.715633,3551.875933,1,106551468,106556277,4809,0.8130808970921132
39828,3551.877033,3551.880833,1,106556310,106556424,114,0.6986356330440987
39829,3551.8821,3551.952333,1,106556463,106558569,2106,0.8189894268340869
39830,3551.959,3552.0501,1,106558770,106561503,2733,0.8031879077094131
39831,3552.065967,3552.123933,1,106561979,106563717,1738,0.09775799166242108
39832,3552.136333,3552.229967,1,106564089,106566899,2810,0.8317763736101473
39833,3552.231533,3552.358,1,106566945,106570740,3795,0.8667523282522401
39834,3552.3694,3552.402633,1,106571082,106572078,996,-0.05445642658708386
39835,3552.4043,3552.431533,1,106572129,106572945,816,-0.14138528107521872
39836,3552.4477,3552.627467,1,106573431,106578824,5393,0.8339369563465012
39837,3552.630167,3552.637333,1,106578905,106579119,214,0.5530060622843704
39838,3552.638833,3552.7413,1,106579164,106582239,3075,0.8182347094572606
39839,3552.743367,3552.79,1,106582301,106583700,1399,0.7675434359085656
39840,3552.793267,3552.920967,1,106583798,106587629,3831,0.8217444191972688
39841,3552.9243,3553.028033,1,106587729,106590840,3111,0.7854917095009912
39842,3553.0313,3553.037767,1,106590939,106591133,194,0.673824500412122
39843,3553.038833,3553.117967,1,106591164,106593539,2375,0.8303879603754427
39844,3553.119733,3553.1455,1,106593591,106594365,774,0.6813918392682461
39845,3553.1487,3553.237733,1,106594461,106597131,2670,0.845549640888981
39846,3553.245,3553.264333,1,106597350,106597929,579,0.7820931107272142
39847,3553.2679,3553.359867,1,106598037,106600796,2759,0.7504936537701196
39848,3553.362167,3553.3893,1,106600865,106601679,814,0.621247409377801
39849,3553.392667,3553.504833,1,106601780,106605144,3364,0.5644447413100425
39850,3553.505833,3553.5166,1,106605174,106605498,324,0.7646070156699428
39851,3553.520133,3553.618333,1,106605603,106608549,2946,0.8473855956770734
39852,3553.619833,3553.642867,1,106608594,106609286,692,0.8781145789489581
39853,3553.649567,3553.745433,1,106609487,106612362,2875,0.8443823367384109
39854,3553.748567,3553.775433,1,106612457,106613262,805,0.8571112854542223
39855,3553.7781,3553.874133,1,106613343,106616223,2880,0.816532008639329
39856,3553.879933,3553.9017,1,106616397,106617051,654,0.8736027039760929
39857,3553.9103,3553.9757,1,106617309,106619271,1962,0.8110414857426057
39858,3553.978167,3554.000567,1,106619345,106620017,672,0.8259408118741062
39859,3554.005867,3554.0107,1,106620176,106620321,145,0.5628609539510518
39860,3554.0235,3554.0265,1,106620705,106620795,90,0.8940531422396787
39861,3554.030867,3554.088967,1,106620926,106622669,1743,0.6946250345257319
39862,3554.112367,3554.135433,1,106623371,106624062,691,0.3418665169276721
39863,3554.147467,3554.233133,1,106624424,106626993,2569,0.8160301927961919
39864,3554.253333,3554.257033,1,106627599,106627710,111,0.14676456203463623
39865,3554.259933,3554.263,1,106627797,106627890,93,0.27959924130032915
39866,3554.2642,3554.268867,1,106627926,106628066,140,-0.2471241903098134
39867,3554.333833,3554.421733,1,106630014,106632651,2637,0.8285977765520643
39868,3554.431867,3554.441,1,106632956,106633230,274,0.10792483886244003
39869,3554.445033,3554.451233,1,106633350,106633536,186,
39870,3554.462667,3554.468533,1,106633880,106634055,175,0.3008507336248838
39871,3554.7436,3554.7481,1,106642308,106642443,135,0.590848558824563
39872,3554.771233,3554.7883,1,106643136,106643649,513,0.6625853267804693
39873,3554.827933,3554.841933,1,106644837,106645257,420,0.7874078200788407
39874,3554.9158,3554.919467,1,106647474,106647584,110,-0.1895339744386282
39875,3554.920467,3554.9273,1,106647614,106647819,205,0.43902383117033894
39876,3554.931833,3554.937167,1,106647954,106648115,161,0.24527108018479774
39877,3554.964933,3554.9687,1,106648947,106649061,114,0.5502949175377654
39878,3554.970767,3554.9866,1,106649123,106649598,475,0.7028949960214667
39879,3554.991267,3555.011433,1,106649738,106650342,604,0.7291673147031608
39880,3555.043067,3555.047,1,106651292,106651410,118,0.35309530767498887
39881,3555.051833,3555.059567,1,106651554,106651787,233,0.5512815456603886
39882,3555.096,3555.109667,1,106652880,106653290,410,0.144104188038407
39883,3555.239367,3555.2427,1,106657181,106657281,100,0.5487041781424337
39884,3555.249767,3555.438667,1,106657493,106663160,5667,0.788883637764616
39885,3555.4397,3555.465067,1,106663191,106663952,761,0.8076934095293068
39886,3555.5039,3555.638367,1,106665117,106669151,4034,0.7372285954200329
39887,3555.667233,3555.670267,1,106670016,106670108,92,
39888,3555.671333,3555.677467,1,106670139,106670324,185,0.46976693077573584
39889,3556.118733,3556.1615,1,106683561,106684845,1284,0.6632123739259864
39890,3556.170767,3556.1944,1,106685123,106685832,709,0.5383349947585543
39891,3556.220367,3556.2276,1,106686611,106686828,217,0.7803224005041022
39892,3556.244967,3556.258167,1,106687349,106687745,396,0.8136720199655382
39893,3556.287467,3556.2932,1,106688624,106688796,172,-0.31545162736548765
39894,3556.296,3556.299433,1,106688880,106688982,102,-0.15262017276948064
39895,3556.405067,3556.5101,1,106692152,106695303,3151,0.7537723722570786
39896,3556.527667,3556.535,1,106695830,106696050,220,-0.16043326451346646
39897,3556.536167,3556.540033,1,106696085,106696200,115,-0.02461832320780718
39898,3556.560433,3556.682567,1,106696812,106700477,3665,0.8775444581006022
39899,3556.709667,3556.802167,1,106701290,106704065,2775,0.7903149810569636
39900,3556.8032,3556.808567,1,106704096,106704257,161,0.2823371916500605
39901,3557.593267,3557.604367,1,106727798,106728131,333,0.7160697142415628
39902,3557.606633,3557.621767,1,106728198,106728653,455,0.6356207805667368
39903,3557.673767,3557.677467,1,106730213,106730324,111,0.3894530042539654
39904,3557.687733,3557.700267,1,106730631,106731008,377,0.4588232960820103
39905,3557.866933,3557.980767,1,106736007,106739423,3416,0.7368156352389637
39906,3558.2514,3558.293833,1,106747542,106748814,1272,0.6397295194715552
39907,3558.833233,3558.840733,1,106764996,106765221,225,0.5315706704718896
39908,3558.859567,3558.918433,1,106765787,106767552,1765,0.5960706153307577
39909,3558.936533,3558.964733,1,106768095,106768941,846,0.6603380750423381
39910,3558.987267,3558.992333,1,106769618,106769769,151,0.4641020351146417
39911,3558.993767,3559.009267,1,106769813,106770278,465,0.6248273470771454
39912,3559.0107,3559.032267,1,106770321,106770968,647,0.5802642818164658
39913,3559.042967,3559.0508,1,106771289,106771524,235,0.5520068241771108
39914,3559.0665,3559.072767,1,106771995,106772183,188,0.22705582508337047
39915,3559.0871,3559.1003,1,106772613,106773009,396,0.6590932717076509
39916,3559.1074,3559.129467,1,106773222,106773884,662,0.08860871630153988
39917,3559.1308,3559.143433,1,106773924,106774302,378,0.10139349587316553
39918,3559.170433,3559.174967,1,106775112,106775249,137,0.38994716418658526
39919,3559.180167,3559.2977,1,106775405,106778931,3526,0.7967395357721857
39920,3559.738833,3559.743467,1,106792164,106792304,140,0.6960177652582364
39921,3559.7588,3559.765433,1,106792764,106792962,198,0.5819807723735259
39922,3559.8097,3559.845867,1,106794291,106795376,1085,0.8108271940492432
39923,3559.8677,3559.8984,1,106796031,106796952,921,0.19319093271759122
39924,3559.979133,3559.987567,1,106799373,106799627,254,0.6060474181903415
39925,3560.0405,3560.0565,1,106801215,106801695,480,0.6291992527736857
39926,3560.0628,3560.083533,1,106801884,106802505,621,0.693514982399603
39927,3560.111633,3560.128933,1,106803348,106803867,519,0.7163114745626702
39928,3560.154533,3560.1632,1,106804635,106804896,261,0.583785035980959
39929,3560.1707,3560.1791,1,106805121,106805373,252,0.5633563545417457
39930,3560.387867,3560.415067,1,106811636,106812452,816,0.5996810992534041
39931,3560.417567,3560.513,1,106812527,106815390,2863,0.7951816674547708
39932,3560.531767,3560.538067,1,106815953,106816142,189,0.5530038614438212
39933,3560.606367,3560.6123,1,106818191,106818369,178,-0.12228459812556498
39934,3560.614433,3560.7045,1,106818432,106821135,2703,0.785793953162958
39935,3560.7264,3560.7319,1,106821792,106821957,165,-0.13862098526886718
39936,3560.9984,3561.0274,1,106829952,106830822,870,0.731870650159758
39937,3561.0496,3561.095233,1,106831488,106832856,1368,0.7598323988996936
39938,3561.0972,3561.100667,1,106832916,106833020,104,0.5096690049912944
39939,3561.101833,3561.135633,1,106833054,106834068,1014,0.7796609133951361
39940,3561.153367,3561.1948,1,106834601,106835844,1243,0.6662971567392628
39941,3561.196567,3561.2504,1,106835897,106837512,1615,0.7098240835526034
39942,3561.2542,3561.332667,1,106837626,106839980,2354,0.7185944704357237
39943,3561.3353,3561.3395,1,106840059,106840185,126,0.45114802749773086
39944,3561.3418,3561.382167,1,106840254,106841465,1211,0.7081586213472674
39945,3561.3951,3561.434933,1,106841853,106843047,1194,0.7855203505572946
39946,3561.436867,3561.459267,1,106843106,106843778,672,0.7386408192176186
39947,3561.487867,3561.5321,1,106844636,106845963,1327,0.03608092768930797
39948,3561.533233,3561.54,1,106845996,106846200,204,0.05477804866772251
39949,3561.5582,3561.664167,1,106846746,106849925,3179,0.7067244875676276
39950,3561.6819,3561.716367,1,106850457,106851491,1034,-0.01793896418761854
39951,3561.718033,3561.740133,1,106851540,106852203,663,0.18507699715828027
39952,3561.7473,3561.7579,1,106852419,106852737,318,0.5200190098309492
39953,3561.7609,3561.930033,1,106852827,106857900,5073,0.8440597767867989
39954,3561.9311,3562.0376,1,106857933,106861128,3195,0.7998270086924789
39955,3562.069567,3562.0871,1,106862087,106862613,526,0.12410793613507846
39956,3562.7546,3562.762933,1,106882638,106882887,249,0.38716375142827425
39957,3562.7847,3562.788633,1,106883541,106883658,117,0.6579489642958606
39958,3562.7905,3562.797233,1,106883715,106883916,201,0.41416800378258317
39959,3562.838633,3562.843333,1,106885158,106885299,141,0.5670057696350324
39960,3562.873267,3562.888933,1,106886198,106886667,469,0.5460147361763048
39961,3562.926767,3562.933067,1,106887803,106887992,189,0.6992217573485919
39962,3562.9343,3562.948,1,106888029,106888440,411,0.5579995787183342
39963,3562.980233,3562.986467,1,106889406,106889594,188,0.5918000508599622
39964,3562.9927,3563.013967,1,106889781,106890419,638,0.5148564251618426
39965,3563.030333,3563.048667,1,106890909,106891460,551,0.5525901579258947
39966,3563.077667,3563.0828,1,106892330,106892484,154,0.3082297315490676
39967,3563.096933,3563.1018,1,106892907,106893054,147,0.3981775369463268
39968,3563.105233,3563.1151,1,106893156,106893453,297,0.6265460969432125
39969,3563.142533,3563.151,1,106894275,106894530,255,0.626031911534421
39970,3563.158267,3563.165667,1,106894748,106894970,222,0.6352369003672915
39971,3563.290367,3563.295067,1,106898711,106898852,141,0.7120407776147112
39972,3563.297967,3563.3153,1,106898939,106899459,520,0.8689484288068348
39973,3563.3164,3563.415833,1,106899492,106902474,2982,0.7906360477357522
39974,3563.6522,3563.850633,1,106909566,106915518,5952,0.8051848806629589
39975,3563.868,3563.9386,1,106916040,106918158,2118,0.7465564551456071
39976,3563.9435,3564.0324,1,106918305,106920972,2667,0.7427627568860257
39977,3564.0347,3564.045767,1,106921041,106921373,332,0.784978341458461
39978,3564.0555,3564.0593,1,106921665,106921779,114,0.6178062200076961
39979,3564.572967,3564.5992,1,106937189,106937976,787,0.5875164331550604
39980,3564.6192,3564.666133,1,106938576,106939983,1407,0.7553955040566437
39981,3564.684967,3564.7238,1,106940549,106941714,1165,0.718147629205464
39982,3564.758667,3564.771733,1,106942760,106943151,391,0.5878502109918075
39983,3564.772967,3564.790433,1,106943189,106943712,523,0.4982916408108447
39984,3564.8101,3564.8354,1,106944303,106945062,759,0.6401554614700513
39985,3564.836533,3564.859733,1,106945095,106945791,696,0.5409531618087059
39986,3564.884333,3564.901933,1,106946529,106947057,528,0.8238257499285088
39987,3564.926733,3564.9385,1,106947801,106948155,354,0.7653933301098855
39988,3564.947233,3564.9663,1,106948416,106948989,573,0.77349642706155
39989,3564.998533,3565.020133,1,106949955,106950603,648,-0.049646344979105486
39990,3565.023033,3565.046733,1,106950690,106951401,711,0.14165725796779544
39991,3565.208,3565.432767,1,106956240,106962983,6743,0.7624528295396462
39992,3565.4626,3565.4668,1,106963878,106964004,126,-0.0034069008155273414
39993,3565.473733,3565.486133,1,106964211,106964583,372,0.35583708199941066
39994,3565.525967,3565.6105,1,106965779,106968315,2536,0.7992548777705919
39995,3565.6205,3565.6235,1,106968615,106968705,90,0.1343612034194907
39996,3565.6265,3565.631633,1,106968795,106968948,153,-0.09325670335326422
39997,3565.8475,3565.851067,1,106975425,106975532,107,0.8056081721614464
39998,3565.853233,3565.903,1,106975596,106977090,1494,0.8030309276267062
39999,3565.9046,3565.909067,1,106977138,106977272,134,0.1299619780576379
40000,3565.910967,3565.951733,1,106977329,106978551,1222,0.7919190467435897
40001,3565.977367,3565.999967,1,106979321,106979999,678,0.17052651649899456
40002,3566.001033,3566.0109,1,106980030,106980327,297,-0.1421886458973907
40003,3566.0123,3566.025133,1,106980369,106980753,384,0.376022781174999
40004,3566.1019,3566.1066,1,106983057,106983198,141,0.663322960543866
40005,3566.110067,3566.114633,1,106983302,106983438,136,0.5865947396180761
40006,3566.1221,3566.128267,1,106983663,106983848,185,0.5790803718562387
40007,3566.145433,3566.1528,1,106984362,106984584,222,0.2059688448396202
40008,3566.211733,3566.3537,1,106986351,106990611,4260,0.7814633766519019
40009,3566.357233,3566.360267,1,106990716,106990808,92,0.47331327186202854
40010,3566.361567,3566.431033,1,106990847,106992930,2083,0.7921065274297044
40011,3566.432033,3566.460667,1,106992960,106993820,860,0.6660182014197372
40012,3566.4875,3566.494967,1,106994625,106994849,224,-0.09353317176712136
40013,3566.498833,3566.535367,1,106994964,106996061,1097,-0.05029569011198095
40014,3566.555,3566.5585,1,106996650,106996755,105,-0.010722762410491016
40015,3566.5644,3566.579233,1,106996932,106997376,444,0.8114281342244212
40016,3566.581333,3566.703667,1,106997439,107001110,3671,0.8273284102857676
40017,3566.710133,3566.721167,1,107001303,107001635,332,0.4968632836909805
40018,3566.7239,3566.815133,1,107001717,107004453,2736,0.7969197884184348
40019,3566.875,3566.885333,1,107006250,107006559,309,-0.08438296438387838
40020,3566.957067,3567.070967,1,107008712,107012129,3417,0.7993359708605806
40021,3567.0899,3567.0953,1,107012697,107012859,162,-0.015236494060396667
40022,3567.099033,3567.103267,1,107012970,107013098,128,0.16669549262857247
40023,3567.589767,3567.6091,1,107027693,107028273,580,0.6577076567741843
40024,3567.6118,3567.6262,1,107028354,107028786,432,0.6309570480977992
40025,3567.641267,3567.6661,1,107029238,107029983,745,0.5800613330409266
40026,3568.229433,3568.261833,1,107046882,107047854,972,0.5178910008956943
40027,3568.289867,3568.3076,1,107048696,107049228,532,0.5881585864530394
40028,3568.360633,3568.365033,1,107050818,107050950,132,0.6526378131614496
40029,3568.526267,3568.634433,1,107055788,107059032,3244,0.8174462247733884
40030,3568.662933,3568.667233,1,107059887,107060016,129,0.8544141227954031
40031,3568.9166,3568.934833,1,107067498,107068044,546,0.639142155371042
40032,3569.199933,3569.334067,1,107075997,107080022,4025,0.7959727091218186
40033,3569.335133,3569.345533,1,107080053,107080365,312,0.6112462362753597
40034,3569.358467,3569.439,1,107080754,107083170,2416,0.7914824075167312
40035,3569.4816,3569.4851,1,107084448,107084553,105,
40036,3569.622733,3569.8043,1,107088681,107094129,5448,0.799834638299971
40037,3569.813433,3569.864367,1,107094402,107095931,1529,0.8204372750538903
40038,3569.876433,3569.88,1,107096292,107096400,108,0.8784783294842111
40039,3569.892133,3569.9172,1,107096763,107097516,753,0.8116541463057312
40040,3569.946767,3569.952167,1,107098403,107098565,162,-0.01767470202415913
40041,3570.556033,3570.5638,1,107116680,107116914,234,0.6936143419062377
40042,3570.5653,3570.5725,1,107116959,107117175,216,0.5575039024065833
40043,3570.575333,3570.641567,1,107117259,107119247,1988,0.5226743006760499
40044,3570.644033,3570.6478,1,107119320,107119434,114,0.3081497925561715
40045,3570.656267,3570.692367,1,107119688,107120771,1083,0.607893213031412
40046,3570.713533,3570.730167,1,107121405,107121905,500,0.5140937996675673
40047,3570.733967,3570.7549,1,107122019,107122647,628,0.5488361468812816
40048,3570.766733,3570.771733,1,107123001,107123151,150,0.3135686517442934
40049,3570.820233,3570.860767,1,107124606,107125823,1217,0.04326316290270986
40050,3570.8658,3570.8792,1,107125974,107126376,402,-0.3295304126158831
40051,3570.8803,3571.032133,1,107126409,107130963,4554,0.8064587854334153
40052,3571.0422,3571.1007,1,107131266,107133021,1755,0.7737527078082743
40053,3571.1393,3571.143333,1,107134179,107134299,120,0.3263647605629674
40054,3571.144533,3571.152933,1,107134335,107134587,252,0.3962184262489398
40055,3571.7956,3571.801967,1,107153868,107154059,191,0.7332853061119977
40056,3571.827733,3571.869833,1,107154831,107156094,1263,0.8098425594155815
40057,3571.9022,3571.9193,1,107157066,107157579,513,0.7766412329926222
40058,3571.927667,3571.9324,1,107157830,107157972,142,0.39651240659423764
40059,3571.938733,3571.978733,1,107158161,107159361,1200,0.43556947582578753
40060,3571.9987,3572.0037,1,107159961,107160111,150,-0.340404611640765
40061,3572.0064,3572.019733,1,107160192,107160591,399,0.4595806457850202
40062,3572.0466,3572.052467,1,107161398,107161574,176,0.5729444044598873
40063,3572.067633,3572.081,1,107162028,107162430,402,0.018570442306319466
40064,3572.082567,3572.1006,1,107162477,107163018,541,0.1311458731206745
40065,3572.1274,3572.269333,1,107163822,107168079,4257,0.8189926144050501
40066,3572.294867,3572.3388,1,107168846,107170164,1318,0.8572007127782436
40067,3572.339867,3572.413433,1,107170196,107172402,2206,0.6901510565613783
40068,3572.414733,3572.504233,1,107172441,107175126,2685,0.7717106692618746
40069,3572.5206,3572.537533,1,107175618,107176125,507,0.07980209111402861
40070,3572.5454,3572.5638,1,107176362,107176914,552,0.2813725742154754
40071,3572.7646,3572.797667,1,107182938,107183930,992,0.7459206670666461
40072,3572.975967,3572.9797,1,107189279,107189391,112,-0.014489072003015522
40073,3572.981633,3573.115167,1,107189448,107193455,4007,0.7769835059897456
40074,3573.1372,3573.2323,1,107194116,107196969,2853,0.8171806056671596
40075,3573.2728,3573.276767,1,107198184,107198303,119,
40076,3573.571733,3573.578667,1,107207151,107207360,209,0.5546903017179617
40077,3573.5802,3573.597733,1,107207406,107207931,525,0.7013935650481297
40078,3573.607267,3573.707733,1,107208218,107211231,3013,0.8323946974563631
40079,3573.7148,3573.809533,1,107211444,107214285,2841,0.7799787036432487
40080,3573.810633,3573.8177,1,107214318,107214531,213,0.6785931587162275
40081,3573.838967,3573.895667,1,107215169,107216870,1701,0.8242386586018299
40082,3573.905767,3573.923033,1,107217173,107217690,517,0.6374228487855437
40083,3573.924233,3573.939367,1,107217726,107218181,455,0.4991065990976716
40084,3573.958467,3573.961633,1,107218754,107218848,94,0.13240049752646085
40085,3573.967033,3573.973667,1,107219010,107219210,200,0.25006331992065833
40086,3573.9753,3574.013033,1,107219259,107220390,1131,0.027742042348996243
40087,3574.036267,3574.330067,1,107221088,107229902,8814,0.7649808293441837
40088,3574.340933,3574.344767,1,107230227,107230343,116,0.08330705328240257
40089,3574.365833,3574.370833,1,107230974,107231124,150,0.1647689105844
40090,3574.371933,3574.375467,1,107231157,107231264,107,0.05628470987575323
40091,3574.5156,3574.553933,1,107235468,107236617,1149,0.7971842617973389
40092,3574.554933,3574.640733,1,107236647,107239221,2574,0.8165242995923309
40093,3574.652233,3574.667733,1,107239566,107240031,465,-0.0547000770074006
40094,3574.6755,3574.679367,1,107240265,107240381,116,-0.016116535236419382
40095,3574.691967,3574.6963,1,107240759,107240889,130,
40096,3575.3004,3575.327867,1,107259012,107259836,824,0.5449503947219698
40097,3575.382433,3575.400933,1,107261472,107262027,555,0.6032697147252671
40098,3575.5137,3575.5267,1,107265411,107265801,390,0.764297400212628
40099,3575.527833,3575.532867,1,107265834,107265986,152,0.247202719534004
40100,3575.574733,3575.590633,1,107267241,107267718,477,0.5995305847062459
40101,3575.7466,3575.827533,1,107272398,107274825,2427,0.722991608747927
40102,3575.829733,3575.879033,1,107274891,107276370,1479,0.8022622428132286
40103,3575.894367,3575.913467,1,107276831,107277404,573,0.7530105542608618
40104,3575.9146,3576.019333,1,107277438,107280579,3141,0.8158572216427682
40105,3576.022233,3576.0841,1,107280666,107282523,1857,0.7877524836198887
40106,3576.0898,3576.109,1,107282694,107283270,576,0.7205919840198274
40107,3576.112767,3576.175967,1,107283383,107285279,1896,0.7605621903767983
40108,3576.1803,3576.190267,1,107285409,107285708,299,0.42693086777556527
40109,3576.966,3576.971567,1,107308980,107309147,167,0.6666006937463901
40110,3577.01,3577.0353,1,107310300,107311059,759,0.7143359708903728
40111,3577.0375,3577.0455,1,107311125,107311365,240,0.6662145728402723
40112,3577.080867,3577.109033,1,107312426,107313270,844,0.5073869309474742
40113,3577.1468,3577.151367,1,107314404,107314541,137,0.8367129011677407
40114,3577.175667,3577.214,1,107315270,107316420,1150,0.4605450493911173
40115,3577.2409,3577.255933,1,107317227,107317677,450,0.6985114933426019
40116,3577.438167,3577.441367,1,107323145,107323241,96,0.12988790659962685
40117,3577.4694,3577.574967,1,107324082,107327249,3167,0.7823393513907498
40118,3577.724,3577.9928,1,107331720,107339784,8064,0.7607646344239193
40119,3578.004833,3578.008267,1,107340144,107340248,104,-0.16629525647534002
40120,3578.5011,3578.5053,1,107355033,107355159,126,0.6766029682603912
40121,3578.511467,3578.5809,1,107355344,107357427,2083,0.8142505357676301
40122,3578.5963,3578.630733,1,107357889,107358921,1032,0.8675110746296176
40123,3578.643467,3578.654433,1,107359304,107359632,328,0.6425977179987077
40124,3578.664433,3578.679667,1,107359932,107360390,458,-0.08526377220652476
40125,3578.682933,3578.711433,1,107360487,107361342,855,0.2619710313802996
40126,3578.816867,3578.888167,1,107364506,107366645,2139,0.7563411421213547
40127,3578.9036,3578.9198,1,107367108,107367594,486,0.8835624406881102
40128,3578.972867,3578.9845,1,107369186,107369535,349,0.6190091144861687
40129,3578.986033,3579.003633,1,107369580,107370108,528,0.7148846861989786
40130,3579.0057,3579.092833,1,107370171,107372784,2613,0.7720538563465426
40131,3579.1164,3579.123267,1,107373492,107373698,206,0.4321021344235308
40132,3579.133,3579.172667,1,107373990,107375180,1190,0.21026488530242526
40133,3579.174267,3579.198067,1,107375228,107375942,714,0.06664261993375875
40134,3579.227267,3579.337967,1,107376818,107380139,3321,0.849605617792113
40135,3579.3543,3579.364533,1,107380629,107380935,306,0.5997817844629497
40136,3579.370867,3579.414067,1,107381126,107382422,1296,0.06970178741429701
40137,3579.417,3579.421533,1,107382510,107382645,135,0.3290094280993853
40138,3579.4226,3579.4326,1,107382678,107382978,300,0.16565471651039793
40139,3579.441067,3579.446867,1,107383232,107383406,174,0.6306402693771462
40140,3579.456667,3579.6626,1,107383700,107389878,6178,0.8223095658549607
40141,3579.673667,3579.693033,1,107390210,107390790,580,0.7045298122496102
40142,3579.6943,3579.699767,1,107390829,107390993,164,0.10814512523636514
40143,3579.709633,3579.721167,1,107391288,107391635,347,0.5134542847785437
40144,3579.723767,3579.771167,1,107391713,107393135,1422,-0.037623840907619915
40145,3579.797233,3579.801567,1,107393916,107394047,131,-0.32556448452871467
40146,3579.802633,3579.9338,1,107394078,107398014,3936,0.8444001517466874
40147,3579.975533,3579.982133,1,107399265,107399463,198,-0.17627917821880132
40148,3579.9873,3579.991033,1,107399619,107399730,111,
40149,3579.9922,3579.995467,1,107399766,107399864,98,
40150,3580.2408,3580.264233,1,107407224,107407926,702,0.5418264717405457
40151,3580.279333,3580.313533,1,107408379,107409405,1026,0.7077838505799545
40152,3580.319133,3580.372067,1,107409573,107411162,1589,0.803872506246476
40153,3580.382667,3580.4538,1,107411480,107413614,2134,0.7271278425024127
40154,3580.455567,3580.4613,1,107413667,107413839,172,-0.36036706121174406
40155,3580.473633,3580.561033,1,107414208,107416830,2622,0.7555007631752739
40156,3581.934067,3581.939467,1,107458022,107458184,162,0.4463865229690241
40157,3581.9543,3581.9592,1,107458629,107458776,147,0.6062211857853566
40158,3582.007533,3582.018367,1,107460225,107460551,326,0.7835439297760078
40159,3582.054333,3582.063533,1,107461629,107461905,276,0.7004876674698596
40160,3582.089733,3582.094367,1,107462691,107462831,140,0.3380035809410479
40161,3582.0992,3582.125,1,107462976,107463750,774,0.7220355796771957
40162,3582.134,3582.1373,1,107464020,107464119,99,0.6194598351109168
40163,3582.143167,3582.1695,1,107464295,107465085,790,0.5917925892408497
40164,3582.175833,3582.188167,1,107465274,107465645,371,0.7016293635299377
40165,3582.331167,3582.3402,1,107469935,107470206,271,0.5593732302793961
40166,3582.359533,3582.3807,1,107470785,107471421,636,0.7616800442292666
40167,3582.4753,3582.484033,1,107474259,107474520,261,0.4971921703536876
40168,3582.508967,3582.5198,1,107475269,107475594,325,0.7515109152401241
40169,3582.536433,3582.5553,1,107476092,107476659,567,0.6379053461694659
40170,3582.556767,3582.560567,1,107476703,107476817,114,0.8179626101158864
40171,3582.5627,3582.569833,1,107476881,107477094,213,0.6061867533715987
40172,3582.571133,3582.574667,1,107477133,107477240,107,-0.34687758015170467
40173,3582.6552,3582.663867,1,107479656,107479916,260,0.7861935600257983
40174,3582.6827,3582.700767,1,107480481,107481023,542,0.8761468831575242
40175,3582.7089,3582.7157,1,107481267,107481471,204,-0.37900263970747905
40176,3582.767133,3582.771033,1,107483013,107483130,117,0.9261110350423903
40177,3582.797533,3582.806233,1,107483925,107484186,261,0.6879089620440125
40178,3582.8277,3582.849167,1,107484831,107485475,644,0.24048477972240295
40179,3582.855867,3582.889867,1,107485676,107486696,1020,0.7854522103104767
40180,3582.893,3582.9057,1,107486790,107487171,381,0.750798731069147
40181,3582.909267,3582.930433,1,107487278,107487912,634,0.8761311823775619
40182,3582.935233,3582.9508,1,107488056,107488524,468,-0.09257706758913781
40183,3582.9522,3582.970667,1,107488566,107489120,554,0.8218062021435195
40184,3582.978667,3582.9866,1,107489360,107489598,238,0.5093080491131712
40185,3582.988367,3582.9915,1,107489651,107489745,94,0.2750368992311482
40186,3583.0412,3583.047067,1,107491236,107491412,176,0.6721652430708399
40187,3583.148,3583.156533,1,107494440,107494695,255,0.55511324515405
40188,3583.181967,3583.190467,1,107495459,107495714,255,0.7300499012862881
40189,3583.212567,3583.2328,1,107496377,107496984,607,0.3222901039598374
40190,3583.2422,3583.252733,1,107497266,107497581,315,0.5286502747243098
40191,3583.259333,3583.277533,1,107497779,107498325,546,0.8181637025825683
40192,3583.2937,3583.298033,1,107498811,107498940,129,0.3393921564843555
40193,3583.301533,3583.3192,1,107499045,107499576,531,0.3294990615212484
40194,3583.330567,3583.342233,1,107499917,107500266,349,-0.038005903638805634
40195,3583.351967,3583.3696,1,107500559,107501088,529,0.8646742404397487
40196,3583.377567,3583.389033,1,107501327,107501670,343,-0.06513692754759867
40197,3583.511233,3583.525,1,107505336,107505750,414,0.3128707068216684
40198,3583.566967,3583.585333,1,107507009,107507559,550,0.39449814664436844
40199,3583.6203,3583.630933,1,107508609,107508927,318,0.6191457071714783
40200,3583.654033,3583.6605,1,107509620,107509815,195,0.6166369113941532
40201,3583.688033,3583.701933,1,107510640,107511057,417,0.3095714525418363
40202,3583.8421,3583.849133,1,107515263,107515473,210,0.3035497482254518
40203,3583.870433,3583.883167,1,107516112,107516495,383,0.44785788362806844
40204,3583.903333,3583.918133,1,107517099,107517543,444,0.27097271239187537
40205,3583.936267,3583.961467,1,107518088,107518844,756,0.7836750065540253
40206,3583.9739,3583.979,1,107519217,107519370,153,0.16001549283363498
40207,3583.993833,3584.003467,1,107519814,107520104,290,0.5951388222784939
40208,3584.338067,3584.344033,1,107530142,107530320,178,0.2752508793024944
40209,3584.3872,3584.4009,1,107531616,107532027,411,0.6120246956459884
40210,3584.4427,3584.4632,1,107533281,107533896,615,0.5338635921989742
40211,3584.5366,3584.540367,1,107536098,107536211,113,
40212,3584.5631,3584.5749,1,107536893,107537247,354,0.2822050324652635
40213,3584.6132,3584.632933,1,107538396,107538987,591,0.6894322168685204
40214,3584.671767,3584.6775,1,107540153,107540325,172,-0.265038547114439
40215,3584.678667,3584.701,1,107540360,107541030,670,0.3382297538438846
40216,3584.761333,3584.809,1,107542839,107544270,1431,0.4908938185675548
40217,3584.820967,3584.827967,1,107544629,107544839,210,0.6140161109611102
40218,3584.829233,3584.8559,1,107544876,107545677,801,0.18723786083741423
40219,3587.9556,3587.959133,1,107638668,107638773,105,
40220,3587.974167,3587.978067,1,107639225,107639342,117,0.4976891819021303
40221,3588.604167,3588.6139,1,107658125,107658417,292,0.5293299369855851
40222,3589.599033,3589.615133,1,107687970,107688453,483,0.7025340330359385
40223,3589.616133,3589.621333,1,107688483,107688639,156,0.3233743715301333
40224,3589.6369,3589.639933,1,107689107,107689197,90,0.6490287083004671
40225,3589.715133,3589.7446,1,107691453,107692338,885,0.5646131319349571
40226,3589.7462,3589.749367,1,107692386,107692481,95,0.19022605736168588
40227,3589.7506,3589.758767,1,107692518,107692763,245,0.5929754885230824
40228,3589.7598,3589.798467,1,107692794,107693954,1160,0.4297673765251362
40229,3590.744467,3590.748833,1,107722334,107722464,130,0.4778865857855404
40230,3590.909067,3590.9196,1,107727272,107727588,316,0.7226686408647267
40231,3590.975833,3590.9859,1,107729274,107729577,303,0.6064644675995621
40232,3591.118833,3591.1275,1,107733564,107733825,261,0.654753418370237
40233,3591.151033,3591.164267,1,107734530,107734928,398,0.07067540345472371
40234,3591.180033,3591.1868,1,107735400,107735604,204,-0.3272032358173871
40235,3591.281133,3591.288633,1,107738433,107738658,225,0.6023583587295814
40236,3591.311767,3591.327567,1,107739353,107739827,474,-0.3132368746834505
40237,3591.349367,3591.3525,1,107740481,107740575,94,0.08430514455806769
40238,3591.3565,3591.3718,1,107740695,107741154,459,0.648996981781802
40239,3591.4011,3591.4123,1,107742033,107742369,336,0.8545237884729516
40240,3591.4413,3591.453433,1,107743239,107743602,363,-0.2547075284119797
40241,3591.488167,3591.5051,1,107744645,107745153,508,0.31296785587831394
40242,3591.512567,3591.516,1,107745377,107745480,103,
40243,3591.5172,3591.521267,1,107745516,107745638,122,0.3743681655600733
40244,3591.641667,3591.644733,1,107749250,107749341,91,-0.21305202806605003
40245,3591.673233,3591.6778,1,107750196,107750334,138,0.6685310914416923
40246,3591.705,3591.722367,1,107751150,107751671,521,0.5917112212625805
40247,3591.7327,3591.7436,1,107751981,107752308,327,0.8217752339091132
40248,3591.7474,3591.769467,1,107752422,107753084,662,0.4749078404298518
40249,3591.7734,3591.787067,1,107753202,107753612,410,-0.016603887053293645
40250,3591.793067,3591.812267,1,107753792,107754368,576,0.8285008312099597
40251,3591.817267,3591.826,1,107754518,107754780,262,-0.31941292839469887
40252,3591.9284,3591.933367,1,107757852,107758001,149,0.5047271400731688
40253,3591.96,3591.9638,1,107758800,107758914,114,0.8177561451038152
40254,3591.9648,3591.974167,1,107758944,107759225,281,0.7033399137278928
40255,3593.882367,3593.886,1,107816471,107816580,109,0.6105261150326028
40256,3593.9398,3593.943033,1,107818194,107818290,96,0.3348065088145389
40257,3594.433767,3594.437933,1,107833013,107833137,124,0.7583535487247901
40258,3594.464467,3594.476433,1,107833934,107834292,358,0.6913383062733187
40259,3594.489333,3594.499067,1,107834679,107834972,293,0.7358603259931207
40260,3594.5167,3594.527333,1,107835501,107835819,318,-0.12126170944410906
40261,3594.543233,3594.5492,1,107836296,107836476,180,0.9159757424527468
40262,3594.7097,3594.717867,1,107841291,107841536,245,0.7810887971532534
40263,3594.730633,3594.747067,1,107841918,107842412,494,0.681004550585696
40264,3594.7632,3594.778433,1,107842896,107843352,456,0.8366363592592717
40265,3594.7921,3594.795267,1,107843763,107843858,95,
40266,3594.832667,3594.840667,1,107844980,107845220,240,0.3903068463172425
40267,3594.997133,3595.0015,1,107849913,107850045,132,-0.09075060656203274
40268,3595.298867,3595.3026,1,107858966,107859078,112,0.6686456956851305
40269,3595.8146,3595.820833,1,107874438,107874624,186,0.6056992118946696
40270,3595.8408,3595.850533,1,107875224,107875515,291,0.013538840125423359
40271,3595.851667,3595.9189,1,107875550,107877567,2017,0.15271946592015676
40272,3595.926167,3595.994933,1,107877785,107879847,2062,0.4073854728818876
40273,3595.997167,3596.009333,1,107879915,107880279,364,-0.08958611645155201
40274,3596.067233,3596.070767,1,107882016,107882123,107,0.25633007872666175
40275,3596.0723,3596.082033,1,107882169,107882460,291,0.6290014235649265
40276,3596.087333,3596.0996,1,107882619,107882988,369,0.5855279668335565
40277,3596.191067,3596.196367,1,107885732,107885891,159,0.7578888788642306
40278,3596.2242,3596.257233,1,107886726,107887716,990,0.35334017377867405
40279,3596.2855,3596.2898,1,107888565,107888694,129,0.47516126146707266
40280,3596.295367,3596.298867,1,107888861,107888966,105,0.27203787648159206
40281,3596.870867,3596.8762,1,107906126,107906286,160,0.4400251026657687
40282,3596.916867,3596.924,1,107907506,107907720,214,0.4122120904067541
40283,3596.925933,3596.9335,1,107907777,107908005,228,0.6200333014145819
40284,3596.9698,3596.9757,1,107909094,107909271,177,0.578216194220582
40285,3597.3934,3597.412733,1,107921802,107922381,579,0.8052680313451408
40286,3597.500367,3597.510167,1,107925011,107925305,294,0.6873648120388282
40287,3597.562333,3597.566667,1,107926869,107927000,131,0.46858965426986765
40288,3597.567767,3597.578167,1,107927033,107927345,312,0.5160394433282793
40289,3597.8728,3597.883733,1,107936184,107936511,327,0.4846606985622574
40290,3597.889067,3597.9265,1,107936672,107937795,1123,0.6482080902882492
40291,3597.938767,3597.9545,1,107938163,107938635,472,0.37761281217270287
40292,3597.957533,3597.969867,1,107938725,107939096,371,0.5121953321422628
40293,3597.972833,3597.983467,1,107939184,107939504,320,0.6822148412477237
40294,3598.001567,3598.0222,1,107940047,107940666,619,0.5993795165794427
40295,3598.0232,3598.0419,1,107940696,107941257,561,0.5307189326443911
40296,3598.0553,3598.0902,1,107941659,107942706,1047,0.6086147782299469
40297,3598.091767,3598.1116,1,107942753,107943348,595,0.5882715515300072
40298,3598.1422,3598.151633,1,107944266,107944548,282,0.5781955419539485
40299,3598.155267,3598.1768,1,107944658,107945304,646,0.6099346701047618
40300,3598.221933,3598.2288,1,107946657,107946864,207,0.08890462747402869
40301,3598.2301,3598.3019,1,107946903,107949057,2154,0.6298487931281819
40302,3598.3029,3598.3443,1,107949087,107950329,1242,0.027912558342600563
40303,3598.349233,3598.3577,1,107950476,107950731,255,-0.016165608140255968
40304,3598.359633,3598.3633,1,107950788,107950899,111,0.28219729261375426
40305,3598.3644,3598.390167,1,107950932,107951705,773,0.11487773574092977
40306,3598.3935,3598.460367,1,107951805,107953811,2006,0.5788356449762023
40307,3598.477533,3598.543267,1,107954325,107956298,1973,0.7620130612502202
40308,3598.545,3598.5768,1,107956350,107957304,954,0.7971595333645831
40309,3598.755333,3598.7625,1,107962659,107962875,216,0.5266237629701608
40310,3598.764867,3598.771833,1,107962946,107963154,208,0.8169024866206044
40311,3598.8737,3599.034033,1,107966211,107971020,4809,0.8192409063489507
40312,3599.037333,3599.0657,1,107971119,107971971,852,0.6395408940989415
40313,3599.075533,3599.095067,1,107972265,107972852,587,0.6447476491609373
40314,3599.313133,3599.317533,1,107979393,107979525,132,0.4969511000413566
40315,3599.420767,3599.442167,1,107982623,107983265,642,0.6940411088981512
40316,3599.4465,3599.4579,1,107983395,107983737,342,0.533678117691107
40317,3599.484,3599.5124,1,107984520,107985372,852,0.5896729871631515
40318,3599.542133,3599.569433,1,107986263,107987082,819,0.6665805273439196
40319,3599.571733,3599.585133,1,107987151,107987553,402,0.40718739975843027
40320,3599.6044,3599.648133,1,107988132,107989443,1311,0.7376842389173218
40321,3599.668033,3599.7051,1,107990040,107991153,1113,0.5815714240383321
40322,3599.7201,3599.7375,1,107991603,107992125,522,0.5580796487238491
40323,3599.787067,3599.793733,1,107993612,107993811,199,0.7125629426406818
40324,3599.796567,3599.805867,1,107993897,107994176,279,0.6709292004719779
40325,3599.832267,3599.839133,1,107994968,107995173,205,0.6964537843897487
40326,3599.846567,3599.861967,1,107995397,107995859,462,0.6180557092012287
40327,3600.0246,3600.034933,1,108000738,108001047,309,0.7963784927588409
40328,3600.0373,3600.084533,1,108001119,108002535,1416,0.7818203291845772
40329,3600.0876,3600.131167,1,108002628,108003935,1307,0.8000033665364079
40330,3600.489167,3600.4945,1,108014675,108014835,160,0.8660083401680094
40331,3600.4962,3600.539733,1,108014886,108016191,1305,0.7734694275009678
40332,3600.543767,3600.593067,1,108016313,108017792,1479,0.8253365871915618
40333,3600.6236,3600.632167,1,108018708,108018965,257,0.32258492199695266
40334,3600.644433,3600.653633,1,108019332,108019608,276,0.5079412220698546
40335,3600.763633,3600.7753,1,108022908,108023259,351,0.1996443585593478
40336,3600.782767,3600.907333,1,108023483,108027219,3736,0.5191669288230802
40337,3600.9104,3600.928267,1,108027312,108027848,536,0.7575209233088341
40338,3600.9313,3601.051733,1,108027939,108031551,3612,0.7765405199227385
40339,3601.3359,3601.341867,1,108040077,108040256,179,0.40477248885446665
40340,3601.353567,3601.359733,1,108040607,108040791,184,0.8754176358286444
40341,3601.381467,3601.400633,1,108041444,108042018,574,0.769600552358705
40342,3601.411433,3601.4618,1,108042342,108043854,1512,0.7211372596388852
40343,3601.473567,3601.500033,1,108044207,108045000,793,0.8295911500095214
40344,3601.504033,3601.533933,1,108045120,108046017,897,0.7178405766985271
40345,3601.5376,3601.545167,1,108046128,108046355,227,0.49901763110018504
40346,3601.567533,3601.628433,1,108047025,108048852,1827,0.8402676244956614
40347,3601.645733,3601.649967,1,108049371,108049499,128,0.7683556323498533
40348,3601.6524,3601.684933,1,108049572,108050547,975,0.7910042442885601
40349,3601.955967,3601.968633,1,108058679,108059058,379,0.886816407246008
40350,3601.9708,3602.0667,1,108059124,108062001,2877,0.8243709172002142
40351,3602.395267,3602.468167,1,108071858,108074045,2187,0.7693412123519389
40352,3602.485033,3602.500933,1,108074550,108075027,477,0.7790665800443703
40353,3602.5129,3602.5397,1,108075387,108076191,804,0.7301537118347387
40354,3602.547733,3602.573367,1,108076431,108077201,770,0.6161396015122397
40355,3602.578667,3602.593133,1,108077360,108077793,433,0.8085599229259859
40356,3602.609167,3602.625067,1,108078275,108078752,477,0.6393105037855009
40357,3602.630467,3602.637133,1,108078914,108079113,199,0.4971836324299428
40358,3602.641767,3602.652767,1,108079253,108079583,330,0.8721767354985874
40359,3602.661067,3602.736767,1,108079832,108082103,2271,0.7540198645039247
40360,3602.7465,3602.751567,1,108082395,108082547,152,0.579373339726714
40361,3602.7631,3602.787933,1,108082893,108083637,744,0.7232597277570415
40362,3602.800767,3602.809467,1,108084023,108084284,261,0.5681771768673987
40363,3602.810733,3602.887067,1,108084321,108086612,2291,0.2750393945825616
40364,3602.915467,3603.018267,1,108087464,108090548,3084,0.7536027718625001
40365,3603.304867,3603.403567,1,108099146,108102107,2961,0.8156167287253303
40366,3603.404833,3603.4408,1,108102144,108103224,1080,0.7907123255238674
40367,3603.779,3603.784167,1,108113370,108113525,155,0.3893779825020512
40368,3603.7957,3603.831367,1,108113871,108114941,1070,0.8140347748873565
40369,3603.832967,3603.8596,1,108114989,108115788,799,0.7719559488958064
40370,3603.867567,3603.890967,1,108116027,108116729,702,0.758159037705085
40371,3603.893133,3603.9297,1,108116793,108117891,1098,0.7661369841220588
40372,3603.9597,3604.046467,1,108118791,108121394,2603,0.609988222381149
40373,3604.093333,3604.100867,1,108122799,108123026,227,0.5826859456870885
40374,3604.109367,3604.1335,1,108123281,108124005,724,0.09376456434967645
40375,3604.135,3604.1564,1,108124050,108124692,642,-0.06849284305633041
40376,3604.263833,3604.268133,1,108127914,108128043,129,0.41924982772845704
40377,3604.392767,3604.528567,1,108131783,108135857,4074,0.7887749807194937
40378,3610.2023,3610.205833,1,108306069,108306174,105,
40379,3623.886,3623.889133,1,108716580,108716673,93,0.31072519512099445
40380,3624.130867,3624.134733,1,108723926,108724041,115,-0.28262368243909636
40381,3632.5242,3632.544333,1,108975726,108976329,603,0.18849230842166
40382,3632.5578,3632.591567,1,108976734,108977747,1013,0.24298919415053483
40383,3632.6089,3632.613,1,108978267,108978390,123,0.06936948413138344
40384,3632.6216,3632.626433,1,108978648,108978792,144,0.1277500406166515
40385,3632.6278,3632.652167,1,108978834,108979565,731,0.5447532209876995
40386,3632.655467,3632.6778,1,108979664,108980334,670,-0.026458695566082005
40387,3634.2689,3634.2694,1,109028067,109028082,15,
40388,3635.154667,3635.1582,1,109054640,109054746,106,0.7566377951079092
40389,3643.484033,3643.488667,1,109304520,109304660,140,0.6314425486728926
40390,3645.257267,3645.272033,1,109357718,109358160,442,0.3621466543460102
40391,3645.297967,3645.301833,1,109358939,109359054,115,0.05832926821369762
40392,3645.3118,3645.3215,1,109359354,109359645,291,0.008891166375138008
40393,3645.352333,3645.36,1,109360569,109360800,231,0.3850072419831948
40394,3645.3612,3645.3644,1,109360836,109360932,96,0.6951254662624947
40395,3645.445633,3645.4545,1,109363368,109363635,267,-0.17629852552469336
40396,3645.457267,3645.4629,1,109363718,109363887,169,0.11087809668317081
40397,3645.4863,3645.494667,1,109364589,109364840,251,0.10956367302166725
40398,3645.498733,3645.537567,1,109364961,109366127,1166,0.11081410657428646
40399,3645.539267,3645.660167,1,109366178,109369805,3627,0.7615042083323922
40400,3645.661233,3645.6754,1,109369836,109370262,426,0.11855690914269251
40401,3645.6889,3645.759433,1,109370667,109372782,2115,0.14269940921105106
40402,3645.7974,3645.8289,1,109373922,109374867,945,0.1829582369836164
40403,3645.839467,3645.844267,1,109375184,109375328,144,0.28312465512291596
40404,3645.854967,3645.8619,1,109375649,109375857,208,0.2203203919926533
40405,3646.477667,3646.480667,1,109394330,109394420,90,
40406,3646.5085,3646.534833,1,109395255,109396044,789,0.29388864942439374
40407,3646.565633,3646.582567,1,109396968,109397477,509,0.10490054502305145
40408,3646.6642,3646.670833,1,109399926,109400124,198,-0.00973518810820231
40409,3646.673467,3646.684133,1,109400204,109400523,319,0.21423701380019736
40410,3647.489033,3647.495333,1,109424670,109424859,189,0.37359263962334643
40411,3647.934667,3647.940067,1,109438040,109438202,162,0.6562334422671764
40412,3647.9557,3647.969533,1,109438671,109439085,414,0.29275967874276243
40413,3648.0346,3648.040433,1,109441038,109441212,174,0.19826383152829766
40414,3648.105033,3648.126967,1,109443150,109443809,659,0.012360784282952685
40415,3648.1494,3648.169567,1,109444482,109445087,605,0.16107046535797195
40416,3648.171033,3648.174467,1,109445130,109445234,104,0.8002179137212426
40417,3648.221333,3648.2255,1,109446639,109446765,126,0.23118708255558648
40418,3648.2402,3648.270133,1,109447206,109448103,897,0.0046963441383485165
40419,3648.2713,3648.399033,1,109448139,109451970,3831,0.0705880994287
40420,3648.427967,3648.453267,1,109452839,109453598,759,0.08744749126411085
40421,3648.459467,3648.523367,1,109453784,109455701,1917,0.21276912030544007
40422,3648.534233,3648.5384,1,109456026,109456152,126,0.018712892944278314
40423,3648.539533,3648.549233,1,109456185,109456476,291,0.6489044955548751
40424,3648.551333,3648.567,1,109456539,109457010,471,0.05002676732439716
40425,3648.5843,3648.601467,1,109457529,109458044,515,0.13143437142080105
40426,3648.605533,3648.610667,1,109458165,109458320,155,0.4424602069522976
40427,3649.004367,3649.011267,1,109470131,109470338,207,0.5721292497837125
40428,3650.395133,3650.399733,1,109511853,109511991,138,0.19920584246234446
40429,3650.413967,3650.4401,1,109512419,109513203,784,0.16617672537797346
40430,3650.448033,3650.551333,1,109513440,109516539,3099,0.6854265008661359
40431,3650.557767,3650.5713,1,109516733,109517139,406,-0.0667623445861307
40432,3650.581633,3650.587967,1,109517448,109517639,191,0.1323763033100681
40433,3650.5893,3650.5957,1,109517679,109517871,192,-0.011676469966464749
40434,3650.601167,3650.616367,1,109518035,109518491,456,0.17720338784334894
40435,3650.619367,3650.623633,1,109518581,109518708,127,-0.047359834341868995
40436,3650.624733,3650.653,1,109518741,109519590,849,0.07737518958707475
40437,3650.657533,3650.727733,1,109519725,109521831,2106,0.2779498057053584
40438,3650.732667,3650.747233,1,109521980,109522416,436,0.03739706010139863
40439,3650.748667,3650.7601,1,109522460,109522803,343,0.5504068735640067
40440,3650.7634,3650.780033,1,109522902,109523400,498,-0.0286890316344171
40441,3650.792633,3650.797033,1,109523778,109523910,132,0.25057688617687424
40442,3650.808133,3650.812067,1,109524243,109524362,119,-0.5532089753720859
40443,3650.85,3650.853333,1,109525500,109525599,99,0.5914342186747767
40444,3651.281367,3651.289633,1,109538441,109538688,247,0.45782618154657834
40445,3651.3485,3651.353,1,109540455,109540590,135,0.727838477676489
40446,3651.355667,3651.360667,1,109540670,109540820,150,0.1759737456170834
40447,3651.3891,3651.3976,1,109541673,109541928,255,-0.08604589553368239
40448,3651.4264,3651.430767,1,109542792,109542923,131,0.09555813473466228
40449,3651.742333,3651.778933,1,109552269,109553367,1098,0.4497706927221324
40450,3651.794333,3651.8026,1,109553829,109554078,249,0.09364458565931376
40451,3651.818033,3651.824133,1,109554540,109554723,183,0.16302935966353235
40452,3651.8455,3651.853367,1,109555365,109555601,236,0.054870566164584134
40453,3651.8545,3651.9033,1,109555635,109557099,1464,0.37158275527321266
40454,3651.944767,3651.950667,1,109558343,109558520,177,-0.03672194199437893
40455,3652.007367,3652.021233,1,109560221,109560636,415,0.3723514661221722
40456,3652.0223,3652.0271,1,109560669,109560813,144,0.5934612023446915
40457,3652.030667,3652.046167,1,109560920,109561385,465,0.26376485974483055
40458,3652.373033,3652.3851,1,109571190,109571553,363,0.24970785944479604
40459,3652.387267,3652.392833,1,109571618,109571784,166,0.06491116737200893
40460,3652.394133,3652.495167,1,109571823,109574855,3032,0.6395160712204302
40461,3652.5045,3652.508967,1,109575135,109575269,134,
40462,3652.516033,3652.527167,1,109575480,109575815,335,0.042572977765959336
40463,3652.528333,3652.5457,1,109575849,109576371,522,0.011900171017185946
40464,3652.5515,3652.5664,1,109576545,109576992,447,-0.02092706920786335
40465,3652.5825,3652.5986,1,109577475,109577958,483,0.07607821126627433
40466,3652.612233,3652.6625,1,109578366,109579875,1509,0.18283342055809151
40467,3652.668467,3652.685033,1,109580054,109580550,496,0.7206816184737871
40468,3652.694867,3652.715967,1,109580846,109581479,633,0.16102370184231002
40469,3652.717033,3652.720567,1,109581510,109581617,107,-0.018183504313668063
40470,3652.7241,3652.742833,1,109581723,109582284,561,0.14046712258932417
40471,3652.7492,3652.754467,1,109582476,109582634,158,0.30668053402543216
40472,3652.7952,3652.803567,1,109583856,109584107,251,0.07983597349403511
40473,3652.818767,3652.8326,1,109584563,109584978,415,0.0072699050508667675
40474,3652.835767,3652.846933,1,109585073,109585407,334,0.03694328668250279
40475,3652.8568,3652.865367,1,109585704,109585961,257,0.04624185396454596
40476,3652.868133,3652.877333,1,109586043,109586319,276,0.21608081373068805
40477,3652.879667,3652.8831,1,109586390,109586493,103,
40478,3652.902833,3652.909433,1,109587084,109587282,198,0.06381386693954988
40479,3653.753367,3653.758167,1,109612601,109612745,144,0.2800841922838308
40480,3653.818133,3653.825,1,109614543,109614750,207,0.2021996750522985
40481,3653.826633,3653.8461,1,109614798,109615383,585,0.25777019106576415
40482,3653.849733,3653.938567,1,109615491,109618157,2666,0.44572275560365077
40483,3653.939967,3653.9548,1,109618199,109618644,445,-0.026533830077135417
40484,3653.962867,3654.015533,1,109618886,109620465,1579,0.031397819761159296
40485,3654.019733,3654.0446,1,109620591,109621338,747,0.052430484042351864
40486,3654.052367,3654.0668,1,109621571,109622004,433,0.12784568499076188
40487,3654.072133,3654.147667,1,109622163,109624430,2267,0.2680991832834818
40488,3654.1861,3654.203733,1,109625583,109626111,528,0.14281220996605343
40489,3654.215367,3654.2217,1,109626461,109626651,190,0.08824842715370956
40490,3654.271633,3654.276867,1,109628148,109628306,158,-0.3017082528470124
40491,3654.284633,3654.292633,1,109628538,109628778,240,0.08489051855608867
40492,3655.299567,3655.309733,1,109658987,109659291,304,0.29958023093202246
40493,3655.3113,3655.3377,1,109659339,109660131,792,0.32755529630984315
40494,3655.341767,3655.346367,1,109660253,109660391,138,-0.002218417017636547
40495,3655.351533,3655.356933,1,109660545,109660707,162,0.22450479726136488
40496,3655.3637,3655.3833,1,109660911,109661499,588,0.12717882252309137
40497,3655.408933,3655.4198,1,109662267,109662594,327,0.12212899812961629
40498,3655.4629,3655.485367,1,109663887,109664561,674,-0.05785970315308606
40499,3655.488767,3655.491967,1,109664663,109664759,96,-0.09789488724622036
40500,3655.5041,3655.5087,1,109665123,109665261,138,0.11807587802800958
40501,3655.5101,3655.5201,1,109665303,109665603,300,0.09902809400213847
40502,3655.524833,3655.540133,1,109665744,109666203,459,0.21301222013254867
40503,3655.544967,3655.554233,1,109666349,109666626,277,0.06329248158090062
40504,3655.587333,3655.610533,1,109667619,109668315,696,0.27220693496648257
40505,3655.6124,3655.618333,1,109668372,109668549,177,0.012741488985450451
40506,3655.6204,3655.7001,1,109668612,109671003,2391,0.556500242322422
40507,3655.701133,3655.708733,1,109671033,109671261,228,0.031309368431091895
40508,3655.713567,3655.731067,1,109671407,109671932,525,-0.06231829610121549
40509,3655.738333,3655.7499,1,109672149,109672497,348,0.0714252966100192
40510,3655.7511,3655.7575,1,109672533,109672725,192,-0.025042718788102925
40511,3655.7595,3655.7887,1,109672785,109673661,876,0.07391380681119977
40512,3655.794833,3655.862833,1,109673844,109675884,2040,0.2973825409422512
40513,3655.869533,3655.873933,1,109676085,109676217,132,0.007741532892012381
40514,3655.903533,3655.911,1,109677105,109677330,225,-0.055185841659547256
40515,3655.926933,3655.949133,1,109677807,109678473,666,0.18570159646929302
40516,3656.7496,3656.753733,1,109702488,109702611,123,0.1545487223136143
40517,3656.7723,3656.777033,1,109703169,109703310,141,0.3928572765372277
40518,3656.8439,3656.854167,1,109705317,109705625,308,0.2704149912447418
40519,3656.855367,3656.9579,1,109705661,109708737,3076,0.11661444408842908
40520,3656.959733,3656.962967,1,109708791,109708889,98,0.08399390377218291
40521,3656.970167,3656.987167,1,109709105,109709615,510,-0.06742456110810109
40522,3656.990867,3656.996367,1,109709726,109709891,165,-0.07716685515366083
40523,3657.004467,3657.014633,1,109710134,109710438,304,0.038004434314723085
40524,3657.019433,3657.033567,1,109710582,109711007,425,0.06709543651594219
40525,3657.035033,3657.052233,1,109711050,109711566,516,0.28165910660531607
40526,3657.0588,3657.063467,1,109711764,109711904,140,0.11636356706291272
40527,3657.0647,3657.074233,1,109711941,109712226,285,-0.05420935586093127
40528,3657.080933,3657.1174,1,109712427,109713522,1095,0.059895743965644496
40529,3657.1185,3657.1266,1,109713555,109713798,243,-0.08642211685446012
40530,3657.128233,3657.1342,1,109713846,109714026,180,0.4865031400522482
40531,3657.1444,3657.161667,1,109714332,109714850,518,0.21427443907778834
40532,3657.171533,3657.2533,1,109715145,109717599,2454,0.2588465160876067
40533,3658.3763,3658.386367,1,109751289,109751591,302,0.44480920103595445
40534,3658.455233,3658.4609,1,109753656,109753827,171,0.43417335880481167
40535,3658.4621,3658.483767,1,109753863,109754513,650,0.3013249380688299
40536,3658.4884,3658.556067,1,109754652,109756682,2030,0.4166973075050284
40537,3658.561133,3658.5887,1,109756833,109757661,828,-0.011890033450219658
40538,3658.5975,3658.615533,1,109757925,109758465,540,0.1782291045972655
40539,3658.617433,3658.661867,1,109758522,109759856,1334,0.01063599234257829
40540,3658.664767,3658.680933,1,109759943,109760427,484,0.0749019613544295
40541,3658.698167,3658.709167,1,109760945,109761275,330,0.2059580588306724
40542,3658.710933,3658.767467,1,109761327,109763024,1697,0.37229875026011267
40543,3661.575433,3661.5794,1,109847262,109847382,120,0.4064464405837989
40544,3661.641633,3661.645833,1,109849248,109849374,126,0.10969834039776898
40545,3661.6471,3661.651667,1,109849413,109849550,137,0.08411226233223809
40546,3675.844,3675.847433,1,110275320,110275422,102,0.6273459929908454
40547,3675.848633,3675.863833,1,110275458,110275914,456,0.45220049122826517
40548,3675.871233,3675.8747,1,110276136,110276241,105,0.2873716833562509
40549,3675.9127,3675.938367,1,110277381,110278151,770,0.5943922467065927
40550,3676.085033,3676.088833,1,110282550,110282664,114,0.20775747824988705
40551,3681.130967,3681.1344,1,110433929,110434032,103,0.6431398725731483
40552,3684.471567,3684.485233,1,110534147,110534556,409,0.33340177519676645
40553,3684.569733,3684.576333,1,110537091,110537289,198,0.14751668895758988
40554,3684.640467,3684.6439,1,110539214,110539317,103,
40555,3685.744067,3685.749133,1,110572322,110572473,151,0.1400126503579821
40556,3685.7502,3685.767067,1,110572506,110573012,506,0.1188511965322641
40557,3685.790267,3685.801367,1,110573708,110574041,333,0.09971480136989835
40558,3685.847867,3685.8569,1,110575436,110575707,271,-0.028231767196326696
40559,3686.037233,3686.0439,1,110581116,110581317,201,0.020134969832336844
40560,3686.060333,3686.066567,1,110581809,110581997,188,0.29719852197209007
40561,3686.075,3686.104033,1,110582250,110583120,870,0.23333625078557377
40562,3686.107267,3686.189167,1,110583218,110585675,2457,0.43555105914622194
40563,3686.193733,3686.1986,1,110585811,110585958,147,0.22320018197902874
40564,3686.2004,3686.205967,1,110586012,110586179,167,0.14178828040861477
40565,3686.209567,3686.214567,1,110586287,110586437,150,-0.13797566382026802
40566,3686.216267,3686.2233,1,110586488,110586699,211,0.19916563008770394
40567,3686.224467,3686.227767,1,110586734,110586833,99,0.1294576719745218
40568,3686.2503,3686.2562,1,110587509,110587686,177,0.16366817836991288
40569,3686.262267,3686.2689,1,110587868,110588067,199,-0.06785300363646424
40570,3686.273167,3686.294,1,110588195,110588820,625,-0.010663507594181562
40571,3686.295533,3686.313833,1,110588865,110589414,549,0.1558393145648818
40572,3686.320333,3686.3835,1,110589609,110591505,1896,0.19336779464815992
40573,3686.39,3686.393833,1,110591700,110591814,114,0.08363036335225296
40574,3686.422533,3686.426567,1,110592675,110592797,122,-0.0048150304709124745
40575,3686.475333,3686.478633,1,110594259,110594358,99,-0.24998572586378143
40576,3686.4883,3686.493333,1,110594649,110594799,150,-0.10047030710717758
40577,3686.821,3686.826767,1,110604630,110604803,173,0.193075151618508
40578,3694.570333,3694.575633,1,110837109,110837268,159,0.40687634323854444
40579,3696.673133,3696.676567,1,110900193,110900297,104,
40580,3696.6898,3696.6985,1,110900694,110900955,261,0.1323538331808877
40581,3696.7299,3696.7424,1,110901897,110902272,375,0.2469700881485206
40582,3696.7931,3696.7997,1,110903793,110903991,198,0.03854171988319191
40583,3696.925733,3696.934333,1,110907771,110908029,258,0.0995149579781792
40584,3696.9673,3696.973933,1,110909019,110909217,198,0.1786218333899137
40585,3696.986567,3696.990033,1,110909597,110909700,103,0.012004682461276173
40586,3698.070267,3698.079167,1,110942108,110942375,267,0.34695393587926876
40587,3698.081967,3698.102167,1,110942459,110943065,606,0.3036735869406822
40588,3698.1115,3698.1415,1,110943345,110944245,900,0.1614107446782912
40589,3698.1431,3698.221933,1,110944293,110946657,2364,0.4058125889428249
40590,3698.2272,3698.2485,1,110946816,110947455,639,0.027544868175523374
40591,3698.2542,3698.298667,1,110947626,110948960,1334,0.07962577694485526
40592,3698.303833,3698.316067,1,110949114,110949482,368,-0.07089470787051953
40593,3698.3235,3698.3689,1,110949705,110951067,1362,0.10228533189307532
40594,3698.374633,3698.430967,1,110951238,110952929,1691,0.18733386881373168
40595,3698.445867,3698.451533,1,110953376,110953545,169,-0.17004898741614682
40596,3700.100633,3700.110033,1,111003018,111003300,282,0.366119540043215
40597,3700.123467,3700.1297,1,111003704,111003891,187,0.19222714147986375
40598,3700.171567,3700.176633,1,111005147,111005298,151,0.07321894105998158
40599,3700.271167,3700.275067,1,111008135,111008252,117,0.2653412115977596
40600,3702.767933,3702.797633,1,111083037,111083928,891,0.1738699812319403
40601,3702.807267,3702.848333,1,111084218,111085449,1231,0.28173004105915095
40602,3702.8496,3703.001633,1,111085488,111090048,4560,0.42152477347122763
40603,3703.002633,3703.019,1,111090078,111090570,492,0.2709179884549186
40604,3703.020167,3703.093033,1,111090605,111092790,2185,0.2267671557061737
40605,3703.131633,3703.142467,1,111093948,111094274,326,0.08375816024771325
40606,3704.1398,3704.1527,1,111124194,111124581,387,-0.04253306230197452
40607,3704.3236,3704.3269,1,111129708,111129807,99,0.7909147262747879
40608,3704.412633,3704.416633,1,111132378,111132498,120,0.27434897821556864
40609,3704.420467,3704.424,1,111132614,111132720,106,-0.02915692800162512
40610,3704.427767,3704.442267,1,111132833,111133268,435,0.4044443703277548
40611,3704.445667,3704.461067,1,111133370,111133832,462,0.14961099456836147
40612,3704.464267,3704.467733,1,111133928,111134031,103,0.0666836512444299
40613,3704.470933,3704.5513,1,111134127,111136539,2412,0.3861015885316549
40614,3704.5698,3704.580367,1,111137094,111137411,317,-0.0006878715223092093
40615,3704.588867,3704.599233,1,111137666,111137976,310,0.12394699300764588
40616,3704.600467,3704.6472,1,111138014,111139416,1402,0.011543164337870584
40617,3704.652333,3704.6588,1,111139569,111139764,195,0.13790519510630625
40618,3704.6653,3704.668767,1,111139959,111140063,104,0.10109524098457513
40619,3704.680667,3704.711633,1,111140420,111141348,928,0.06813965930368147
40620,3704.729733,3704.804967,1,111141891,111144149,2258,0.3658563580848848
40621,3704.810933,3704.814,1,111144327,111144420,93,
40622,3704.822633,3704.832467,1,111144678,111144974,296,0.05120364554626598
40623,3704.870933,3704.879667,1,111146127,111146390,263,0.13830508382083803
40624,3705.010967,3705.014567,1,111150329,111150437,108,0.19933207703068043
40625,3705.114667,3705.118967,1,111153440,111153569,129,0.5171922820372411
40626,3705.126733,3705.130033,1,111153801,111153900,99,0.1219746744160307
40627,3705.1456,3705.1528,1,111154368,111154584,216,-0.14641977658863972
40628,3706.1709,3706.201633,1,111185127,111186048,921,0.263577127190084
40629,3706.214533,3706.221133,1,111186435,111186633,198,0.0594466989602827
40630,3706.236933,3706.241833,1,111187107,111187254,147,-0.03922046579841814
40631,3706.248433,3706.258233,1,111187452,111187746,294,0.2889129759269822
40632,3706.304967,3706.31,1,111189149,111189300,151,0.15623019294834267
40633,3706.3457,3706.3494,1,111190371,111190482,111,0.16130052456010735
40634,3706.3743,3706.378633,1,111191229,111191358,129,-0.05472458269390265
40635,3706.396,3706.399633,1,111191880,111191988,108,-0.15781154432503108
40636,3706.402867,3706.408633,1,111192086,111192258,172,0.4320744556760386
40637,3706.423533,3706.4306,1,111192705,111192918,213,0.4397023530880741
40638,3706.433,3706.561167,1,111192990,111196835,3845,0.4107045151689388
40639,3706.563133,3706.576967,1,111196893,111197309,416,-0.05061934839631508
40640,3706.5924,3706.6234,1,111197772,111198702,930,0.022938719127298574
40641,3706.6287,3706.642167,1,111198861,111199265,404,0.4727020777695422
40642,3706.652667,3706.668367,1,111199580,111200051,471,-0.031026578584219124
40643,3706.670833,3706.6886,1,111200124,111200658,534,0.20395663490277569
40644,3706.6945,3706.770667,1,111200835,111203120,2285,0.22826172968273242
40645,3706.8356,3706.842733,1,111205068,111205281,213,0.016013517966970585
40646,3706.8525,3706.8585,1,111205575,111205755,180,0.6540809101477172
40647,3707.325033,3707.341967,1,111219750,111220259,509,0.11608180432078699
40648,3707.349533,3707.356633,1,111220485,111220698,213,-0.14628112671524887
40649,3707.386867,3707.3951,1,111221606,111221853,247,0.019490646282402956
40650,3707.455533,3707.4659,1,111223665,111223977,312,0.16505975844559237
40651,3707.474167,3707.505467,1,111224225,111225164,939,0.061016912409974866
40652,3707.506833,3707.525567,1,111225204,111225767,563,0.4880475425200849
40653,3707.5273,3707.551867,1,111225819,111226556,737,0.310796303784633
40654,3707.623933,3707.680133,1,111228717,111230403,1686,0.22657328855329437
40655,3707.682867,3707.762533,1,111230486,111232875,2389,0.21999514080725838
40656,3707.7656,3707.778767,1,111232968,111233363,395,0.19287535525014707
40657,3707.7814,3707.7914,1,111233442,111233742,300,0.04525555272643041
40658,3707.812567,3707.852267,1,111234377,111235568,1191,0.07627290494136518
40659,3707.859867,3707.9206,1,111235796,111237618,1822,0.2647454258824429
40660,3709.1571,3709.161267,1,111274713,111274838,125,0.10714250560119239
40661,3710.8223,3710.828667,1,111324669,111324860,191,0.14410166947246691
40662,3710.8303,3710.851233,1,111324909,111325536,627,0.3668097800990523
40663,3710.865033,3710.875233,1,111325950,111326256,306,0.2116128653727076
40664,3710.876467,3710.887933,1,111326294,111326637,343,0.13725819056645827
40665,3710.8955,3710.9155,1,111326865,111327465,600,0.1835553982616922
40666,3710.973433,3710.976467,1,111329202,111329294,92,0.013967169218988027
40667,3711.066667,3711.070733,1,111332000,111332121,121,-0.1403175952841287
40668,3711.075733,3711.089833,1,111332271,111332694,423,0.16142145619658468
40669,3711.091,3711.117467,1,111332730,111333524,794,0.10416642334994693
40670,3711.120233,3711.17,1,111333606,111335100,1494,0.18380312411993188
40671,3711.171167,3711.199,1,111335135,111335970,835,0.3712850438469458
40672,3711.2003,3711.205367,1,111336009,111336161,152,0.5487791696536582
40673,3711.2116,3711.214733,1,111336348,111336441,93,-0.13759379481779666
40674,3711.215833,3711.225033,1,111336474,111336750,276,-0.07746760587821985
40675,3711.226767,3711.2432,1,111336803,111337296,493,-0.086292090750273
40676,3711.245067,3711.261167,1,111337352,111337835,483,-0.08205476924249397
40677,3711.2626,3711.284333,1,111337878,111338529,651,0.052639667619021134
40678,3711.285967,3711.300633,1,111338579,111339018,439,-0.020632043817316592
40679,3711.306267,3711.345067,1,111339188,111340352,1164,0.10556760207695043
40680,3711.364767,3711.45,1,111340943,111343500,2557,0.3232878031250298
40681,3711.455833,3711.471667,1,111343674,111344150,476,0.05445385963137252
40682,3711.482067,3711.491967,1,111344462,111344759,297,0.13381927545003605
40683,3711.501767,3711.5099,1,111345053,111345297,244,0.4156185726873607
40684,3711.512567,3711.517433,1,111345377,111345522,145,0.3229716432042796
40685,3712.013633,3712.0245,1,111360408,111360735,327,0.27085870824342273
40686,3712.0307,3712.035033,1,111360921,111361050,129,0.43008163676338035
40687,3712.086667,3712.1054,1,111362600,111363162,562,0.19600081568422698
40688,3712.1199,3712.128367,1,111363597,111363851,254,-0.011684695701910467
40689,3712.1342,3712.138133,1,111364026,111364143,117,0.48631549189903
40690,3712.140167,3712.232467,1,111364205,111366974,2769,0.35621524779886155
40691,3712.243033,3712.2688,1,111367290,111368064,774,0.020242717870191967
40692,3712.274033,3712.293067,1,111368220,111368792,572,0.10557981786078176
40693,3712.306633,3712.393,1,111369198,111371790,2592,0.35444908080626764
40694,3713.3502,3713.372833,1,111400506,111401184,678,0.16240841682132728
40695,3713.3763,3713.389733,1,111401289,111401691,402,0.3649243546806363
40696,3713.3956,3713.399367,1,111401868,111401981,113,0.0656315969885918
40697,3713.4097,3713.478033,1,111402291,111404340,2049,0.4538404481844269
40698,3713.481,3713.4939,1,111404430,111404817,387,-0.06024445683344784
40699,3713.514133,3713.5203,1,111405423,111405609,186,0.17048575067378735
40700,3713.5234,3713.603467,1,111405702,111408104,2402,0.041079687698674816
40701,3713.6228,3713.6367,1,111408684,111409101,417,0.2846188641875838
40702,3713.651267,3713.659567,1,111409538,111409787,249,0.12058451374676837
40703,3713.670267,3713.751733,1,111410108,111412551,2443,0.34859831661478885
40704,3713.781633,3713.785333,1,111413448,111413559,111,0.19883830597453833
40705,3713.787,3713.796233,1,111413610,111413886,276,0.028493379622548005
40706,3713.816333,3713.820467,1,111414489,111414614,125,0.4812036408219033
40707,3714.116133,3714.119667,1,111423483,111423590,107,-0.2532778121588348
40708,3714.124133,3714.1294,1,111423723,111423882,159,-0.19953906043667924
40709,3714.551467,3714.572367,1,111436544,111437171,627,0.07774531521535545
40710,3714.6248,3714.6293,1,111438744,111438879,135,-0.01444660458860384
40711,3714.633533,3714.641367,1,111439005,111439241,236,0.0006923168487128012
40712,3714.704567,3714.710067,1,111441137,111441302,165,0.5274696337223429
40713,3714.713267,3714.774833,1,111441398,111443244,1846,0.051647911191705996
40714,3714.786633,3714.7967,1,111443598,111443901,303,-0.021710919679192014
40715,3714.8041,3714.8629,1,111444123,111445887,1764,0.03675514050908722
40716,3714.865533,3714.8725,1,111445965,111446175,210,0.3288229796263745
40717,3714.873833,3714.990767,1,111446214,111449723,3509,0.11177161682879508
40718,3715.683033,3715.6861,1,111470490,111470583,93,-0.3124201468695043
40719,3715.7412,3715.844767,1,111472236,111475343,3107,0.2205243091003811
40720,3715.847667,3715.850667,1,111475430,111475520,90,0.41847720419791967
40721,3715.856433,3715.864667,1,111475692,111475940,248,0.49518254890628527
40722,3715.867133,3715.885667,1,111476013,111476570,557,-0.08436700318720823
40723,3715.891333,3715.999267,1,111476739,111479978,3239,0.6528024068123435
40724,3716.002267,3716.062067,1,111480068,111481862,1794,0.38654349792825193
40725,3716.065167,3716.095067,1,111481955,111482852,897,0.08389489493563423
40726,3716.1062,3716.117033,1,111483186,111483510,324,0.23121514362504295
40727,3716.152567,3716.170867,1,111484577,111485126,549,0.2197457164356722
40728,3716.1756,3716.187067,1,111485268,111485612,344,-0.017981386871875255
40729,3716.192333,3716.198733,1,111485769,111485961,192,0.25605311238682105
40730,3716.214767,3716.228167,1,111486443,111486845,402,-0.07748798662380485
40731,3716.2637,3716.266767,1,111487911,111488003,92,
40732,3716.419367,3716.425433,1,111492581,111492762,181,0.156059688094349
40733,3718.130133,3718.140033,1,111543903,111544200,297,0.439638375456313
40734,3718.143967,3718.158867,1,111544319,111544766,447,0.23935526969091767
40735,3718.1783,3718.261033,1,111545349,111547830,2481,0.5281168031290076
40736,3718.278833,3718.3366,1,111548364,111550098,1734,0.001413373222673659
40737,3718.3417,3718.3467,1,111550251,111550401,150,-0.1649553378772402
40738,3718.3482,3718.3621,1,111550446,111550863,417,0.10338207598732953
40739,3718.363233,3718.366533,1,111550896,111550995,99,-0.37932915474589995
40740,3718.3691,3718.417333,1,111551073,111552519,1446,0.070902536040606
40741,3718.425167,3718.503933,1,111552755,111555117,2362,0.1376001345889241
40742,3718.506967,3718.5134,1,111555209,111555402,193,0.12404599192364374
40743,3718.516533,3718.541933,1,111555495,111556257,762,0.10901593224379108
40744,3718.545733,3718.5614,1,111556371,111556842,471,0.15463363325070978
40745,3718.5675,3718.5708,1,111557025,111557124,99,0.7711860915737361
40746,3718.576,3718.5796,1,111557280,111557388,108,
40747,3718.5806,3718.588933,1,111557418,111557667,249,0.7780309911125508
40748,3719.359933,3719.3948,1,111580797,111581844,1047,0.10794272455814054
40749,3719.3968,3719.4005,1,111581904,111582015,111,0.3984786825466486
40750,3719.4043,3719.408133,1,111582129,111582243,114,0.25357298085364005
40751,3719.409233,3719.417133,1,111582276,111582513,237,0.2002293911163971
40752,3719.505367,3719.509733,1,111585161,111585291,130,0.27294559487129294
40753,3719.534367,3719.548667,1,111586031,111586460,429,0.42257309011487487
40754,3719.5551,3719.571033,1,111586653,111587130,477,0.20782249916887582
40755,3719.644067,3719.6503,1,111589322,111589509,187,0.5219042705478703
40756,3719.713033,3719.727333,1,111591390,111591819,429,-0.19172620711038324
40757,3719.7344,3719.746367,1,111592032,111592391,359,0.17970075235421223
40758,3719.77,3719.7827,1,111593100,111593481,381,-0.0007563538701869563
40759,3719.7872,3719.8791,1,111593616,111596373,2757,0.08811936125640474
40760,3719.884367,3719.8969,1,111596531,111596907,376,-0.10370541849488919
40761,3719.900467,3719.969733,1,111597014,111599091,2077,0.5377485119664149
40762,3719.979067,3720.066567,1,111599372,111601997,2625,0.35362931489679583
40763,3720.078433,3720.0822,1,111602352,111602466,114,0.33246924154260726
40764,3720.0848,3720.097,1,111602544,111602910,366,-0.049712304343601896
40765,3720.1015,3720.104567,1,111603045,111603137,92,0.1919542436711369
40766,3720.1097,3720.132233,1,111603291,111603966,675,0.21564708836100047
40767,3720.134767,3720.147533,1,111604043,111604425,382,0.312336519493069
40768,3720.606233,3720.6223,1,111618186,111618669,483,0.08648247498059125
40769,3720.6292,3720.641333,1,111618876,111619239,363,0.35833876045155627
40770,3720.685833,3720.697,1,111620574,111620910,336,0.1179855973213842
40771,3720.705833,3720.711667,1,111621174,111621350,176,0.0012328274512777506
40772,3720.720333,3720.7242,1,111621609,111621726,117,-0.15290405319376138
40773,3720.727167,3720.7464,1,111621815,111622392,577,0.20349432783254012
40774,3720.7516,3720.768767,1,111622548,111623063,515,0.01619423894866984
40775,3720.887367,3720.898333,1,111626621,111626949,328,0.2058295739632583
40776,3721.360967,3721.365,1,111640829,111640950,121,0.13230706974256762
40777,3722.8436,3722.863733,1,111685308,111685911,603,0.41489115387040293
40778,3722.879867,3722.883467,1,111686396,111686504,108,0.4406690564900038
40779,3722.888433,3722.893333,1,111686652,111686799,147,0.3205902991918036
40780,3722.905,3722.908333,1,111687150,111687249,99,0.0144837913851446
40781,3722.910933,3722.926267,1,111687327,111687788,461,0.23597668917078923
40782,3722.974167,3722.977233,1,111689225,111689316,91,
40783,3723.0616,3723.066267,1,111691848,111691988,140,-0.07293161320013587
40784,3723.075167,3723.091667,1,111692255,111692750,495,0.12117269392443811
40785,3723.092867,3723.112867,1,111692786,111693386,600,0.26412653226456934
40786,3723.1284,3723.207567,1,111693852,111696227,2375,0.3983020792179687
40787,3723.211233,3723.222367,1,111696336,111696671,335,0.05199736471908315
40788,3723.233933,3723.2555,1,111697017,111697665,648,0.08414876447150495
40789,3723.256767,3723.2815,1,111697703,111698445,742,0.1755498826098383
40790,3723.282967,3723.292367,1,111698489,111698771,282,0.04173572525304319
40791,3723.306167,3723.3277,1,111699185,111699831,646,0.03537689586827956
40792,3723.332367,3723.338833,1,111699971,111700164,193,-0.10215894380613517
40793,3723.355167,3723.366133,1,111700655,111700983,328,0.04240162293979042
40794,3723.369067,3723.387167,1,111701072,111701615,543,0.10371645848470824
40795,3723.397867,3723.473033,1,111701936,111704190,2254,0.30149590435389934
40796,3724.2344,3724.238333,1,111727032,111727149,117,-0.27950140521404676
40797,3724.281267,3724.285867,1,111728438,111728576,138,-0.11129835984794034
40798,3724.2871,3724.292067,1,111728613,111728762,149,0.24344783032364456
40799,3724.293167,3724.315033,1,111728795,111729450,655,0.2525539281642953
40800,3724.322633,3724.330833,1,111729678,111729924,246,0.03739232951100915
40801,3724.343633,3724.394833,1,111730308,111731844,1536,0.2003969703782623
40802,3724.398433,3724.4153,1,111731952,111732459,507,0.04020816383838405
40803,3724.419433,3724.4291,1,111732582,111732873,291,-0.10005384613900857
40804,3724.4403,3724.470333,1,111733209,111734109,900,0.09303689968032518
40805,3724.482233,3724.529867,1,111734466,111735896,1430,0.2342069226454916
40806,3724.539033,3724.593433,1,111736170,111737802,1632,0.08151699967233311
40807,3725.4068,3725.4335,1,111762204,111763005,801,0.31148604771018656
40808,3725.4345,3725.450533,1,111763035,111763515,480,0.3271947398293437
40809,3725.467833,3725.4718,1,111764034,111764154,120,0.39604719440835123
40810,3725.528367,3725.5323,1,111765851,111765969,118,0.20663496677546642
40811,3725.550767,3725.566467,1,111766523,111766994,471,0.08706095330382448
40812,3725.5765,3725.588567,1,111767295,111767657,362,0.07336307369394328
40813,3725.591767,3725.601367,1,111767753,111768041,288,0.12996385546731934
40814,3725.6313,3725.635367,1,111768939,111769061,122,0.10096457315947306
40815,3725.692967,3725.733167,1,111770789,111771995,1206,0.14344032823165734
40816,3725.756733,3725.7662,1,111772701,111772986,285,0.3710942473597534
40817,3725.7714,3725.789033,1,111773142,111773670,528,0.2794093357711427
40818,3725.795333,3725.8047,1,111773859,111774141,282,0.21158849664235366
40819,3725.840167,3725.850767,1,111775205,111775523,318,0.04439398101207938
40820,3725.852367,3725.919133,1,111775571,111777573,2002,0.1273481417556782
40821,3725.9308,3725.961767,1,111777924,111778853,929,0.025009192867026197
40822,3725.9689,3725.9745,1,111779067,111779235,168,-0.02947296203889723
40823,3725.9815,3725.988767,1,111779445,111779663,218,0.19139486595599514
40824,3725.9932,3726.031167,1,111779796,111780935,1139,0.07020357183446212
40825,3726.043567,3726.113933,1,111781307,111783417,2110,0.2542580776471454
40826,3727.1766,3727.181767,1,111815298,111815453,155,-0.12986229489023068
40827,3727.182767,3727.188833,1,111815483,111815664,181,0.24568921703081617
40828,3727.193133,3727.204967,1,111815793,111816149,356,-0.002208882035617747
40829,3727.206933,3727.211667,1,111816207,111816350,143,0.38700238699498646
40830,3727.217467,3727.226033,1,111816524,111816780,256,0.24072346558841617
40831,3727.228867,3727.2331,1,111816866,111816993,127,0.7387948831206151
40832,3727.254033,3727.261167,1,111817620,111817835,215,-0.006097362309987476
40833,3727.263767,3727.283967,1,111817913,111818519,606,0.07786146928162897
40834,3727.299667,3727.305033,1,111818990,111819150,160,0.13568411722130683
40835,3727.312033,3727.3167,1,111819360,111819501,141,-0.052785306126444456
40836,3727.349367,3727.375833,1,111820481,111821274,793,0.24287075658756502
40837,3727.3889,3727.396367,1,111821667,111821891,224,-0.1017439731392982
40838,3727.3995,3727.4039,1,111821985,111822117,132,-0.016088652892850996
40839,3727.412533,3727.426,1,111822375,111822780,405,0.19685798859032574
40840,3727.428067,3727.4505,1,111822842,111823515,673,0.1997416286782296
40841,3727.4525,3727.4617,1,111823575,111823851,276,0.13588018683818034
40842,3727.516533,3727.5204,1,111825495,111825612,117,0.17310077540928628
40843,3727.523,3727.5348,1,111825690,111826044,354,0.05480275313505866
40844,3727.5402,3727.545767,1,111826206,111826373,167,-0.05506782230799701
40845,3727.5484,3727.629467,1,111826452,111828884,2432,0.43261100267940994
40846,3727.631767,3727.646967,1,111828953,111829409,456,-0.021154186414717075
40847,3727.6485,3727.658267,1,111829455,111829748,293,0.12862617588392905
40848,3727.663967,3727.689533,1,111829919,111830685,766,0.09598739212003798
40849,3727.698767,3727.7601,1,111830963,111832803,1840,0.16184507372228132
40850,3727.775367,3727.781567,1,111833261,111833447,186,0.16629165029233575
40851,3727.7874,3727.7975,1,111833622,111833925,303,0.09229140578535128
40852,3727.802267,3727.811267,1,111834068,111834338,270,-0.11488218639935247
40853,3727.814133,3727.8179,1,111834423,111834537,114,
40854,3727.819767,3727.828533,1,111834593,111834855,262,0.6026064649956439
40855,3727.829733,3727.8402,1,111834891,111835206,315,0.10329247569565088
40856,3728.375733,3728.383167,1,111851271,111851495,224,0.011139482844447244
40857,3728.396267,3728.402533,1,111851888,111852075,187,0.19291565654768894
40858,3728.403633,3728.409933,1,111852108,111852297,189,0.34807810841622294
40859,3728.411033,3728.425533,1,111852330,111852765,435,0.33037387070466545
40860,3728.429467,3728.439,1,111852884,111853170,286,0.3256035603033609
40861,3728.443933,3728.460933,1,111853317,111853827,510,0.2522391898099206
40862,3728.462533,3728.465567,1,111853875,111853967,92,0.20548166312644742
40863,3728.474533,3728.499767,1,111854235,111854993,758,0.10699226297428821
40864,3728.5723,3728.578233,1,111857169,111857346,177,0.14532304724619152
40865,3728.601633,3728.606133,1,111858048,111858183,135,-0.16480945555392107
40866,3728.610133,3728.6219,1,111858303,111858657,354,0.20373953093711536
40867,3728.623,3728.647933,1,111858690,111859437,747,0.23223061798515274
40868,3728.652733,3728.6577,1,111859581,111859731,150,-0.05878200935004868
40869,3728.6608,3728.742367,1,111859824,111862271,2447,0.331564933635439
40870,3728.744,3728.747833,1,111862320,111862434,114,-0.019495336110417098
40871,3728.751233,3728.761967,1,111862536,111862859,323,-0.0025982327279954007
40872,3728.771433,3728.781067,1,111863142,111863432,290,0.15885692539365798
40873,3728.786233,3728.7991,1,111863586,111863973,387,0.10474433888639886
40874,3728.800567,3728.986033,1,111864017,111869580,5563,0.6054148447589672
40875,3728.999267,3729.006467,1,111869978,111870194,216,0.3639883283367568
40876,3729.011,3729.0232,1,111870330,111870696,366,0.4522237112137826
40877,3729.0326,3729.051467,1,111870978,111871544,566,-0.045343261874503965
40878,3729.054467,3729.058333,1,111871634,111871749,115,
40879,3729.065167,3729.081667,1,111871955,111872450,495,0.050465757730616984
40880,3729.0909,3729.095667,1,111872727,111872870,143,0.42205139553705096
40881,3729.689667,3729.692867,1,111890690,111890786,96,
40882,3729.7108,3729.715367,1,111891324,111891461,137,-0.04734936769301881
40883,3729.765467,3729.784433,1,111892964,111893532,568,0.10661707117368205
40884,3729.820767,3729.8311,1,111894623,111894933,310,0.14548257641857282
40885,3729.849967,3729.853367,1,111895499,111895601,102,
40886,3729.881867,3729.888833,1,111896456,111896664,208,0.01852181583685577
40887,3729.9836,3729.999533,1,111899508,111899985,477,0.09930318731110001
40888,3730.042733,3730.048933,1,111901281,111901467,186,
40889,3730.0567,3730.096967,1,111901701,111902909,1208,0.2018829188146111
40890,3730.103,3730.115,1,111903090,111903450,360,0.043710787628506054
40891,3730.185733,3730.194567,1,111905571,111905837,266,0.3179176888534592
40892,3730.196233,3730.203133,1,111905886,111906093,207,-0.13053460397576908
40893,3730.218667,3730.245867,1,111906560,111907376,816,-0.003528186154944562
40894,3730.278867,3730.284733,1,111908366,111908541,175,-0.09208783131893192
40895,3730.289433,3730.303267,1,111908682,111909098,416,0.20106266284851498
40896,3730.333,3730.3479,1,111909990,111910437,447,0.010777425886623157
40897,3730.358433,3730.3716,1,111910752,111911148,396,0.30398259205603023
40898,3730.394767,3730.4293,1,111911843,111912879,1036,0.20808801702407434
40899,3730.483367,3730.496233,1,111914501,111914886,385,0.24412269570734732
40900,3730.5066,3730.516233,1,111915198,111915486,288,0.2622721033419205
40901,3730.528033,3730.542367,1,111915840,111916271,431,0.1484787289372046
40902,3730.619567,3730.644933,1,111918587,111919347,760,0.22343682274311497
40903,3730.647167,3730.655033,1,111919415,111919650,235,0.2173998148346377
40904,3730.6563,3730.7282,1,111919689,111921846,2157,0.13500611868577544
40905,3730.729567,3730.748833,1,111921887,111922464,577,0.04184597199763686
40906,3730.751533,3730.7635,1,111922545,111922905,360,0.17665698309951636
40907,3730.7722,3730.775567,1,111923166,111923267,101,
40908,3730.788467,3730.7976,1,111923654,111923928,274,0.0678199637859903
40909,3730.798933,3730.8105,1,111923967,111924315,348,0.052643978810557046
40910,3730.812533,3730.819167,1,111924375,111924575,200,0.10688509236656363
40911,3730.8216,3730.8802,1,111924648,111926406,1758,0.18436456917078117
40912,3731.221533,3731.235367,1,111936645,111937061,416,-0.08609554859597417
40913,3731.418933,3731.435267,1,111942567,111943058,491,0.23957024219837111
40914,3731.482467,3731.489467,1,111944474,111944684,210,0.4127347185110596
40915,3731.495133,3731.5046,1,111944853,111945138,285,0.5218205132913143
40916,3731.759633,3731.763567,1,111952788,111952907,119,
40917,3731.785133,3731.788433,1,111953553,111953652,99,
40918,3731.8853,3731.8886,1,111956559,111956658,99,-0.1136390439734091
40919,3731.949133,3731.953433,1,111958473,111958602,129,-0.0064462354162445655
40920,3731.961133,3731.965333,1,111958833,111958959,126,0.4971012200805549
40921,3732.053367,3732.080367,1,111961601,111962411,810,0.22612461835807748
40922,3732.099767,3732.106067,1,111962993,111963182,189,0.25236252055576797
40923,3732.1163,3732.122633,1,111963489,111963678,189,0.28857696927484594
40924,3732.161733,3732.1929,1,111964851,111965787,936,0.10537520379704331
40925,3732.227133,3732.2564,1,111966813,111967692,879,0.20640807182015916
40926,3732.258933,3732.283567,1,111967767,111968507,740,0.3861536985603634
40927,3732.2855,3732.289533,1,111968565,111968685,120,0.5434874592749489
40928,3732.405433,3732.411833,1,111972162,111972354,192,0.35167108295046573
40929,3732.4204,3732.424767,1,111972612,111972743,131,0.49583800332614697
40930,3732.438633,3732.4456,1,111973158,111973368,210,-0.11148023054518438
40931,3732.469833,3732.474233,1,111974094,111974226,132,0.3496863480939351
40932,3732.482267,3732.4865,1,111974468,111974595,127,
40933,3732.4915,3732.495867,1,111974745,111974876,131,0.19738393881673505
40934,3732.502733,3732.517267,1,111975081,111975518,437,0.5706112926482011
40935,3732.5195,3732.528167,1,111975585,111975845,260,-0.17565706050429888
40936,3732.582833,3732.5994,1,111977484,111977982,498,0.2180225409188474
40937,3732.6258,3732.6321,1,111978774,111978963,189,-0.4873674408145495
40938,3732.633767,3732.639367,1,111979013,111979181,168,-0.0026135865169144724
40939,3732.644067,3732.6551,1,111979322,111979653,331,0.40102006600493045
40940,3732.666233,3732.690733,1,111979986,111980721,735,0.3633536360540938
40941,3732.709433,3732.7344,1,111981282,111982032,750,0.17088957479187802
40942,3732.754,3732.769367,1,111982620,111983081,461,0.19815594098624273
40943,3732.772567,3732.785967,1,111983177,111983579,402,0.33277519635153
40944,3732.801267,3732.8189,1,111984038,111984567,529,0.33954411293399134
40945,3732.8207,3732.824833,1,111984621,111984744,123,0.242489994852846
40946,3732.842633,3732.848233,1,111985278,111985446,168,0.04204245753830737
40947,3732.8852,3732.895433,1,111986556,111986862,306,0.11080081136793897
40948,3732.897133,3732.909267,1,111986913,111987278,365,0.005871685290922041
40949,3732.929867,3732.959933,1,111987896,111988797,901,0.0705687290902617
40950,3732.968567,3732.994067,1,111989057,111989822,765,0.0644163148336215
40951,3732.9985,3733.014867,1,111989955,111990446,491,0.25716275420207135
40952,3733.019733,3733.0315,1,111990591,111990945,354,-0.04772019497576208
40953,3733.062733,3733.071933,1,111991881,111992157,276,0.2867830383643007
40954,3733.0777,3733.086033,1,111992331,111992580,249,0.3731241385197999
40955,3733.1022,3733.1088,1,111993066,111993264,198,0.25259235788518375
40956,3733.110367,3733.113533,1,111993311,111993405,94,0.0292390566035864
40957,3733.1261,3733.133933,1,111993783,111994017,234,-0.017142319922021528
40958,3733.176267,3733.266333,1,111995288,111997989,2701,0.08740381372151451
40959,3733.269433,3733.274033,1,111998082,111998220,138,0.07421023516789049
40960,3733.277367,3733.289333,1,111998321,111998679,358,-0.02829962326692319
40961,3733.296267,3733.307133,1,111998888,111999213,325,0.10614639598744476
40962,3733.308433,3733.334467,1,111999252,112000034,782,0.058885044539115625
40963,3733.338233,3733.354233,1,112000146,112000626,480,0.1326191207047103
40964,3733.3569,3733.3988,1,112000707,112001964,1257,0.07556017755726595
40965,3733.4056,3733.410667,1,112002168,112002320,152,0.1386737323914615
40966,3733.419467,3733.4253,1,112002584,112002759,175,0.6675737094809536
40967,3734.152167,3734.162533,1,112024565,112024875,310,0.33650707829071286
40968,3734.169833,3734.237333,1,112025094,112027119,2025,0.1322068467672546
40969,3734.2387,3734.242933,1,112027161,112027287,126,0.4527779670396339
40970,3734.2442,3734.2514,1,112027326,112027542,216,0.13356329096702826
40971,3734.252633,3734.2572,1,112027578,112027716,138,-0.05230775971162433
40972,3734.258667,3734.269133,1,112027760,112028073,313,0.02610270537151208
40973,3734.284033,3734.330933,1,112028520,112029927,1407,0.12398634292961942
40974,3734.338,3734.341467,1,112030140,112030244,104,0.030565043059154
40975,3734.342967,3734.353267,1,112030289,112030598,309,-0.112198012682846
40976,3734.3607,3734.377333,1,112030821,112031319,498,0.05951812851473263
40977,3734.3818,3734.4714,1,112031454,112034142,2688,0.35527196579528103
40978,3734.473467,3734.476967,1,112034204,112034309,105,
40979,3734.577233,3734.5856,1,112037316,112037568,252,-0.11972334523508796
40980,3734.619233,3734.6226,1,112038576,112038678,102,0.02760641164306466
40981,3734.634233,3734.6418,1,112039026,112039254,228,0.12088326375829281
40982,3734.6522,3734.656667,1,112039566,112039700,134,0.12069221821964028
40983,3734.665867,3734.676133,1,112039976,112040283,307,0.16426701400428476
40984,3734.679,3734.6857,1,112040370,112040571,201,0.03669135083149218
40985,3734.701933,3734.707333,1,112041057,112041219,162,0.23411333548575114
40986,3734.7165,3734.723867,1,112041495,112041716,221,0.02482655137068262
40987,3734.731033,3734.744467,1,112041930,112042334,404,-0.0305796666940401
40988,3734.776567,3734.7865,1,112043297,112043595,298,0.5092825652208787
40989,3734.788067,3734.8168,1,112043642,112044504,862,0.1419507818746522
40990,3734.824133,3734.830467,1,112044723,112044914,191,0.7937393777496538
40991,3734.832767,3734.840133,1,112044983,112045203,220,0.5365747297362709
40992,3734.8752,3734.882633,1,112046256,112046478,222,-0.24922000016002238
40993,3734.890267,3734.910733,1,112046708,112047321,613,0.5393498311744989
40994,3734.968833,3734.9943,1,112049064,112049829,765,0.32428975807532373
40995,3735.011633,3735.0212,1,112050348,112050636,288,0.5386973163664159
40996,3735.022467,3735.028533,1,112050674,112050855,181,-0.11070513451664633
40997,3735.0478,3735.051033,1,112051434,112051530,96,0.08642997830952374
40998,3735.0647,3735.0694,1,112051941,112052082,141,0.30283682227158343
40999,3735.368967,3735.372533,1,112061069,112061175,106,-0.4184751124193769
41000,3735.374433,3735.3883,1,112061232,112061649,417,0.08023760185095874
41001,3735.3942,3735.397733,1,112061826,112061931,105,0.16715885630584362
41002,3735.414533,3735.424233,1,112062435,112062726,291,0.41844777064750205
41003,3735.467733,3735.478567,1,112064031,112064357,326,0.5383197762271393
41004,3735.499367,3735.513567,1,112064981,112065407,426,0.1560722536816288
41005,3735.517,3735.527967,1,112065510,112065839,329,-0.06888168132651078
41006,3735.5324,3735.537,1,112065972,112066110,138,0.38799336764730774
41007,3735.541233,3735.549833,1,112066236,112066494,258,-0.08167334078172142
41008,3735.851233,3735.855133,1,112075536,112075653,117,-0.015233986542146916
41009,3735.8569,3735.867067,1,112075707,112076012,305,-0.2151056873779035
41010,3735.868167,3735.8829,1,112076045,112076487,442,0.4176745497119644
41011,3735.911733,3735.9365,1,112077351,112078095,744,0.10753266092057058
41012,3735.977867,3735.9985,1,112079336,112079955,619,0.15852973361060543
41013,3736.0061,3736.010067,1,112080183,112080302,119,0.7077003159186993
41014,3736.015867,3736.033967,1,112080476,112081019,543,0.12668365572772788
41015,3736.238867,3736.2424,1,112087166,112087272,106,
41016,3736.267533,3736.304633,1,112088025,112089138,1113,0.32981688627405376
41017,3736.310733,3736.3421,1,112089321,112090263,942,0.10544046626734135
41018,3736.343433,3736.353467,1,112090302,112090604,302,0.02509667170978044
41019,3736.358767,3736.377367,1,112090763,112091321,558,0.12880494293919867
41020,3736.378367,3736.3829,1,112091351,112091487,136,0.18560748374326785
41021,3736.391233,3736.398533,1,112091736,112091955,219,0.03750628243382149
41022,3736.4369,3736.4455,1,112093107,112093365,258,-0.20032429569403468
41023,3736.465467,3736.480033,1,112093964,112094400,436,0.1410651161332166
41024,3736.482833,3736.491133,1,112094484,112094733,249,0.050532792935781695
41025,3736.4973,3736.559333,1,112094919,112096779,1860,0.15662692944941015
41026,3736.564333,3736.571067,1,112096929,112097132,203,0.23801216879912215
41027,3736.580467,3736.599233,1,112097414,112097976,562,-0.057182230233747536
41028,3736.6074,3736.633667,1,112098222,112099010,788,0.10251911113393287
41029,3736.6421,3736.650967,1,112099263,112099529,266,0.11434043952440145
41030,3736.652633,3736.711067,1,112099578,112101332,1754,0.1395792670875432
41031,3736.712933,3736.717633,1,112101387,112101528,141,
41032,3736.723967,3736.7415,1,112101719,112102245,526,0.39008625351959636
41033,3736.8249,3736.8307,1,112104747,112104921,174,0.5855255367161186
41034,3736.8336,3736.842,1,112105008,112105260,252,0.0039685637470400405
41035,3736.845733,3736.849867,1,112105371,112105496,125,0.11815135734473428
41036,3736.8614,3736.875933,1,112105842,112106277,435,0.5536268495793767
41037,3736.880233,3736.884733,1,112106406,112106541,135,0.11094591904837718
41038,3737.3567,3737.363933,1,112120701,112120917,216,0.10185210550665288
41039,3738.667867,3738.692833,1,112160036,112160784,748,0.10394369968089688
41040,3738.7115,3738.773067,1,112161345,112163192,1847,0.296632996153734
41041,3738.774933,3738.792967,1,112163247,112163789,542,0.13900216338109228
41042,3738.801333,3738.809167,1,112164039,112164275,236,-0.05922324009689419
41043,3738.810233,3738.814767,1,112164306,112164443,137,-0.08817463891976295
41044,3738.816,3738.842367,1,112164480,112165271,791,0.13634473112061318
41045,3738.854467,3738.9281,1,112165634,112167843,2209,0.26631531422202803
41046,3738.930933,3738.9375,1,112167927,112168125,198,0.18463762425202654
41047,3738.939,3738.959467,1,112168170,112168784,614,0.12837411171341553
41048,3740.533367,3740.556767,1,112216001,112216703,702,0.17530295981389715
41049,3740.569833,3740.682267,1,112217094,112220468,3374,0.19167408108056852
41050,3740.6837,3740.694567,1,112220511,112220837,326,0.15861736232198312
41051,3740.695933,3740.701467,1,112220877,112221044,167,-0.027274136663781087
41052,3740.705,3740.7344,1,112221150,112222032,882,0.03484490138300888
41053,3740.736533,3740.751633,1,112222095,112222548,453,0.13546870321813817
41054,3740.753467,3740.812433,1,112222604,112224372,1768,0.13245686812466917
41055,3740.825867,3740.8352,1,112224776,112225056,280,0.5916183976167393
41056,3740.881733,3740.896267,1,112226451,112226888,437,-0.03131422846217591
41057,3740.947933,3740.962267,1,112228437,112228868,431,-0.20420855710437313
41058,3741.129067,3741.134133,1,112233872,112234023,151,0.619622874375551
41059,3741.146967,3741.155333,1,112234409,112234659,250,0.2199782291907967
41060,3741.1609,3741.213433,1,112234827,112236402,1575,0.08058135138311352
41061,3741.216167,3741.221967,1,112236485,112236659,174,0.32627313966974814
41062,3741.224267,3741.248567,1,112236728,112237457,729,-0.04960173943043659
41063,3741.2526,3741.336467,1,112237578,112240094,2516,0.576898339593018
41064,3741.3456,3741.3591,1,112240368,112240773,405,0.12868158521193804
41065,3741.3616,3741.4693,1,112240848,112244079,3231,0.2829642291030314
41066,3741.472167,3741.478433,1,112244165,112244352,187,0.21815837988975625
41067,3741.495467,3741.508533,1,112244864,112245255,391,0.2178724367803533
41068,3741.5215,3741.524533,1,112245645,112245735,90,
41069,3741.525767,3741.533633,1,112245773,112246008,235,-0.08710636376187393
41070,3741.5502,3741.5854,1,112246506,112247562,1056,0.1797594999656256
41071,3742.798067,3742.805867,1,112283942,112284176,234,0.3885927484198518
41072,3742.807,3742.8238,1,112284210,112284714,504,0.4129315986804333
41073,3742.8336,3742.8384,1,112285008,112285152,144,0.18169620552190627
41074,3742.9134,3742.935333,1,112287402,112288059,657,0.42516892407776236
41075,3742.9577,3742.961767,1,112288731,112288853,122,0.002509649518385368
41076,3742.991233,3742.9944,1,112289736,112289832,96,-0.14809573572416168
41077,3743.0615,3743.099267,1,112291845,112292978,1133,0.13460941987135916
41078,3743.102267,3743.107,1,112293068,112293210,142,0.3831051086069841
41079,3743.110067,3743.186033,1,112293302,112295580,2278,0.26839853923691775
41080,3743.187167,3743.1962,1,112295615,112295886,271,-0.09168068094816165
41081,3743.1976,3743.209033,1,112295928,112296270,342,0.061278559180118854
41082,3743.214333,3743.2285,1,112296429,112296855,426,-0.06628992774294658
41083,3743.230867,3743.246633,1,112296926,112297398,472,0.01723103942146274
41084,3743.260833,3743.282367,1,112297824,112298471,647,-0.09020736706003014
41085,3743.283733,3743.292233,1,112298511,112298766,255,0.054794103338351045
41086,3743.3088,3743.3181,1,112299264,112299543,279,-0.016103085818148715
41087,3743.320867,3743.3331,1,112299626,112299993,367,0.04397358539016056
41088,3743.335367,3743.345767,1,112300061,112300373,312,-0.010735546795063172
41089,3743.3469,3743.3628,1,112300407,112300884,477,0.07405912312395292
41090,3743.3687,3743.452033,1,112301061,112303560,2499,0.20546884040747226
41091,3744.215333,3744.2219,1,112326459,112326657,198,-0.16228816728957432
41092,3744.222933,3744.254767,1,112326687,112327643,956,0.2485077938374789
41093,3744.258267,3744.265033,1,112327748,112327950,202,0.23840038990626727
41094,3744.267767,3744.286,1,112328033,112328580,547,0.13155489394365594
41095,3744.310067,3744.318667,1,112329302,112329560,258,0.35968275368930736
41096,3744.349533,3744.3537,1,112330485,112330611,126,0.16411116267700013
41097,3744.393,3744.399333,1,112331790,112331979,189,-0.0799181824096054
41098,3744.557433,3744.5628,1,112336722,112336884,162,0.3572770463951608
41099,3744.564633,3744.577033,1,112336938,112337310,372,0.3246372766530184
41100,3744.580733,3744.5849,1,112337421,112337547,126,0.3510871208814803
41101,3744.5898,3744.5981,1,112337694,112337943,249,0.09164073207473557
41102,3744.599167,3744.656867,1,112337975,112339706,1731,0.13457999245368346
41103,3744.660733,3744.683533,1,112339821,112340505,684,0.036247922888326956
41104,3744.701367,3744.713567,1,112341041,112341407,366,0.07109812221640749
41105,3744.714667,3744.7204,1,112341440,112341612,172,-0.08453346555764212
41106,3744.7223,3744.742933,1,112341669,112342287,618,0.04731432707680091
41107,3744.749967,3744.817867,1,112342499,112344536,2037,0.2562069725519887
41108,3745.384833,3745.390167,1,112361544,112361705,161,-0.31989693818748893
41109,3745.4021,3745.411933,1,112362063,112362357,294,-0.02322357522643365
41110,3745.419833,3745.431,1,112362594,112362930,336,0.09743443178555358
41111,3745.5007,3745.508767,1,112365021,112365263,242,0.06492659158143672
41112,3745.517467,3745.564133,1,112365524,112366923,1399,0.42845730648865504
41113,3745.6549,3745.669667,1,112369647,112370090,443,0.2465896613169419
41114,3745.694933,3745.707467,1,112370847,112371224,377,-0.021533999833935256
41115,3745.7175,3745.725667,1,112371525,112371770,245,0.2432518972315791
41116,3745.731567,3745.8154,1,112371947,112374462,2515,0.17311769119772877
41117,3745.8173,3745.827033,1,112374519,112374810,291,-0.08778321294915008
41118,3745.831867,3745.8429,1,112374956,112375287,331,-0.01081734154912197
41119,3745.852833,3745.864633,1,112375584,112375938,354,0.047561078505351434
41120,3745.865733,3745.887,1,112375971,112376610,639,0.047233403821054
41121,3745.889033,3745.9111,1,112376670,112377333,663,0.0937171420473399
41122,3745.919933,3746.009433,1,112377597,112380282,2685,0.3444433947010527
41123,3746.599167,3746.6078,1,112397975,112398234,259,0.14059955048390416
41124,3746.637867,3746.642233,1,112399136,112399266,130,
41125,3746.662233,3746.672633,1,112399866,112400178,312,-0.1751086520160028
41126,3746.676767,3746.684667,1,112400303,112400540,237,0.2220961467106664
41127,3746.690933,3746.6949,1,112400727,112400847,120,0.6712990660240334
41128,3746.702733,3746.705733,1,112401081,112401171,90,
41129,3746.7207,3746.7605,1,112401621,112402815,1194,0.15720807916349097
41130,3746.763033,3746.770567,1,112402890,112403117,227,-0.0695819300832709
41131,3746.779167,3746.785033,1,112403375,112403550,175,-0.3600367904270933
41132,3746.812033,3746.815367,1,112404360,112404461,101,0.396174310806948
41133,3746.8211,3746.833067,1,112404633,112404992,359,0.2281689942524889
41134,3746.849133,3746.862433,1,112405473,112405872,399,-0.00178809802597463
41135,3747.135867,3747.146267,1,112414076,112414388,312,0.5432792805764741
41136,3747.150633,3747.175767,1,112414518,112415273,755,0.05949393276259467
41137,3747.183167,3747.242267,1,112415495,112417268,1773,0.09641028078501834
41138,3747.252833,3747.276967,1,112417584,112418309,725,-0.06818353607469935
41139,3747.2832,3747.2963,1,112418496,112418889,393,0.27586874285997276
41140,3747.298333,3747.308933,1,112418949,112419267,318,-0.013349163924760751
41141,3747.314567,3747.3385,1,112419437,112420155,718,0.15563993235036633
41142,3747.342033,3747.354133,1,112420260,112420623,363,0.15272332580004205
41143,3747.356867,3747.375833,1,112420706,112421274,568,0.1799517661955343
41144,3747.4113,3747.430433,1,112422339,112422912,573,0.3183417054634958
41145,3747.438467,3747.512233,1,112423154,112425366,2212,0.09049878675863879
41146,3747.725033,3747.729733,1,112431750,112431891,141,-0.10451913975583454
41147,3747.9874,3747.9936,1,112439622,112439808,186,0.3252719163798897
41148,3747.996633,3748.0226,1,112439898,112440678,780,0.4509329969309897
41149,3748.0271,3748.0512,1,112440813,112441536,723,0.10162061640699434
41150,3748.055633,3748.059633,1,112441668,112441788,120,0.5609873318582134
41151,3748.0612,3748.0645,1,112441836,112441935,99,
41152,3748.0708,3748.076533,1,112442124,112442295,171,-0.04034134418348909
41153,3748.082733,3748.086267,1,112442481,112442588,107,
41154,3748.087733,3748.095467,1,112442631,112442864,233,0.05511219549730285
41155,3748.1078,3748.136533,1,112443234,112444095,861,0.010483640817990804
41156,3748.1536,3748.158333,1,112444608,112444749,141,0.2862686145339897
41157,3748.166167,3748.176767,1,112444985,112445303,318,-0.07474169699717449
41158,3748.949,3748.953733,1,112468470,112468611,141,0.14745713198059296
41159,3748.960567,3748.980533,1,112468817,112469415,598,0.1682659989541858
41160,3748.985233,3748.9928,1,112469556,112469784,228,0.13027483725565864
41161,3748.994533,3749.013733,1,112469835,112470411,576,0.0201487683774127
41162,3749.060233,3749.072333,1,112471806,112472169,363,0.2686151467594573
41163,3749.091667,3749.0959,1,112472750,112472877,127,-0.09838736570513912
41164,3749.1607,3749.164633,1,112474821,112474938,117,-0.15372828391592983
41165,3749.200533,3749.210767,1,112476015,112476323,308,0.36878418502241356
41166,3749.212033,3749.2304,1,112476360,112476912,552,0.03936993443904661
41167,3749.235133,3749.2468,1,112477053,112477404,351,0.11669569190262703
41168,3749.262467,3749.3275,1,112477874,112479825,1951,0.15592418779332243
41169,3749.334133,3749.3581,1,112480023,112480743,720,0.0925798263482066
41170,3749.372267,3749.393933,1,112481168,112481817,649,0.15200979671668213
41171,3749.414167,3749.4196,1,112482425,112482588,163,-0.062146915773741096
41172,3749.437067,3749.440767,1,112483112,112483223,111,0.09038796803283626
41173,3749.454667,3749.4613,1,112483640,112483839,199,0.5873247515520926
41174,3749.4738,3749.513067,1,112484214,112485392,1178,0.15250384441041215
41175,3749.5162,3749.530333,1,112485486,112485909,423,0.17154376731585275
41176,3749.5575,3749.560567,1,112486725,112486817,92,
41177,3749.561667,3749.5657,1,112486850,112486971,121,0.4414498132831763
41178,3749.576733,3749.581833,1,112487301,112487454,153,0.29474921799451365
41179,3749.583433,3749.592733,1,112487502,112487781,279,-0.0920238586332607
41180,3749.5986,3749.601967,1,112487958,112488059,101,-0.15373286947878978
41181,3749.624567,3749.631467,1,112488737,112488944,207,0.09762902225871053
41182,3749.634133,3749.654867,1,112489023,112489646,623,0.22374958573549902
41183,3749.657333,3749.6613,1,112489719,112489839,120,
41184,3749.665633,3749.672367,1,112489968,112490171,203,0.5467123615668473
41185,3749.683867,3749.707767,1,112490516,112491233,717,0.020283080805093688
41186,3749.726367,3749.736,1,112491791,112492080,289,0.7966034295095838
41187,3749.745567,3749.768533,1,112492367,112493055,688,0.11684972348385893
41188,3749.772,3749.781467,1,112493160,112493444,284,0.3236949605874543
41189,3749.789133,3749.792667,1,112493673,112493780,107,0.5255754701479937
41190,3749.8799,3749.883033,1,112496397,112496490,93,0.7178250795852418
41191,3750.3506,3750.369433,1,112510518,112511082,564,0.10360729698642336
41192,3750.3767,3750.3899,1,112511301,112511697,396,0.19824142469016823
41193,3750.391467,3750.3951,1,112511744,112511853,109,0.08285378403617388
41194,3750.415533,3750.424967,1,112512465,112512749,284,0.08084509782824598
41195,3750.442833,3750.449967,1,112513284,112513499,215,-0.07149234050654346
41196,3750.4564,3750.4696,1,112513692,112514088,396,0.010096610713543331
41197,3750.480267,3750.5342,1,112514408,112516026,1618,0.6037081785496976
41198,3750.5409,3750.546233,1,112516227,112516386,159,0.41728152461178497
41199,3750.548633,3750.552433,1,112516458,112516572,114,
41200,3750.557767,3750.5695,1,112516733,112517085,352,0.052582815325361854
41201,3750.613033,3750.631633,1,112518390,112518948,558,0.17114606962162762
41202,3750.641367,3750.676833,1,112519241,112520304,1063,0.4053792889750369
41203,3750.693933,3750.728133,1,112520817,112521843,1026,0.539587663263281
41204,3750.730133,3750.740433,1,112521903,112522212,309,0.16412569772132332
41205,3750.7609,3750.764967,1,112522827,112522949,122,0.2527525065019547
41206,3750.7665,3750.771,1,112522995,112523130,135,0.2205478992901864
41207,3750.819933,3750.824067,1,112524597,112524722,125,-0.18418574070418042
41208,3750.826533,3750.858333,1,112524795,112525749,954,0.2528059048834673
41209,3750.861267,3750.8859,1,112525838,112526577,739,0.01596854263011584
41210,3750.888133,3750.9001,1,112526643,112527003,360,0.05559917664599651
41211,3750.904667,3750.966567,1,112527140,112528997,1857,0.1619762726779024
41212,3750.984033,3750.9878,1,112529520,112529634,114,-0.00986545565593139
41213,3750.991967,3751.0086,1,112529759,112530258,499,0.127580419856196
41214,3751.010033,3751.038933,1,112530300,112531167,867,0.016937510092506044
41215,3751.051633,3751.061,1,112531548,112531830,282,-0.04228501973767184
41216,3751.069233,3751.0724,1,112532076,112532172,96,0.10747676549928901
41217,3751.0777,3751.0815,1,112532331,112532445,114,0.3341466622973847
41218,3751.089233,3751.0996,1,112532676,112532988,312,-0.008418317973125006
41219,3751.104567,3751.1235,1,112533137,112533705,568,0.17131660146607935
41220,3751.130933,3751.1965,1,112533927,112535895,1968,0.257770904795249
41221,3751.4331,3751.444,1,112542993,112543320,327,0.11171857021106973
41222,3751.4615,3751.4698,1,112543845,112544094,249,-0.17774482265987795
41223,3751.5194,3751.523267,1,112545582,112545698,116,0.30797069783239456
41224,3751.686867,3751.6906,1,112550606,112550718,112,
41225,3751.695867,3751.715167,1,112550876,112551455,579,0.2251817648896953
41226,3751.716433,3751.727167,1,112551492,112551815,323,-0.06293631949465202
41227,3751.731533,3751.7454,1,112551945,112552362,417,0.21901856841451714
41228,3751.752967,3751.761167,1,112552589,112552835,246,0.13470443881634775
41229,3751.807633,3751.815067,1,112554228,112554452,224,0.49011421542003886
41230,3751.820533,3751.824967,1,112554615,112554749,134,-0.107436625517548
41231,3751.829067,3751.835767,1,112554872,112555073,201,0.07546103622530877
41232,3751.8408,3751.900667,1,112555224,112557020,1796,0.07850188459670185
41233,3751.9131,3751.9316,1,112557393,112557948,555,-0.03809675041047359
41234,3751.9403,3751.9467,1,112558209,112558401,192,-0.031537168073344266
41235,3751.9627,3751.9747,1,112558881,112559241,360,0.16393927589035112
41236,3751.9761,3751.9925,1,112559283,112559775,492,0.014953867303995696
41237,3752.006367,3752.019267,1,112560191,112560578,387,0.043642844124199574
41238,3752.031433,3752.091667,1,112560942,112562750,1808,0.24277053107560842
41239,3752.0929,3752.102767,1,112562787,112563083,296,0.04574152485923439
41240,3752.105533,3752.116233,1,112563165,112563486,321,-0.09141716248849495
41241,3752.122833,3752.154233,1,112563684,112564626,942,0.09844929303157127
41242,3752.1567,3752.166333,1,112564701,112564989,288,-0.07991471630615972
41243,3752.647233,3752.651733,1,112579416,112579551,135,-0.21121908888218632
41244,3752.658767,3752.6734,1,112579763,112580202,439,0.21664379961658334
41245,3752.675267,3752.6898,1,112580258,112580694,436,5.1700190329243735e-05
41246,3752.7035,3752.7153,1,112581105,112581459,354,0.09673420864840027
41247,3752.716833,3752.732467,1,112581504,112581974,470,0.07638747497088375
41248,3752.737867,3752.757767,1,112582136,112582733,597,0.30274548031028314
41249,3752.7834,3752.794867,1,112583502,112583846,344,0.26250664775340343
41250,3752.8059,3752.811767,1,112584177,112584353,176,
41251,3752.8317,3752.837,1,112584951,112585110,159,0.07903360297080714
41252,3753.073,3753.1063,1,112592190,112593189,999,0.19206609922100035
41253,3753.110367,3753.1137,1,112593311,112593411,100,0.9536419628401342
41254,3753.118667,3753.158067,1,112593560,112594742,1182,0.412320738319255
41255,3753.166433,3753.175233,1,112594992,112595256,264,0.36082878682526054
41256,3753.1812,3753.1855,1,112595436,112595565,129,0.34006803596638896
41257,3753.2014,3753.213633,1,112596042,112596408,366,-0.07840448166143849
41258,3753.254367,3753.262,1,112597631,112597860,229,0.2229047025972407
41259,3753.268267,3753.279367,1,112598048,112598381,333,0.08320326868673747
41260,3753.282833,3753.308933,1,112598484,112599267,783,0.06669635640658494
41261,3753.309967,3753.3858,1,112599299,112601574,2275,0.42935844960893466
41262,3753.388767,3753.4173,1,112601663,112602519,856,0.04354590606948355
41263,3753.426333,3753.436633,1,112602789,112603098,309,0.08862054593128336
41264,3753.438633,3753.4451,1,112603158,112603353,195,0.10796641325235654
41265,3753.447167,3753.471433,1,112603415,112604142,727,0.11074785957981086
41266,3753.4831,3753.497067,1,112604493,112604912,419,-0.0053975228590242555
41267,3753.511967,3753.578667,1,112605359,112607360,2001,0.1943975190069604
41268,3753.582667,3753.603367,1,112607480,112608101,621,0.30229429683238723
41269,3753.6048,3753.608867,1,112608144,112608266,122,0.7325171244161768
41270,3753.611667,3753.631567,1,112608350,112608947,597,0.13450224154135187
41271,3753.6331,3753.6418,1,112608993,112609254,261,0.5115221906876731
41272,3753.644,3753.648633,1,112609320,112609458,138,-0.14147728251152206
41273,3753.6531,3753.662733,1,112609593,112609881,288,0.4068886921380463
41274,3753.670533,3753.6978,1,112610115,112610934,819,0.037653282358982645
41275,3753.7349,3753.7414,1,112612047,112612242,195,0.006103197182271909
41276,3753.745,3753.758,1,112612350,112612740,390,0.23522006035548113
41277,3753.768,3753.7734,1,112613040,112613202,162,0.09497803519579655
41278,3753.8006,3753.8071,1,112614018,112614213,195,0.18461062823558289
41279,3753.813967,3753.818633,1,112614419,112614558,139,0.10235416988728044
41280,3753.830633,3753.834767,1,112614918,112615043,125,-0.04410824757415773
41281,3753.868433,3753.871567,1,112616052,112616147,95,0.2662296837252011
41282,3753.998667,3754.003167,1,112619960,112620095,135,
41283,3754.0046,3754.0078,1,112620138,112620234,96,
41284,3754.0394,3754.0483,1,112621182,112621449,267,-0.11803646597056679
41285,3754.049767,3754.0606,1,112621493,112621818,325,0.42937473849459096
41286,3754.101233,3754.1097,1,112623036,112623291,255,0.5953030586482686
41287,3754.1181,3754.1249,1,112623543,112623747,204,0.08856011830276618
41288,3754.128667,3754.140667,1,112623860,112624220,360,0.45186442447509345
41289,3754.153067,3754.170633,1,112624592,112625118,526,0.2593281063891853
41290,3754.1915,3754.196567,1,112625745,112625897,152,0.15370854880874113
41291,3755.221767,3755.2318,1,112656653,112656954,301,0.017325311787979625
41292,3755.244133,3755.311667,1,112657323,112659350,2027,0.07574322416305698
41293,3755.3139,3755.3192,1,112659417,112659576,159,0.2154426050522577
41294,3755.3209,3755.325433,1,112659627,112659762,135,-0.17161179657166312
41295,3755.346733,3755.353233,1,112660401,112660596,195,0.08036102445710495
41296,3755.354633,3755.3606,1,112660638,112660818,180,0.11026845279175075
41297,3755.3619,3755.378,1,112660857,112661340,483,0.06797319112764395
41298,3755.388767,3755.3932,1,112661663,112661796,133,-0.07630599697235094
41299,3755.401767,3755.474367,1,112662053,112664231,2178,0.08450169764909549
41300,3756.383833,3756.390133,1,112691514,112691703,189,0.299630687347957
41301,3756.4002,3756.4159,1,112692006,112692477,471,-0.008248162605848541
41302,3756.422567,3756.4337,1,112692677,112693011,334,0.2811753978476936
41303,3756.485467,3756.496833,1,112694564,112694904,340,0.02554709280019124
41304,3756.522533,3756.533167,1,112695675,112695995,320,0.04537778924668388
41305,3756.5386,3756.5656,1,112696158,112696968,810,0.03477060604488764
41306,3756.7013,3756.706133,1,112701039,112701183,144,-0.02567848531612989
41307,3756.7404,3756.7569,1,112702212,112702707,495,0.49897926647918955
41308,3756.7806,3756.836933,1,112703418,112705107,1689,0.05511668671939541
41309,3756.837933,3756.861467,1,112705137,112705844,707,-0.07044270776539888
41310,3756.8639,3756.869667,1,112705917,112706090,173,0.04530541313322869
41311,3756.876867,3756.897267,1,112706306,112706918,612,0.04574641143233579
41312,3756.898767,3756.907033,1,112706963,112707210,247,-0.1047837139607878
41313,3756.909867,3756.930933,1,112707296,112707927,631,0.060436688170109804
41314,3756.943933,3756.9509,1,112708317,112708527,210,0.2023039021510559
41315,3756.9538,3757.0427,1,112708614,112711281,2667,0.2650021604522783
41316,3757.0565,3757.0699,1,112711695,112712097,402,0.20644214008054085
41317,3757.092333,3757.101833,1,112712769,112713054,285,0.032770342256185095
41318,3757.117533,3757.131167,1,112713525,112713935,410,-0.013269440318020947
41319,3757.154933,3757.162233,1,112714647,112714866,219,0.06233475437802831
41320,3757.205367,3757.211167,1,112716161,112716335,174,0.029086996654683856
41321,3757.213033,3757.224833,1,112716390,112716744,354,0.22310509433598916
41322,3757.236667,3757.263467,1,112717100,112717904,804,0.1996171698368434
41323,3757.869233,3757.879933,1,112736076,112736397,321,0.21104821098109788
41324,3757.883133,3757.8969,1,112736493,112736907,414,-0.001899557849808497
41325,3757.909367,3757.924633,1,112737281,112737738,457,0.10371213954124488
41326,3757.956267,3757.963667,1,112738688,112738910,222,0.5358297516237085
41327,3757.965133,3757.971367,1,112738953,112739141,188,0.1194392996856895
41328,3757.982,3758.000867,1,112739460,112740026,566,0.12866024017918246
41329,3758.003867,3758.0492,1,112740116,112741476,1360,0.5331756651833801
41330,3758.094267,3758.115933,1,112742828,112743477,649,0.12615048926963343
41331,3758.120967,3758.124167,1,112743629,112743725,96,
41332,3758.1474,3758.1575,1,112744422,112744725,303,0.24868193691706927
41333,3758.158767,3758.1842,1,112744763,112745526,763,0.046862918112809224
41334,3758.2121,3758.240633,1,112746363,112747218,855,0.0903745609456394
41335,3758.2479,3758.253133,1,112747437,112747593,156,-0.025759426184920962
41336,3758.261433,3758.367033,1,112747842,112751010,3168,0.14970772819304395
41337,3758.369267,3758.393067,1,112751078,112751792,714,-0.004740056171175411
41338,3758.399,3758.4319,1,112751970,112752957,987,-0.022709784306757543
41339,3758.435767,3758.454233,1,112753073,112753626,553,0.10254943159778918
41340,3758.4622,3758.5393,1,112753866,112756179,2313,0.2004599649664871
41341,3758.570633,3758.5782,1,112757118,112757346,228,0.22638887851450945
41342,3759.1823,3759.197933,1,112775469,112775937,468,0.45971482138278774
41343,3759.202067,3759.2111,1,112776062,112776333,271,0.3621376126144467
41344,3759.213733,3759.228333,1,112776411,112776849,438,0.049488444913680915
41345,3759.229933,3759.243433,1,112776897,112777302,405,0.279942028385689
41346,3759.264867,3759.2802,1,112777946,112778406,460,0.2610932242410003
41347,3759.3239,3759.328933,1,112779717,112779867,150,0.23526467061275586
41348,3759.346067,3759.3635,1,112780382,112780905,523,0.1974613767715696
41349,3759.373,3759.383367,1,112781190,112781501,311,0.42749876813098736
41350,3759.3936,3759.401733,1,112781808,112782051,243,-0.07023052176511281
41351,3759.411933,3759.435567,1,112782357,112783067,710,-0.034036831490782085
41352,3759.498333,3759.526633,1,112784949,112785798,849,0.190985442254456
41353,3759.537733,3759.636733,1,112786131,112789101,2970,0.3507615011971198
41354,3759.648733,3759.659967,1,112789461,112789799,338,0.3114865257305462
41355,3759.660967,3759.666133,1,112789829,112789983,154,0.2819749228121594
41356,3759.6678,3759.694567,1,112790034,112790837,803,0.006840894391042326
41357,3759.7324,3759.777767,1,112791972,112793333,1361,0.10459293686323093
41358,3759.790433,3759.805967,1,112793712,112794179,467,0.04208227231517533
41359,3759.8111,3759.881367,1,112794333,112796441,2108,0.17219630482205542
41360,3759.882367,3759.892767,1,112796471,112796783,312,0.24239007230677476
41361,3760.114167,3760.118767,1,112803425,112803563,138,-0.17408500463341228
41362,3760.4288,3760.433767,1,112812864,112813013,149,
41363,3760.434767,3760.440633,1,112813043,112813218,175,-0.08182467874951686
41364,3760.4578,3760.465033,1,112813734,112813950,216,0.5496702780284924
41365,3760.5338,3760.5377,1,112816014,112816131,117,
41366,3760.552733,3760.570067,1,112816581,112817102,521,0.3096908394195238
41367,3760.574833,3760.579333,1,112817244,112817379,135,-0.006776869905379012
41368,3760.583033,3760.6178,1,112817490,112818534,1044,0.33708739670239884
41369,3760.6261,3760.633,1,112818783,112818990,207,0.17796525402842936
41370,3760.658067,3760.6679,1,112819742,112820037,295,0.4038021800427097
41371,3760.678933,3760.682,1,112820367,112820460,93,
41372,3760.6839,3760.691467,1,112820517,112820744,227,0.2835786060929992
41373,3760.6955,3760.706033,1,112820865,112821180,315,0.1487133531519279
41374,3760.712267,3760.725133,1,112821368,112821753,385,0.20124547551256472
41375,3760.7429,3760.760633,1,112822287,112822818,531,-0.014958786635020793
41376,3760.8415,3760.8485,1,112825245,112825455,210,0.0597952543374141
41377,3760.855633,3760.860667,1,112825668,112825820,152,0.2575281613840636
41378,3760.862,3760.8667,1,112825860,112826001,141,-0.26378940872589707
41379,3760.870033,3760.874767,1,112826100,112826243,143,0.5867906334339146
41380,3760.876633,3760.879767,1,112826298,112826393,95,
41381,3760.880867,3760.924333,1,112826426,112827729,1303,0.06575175099347497
41382,3760.927933,3760.9352,1,112827837,112828056,219,0.5106753060162567
41383,3760.9491,3760.953,1,112828473,112828590,117,0.45462860976695557
41384,3760.956867,3760.9784,1,112828706,112829352,646,0.11096293890563953
41385,3760.981,3760.994167,1,112829430,112829825,395,0.0993772674803825
41386,3760.996733,3761.038733,1,112829901,112831161,1260,-0.03599926541077973
41387,3761.040633,3761.049733,1,112831218,112831491,273,0.31663166572771906
41388,3761.230867,3761.237533,1,112836926,112837125,199,0.3909564372719866
41389,3761.2391,3761.242467,1,112837173,112837274,101,-0.19189690147303318
41390,3762.0487,3762.052367,1,112861461,112861571,110,0.5480932631603811
41391,3762.0579,3762.071933,1,112861737,112862157,420,0.3035050003237681
41392,3762.074433,3762.142167,1,112862232,112864265,2033,0.15144922828377402
41393,3762.152467,3762.177667,1,112864574,112865330,756,-0.08610886317105118
41394,3762.181,3762.192,1,112865430,112865760,330,0.05419173415418127
41395,3762.1931,3762.2302,1,112865793,112866906,1113,0.01357364472411658
41396,3762.2392,3762.2869,1,112867176,112868607,1431,0.10594759236010078
41397,3762.2955,3762.387633,1,112868865,112871628,2763,0.4811894626200563
41398,3762.433633,3762.439233,1,112873008,112873176,168,-0.12147721644344323
41399,3762.908133,3762.911867,1,112887243,112887356,113,-0.1682604477757332
41400,3763.035867,3763.062767,1,112891076,112891883,807,0.22151875993427447
41401,3763.0658,3763.115033,1,112891974,112893450,1476,0.1228401245535248
41402,3763.118767,3763.130733,1,112893563,112893921,358,-0.028621333376560927
41403,3763.134567,3763.1447,1,112894037,112894341,304,0.15403748349331353
41404,3763.1594,3763.219,1,112894782,112896570,1788,0.020815150857109572
41405,3763.220667,3763.2503,1,112896620,112897509,889,-0.029971278403180857
41406,3763.257367,3763.356,1,112897721,112900680,2959,0.4736495834683875
41407,3764.544467,3764.619167,1,112936334,112938575,2241,0.17876774150864386
41408,3764.620433,3764.654067,1,112938612,112939622,1010,0.05213587623114265
41409,3764.6714,3764.6887,1,112940142,112940661,519,0.02119554419762437
41410,3764.6935,3764.787567,1,112940805,112943627,2822,0.24620799115653175
41411,3765.035433,3765.056333,1,112951062,112951689,627,0.11532664877337565
41412,3765.0653,3765.078767,1,112951959,112952363,404,0.16963298076687644
41413,3765.088033,3765.0925,1,112952640,112952775,135,-0.23814285456842632
41414,3765.0976,3765.116767,1,112952928,112953503,575,0.2887414314814411
41415,3765.182367,3765.211633,1,112955471,112956348,877,0.38867270268778764
41416,3765.2867,3765.317033,1,112958601,112959510,909,0.0287731727712025
41417,3765.318533,3765.331767,1,112959555,112959953,398,0.08887071207838826
41418,3765.369633,3765.402467,1,112961088,112962074,986,0.011198677170986496
41419,3765.408067,3765.443767,1,112962242,112963313,1071,0.45762356195379905
41420,3765.454867,3765.459867,1,112963646,112963796,150,0.12579414252526086
41421,3765.520667,3765.524567,1,112965620,112965737,117,0.32523315088845584
41422,3765.5297,3765.535033,1,112965891,112966050,159,0.2925738172703568
41423,3765.536067,3765.547167,1,112966082,112966415,333,0.23298429276338883
41424,3765.557667,3765.563467,1,112966730,112966904,174,0.40680906784270465
41425,3765.608067,3765.6164,1,112968242,112968492,250,0.29376169724435885
41426,3765.618767,3765.626333,1,112968563,112968789,226,0.44587257200371666
41427,3765.649233,3765.6563,1,112969476,112969689,213,0.5085142116174828
41428,3765.660867,3765.763267,1,112969826,112972898,3072,0.12564806484007915
41429,3765.7854,3765.837,1,112973562,112975110,1548,0.07459797149918046
41430,3765.860967,3765.875933,1,112975829,112976277,448,0.2429037239433211
41431,3765.8848,3765.949167,1,112976544,112978475,1931,0.19483133179592865
41432,3766.742933,3766.7527,1,113002287,113002581,294,0.15233906359119948
41433,3766.753933,3766.772167,1,113002617,113003165,548,0.2861052504858132
41434,3766.7825,3766.793167,1,113003475,113003795,320,0.24072895636751293
41435,3766.797933,3766.801233,1,113003937,113004036,99,0.16645080197010373
41436,3766.842167,3766.867567,1,113005265,113006027,762,0.4093882921606147
41437,3766.874133,3766.880267,1,113006223,113006408,185,0.268845788729699
41438,3766.885033,3766.889533,1,113006550,113006685,135,-0.12320627156626622
41439,3766.930067,3766.937133,1,113007902,113008113,211,-0.12941116851909013
41440,3766.9472,3766.9509,1,113008416,113008527,111,0.12099608878282604
41441,3766.952367,3766.9691,1,113008571,113009073,502,0.2831674796119831
41442,3766.9744,3766.9791,1,113009232,113009373,141,0.4631286805395157
41443,3766.984533,3767.0073,1,113009535,113010219,684,-0.010011598719544077
41444,3767.028433,3767.094267,1,113010852,113012828,1976,0.4729561058834298
41445,3767.158033,3767.167467,1,113014740,113015024,284,0.1481539294816317
41446,3767.1697,3767.1903,1,113015091,113015709,618,0.16455542995843495
41447,3767.1973,3767.204233,1,113015919,113016126,207,-0.0973192333179691
41448,3767.214567,3767.221333,1,113016437,113016639,202,-0.029743814517878896
41449,3767.288633,3767.317333,1,113018658,113019519,861,0.5816973537914539
41450,3767.3271,3767.331133,1,113019813,113019933,120,0.12754581411228316
41451,3767.347267,3767.350267,1,113020418,113020508,90,
41452,3767.3575,3767.381,1,113020725,113021430,705,0.04711430978189829
41453,3767.382533,3767.429433,1,113021475,113022882,1407,0.40670341621941186
41454,3767.467267,3767.473433,1,113024018,113024202,184,0.056357717071718105
41455,3767.511033,3767.519133,1,113025330,113025573,243,0.2837472980717549
41456,3767.525633,3767.555867,1,113025768,113026676,908,0.19875272122949336
41457,3767.564033,3767.568233,1,113026920,113027046,126,-0.07024232368299221
41458,3767.579,3767.588733,1,113027370,113027661,291,0.14730662451260693
41459,3767.5907,3767.657367,1,113027721,113029721,2000,0.16545481491524472
41460,3767.665267,3767.670767,1,113029958,113030123,165,0.22623757923360488
41461,3767.705133,3767.725533,1,113031153,113031765,612,0.08692825370660774
41462,3767.751767,3767.756733,1,113032553,113032701,148,
41463,3767.758267,3767.773367,1,113032748,113033201,453,0.10290681361756404
41464,3767.812933,3767.8234,1,113034387,113034702,315,-0.14287270527202048
41465,3767.8755,3767.887567,1,113036265,113036627,362,0.3233822067612182
41466,3767.9015,3767.9069,1,113037045,113037207,162,-0.48416097595151286
41467,3768.924033,3768.944367,1,113067720,113068331,611,0.10532831796918078
41468,3768.995567,3769.005833,1,113069867,113070174,307,0.1248484120540409
41469,3769.015267,3769.022733,1,113070458,113070681,223,0.17434934871616392
41470,3769.0268,3769.045467,1,113070804,113071364,560,0.09163670013012115
41471,3769.068267,3769.090833,1,113072048,113072724,676,0.20475905270762407
41472,3769.1551,3769.162367,1,113074653,113074871,218,0.07920223936097372
41473,3769.1887,3769.200433,1,113075661,113076012,351,0.3135498017113207
41474,3769.2024,3769.215833,1,113076072,113076474,402,0.2924545611665876
41475,3769.2283,3769.297867,1,113076849,113078936,2087,0.19235033209196914
41476,3769.301733,3769.326967,1,113079051,113079809,758,-0.05949102066116051
41477,3769.3378,3769.3823,1,113080134,113081469,1335,0.011419301581026955
41478,3769.387167,3769.393433,1,113081615,113081802,187,-0.0497738868902942
41479,3769.399467,3769.404167,1,113081984,113082125,141,0.0017734040350074196
41480,3769.405233,3769.433,1,113082156,113082990,834,0.030138501718715984
41481,3769.4416,3769.4642,1,113083248,113083926,678,0.12548728509272367
41482,3769.468033,3769.5561,1,113084040,113086683,2643,0.12034081435401511
41483,3770.341733,3770.348633,1,113110251,113110458,207,0.593202214770609
41484,3770.3829,3770.3862,1,113111487,113111586,99,-0.1466586779646646
41485,3770.3879,3770.393067,1,113111637,113111792,155,
41486,3770.394133,3770.399433,1,113111823,113111982,159,0.07046919891267607
41487,3770.403433,3770.410267,1,113112102,113112308,206,0.11073107798935213
41488,3770.424933,3770.5291,1,113112747,113115873,3126,0.48194435969195215
41489,3770.537567,3770.579133,1,113116127,113117373,1246,0.10095751560448245
41490,3770.5848,3770.615367,1,113117544,113118461,917,-0.014101346896444836
41491,3770.622367,3770.642533,1,113118671,113119275,604,0.13665568645611273
41492,3770.651133,3770.677033,1,113119533,113120310,777,0.07872570512977992
41493,3770.681133,3770.702867,1,113120433,113121086,653,0.19152646609682986
41494,3770.7051,3770.761467,1,113121153,113122844,1691,0.251835738266606
41495,3770.7639,3770.809633,1,113122917,113124288,1371,0.23330736663299306
41496,3770.832167,3770.839333,1,113124965,113125179,214,-0.1069509056099084
41497,3771.057133,3771.0703,1,113131713,113132109,396,0.08728425123090879
41498,3771.0913,3771.096733,1,113132739,113132901,162,0.16419138344477588
41499,3771.1289,3771.1384,1,113133867,113134152,285,0.5407692109824758
41500,3771.220367,3771.227567,1,113136611,113136827,216,0.0849682810267751
41501,3771.229367,3771.234767,1,113136881,113137043,162,-0.2228675975468448
41502,3771.242033,3771.2478,1,113137260,113137434,174,0.2379011712135948
41503,3771.2489,3771.268267,1,113137467,113138048,581,0.4067415475348618
41504,3771.269633,3771.282633,1,113138088,113138478,390,0.3979643988326184
41505,3771.2838,3771.2879,1,113138514,113138637,123,-0.25839469852352914
41506,3771.2977,3771.3061,1,113138931,113139183,252,0.04232143229399138
41507,3771.3207,3771.326367,1,113139621,113139791,170,0.6266933080892684
41508,3771.329567,3771.337767,1,113139887,113140133,246,0.3498904768033402
41509,3771.3428,3771.355767,1,113140284,113140673,389,0.14646097178175121
41510,3771.369567,3771.375367,1,113141087,113141261,174,0.4331353441886945
41511,3771.389567,3771.4128,1,113141687,113142384,697,-0.01693585409709418
41512,3771.4207,3771.426667,1,113142621,113142800,179,0.17189859647358532
41513,3771.4307,3771.438833,1,113142921,113143164,243,0.07326697840360617
41514,3771.469067,3771.4724,1,113144072,113144172,100,-0.009209401012502718
41515,3771.483233,3771.486633,1,113144496,113144598,102,
41516,3771.488533,3771.5009,1,113144655,113145027,372,0.04115643785132382
41517,3771.506133,3771.509567,1,113145183,113145287,104,0.6121903901334682
41518,3771.6033,3771.608667,1,113148099,113148260,161,0.3811148874340292
41519,3771.793567,3771.806833,1,113153807,113154204,397,0.26053665285556304
41520,3771.843833,3771.846867,1,113155314,113155406,92,0.6680680291070377
41521,3771.859767,3771.87,1,113155793,113156100,307,0.448319110034842
41522,3772.0954,3772.173567,1,113162862,113165207,2345,0.1432347994251776
41523,3772.1839,3772.1984,1,113165517,113165952,435,-0.021329419439996083
41524,3772.2087,3772.231933,1,113166261,113166957,696,0.0006309598338788493
41525,3772.238633,3772.2463,1,113167158,113167389,231,0.011763581276972771
41526,3772.268,3772.3319,1,113168040,113169957,1917,0.2054779531769978
41527,3772.346967,3772.358333,1,113170409,113170749,340,0.48788448153236386
41528,3772.365467,3772.392067,1,113170964,113171762,798,0.11749438852238522
41529,3772.394967,3772.406833,1,113171849,113172204,355,0.5155064495304965
41530,3772.408667,3772.4173,1,113172260,113172519,259,0.4631613222191754
41531,3772.46,3772.464667,1,113173800,113173940,140,0.25729219486292254
41532,3772.846533,3772.8512,1,113185395,113185536,141,0.5037188976890967
41533,3772.905667,3772.914967,1,113187170,113187449,279,0.4863753911020812
41534,3772.923233,3772.936567,1,113187696,113188097,401,0.1858683466562095
41535,3772.941467,3772.953733,1,113188244,113188611,367,0.15167896875652787
41536,3772.956733,3773.0114,1,113188701,113190342,1641,0.23710490593340036
41537,3773.012733,3773.025067,1,113190381,113190752,371,-0.02141872771366648
41538,3773.026367,3773.042067,1,113190791,113191262,471,0.01715857214513864
41539,3773.052433,3773.072867,1,113191572,113192186,614,0.09138357808276608
41540,3773.086433,3773.155067,1,113192592,113194652,2060,0.17603151089517877
41541,3773.1858,3773.201033,1,113195574,113196030,456,0.2996539294140231
41542,3773.262367,3773.271233,1,113197871,113198136,265,0.3495912228322631
41543,3773.273467,3773.2792,1,113198204,113198376,172,-0.09436593888427092
41544,3773.294767,3773.305367,1,113198843,113199161,318,-0.24666882476612048
41545,3773.341333,3773.344833,1,113200239,113200344,105,-0.19282010849191802
41546,3773.418667,3773.422033,1,113202560,113202660,100,
41547,3773.423933,3773.439467,1,113202717,113203184,467,0.5622243463966423
41548,3773.465433,3773.4709,1,113203962,113204127,165,-0.024947638814581483
41549,3773.553967,3773.605333,1,113206619,113208159,1540,0.14268226391211764
41550,3773.6069,3773.638667,1,113208207,113209160,953,0.20766017970282957
41551,3773.6669,3773.674967,1,113210007,113210249,242,0.01714254135377907
41552,3773.8112,3773.8203,1,113214336,113214609,273,0.22681543704643392
41553,3773.858867,3773.869367,1,113215766,113216081,315,0.1648255948405621
41554,3773.888667,3773.9126,1,113216660,113217378,718,0.020769982937879156
41555,3773.9359,3773.945733,1,113218077,113218371,294,0.3332532012360745
41556,3773.946833,3773.951567,1,113218404,113218547,143,0.26223766744993515
41557,3773.952633,3773.968567,1,113218578,113219057,479,0.18152310404130698
41558,3773.972733,3774.051233,1,113219181,113221536,2355,0.10917755140565168
41559,3774.0559,3774.070067,1,113221677,113222102,425,-0.054647265740097
41560,3774.0799,3774.1237,1,113222397,113223711,1314,0.027419509253020436
41561,3774.126033,3774.137933,1,113223780,113224137,357,-0.033808077584926446
41562,3774.141367,3774.1509,1,113224241,113224527,286,0.17078261280004742
41563,3774.1521,3774.1554,1,113224563,113224662,99,
41564,3774.161733,3774.179033,1,113224851,113225370,519,-0.0936004815275212
41565,3774.1841,3774.2088,1,113225523,113226264,741,0.16951468035073655
41566,3774.215967,3774.2295,1,113226479,113226885,406,0.20858075943611165
41567,3774.2306,3774.322333,1,113226918,113229669,2751,0.2519550924921353
41568,3774.338133,3774.3417,1,113230143,113230251,108,-0.03985314636088187
41569,3774.8418,3774.846367,1,113245254,113245391,137,0.05166344295203917
41570,3774.848767,3774.877767,1,113245463,113246333,870,0.07689858143337948
41571,3774.884867,3774.899067,1,113246546,113246972,426,0.25362223295300906
41572,3774.908933,3774.920233,1,113247267,113247606,339,0.35306622737991206
41573,3774.922933,3774.931633,1,113247687,113247948,261,0.472462658286728
41574,3774.9367,3774.939733,1,113248101,113248191,90,-0.12261354321116497
41575,3774.945067,3774.9532,1,113248352,113248596,244,0.3336228226227802
41576,3775.199133,3775.2044,1,113255973,113256132,159,-0.10375506937983073
41577,3775.265167,3775.273533,1,113257955,113258205,250,0.43809610234568264
41578,3775.3357,3775.343767,1,113260071,113260313,242,0.3003366057713984
41579,3775.349867,3775.359467,1,113260496,113260784,288,0.4295703083021537
41580,3775.373767,3775.381367,1,113261213,113261441,228,0.33495127983351397
41581,3775.3902,3775.395,1,113261706,113261850,144,0.7111708026171866
41582,3775.398267,3775.409033,1,113261948,113262270,322,0.11812000481785687
41583,3775.427067,3775.455433,1,113262812,113263662,850,0.15618322283502067
41584,3775.4842,3775.4941,1,113264526,113264823,297,0.44605656489146206
41585,3775.5024,3775.5205,1,113265072,113265615,543,0.03311850147150075
41586,3775.5223,3775.527,1,113265669,113265810,141,-0.10539045540895485
41587,3775.535167,3775.5406,1,113266055,113266218,163,
41588,3776.457033,3776.4725,1,113293710,113294175,465,0.18923174035116938
41589,3776.477867,3776.4858,1,113294336,113294574,238,0.6649621114224503
41590,3776.487,3776.491133,1,113294610,113294733,123,0.23983275965221165
41591,3776.532333,3776.628833,1,113295969,113298864,2895,0.3969593974940462
41592,3776.630067,3776.634233,1,113298902,113299026,124,-0.08807392676029784
41593,3776.6374,3776.647433,1,113299122,113299422,300,0.09786422509010027
41594,3776.648833,3776.722667,1,113299464,113301680,2216,-0.025789995384753673
41595,3776.731233,3776.7444,1,113301936,113302332,396,0.00897593545416553
41596,3776.750067,3776.7717,1,113302502,113303151,649,0.13282497668054755
41597,3776.7774,3776.7814,1,113303322,113303442,120,0.8060347365671818
41598,3776.7859,3776.8736,1,113303577,113306208,2631,0.35148682425918926
41599,3779.1448,3779.1489,1,113374344,113374467,123,0.5906696275316105
41600,3779.182767,3779.191667,1,113375483,113375750,267,0.19292853086207576
41601,3779.304133,3779.3405,1,113379123,113380215,1092,0.3471352660176421
41602,3779.3448,3779.3478,1,113380344,113380434,90,0.7269151766590033
41603,3779.352,3779.355467,1,113380560,113380664,104,0.2229900094599303
41604,3779.435233,3779.453067,1,113383056,113383592,536,0.11762828536179307
41605,3779.478833,3779.497367,1,113384364,113384921,557,0.244280703268167
41606,3779.499367,3779.511933,1,113384981,113385357,376,0.2556738944036059
41607,3779.570733,3779.584033,1,113387121,113387520,399,0.25774442077877147
41608,3779.606667,3779.6777,1,113388200,113390331,2131,0.17089290954243624
41609,3779.6789,3779.688867,1,113390367,113390666,299,0.32139052482080854
41610,3779.689867,3779.760667,1,113390696,113392820,2124,0.5785556843156149
41611,3779.7644,3779.847933,1,113392932,113395437,2505,0.2358785287011172
41612,3779.8492,3779.873667,1,113395476,113396210,734,0.23985151897208123
41613,3779.878233,3779.882267,1,113396346,113396468,122,0.6881641191241339
41614,3779.890767,3779.9105,1,113396723,113397315,592,0.0959578705088169
41615,3779.9166,3779.928633,1,113397498,113397858,360,0.012479365615719586
41616,3779.934367,3779.943,1,113398031,113398290,259,-0.2718499033579955
41617,3780.6654,3780.693567,1,113419962,113420807,845,0.35127767545588956
41618,3780.696867,3780.771067,1,113420906,113423132,2226,0.39338326953082176
41619,3780.7805,3780.803733,1,113423415,113424111,696,0.10617278537010923
41620,3780.810567,3780.868233,1,113424317,113426046,1729,0.07483939762663508
41621,3780.874867,3780.884567,1,113426246,113426537,291,0.09130405841605758
41622,3780.885567,3780.920633,1,113426567,113427618,1051,-0.020724754952651057
41623,3780.922467,3780.930733,1,113427674,113427921,247,-0.031179836589935905
41624,3780.9462,3780.9611,1,113428386,113428833,447,-0.028023406772515132
41625,3780.9665,3780.988733,1,113428995,113429661,666,0.18252077014371654
41626,3780.994067,3781.078467,1,113429822,113432354,2532,0.28868175950140706
41627,3782.2268,3782.230833,1,113466804,113466924,120,-0.3123953977816591
41628,3782.2356,3782.2432,1,113467068,113467296,228,0.4095163711182253
41629,3782.250667,3782.254167,1,113467520,113467625,105,0.501764376235405
41630,3782.279,3782.282867,1,113468370,113468486,116,-0.03535587670680724
41631,3782.2967,3782.310467,1,113468901,113469314,413,0.20021416285442337
41632,3782.350233,3782.3566,1,113470506,113470698,192,0.1603363418940667
41633,3783.062333,3783.157333,1,113491869,113494719,2850,0.17117199265521846
41634,3783.168133,3783.180533,1,113495043,113495415,372,0.08687882866059125
41635,3783.181633,3783.1861,1,113495448,113495583,135,-0.10866814875605044
41636,3783.1972,3783.259433,1,113495916,113497782,1866,0.09931435267528829
41637,3783.260467,3783.283633,1,113497814,113498508,694,0.1668570713991748
41638,3783.285933,3783.295267,1,113498577,113498858,281,-0.025936307584834582
41639,3783.296433,3783.373233,1,113498892,113501196,2304,0.44525541823397635
41640,3783.3937,3783.400767,1,113501811,113502023,212,-0.025105661246789934
41641,3784.268333,3784.2917,1,113528049,113528751,702,0.06013983878814997
41642,3784.307533,3784.317833,1,113529225,113529534,309,0.16750546136943995
41643,3784.349633,3784.395267,1,113530488,113531858,1370,0.26193036424058663
41644,3784.502167,3784.530767,1,113535065,113535923,858,0.39093764557715144
41645,3784.5318,3784.5403,1,113535954,113536209,255,-0.0067687071857198975
41646,3784.549667,3784.622933,1,113536490,113538687,2197,0.13482550172711677
41647,3784.6271,3784.641067,1,113538813,113539232,419,-0.10076094017076752
41648,3784.648767,3784.6602,1,113539463,113539806,343,0.0012306976168574508
41649,3784.661233,3784.7099,1,113539836,113541297,1461,0.15170944112248894
41650,3784.7127,3784.730033,1,113541381,113541900,519,0.10937797715492066
41651,3784.732,3784.7353,1,113541960,113542059,99,0.19625977207721412
41652,3784.739267,3784.8112,1,113542178,113544336,2158,0.262668500554736
41653,3784.815733,3784.8251,1,113544471,113544753,282,0.36234293507655857
41654,3784.8292,3784.841033,1,113544876,113545230,354,0.19289701126338307
41655,3785.1786,3785.1829,1,113555358,113555487,129,0.5591878466351734
41656,3785.213667,3785.2243,1,113556410,113556729,319,-0.059985129278514286
41657,3785.271933,3785.276533,1,113558157,113558295,138,0.6481964068521906
41658,3785.286,3785.2938,1,113558580,113558814,234,-0.11142399900048174
41659,3785.298333,3785.304933,1,113558949,113559147,198,0.3774501159455974
41660,3785.3447,3785.3477,1,113560341,113560431,90,
41661,3785.376067,3785.381433,1,113561282,113561442,160,0.3258177600332535
41662,3786.0567,3786.075467,1,113581701,113582264,563,0.3808040022230506
41663,3786.104133,3786.118033,1,113583123,113583540,417,0.09381751690293762
41664,3786.121633,3786.1362,1,113583648,113584086,438,-0.023538000685384714
41665,3786.2793,3786.2986,1,113588379,113588958,579,0.06365795008311916
41666,3786.3029,3786.3959,1,113589087,113591877,2790,0.17127244714709874
41667,3786.408967,3786.419067,1,113592269,113592572,303,0.12041142725070343
41668,3786.4223,3786.451967,1,113592669,113593559,890,0.06272157895955896
41669,3786.459933,3786.4857,1,113593797,113594571,774,0.05728492038005362
41670,3786.489533,3786.593133,1,113594685,113597793,3108,0.20188786277302956
41671,3786.641833,3786.6498,1,113599254,113599494,240,0.16873859299634184
41672,3786.651333,3786.657567,1,113599539,113599727,188,0.30000054534701714
41673,3786.659567,3786.696667,1,113599787,113600900,1113,0.07921640741729967
41674,3787.7397,3787.742933,1,113632191,113632287,96,0.16940770871573782
41675,3787.7896,3787.904,1,113633688,113637120,3432,0.6087869012564349
41676,3787.9082,3787.912533,1,113637246,113637375,129,0.1772439118391609
41677,3787.921933,3787.925333,1,113637657,113637759,102,-0.09468716766616492
41678,3787.937067,3788.001433,1,113638112,113640042,1930,0.6544580306117316
41679,3788.015367,3788.0832,1,113640461,113642496,2035,0.6561740509538646
41680,3788.124667,3788.1424,1,113643740,113644272,532,0.02853106139902469
41681,3788.146833,3788.1547,1,113644404,113644641,237,0.2825769316626975
41682,3788.189667,3788.1933,1,113645690,113645799,109,0.30041223661592614
41683,3788.195167,3788.198433,1,113645855,113645952,97,-0.1003260698799013
41684,3788.2405,3788.253333,1,113647215,113647599,384,0.10583868742385645
41685,3789.402833,3789.4283,1,113682084,113682849,765,0.10341138762738324
41686,3789.4445,3789.449667,1,113683335,113683490,155,0.2950345966854661
41687,3789.460767,3789.467333,1,113683823,113684019,196,0.08987851811749023
41688,3789.531033,3789.5703,1,113685930,113687109,1179,0.1748291063446428
41689,3789.652933,3789.6618,1,113689587,113689854,267,0.1644382612168386
41690,3789.691233,3789.729533,1,113690736,113691885,1149,0.1958417330271161
41691,3789.738133,3789.746,1,113692143,113692380,237,0.2971757904992573
41692,3789.748967,3789.806033,1,113692469,113694180,1711,0.15000132270933916
41693,3789.8091,3789.816167,1,113694273,113694485,212,0.2703735559518247
41694,3789.818233,3789.8301,1,113694546,113694903,357,-0.08541566014207588
41695,3789.852,3789.861967,1,113695560,113695859,299,0.1682460418022617
41696,3789.868933,3789.886533,1,113696067,113696595,528,0.011000893201888313
41697,3789.894933,3789.9215,1,113696847,113697645,798,0.02944611805562654
41698,3789.9261,3789.944567,1,113697783,113698337,554,0.13758054357841953
41699,3789.9463,3789.949633,1,113698389,113698488,99,
41700,3789.952133,3790.039933,1,113698563,113701197,2634,0.3161109524163671
41701,3790.059933,3790.0672,1,113701797,113702016,219,-0.1613422081694264
41702,3790.0739,3790.092733,1,113702217,113702781,564,0.0687480489848875
41703,3790.094333,3790.1031,1,113702829,113703093,264,0.26043395466428804
41704,3790.1059,3790.116333,1,113703177,113703489,312,0.297433036483248
41705,3790.118233,3790.128033,1,113703546,113703840,294,0.16169234251819428
41706,3790.133633,3790.137167,1,113704008,113704115,107,
41707,3790.139367,3790.157333,1,113704181,113704719,538,0.07390357599001907
41708,3790.1633,3790.170367,1,113704899,113705111,212,-0.03727484540522386
41709,3790.172667,3790.184467,1,113705180,113705534,354,0.6198251440482857
41710,3790.196133,3790.213933,1,113705883,113706417,534,0.13696629880742497
41711,3790.216867,3790.2256,1,113706506,113706768,262,-0.027491586890563576
41712,3790.498933,3790.503867,1,113714967,113715116,149,0.10026402936030948
41713,3790.514133,3790.5286,1,113715423,113715858,435,0.2280393740847912
41714,3790.548667,3790.555067,1,113716460,113716652,192,-0.13857360732568877
41715,3790.556933,3790.562333,1,113716707,113716869,162,-0.2407870687368255
41716,3790.5871,3790.596767,1,113717613,113717903,290,0.16159659779929425
41717,3790.5988,3790.6086,1,113717964,113718258,294,0.11863424671192535
41718,3790.8048,3790.819067,1,113724144,113724572,428,0.30872319121793085
41719,3790.835233,3790.838833,1,113725056,113725164,108,
41720,3790.910133,3790.918333,1,113727303,113727549,246,-0.06491941411735742
41721,3790.949867,3790.964833,1,113728496,113728944,448,0.5408416025945458
41722,3790.971533,3790.979167,1,113729145,113729375,230,-0.21443182543840153
41723,3790.981633,3790.985133,1,113729448,113729553,105,0.4935859135552419
41724,3790.9867,3790.9897,1,113729601,113729691,90,
41725,3791.2277,3791.233733,1,113736831,113737011,180,0.33908594774459966
41726,3791.286867,3791.302233,1,113738606,113739066,460,0.0556416606753076
41727,3791.3034,3791.311767,1,113739102,113739353,251,0.05877391960839464
41728,3791.315,3791.412633,1,113739450,113742378,2928,0.05395510652816231
41729,3791.7191,3791.7224,1,113751573,113751672,99,
41730,3791.7234,3791.731733,1,113751702,113751951,249,0.24068535138972882
41731,3791.7342,3791.744367,1,113752026,113752331,305,-0.09350437806751813
41732,3791.755633,3791.7739,1,113752668,113753217,549,0.29740148171487624
41733,3791.860867,3791.865567,1,113755826,113755967,141,
41734,3791.870233,3791.878067,1,113756106,113756342,236,0.7954711896170411
41735,3791.879167,3791.896,1,113756375,113756880,505,0.29922942131095437
41736,3791.8973,3791.9021,1,113756919,113757063,144,0.6534849058653965
41737,3791.9253,3791.9418,1,113757759,113758254,495,0.15171468902958074
41738,3791.972833,3791.977033,1,113759184,113759310,126,-0.025285718689309167
41739,3792.010333,3792.038767,1,113760309,113761163,854,0.2000146814215153
41740,3792.0443,3792.0813,1,113761329,113762439,1110,0.15171005927239173
41741,3792.172633,3792.1778,1,113765178,113765334,156,0.125655476406402
41742,3792.207133,3792.210267,1,113766213,113766308,95,0.8440667178540678
41743,3792.2615,3792.264933,1,113767845,113767947,102,0.5170018902823424
41744,3792.290033,3792.304367,1,113768700,113769131,431,0.08770914637052302
41745,3792.309633,3792.326,1,113769288,113769780,492,0.10900986207051555
41746,3792.336667,3792.3409,1,113770100,113770227,127,-0.023821389953663855
41747,3792.3902,3792.422033,1,113771706,113772660,954,0.16025222968566527
41748,3792.426467,3792.4507,1,113772794,113773521,727,0.198010182322202
41749,3792.455433,3792.460467,1,113773662,113773814,152,0.39110658332380843
41750,3792.461867,3792.470533,1,113773856,113774115,259,-0.008892066864986366
41751,3792.533633,3792.5395,1,113776008,113776185,177,-0.21725385198484978
41752,3792.541833,3792.545833,1,113776254,113776374,120,0.1853577484178828
41753,3792.573133,3792.584033,1,113777193,113777520,327,0.38474746012094296
41754,3792.589167,3792.6035,1,113777675,113778105,430,0.31412653791091566
41755,3792.6058,3792.6231,1,113778174,113778693,519,-0.12804483253051388
41756,3792.627767,3792.655233,1,113778833,113779656,823,0.11959823028679845
41757,3792.6774,3792.6863,1,113780322,113780589,267,0.4096119990460808
41758,3792.6987,3792.7352,1,113780961,113782056,1095,0.1495078173707232
41759,3792.7454,3792.771267,1,113782362,113783138,776,0.09920220222984905
41760,3792.780733,3792.819,1,113783421,113784570,1149,0.12874283677292325
41761,3792.869567,3792.8917,1,113786087,113786751,664,0.04115513687172721
41762,3792.896767,3792.965833,1,113786903,113788974,2071,0.4015710059377931
41763,3792.9724,3792.9803,1,113789172,113789409,237,0.29780653193197276
41764,3792.9821,3793.0178,1,113789463,113790534,1071,0.044007713505619946
41765,3793.0189,3793.0301,1,113790567,113790903,336,0.03214097536155962
41766,3793.034267,3793.0565,1,113791028,113791695,667,0.07158892282452345
41767,3793.064867,3793.141067,1,113791946,113794232,2286,0.25809238329235434
41768,3793.896633,3793.901133,1,113816898,113817033,135,
41769,3793.9372,3793.9515,1,113818116,113818545,429,0.35167617142958657
41770,3793.961533,3794.046033,1,113818845,113821380,2535,0.22967063746851085
41771,3794.063467,3794.0806,1,113821904,113822418,514,0.08896317751098336
41772,3794.0838,3794.168633,1,113822514,113825058,2544,0.3651950810565752
41773,3794.2258,3794.2296,1,113826774,113826888,114,
41774,3794.6199,3794.625367,1,113838597,113838761,164,-0.08364508632959108
41775,3794.718533,3794.732133,1,113841555,113841963,408,0.2812687707297873
41776,3794.734067,3794.739733,1,113842022,113842191,169,0.24982785691463028
41777,3794.780233,3794.7846,1,113843406,113843538,132,0.5027554873229214
41778,3794.7946,3794.826733,1,113843838,113844801,963,0.28640665072210914
41779,3794.841267,3794.8838,1,113845238,113846514,1276,0.1402954088346521
41780,3794.893367,3794.9029,1,113846801,113847087,286,0.44675811818642014
41781,3795.021867,3795.027367,1,113850656,113850821,165,0.13937671260718534
41782,3795.055267,3795.059967,1,113851658,113851799,141,0.553906437641195
41783,3795.1024,3795.108467,1,113853072,113853254,182,0.47598535050420937
41784,3795.384333,3795.3884,1,113861529,113861652,123,0.5003232666685568
41785,3795.394133,3795.397433,1,113861823,113861922,99,0.23617853140651582
41786,3795.402933,3795.406,1,113862087,113862180,93,
41787,3795.5826,3795.603067,1,113867478,113868092,614,0.23983863573468164
41788,3795.618833,3795.624233,1,113868564,113868726,162,0.5109529115976128
41789,3795.636633,3795.6524,1,113869098,113869572,474,0.470333509773897
41790,3795.658133,3795.6633,1,113869743,113869899,156,0.010437716498408483
41791,3795.749033,3795.770667,1,113872470,113873120,650,0.35510882302253677
41792,3795.848633,3795.859,1,113875458,113875770,312,0.006124182850496387
41793,3795.866667,3795.8931,1,113876000,113876793,793,0.06967060051042168
41794,3795.897533,3795.907767,1,113876925,113877233,308,0.08967939102253986
41795,3795.925267,3795.9503,1,113877758,113878509,751,0.17121635157984422
41796,3795.9618,3795.970533,1,113878854,113879115,261,0.17642415170542958
41797,3796.039367,3796.056067,1,113881181,113881682,501,0.24686883709628776
41798,3796.058633,3796.062,1,113881758,113881860,102,
41799,3796.1127,3796.117967,1,113883381,113883539,158,0.5685837912694375
41800,3796.148933,3796.155967,1,113884467,113884679,212,0.2757015795183453
41801,3796.1738,3796.1771,1,113885214,113885313,99,-0.13342221293476272
41802,3796.1958,3796.2038,1,113885874,113886114,240,0.2277815407379403
41803,3796.213767,3796.2199,1,113886413,113886597,184,0.3818109633384604
41804,3796.236167,3796.250133,1,113887085,113887503,418,-0.08314667494009995
41805,3796.2529,3796.270367,1,113887587,113888111,524,0.06819492435932145
41806,3796.275133,3796.2789,1,113888253,113888367,114,0.1140623249555496
41807,3796.295933,3796.304333,1,113888877,113889129,252,0.19775184234746707
41808,3796.343067,3796.346133,1,113890292,113890383,91,
41809,3796.349567,3796.356967,1,113890487,113890709,222,0.02984401318039198
41810,3796.3667,3796.372933,1,113891001,113891187,186,-0.1744560749146239
41811,3796.374533,3796.385167,1,113891235,113891555,320,0.5204342707400624
41812,3796.3992,3796.411467,1,113891976,113892344,368,0.2500621621658391
41813,3796.417167,3796.423067,1,113892515,113892692,177,-0.22693208775544832
41814,3796.4476,3796.455333,1,113893428,113893659,231,0.6517909284979468
41815,3796.490033,3796.526933,1,113894700,113895807,1107,0.20949699030515695
41816,3796.535067,3796.543,1,113896052,113896290,238,0.1833543747822542
41817,3796.546267,3796.5512,1,113896388,113896536,148,0.38769881984064414
41818,3796.5622,3796.569033,1,113896866,113897070,204,0.49632077589060525
41819,3796.590533,3796.628933,1,113897715,113898867,1152,0.1828978020181224
41820,3796.630833,3796.6389,1,113898924,113899167,243,0.301905132619855
41821,3796.640333,3796.667533,1,113899209,113900025,816,0.34447915826930114
41822,3796.6714,3796.674867,1,113900142,113900246,104,
41823,3796.688833,3796.695367,1,113900664,113900861,197,0.3485068416721455
41824,3796.699433,3796.706133,1,113900982,113901183,201,0.6546376484123871
41825,3796.930667,3796.9342,1,113907920,113908026,106,-0.3420955398589612
41826,3796.9705,3796.979633,1,113909115,113909388,273,0.013330381276017678
41827,3797.020733,3797.052267,1,113910621,113911568,947,0.25340495956025255
41828,3797.056967,3797.0618,1,113911709,113911854,145,0.23689768641116585
41829,3797.063,3797.071333,1,113911890,113912139,249,0.2146339630803852
41830,3798.4874,3798.492667,1,113954622,113954780,158,0.30261886552661926
41831,3798.493733,3798.501433,1,113954811,113955042,231,0.48691883952440324
41832,3798.503933,3798.5215,1,113955117,113955645,528,0.2631676332909196
41833,3798.523467,3798.5311,1,113955704,113955933,229,0.07926697354875481
41834,3798.5357,3798.600233,1,113956071,113958006,1935,0.19994020759995956
41835,3798.6097,3798.612833,1,113958291,113958384,93,0.0522427174835088
41836,3798.614067,3798.621267,1,113958422,113958638,216,-0.031960951931840016
41837,3798.634867,3798.643067,1,113959046,113959292,246,0.09766834234564398
41838,3798.6453,3798.6811,1,113959359,113960433,1074,-0.020427003745420308
41839,3798.699667,3798.707667,1,113960990,113961230,240,0.23546155332560012
41840,3798.709467,3798.7207,1,113961284,113961621,337,-0.12546313684879543
41841,3798.726133,3798.7432,1,113961783,113962296,513,-0.001998278028316728
41842,3798.750333,3798.808767,1,113962509,113964263,1754,0.08508572839862467
41843,3798.811833,3798.8593,1,113964354,113965779,1425,0.13696786258937196
41844,3798.862067,3798.869,1,113965862,113966070,208,0.2146418834235264
41845,3798.885933,3798.892267,1,113966577,113966768,191,-0.40584293776558955
41846,3798.8998,3798.905133,1,113966994,113967153,159,0.7893433255105595
41847,3798.908133,3798.9183,1,113967243,113967549,306,-0.06180607080880416
41848,3798.9503,3798.955667,1,113968509,113968670,161,0.07276972085342624
41849,3799.485667,3799.4901,1,113984570,113984703,133,-0.106385432415334
41850,3799.5958,3799.600767,1,113987874,113988023,149,-0.09427914128580232
41851,3799.654667,3799.6583,1,113989640,113989749,109,0.36990828035560086
41852,3799.6823,3799.6858,1,113990469,113990574,105,
41853,3799.689,3799.6926,1,113990670,113990778,108,0.05502842323806886
41854,3799.693733,3799.725667,1,113990811,113991770,959,0.1843858790765017
41855,3799.769267,3799.7843,1,113993078,113993529,451,0.28126457933679067
41856,3799.932867,3799.941367,1,113997986,113998241,255,0.1109274035576423
41857,3799.943133,3799.982967,1,113998293,113999489,1196,0.14443089982777454
41858,3799.9902,3800.0023,1,113999706,114000069,363,0.11689168904650639
41859,3800.003967,3800.064733,1,114000119,114001941,1822,0.1882293091977355
41860,3800.069967,3800.073367,1,114002099,114002201,102,0.3258200143092129
41861,3800.074833,3800.114933,1,114002244,114003447,1203,0.05987424235394422
41862,3800.1279,3800.132367,1,114003837,114003971,134,0.1778736223516384
41863,3800.145733,3800.157433,1,114004371,114004722,351,-0.07968515297592864
41864,3800.162767,3800.250967,1,114004883,114007529,2646,0.16615111164275898
41865,3800.260667,3800.359633,1,114007820,114010788,2968,0.443740269835224
41866,3800.366267,3800.3742,1,114010988,114011226,238,0.12139244740620446
41867,3800.390033,3800.400867,1,114011700,114012026,326,0.21382318843144069
41868,3800.432533,3800.437533,1,114012975,114013125,150,0.08766643685259036
41869,3800.464667,3800.473233,1,114013940,114014196,256,-0.09941333092180346
41870,3800.474233,3800.497767,1,114014226,114014933,707,-0.10656528373912288
41871,3800.4995,3800.509333,1,114014985,114015279,294,0.05337824538562486
41872,3800.573533,3800.586967,1,114017205,114017609,404,0.10261509778257732
41873,3800.588533,3800.593067,1,114017655,114017792,137,0.29128178425694184
41874,3800.643333,3800.652767,1,114019299,114019583,284,-0.12783075828962026
41875,3800.675867,3800.680833,1,114020276,114020424,148,-0.31938269522156343
41876,3800.829733,3800.835333,1,114024891,114025059,168,-0.09695702954322527
41877,3800.853233,3800.861433,1,114025596,114025842,246,0.19231742650231995
41878,3800.8912,3800.909333,1,114026736,114027279,543,0.1862680706965121
41879,3800.9106,3800.994767,1,114027318,114029843,2525,0.11125154783649514
41880,3801.000733,3801.009533,1,114030021,114030285,264,0.11376315057043661
41881,3801.0112,3801.015933,1,114030336,114030477,141,-0.04895247813688549
41882,3801.025267,3801.0405,1,114030758,114031215,457,0.14642899871066012
41883,3801.0444,3801.079733,1,114031332,114032391,1059,0.032159650044704405
41884,3801.098033,3801.109367,1,114032940,114033281,341,-0.06944797073803174
41885,3801.1124,3801.141,1,114033372,114034230,858,0.0778525222784786
41886,3801.146533,3801.166433,1,114034395,114034992,597,0.0681543998013703
41887,3801.169167,3801.252667,1,114035075,114037580,2505,0.12219239817490168
41888,3801.253967,3801.256967,1,114037619,114037709,90,-0.05074020253390389
41889,3801.258,3801.2848,1,114037740,114038544,804,-0.012322682862792998
41890,3801.286233,3801.311867,1,114038586,114039356,770,0.023653033930940683
41891,3801.3188,3801.3259,1,114039564,114039777,213,0.04716484867086538
41892,3801.327367,3801.332067,1,114039821,114039962,141,
41893,3802.373833,3802.3895,1,114071214,114071685,471,-0.050239836355208206
41894,3802.3981,3802.4066,1,114071943,114072198,255,-0.02751864117416307
41895,3802.410733,3802.415867,1,114072321,114072476,155,0.052693638004241344
41896,3802.4325,3802.4486,1,114072975,114073458,483,-0.019594604416369985
41897,3802.4751,3802.509033,1,114074253,114075270,1017,0.5110444677013589
41898,3802.5703,3802.576367,1,114077109,114077291,182,0.18047575948630443
41899,3802.6159,3802.651367,1,114078477,114079541,1064,0.27842694363544324
41900,3802.6539,3802.674067,1,114079617,114080222,605,-0.03523717168279757
41901,3802.675667,3802.765967,1,114080270,114082979,2709,0.2983309284534402
41902,3802.774833,3802.787233,1,114083244,114083616,372,0.0016588880584989505
41903,3802.7914,3802.837933,1,114083742,114085137,1395,-0.0017313420383176152
41904,3802.840067,3802.886233,1,114085202,114086586,1384,0.05968816506553214
41905,3802.890033,3802.906467,1,114086700,114087194,494,-0.016316579528246736
41906,3802.911133,3803.004167,1,114087333,114090125,2792,0.6308267121960265
41907,3803.010933,3803.0142,1,114090327,114090426,99,0.20702687033520586
41908,3803.017433,3803.0301,1,114090522,114090903,381,0.1244617582644661
41909,3803.036533,3803.050167,1,114091095,114091505,410,0.10634698293404393
41910,3803.056233,3803.153067,1,114091686,114094592,2906,0.3604790934475821
41911,3803.644267,3803.6473,1,114109328,114109419,91,0.5415326578032501
41912,3803.6888,3803.6977,1,114110664,114110931,267,-0.07328969767052369
41913,3803.699867,3803.703067,1,114110996,114111092,96,-0.06819665657279639
41914,3803.709967,3803.734133,1,114111299,114112023,724,0.23000408055829796
41915,3803.7363,3803.805633,1,114112089,114114168,2079,0.15150037611225625
41916,3803.8133,3803.820033,1,114114399,114114600,201,0.1296782261487257
41917,3803.823233,3803.835533,1,114114696,114115065,369,0.16800155039717637
41918,3803.8388,3803.8726,1,114115164,114116178,1014,-0.003424380275074227
41919,3803.881833,3803.890767,1,114116454,114116723,269,-0.05875997276875979
41920,3803.8985,3803.915533,1,114116955,114117465,510,0.16425016023622896
41921,3803.925433,3803.9608,1,114117762,114118824,1062,-0.006749787152452105
41922,3803.961967,3803.979267,1,114118859,114119378,519,0.06409777683496919
41923,3803.9841,3804.087233,1,114119523,114122616,3093,0.3441788948094365
41924,3804.358867,3804.369333,1,114130766,114131079,313,0.21000680311083594
41925,3804.3711,3804.3781,1,114131133,114131343,210,-0.07418757283614293
41926,3804.678533,3804.689933,1,114140355,114140697,342,-0.09794555184658077
41927,3804.734267,3804.744667,1,114142028,114142340,312,-0.07280920467784929
41928,3804.753533,3804.7577,1,114142605,114142731,126,
41929,3804.760067,3804.772367,1,114142802,114143171,369,0.04757721741691338
41930,3804.885367,3804.921067,1,114146561,114147632,1071,0.35212144852437544
41931,3804.929033,3804.9613,1,114147870,114148839,969,0.19558438531607913
41932,3804.979267,3804.9851,1,114149378,114149553,175,0.23694983702082154
41933,3804.9864,3804.994667,1,114149592,114149840,248,0.06444464531385419
41934,3805.007733,3805.036833,1,114150231,114151104,873,-0.0022444266068303667
41935,3805.042233,3805.0491,1,114151266,114151473,207,0.31609440501730496
41936,3805.063267,3805.071833,1,114151898,114152154,256,0.12726610162891458
41937,3805.078167,3805.106067,1,114152345,114153182,837,-0.014891928720852312
41938,3805.108233,3805.119233,1,114153246,114153576,330,0.04404825639544764
41939,3805.121433,3805.1304,1,114153642,114153912,270,0.2375848285911551
41940,3805.131533,3805.134633,1,114153945,114154038,93,-0.25146721550971685
41941,3806.005333,3806.012467,1,114180159,114180374,215,0.16074296932919938
41942,3806.050967,3806.0566,1,114181529,114181698,169,0.3396339068089081
41943,3806.0648,3806.0686,1,114181944,114182058,114,0.09541709015694527
41944,3806.078167,3806.0819,1,114182345,114182457,112,0.04826052469701332
41945,3806.086667,3806.1549,1,114182600,114184647,2047,0.4859843947536104
41946,3806.156967,3806.180733,1,114184709,114185421,712,0.11819098488374338
41947,3806.1872,3806.236333,1,114185616,114187089,1473,0.05475946851117241
41948,3806.2412,3806.254033,1,114187236,114187620,384,0.08349381291429779
41949,3806.271067,3806.315033,1,114188132,114189450,1318,0.06524226318235271
41950,3806.316233,3806.327267,1,114189486,114189818,332,0.1361269550871269
41951,3806.3307,3806.3483,1,114189921,114190449,528,0.14567334591073167
41952,3806.349867,3806.4348,1,114190496,114193044,2548,0.3194541495541439
41953,3806.438867,3806.445367,1,114193166,114193361,195,-0.07499067739030532
41954,3807.929867,3807.939967,1,114237896,114238199,303,-0.008951926815972192
41955,3807.9419,3807.968133,1,114238257,114239043,786,0.44468858296762137
41956,3808.070267,3808.076567,1,114242108,114242297,189,0.2142367022496558
41957,3808.115133,3808.123133,1,114243453,114243693,240,0.2993080646026684
41958,3808.1242,3808.146333,1,114243726,114244389,663,0.17784903913242997
41959,3808.149767,3808.226267,1,114244493,114246788,2295,0.22416145507090451
41960,3808.237733,3808.241767,1,114247131,114247253,122,-0.0813486934849826
41961,3808.242767,3808.256833,1,114247283,114247704,421,-0.0538838074676069
41962,3808.262867,3808.2669,1,114247886,114248007,121,0.018290000193165915
41963,3808.2727,3808.2865,1,114248181,114248595,414,0.10928164199079642
41964,3808.296033,3808.3346,1,114248880,114250038,1158,0.009351455053813015
41965,3808.336633,3808.347467,1,114250098,114250424,326,-0.16112783015493465
41966,3808.3597,3808.3839,1,114250791,114251517,726,-0.030376403517980835
41967,3808.389367,3808.3961,1,114251681,114251883,202,0.22498007179878088
41968,3808.4233,3808.437267,1,114252699,114253118,419,0.13705932782091645
41969,3808.444867,3808.4538,1,114253346,114253614,268,0.2369527048218331
41970,3808.456967,3808.549433,1,114253709,114256482,2773,0.2719707840786573
41971,3809.482833,3809.511633,1,114284484,114285348,864,0.15865509273870687
41972,3809.5735,3809.586067,1,114287205,114287582,377,0.17142459584319392
41973,3809.6701,3809.689167,1,114290103,114290675,572,-0.007647235756095981
41974,3809.7065,3809.712933,1,114291195,114291387,192,0.602955313480911
41975,3809.7141,3809.7371,1,114291423,114292113,690,0.0398016452434578
41976,3809.766767,3809.783633,1,114293003,114293508,505,0.32544921543765803
41977,3809.785767,3809.851033,1,114293573,114295530,1957,0.5372491852286556
41978,3809.880167,3809.8957,1,114296405,114296871,466,0.3077713990542744
41979,3809.965767,3809.981,1,114298973,114299430,457,0.062107715838695315
41980,3810.082167,3810.1029,1,114302465,114303087,622,0.020150636185974184
41981,3810.108767,3810.1125,1,114303263,114303375,112,
41982,3810.1329,3810.153467,1,114303987,114304604,617,0.22558324613292965
41983,3810.177367,3810.1807,1,114305321,114305421,100,0.0832785169307925
41984,3810.2413,3810.270333,1,114307239,114308109,870,0.2544435419333968
41985,3810.272433,3810.283133,1,114308172,114308493,321,0.23989684495636465
41986,3810.3016,3810.374467,1,114309048,114311234,2186,0.052437516996635306
41987,3810.3802,3810.405567,1,114311406,114312167,761,-0.00969874192872436
41988,3810.408,3810.4231,1,114312240,114312693,453,0.039113517042355536
41989,3810.429133,3810.440533,1,114312873,114313215,342,0.09830272868476346
41990,3810.447367,3810.4638,1,114313421,114313914,493,-0.07098238943272767
41991,3810.470233,3810.4966,1,114314106,114314898,792,0.1255695618689745
41992,3810.506033,3810.519567,1,114315180,114315587,407,0.07492918245349624
41993,3810.522367,3810.578467,1,114315671,114317354,1683,0.0800148225909537
41994,3810.5851,3810.5921,1,114317553,114317763,210,-0.14760000962881392
41995,3810.602633,3810.611733,1,114318078,114318351,273,0.053690106003992835
41996,3811.839867,3811.848,1,114355196,114355440,244,0.4643603290308092
41997,3811.905367,3811.919967,1,114357161,114357599,438,0.07678733948465684
41998,3811.936067,3811.948933,1,114358082,114358467,385,-0.07456301151256536
41999,3811.9508,3812.007933,1,114358524,114360237,1713,0.13644901694947548
42000,3812.013133,3812.0365,1,114360393,114361095,702,-0.03303658875920544
42001,3812.043133,3812.0804,1,114361293,114362412,1119,0.1198198271281265
42002,3812.084067,3812.096433,1,114362522,114362892,370,0.21360283741228006
42003,3812.103933,3812.1127,1,114363117,114363381,264,0.22248628545900292
42004,3812.115267,3812.1515,1,114363458,114364545,1087,0.12703693943268227
42005,3812.1561,3812.159667,1,114364683,114364790,107,
42006,3812.174567,3812.178667,1,114365237,114365360,123,0.6905399740987507
42007,3812.181833,3812.205867,1,114365454,114366176,722,0.153631189367376
42008,3812.224467,3812.2282,1,114366734,114366846,112,0.3972227092964683
42009,3812.233067,3812.248267,1,114366992,114367448,456,0.016229644235305884
42010,3812.249467,3812.257767,1,114367484,114367733,249,0.13484080366412676
42011,3812.263567,3812.268767,1,114367907,114368063,156,0.4436881775775466
42012,3812.298167,3812.311767,1,114368945,114369353,408,0.2932622326732114
42013,3812.316,3812.319133,1,114369480,114369573,93,
42014,3812.3739,3812.3895,1,114371217,114371685,468,0.2517778768005885
42015,3812.4076,3812.410633,1,114372228,114372318,90,-0.15271534002976025
42016,3812.7146,3812.735933,1,114381438,114382077,639,0.1279494608877875
42017,3812.739967,3812.7434,1,114382199,114382302,103,0.35688836019930004
42018,3812.7538,3812.7618,1,114382614,114382854,240,0.3999588060358034
42019,3812.782267,3812.803,1,114383468,114384090,622,0.34051285964571104
42020,3812.8148,3812.821833,1,114384444,114384654,210,0.3008524198623418
42021,3813.654833,3813.684267,1,114409644,114410528,884,0.3541580397231888
42022,3813.689167,3813.698833,1,114410675,114410964,289,0.05844639434367765
42023,3813.7002,3813.707933,1,114411006,114411237,231,-0.10359829910621787
42024,3813.7133,3813.7187,1,114411399,114411561,162,-0.1569591771773932
42025,3813.759167,3813.7702,1,114412775,114413106,331,0.19966918109838785
42026,3813.809533,3813.8142,1,114414285,114414426,141,0.006698739155991943
42027,3813.9156,3813.9224,1,114417468,114417672,204,-0.2077953625640753
42028,3813.932967,3813.9496,1,114417989,114418488,499,-0.055409604502754006
42029,3813.951633,3813.956,1,114418548,114418680,132,0.3260450544669648
42030,3813.961467,3814.0395,1,114418844,114421185,2341,0.24989390919297894
42031,3814.048067,3814.052133,1,114421442,114421563,121,0.5407339834799968
42032,3814.059633,3814.076867,1,114421788,114422306,518,-0.10136326710726988
42033,3814.0874,3814.0958,1,114422622,114422874,252,0.02220146082213005
42034,3814.102933,3814.154933,1,114423087,114424647,1560,0.06283275689921904
42035,3814.1601,3814.1752,1,114424803,114425256,453,0.10392567241846973
42036,3814.183833,3814.2785,1,114425514,114428355,2841,0.2371647365165811
42037,3814.298867,3814.302,1,114428966,114429060,94,
42038,3814.3097,3814.3341,1,114429291,114430023,732,-0.061403624608848434
42039,3814.335733,3814.342733,1,114430071,114430281,210,0.10498952518316097
42040,3814.9242,3814.9281,1,114447726,114447843,117,0.7624403963458515
42041,3814.933933,3814.971267,1,114448017,114449138,1121,0.24342450327225035
42042,3814.972633,3814.986667,1,114449178,114449600,422,0.0921674849766538
42043,3815.005033,3815.017433,1,114450150,114450522,372,0.4070241275114018
42044,3815.0381,3815.042933,1,114451143,114451287,144,0.23217282647779208
42045,3815.0959,3815.101867,1,114452877,114453056,179,0.7257533838016019
42046,3815.105667,3815.109233,1,114453170,114453276,106,
42047,3815.165767,3815.197067,1,114454973,114455912,939,0.4378885314309641
42048,3815.198067,3815.2068,1,114455942,114456204,262,0.28108004915317036
42049,3815.208,3815.214033,1,114456240,114456420,180,0.41409435975721565
42050,3815.216533,3815.238233,1,114456495,114457146,651,0.21994794691639916
42051,3815.252233,3815.257067,1,114457566,114457712,146,
42052,3815.262167,3815.269833,1,114457865,114458094,229,0.10646427471540822
42053,3815.276333,3815.286733,1,114458289,114458601,312,-0.0658667931746505
42054,3815.287933,3815.305067,1,114458637,114459152,515,0.39733630280906834
42055,3815.315167,3815.3215,1,114459455,114459645,190,0.1709048209461133
42056,3815.365767,3815.3728,1,114460973,114461184,211,0.11597525312412625
42057,3815.380233,3815.392867,1,114461406,114461786,380,-0.08989786697601415
42058,3815.413033,3815.506167,1,114462390,114465185,2795,0.6915886208527832
42059,3815.507533,3815.571733,1,114465225,114467151,1926,0.0827151792380771
42060,3815.582067,3815.588933,1,114467462,114467667,205,-0.0775501829278716
42061,3815.603033,3815.650067,1,114468090,114469502,1412,0.030274696033383897
42062,3815.662,3815.670233,1,114469860,114470106,246,0.14394502707211534
42063,3815.680133,3815.7347,1,114470403,114472041,1638,0.11833435418141773
42064,3815.735867,3815.770367,1,114472076,114473111,1035,0.09520643311934725
42065,3815.772533,3815.777333,1,114473175,114473319,144,0.516344894429729
42066,3816.146733,3816.170067,1,114484401,114485102,701,0.26187655351398836
42067,3816.1805,3816.187867,1,114485415,114485636,221,0.11262491716781246
42068,3816.1931,3816.1998,1,114485793,114485994,201,0.23676945928533313
42069,3816.263033,3816.268967,1,114487890,114488069,179,0.4240155055917082
42070,3816.300367,3816.310467,1,114489011,114489314,303,0.09378032286595687
42071,3816.330133,3816.339167,1,114489903,114490175,272,0.6699475833224654
42072,3816.360233,3816.376033,1,114490806,114491280,474,0.32809993052374825
42073,3816.3772,3816.3827,1,114491316,114491481,165,0.2356548070937875
42074,3816.487933,3816.496733,1,114494637,114494901,264,0.5082973085374396
42075,3816.501567,3816.5054,1,114495047,114495162,115,0.8288085113391154
42076,3816.517367,3816.528967,1,114495521,114495869,348,0.10615770221545867
42077,3816.532833,3816.535833,1,114495984,114496074,90,
42078,3816.5402,3816.5458,1,114496206,114496374,168,-0.03692291409268768
42079,3816.5604,3816.564067,1,114496812,114496922,110,0.30638430537810274
42080,3816.574533,3816.580167,1,114497235,114497405,170,0.23902521947526217
42081,3816.613667,3816.6272,1,114498410,114498816,406,0.39635677444072714
42082,3816.6446,3816.6706,1,114499338,114500118,780,0.32583842452943323
42083,3816.675367,3816.678667,1,114500261,114500360,99,0.42029748358648145
42084,3816.6886,3816.7029,1,114500658,114501087,429,0.24740645875940603
42085,3816.7176,3816.743667,1,114501528,114502310,782,0.24501211256206282
42086,3816.745467,3816.751267,1,114502364,114502538,174,0.30982446238989875
42087,3816.7523,3816.761967,1,114502569,114502859,290,0.46720471425686655
42088,3816.767067,3816.779833,1,114503012,114503394,382,0.31702028075775035
42089,3816.780867,3816.785533,1,114503426,114503565,139,0.5942205537935631
42090,3816.788,3816.811833,1,114503640,114504354,714,0.17182823846351772
42091,3816.8275,3816.848967,1,114504825,114505469,644,0.4170166785697688
42092,3816.855267,3816.870533,1,114505658,114506115,457,0.037486427759254495
42093,3816.877633,3816.8973,1,114506328,114506919,591,0.06832127828572572
42094,3816.900133,3816.922067,1,114507003,114507662,659,0.07770248610925856
42095,3816.940067,3816.9448,1,114508202,114508344,142,0.15171848449809688
42096,3816.998667,3817.009033,1,114509960,114510270,310,0.17474160481345383
42097,3817.063433,3817.0765,1,114511902,114512295,393,0.4171623529769404
42098,3817.080033,3817.0931,1,114512400,114512793,393,0.3646177187435444
42099,3817.293167,3817.3128,1,114518795,114519384,589,0.14758558818149065
42100,3817.332133,3817.347467,1,114519963,114520424,461,-0.11076209491788341
42101,3817.352633,3817.405367,1,114520578,114522161,1583,0.15585407330687875
42102,3817.420967,3817.4452,1,114522629,114523356,727,0.06379131255972484
42103,3817.454567,3817.466733,1,114523637,114524001,364,0.17938359331618808
42104,3817.4868,3817.515233,1,114524604,114525456,852,0.15709765747823523
42105,3817.530533,3817.534767,1,114525915,114526043,128,-0.10482290757370646
42106,3817.5515,3817.557733,1,114526545,114526731,186,0.6138838458773902
42107,3817.564667,3817.570533,1,114526940,114527115,175,0.17523428081123266
42108,3817.574633,3817.597567,1,114527238,114527927,689,0.022944727312075197
42109,3817.609733,3817.614033,1,114528291,114528420,129,0.6050545782784125
42110,3817.619867,3817.622933,1,114528596,114528687,91,
42111,3817.6336,3817.648967,1,114529008,114529469,461,-0.0787291852878281
42112,3817.656067,3817.66,1,114529682,114529800,118,0.13952756674707537
42113,3817.662267,3817.670967,1,114529868,114530129,261,0.09354200239635697
42114,3817.698,3817.7135,1,114530940,114531405,465,0.05696540107512469
42115,3818.082533,3818.085533,1,114542475,114542565,90,-0.17758686626883544
42116,3818.088733,3818.094833,1,114542661,114542844,183,-0.13046630640847953
42117,3818.097467,3818.102067,1,114542924,114543062,138,-0.16888531553985514
42118,3818.123967,3818.130533,1,114543719,114543915,196,0.30396828986090607
42119,3818.131733,3818.145767,1,114543951,114544373,422,0.5128301936111649
42120,3818.1473,3818.158367,1,114544419,114544751,332,0.08193018266467923
42121,3818.1805,3818.184467,1,114545415,114545534,119,-0.13444949499551037
42122,3818.190167,3818.2101,1,114545705,114546303,598,-0.0892691103263144
42123,3818.2196,3818.230633,1,114546588,114546918,330,0.18958883036663332
42124,3818.231767,3818.259833,1,114546953,114547794,841,0.12313783613235382
42125,3818.261567,3818.313967,1,114547847,114549419,1572,0.0762953174009669
42126,3818.318233,3818.364667,1,114549546,114550940,1394,0.10413208394211493
42127,3818.3657,3818.370533,1,114550971,114551115,144,0.24739128653778775
42128,3818.428733,3818.432133,1,114552861,114552963,102,-0.040417580616218265
42129,3818.458067,3818.4639,1,114553742,114553917,175,0.24250103141705812
42130,3818.470233,3818.475533,1,114554106,114554265,159,0.18349603950263654
42131,3818.4791,3818.486833,1,114554373,114554604,231,0.09310010165619394
42132,3818.503833,3818.509933,1,114555114,114555297,183,0.5473991303426822
42133,3818.516967,3818.5261,1,114555509,114555783,274,0.308948203824577
42134,3818.5271,3818.568267,1,114555813,114557048,1235,0.10789828545416988
42135,3818.5695,3818.573733,1,114557085,114557211,126,0.28345962454001755
42136,3818.5753,3818.580967,1,114557259,114557429,170,-0.08019585483937322
42137,3818.5906,3818.6021,1,114557718,114558063,345,-0.035457190232742464
42138,3818.6076,3818.6431,1,114558228,114559293,1065,-0.017113071355011156
42139,3818.6456,3818.6544,1,114559368,114559632,264,0.09716057760728371
42140,3818.662067,3818.7031,1,114559862,114561093,1231,0.14500470171555652
42141,3818.712233,3818.7929,1,114561366,114563787,2421,0.1291168473450907
42142,3818.796867,3818.803267,1,114563906,114564098,192,-0.3562354132700656
42143,3818.814433,3818.85,1,114564432,114565500,1068,0.18624924708248616
42144,3819.029833,3819.037367,1,114570894,114571121,227,-0.05706049629260634
42145,3819.097033,3819.107433,1,114572910,114573222,312,0.49242805132162665
42146,3819.329767,3819.334067,1,114579893,114580022,129,0.30742147426000765
42147,3819.403967,3819.4196,1,114582119,114582588,469,-0.07758101137882738
42148,3819.4524,3819.456667,1,114583572,114583700,128,0.4097298592057429
42149,3819.488067,3819.494467,1,114584642,114584834,192,0.13147917802590178
42150,3819.51,3819.513167,1,114585300,114585395,95,0.15288841605756295
42151,3819.566433,3819.5701,1,114586992,114587103,111,0.37977157893097024
42152,3819.765367,3819.769433,1,114592961,114593082,121,0.6025040330717639
42153,3819.818967,3819.822467,1,114594569,114594674,105,0.5448385582723062
42154,3819.852633,3819.865,1,114595578,114595950,372,0.03461249089259392
42155,3819.8831,3819.898133,1,114596493,114596943,450,0.44574819324636294
42156,3820.159533,3820.167333,1,114604785,114605019,234,0.7279619410259717
42157,3820.203367,3820.2107,1,114606101,114606321,220,0.3772049231470946
42158,3820.237633,3820.253933,1,114607128,114607617,489,0.2135147692479744
42159,3820.255367,3820.260733,1,114607661,114607821,160,
42160,3820.2754,3820.281567,1,114608262,114608447,185,0.10408174544183164
42161,3820.282567,3820.286567,1,114608477,114608597,120,0.4298241910504561
42162,3820.2905,3820.294933,1,114608715,114608847,132,-0.19471997854664902
42163,3820.332633,3820.357567,1,114609978,114610727,749,-0.08719643051147466
42164,3820.397733,3820.4023,1,114611931,114612069,138,0.043860875683385654
42165,3820.4132,3820.423567,1,114612396,114612707,311,0.2681641684784823
42166,3820.433733,3820.4657,1,114613011,114613971,960,0.16861158988608863
42167,3820.4675,3820.4798,1,114614025,114614394,369,0.3125205633678032
42168,3820.839767,3820.8438,1,114625193,114625314,121,0.15469253617947792
42169,3820.879533,3820.883967,1,114626385,114626519,134,0.2229038613422529
42170,3820.923067,3820.9303,1,114627692,114627909,217,-0.03261393387820041
42171,3820.935033,3820.940667,1,114628050,114628220,170,0.2243011643820845
42172,3821.1164,3821.129633,1,114633492,114633888,396,0.16778776236079335
42173,3821.1601,3821.178467,1,114634803,114635354,551,0.04586471083115951
42174,3821.208667,3821.217333,1,114636260,114636519,259,0.198012529690495
42175,3821.235633,3821.242667,1,114637068,114637280,212,0.4026617553346426
42176,3821.267033,3821.2753,1,114638010,114638259,249,0.3577747883683154
42177,3821.277,3821.2873,1,114638310,114638619,309,0.0056568688967135235
42178,3821.294967,3821.302367,1,114638849,114639071,222,0.5699998540688767
42179,3821.307433,3821.317633,1,114639222,114639528,306,0.04820258648274441
42180,3821.322233,3821.360933,1,114639666,114640827,1161,0.14794916305253186
42181,3821.365133,3821.377667,1,114640953,114641330,377,0.3240329737188784
42182,3821.387567,3821.391867,1,114641627,114641756,129,-0.15219814692163824
42183,3821.4283,3821.435333,1,114642849,114643059,210,0.5175744692255306
42184,3821.454267,3821.460967,1,114643628,114643829,201,-0.09434291888877616
42185,3821.4885,3821.494867,1,114644655,114644846,191,0.266657427802562
42186,3821.505133,3821.509933,1,114645153,114645297,144,0.41618328393597825
42187,3821.539733,3821.5472,1,114646191,114646416,225,0.713350125579578
42188,3821.657933,3821.661233,1,114649737,114649836,99,
42189,3821.754867,3821.762567,1,114652646,114652877,231,0.36696933912754537
42190,3821.8569,3821.8689,1,114655707,114656067,360,0.11429463246673889
42191,3821.869933,3821.8755,1,114656097,114656265,168,0.015015005167695413
42192,3821.885633,3821.9087,1,114656568,114657261,693,0.01577563717873122
42193,3821.927833,3821.959267,1,114657834,114658778,944,0.35892901963969465
42194,3821.962367,3821.975267,1,114658871,114659258,387,0.21224902443739066
42195,3822.827967,3822.840367,1,114684839,114685211,372,0.12970350644182246
42196,3822.995733,3823.0151,1,114689871,114690453,582,0.1890380865132129
42197,3823.016333,3823.021467,1,114690489,114690644,155,0.26270048661209594
42198,3823.028033,3823.071967,1,114690840,114692159,1319,0.6044950641030444
42199,3823.1741,3823.1804,1,114695223,114695412,189,0.449653437491961
42200,3823.190067,3823.210567,1,114695702,114696317,615,0.20278293567321617
42201,3823.214667,3823.222667,1,114696440,114696680,240,-0.05586354681345928
42202,3823.232667,3823.236367,1,114696980,114697091,111,0.11559245287730152
42203,3823.237467,3823.244667,1,114697124,114697340,216,0.3213239619800132
42204,3823.252167,3823.319833,1,114697565,114699594,2029,0.5113768392650123
42205,3823.332333,3823.343567,1,114699969,114700307,338,-0.050292700081176776
42206,3823.350233,3823.357433,1,114700506,114700722,216,-0.05241155200078025
42207,3823.361867,3823.3797,1,114700856,114701391,535,0.17318447780706966
42208,3823.384533,3823.397833,1,114701535,114701934,399,0.26637791897966107
42209,3823.3997,3823.428133,1,114701991,114702843,852,0.0658485836477105
42210,3823.436333,3823.447233,1,114703089,114703416,327,0.18098770505382522
42211,3823.449567,3823.460467,1,114703487,114703814,327,-0.09904791577507564
42212,3823.463433,3823.4786,1,114703902,114704358,456,0.17605220127515586
42213,3823.4877,3823.560333,1,114704631,114706809,2178,0.1116294486087081
42214,3823.561567,3823.576167,1,114706847,114707285,438,0.10780844594649633
42215,3823.578533,3823.581633,1,114707355,114707448,93,0.5195342000103137
42216,3823.589067,3823.5974,1,114707672,114707922,250,0.3746463505513029
42217,3824.388467,3824.405733,1,114731654,114732171,517,0.12709785966034948
42218,3824.4072,3824.416633,1,114732216,114732498,282,0.04114006580927485
42219,3824.4345,3824.438833,1,114733035,114733164,129,-0.15545909865833066
42220,3824.553533,3824.559167,1,114736605,114736775,170,0.11699662747215551
42221,3824.587667,3824.594,1,114737630,114737820,190,-0.08746393099674162
42222,3824.640267,3824.6467,1,114739208,114739401,193,0.1266316678844719
42223,3824.687933,3824.6944,1,114740637,114740832,195,0.2939194362734618
42224,3824.704833,3824.719,1,114741144,114741570,426,0.2539498569781413
42225,3824.721733,3824.7283,1,114741651,114741849,198,0.06642987164796312
42226,3824.738233,3824.824867,1,114742146,114744746,2600,0.44006950468438294
42227,3824.864467,3824.908033,1,114745934,114747240,1306,0.6201820997643519
42228,3824.912033,3824.918267,1,114747360,114747548,188,0.09850776795836032
42229,3824.922367,3824.940367,1,114747671,114748211,540,0.4744314789683131
42230,3824.948333,3825.0425,1,114748449,114751275,2826,0.5039675569822932
42231,3825.066933,3825.07,1,114752007,114752100,93,0.3084169322674227
42232,3825.0721,3825.085333,1,114752163,114752559,396,0.0037836300372729196
42233,3825.099833,3825.114033,1,114752994,114753420,426,0.4046135968275994
42234,3825.1156,3825.129467,1,114753468,114753884,416,0.08532054898676177
42235,3825.204467,3825.209667,1,114756134,114756290,156,0.16413521813657256
42236,3825.219567,3825.2234,1,114756587,114756702,115,0.11408566242135613
42237,3825.2309,3825.2375,1,114756927,114757125,198,0.6078655272815776
42238,3825.238633,3825.2525,1,114757158,114757575,417,-0.0223815205137165
42239,3825.262167,3825.274133,1,114757865,114758223,358,0.2438523097349435
42240,3825.277667,3825.289867,1,114758330,114758696,366,0.21569513022185985
42241,3825.3047,3825.310167,1,114759141,114759305,164,-0.02628438275798928
42242,3825.322067,3825.3295,1,114759662,114759885,223,0.691961086656025
42243,3825.3323,3825.337967,1,114759969,114760139,170,0.671558525868806
42244,3825.3395,3825.357667,1,114760185,114760730,545,0.3586464632851272
42245,3825.363567,3825.380167,1,114760907,114761405,498,0.07175174391336495
42246,3825.385967,3825.398967,1,114761579,114761969,390,0.1117456567259609
42247,3825.399967,3825.405167,1,114761999,114762155,156,-0.05657673334381246
42248,3825.415067,3825.420533,1,114762452,114762615,163,0.512297016942027
42249,3825.4282,3825.435833,1,114762846,114763074,228,0.06407380429984524
42250,3825.445833,3825.463467,1,114763374,114763904,530,0.3242304881905478
42251,3825.4696,3825.474367,1,114764088,114764231,143,-0.05998810902603237
42252,3825.55,3825.559133,1,114766500,114766773,273,0.06306533978934123
42253,3825.5749,3825.583,1,114767247,114767490,243,0.4503505338556307
42254,3825.6255,3825.635067,1,114768765,114769052,287,0.05654774346534317
42255,3825.654433,3825.669333,1,114769632,114770079,447,0.08308005309926321
42256,3825.688233,3825.692033,1,114770646,114770760,114,
42257,3825.7062,3825.710067,1,114771186,114771302,116,0.216012415888703
42258,3825.734633,3825.7466,1,114772038,114772398,360,-0.0702052812946088
42259,3825.776367,3825.779967,1,114773291,114773399,108,0.39676569182363564
42260,3826.014,3826.0198,1,114780420,114780594,174,-0.0010093331370913073
42261,3826.042067,3826.046333,1,114781262,114781389,127,0.34524107655309616
42262,3826.0707,3826.076933,1,114782121,114782307,186,-0.1592206847403819
42263,3826.079633,3826.087133,1,114782388,114782613,225,0.4345914413473252
42264,3826.090167,3826.097833,1,114782705,114782934,229,0.46853282652349343
42265,3826.103733,3826.111267,1,114783111,114783338,227,-0.026468940210949855
42266,3826.120667,3826.125433,1,114783620,114783762,142,-0.02074509610846188
42267,3826.132533,3826.150933,1,114783975,114784527,552,0.44149919201203475
42268,3826.181333,3826.186,1,114785439,114785580,141,-0.100836135099877
42269,3826.209167,3826.230333,1,114786275,114786909,634,0.36428805219423804
42270,3826.248033,3826.255833,1,114787440,114787674,234,0.6865265438368773
42271,3826.270233,3826.273933,1,114788106,114788217,111,-0.3449317160001555
42272,3826.3818,3826.386933,1,114791454,114791607,153,0.31055399134989936
42273,3826.488967,3826.521,1,114794669,114795630,961,0.17393658125424113
42274,3826.542467,3826.547867,1,114796274,114796436,162,-0.06876321197209406
42275,3826.5737,3826.587067,1,114797211,114797612,401,-0.02394794542470225
42276,3826.638733,3826.6427,1,114799161,114799281,120,
42277,3826.779167,3826.786133,1,114803375,114803583,208,0.5590294389952543
42278,3827.4245,3827.434367,1,114822735,114823031,296,0.03871464837113415
42279,3827.441367,3827.4492,1,114823241,114823476,235,0.09059565545838957
42280,3828.7309,3828.737633,1,114861927,114862128,201,0.650084942140332
42281,3831.8244,3831.8331,1,114954732,114954993,261,0.3967092503904405
42282,3851.253367,3851.2565,1,115537601,115537695,94,
42283,3854.0452,3854.050033,1,115621356,115621500,144,-0.43984136344924724
42284,3858.337233,3858.341933,1,115750116,115750257,141,-0.5104452406112846
42285,3858.3501,3858.3531,1,115750503,115750593,90,
42286,3864.808033,3864.811267,1,115944240,115944338,98,
42287,3867.150767,3867.1609,1,116014523,116014827,304,0.15805567665359868
42288,3867.662467,3867.671433,1,116029874,116030142,268,0.06960500513562738
42289,3867.6826,3867.698367,1,116030478,116030951,473,0.34611532237287
42290,3867.7005,3867.704267,1,116031015,116031128,113,0.012032700723692693
42291,3867.748467,3867.754933,1,116032454,116032647,193,0.6532606280297089
42292,3867.7632,3867.766467,1,116032896,116032994,98,
42293,3868.3052,3868.321267,1,116049156,116049638,482,0.1910352711437941
42294,3868.324467,3868.3485,1,116049734,116050455,721,0.19506977081370863
42295,3868.425433,3868.4374,1,116052762,116053122,360,0.443040092748391
42296,3868.442267,3868.4647,1,116053268,116053941,673,0.0984279216469104
42297,3868.578133,3868.610733,1,116057343,116058321,978,0.43327211576065333
42298,3868.679467,3868.6871,1,116060384,116060613,229,0.26889291438928675
42299,3868.688833,3868.693367,1,116060664,116060801,137,0.5526920216942586
42300,3868.694367,3868.707767,1,116060831,116061233,402,0.4201166266993965
42301,3868.925133,3868.929233,1,116067753,116067876,123,0.06662189085589316
42302,3869.351633,3869.356267,1,116080548,116080688,140,0.17374157404862028
42303,3869.4489,3869.453633,1,116083467,116083608,141,0.37217144732009805
42304,3869.513267,3869.521967,1,116085398,116085659,261,0.4716146375715889
42305,3869.524333,3869.531667,1,116085729,116085950,221,-0.09693636795759625
42306,3869.5558,3869.5737,1,116086674,116087211,537,0.3732348939891502
42307,3869.585333,3869.599867,1,116087559,116087996,437,0.10033815993182561
42308,3869.6564,3869.6643,1,116089692,116089929,237,0.1949174392305219
42309,3869.695433,3869.7076,1,116090862,116091228,366,-0.0314681555426328
42310,3869.745133,3869.754133,1,116092353,116092623,270,-0.06989099907474614
42311,3869.76,3869.766833,1,116092800,116093004,204,-0.03376473077974657
42312,3869.794433,3869.805833,1,116093832,116094174,342,0.04670296970253094
42313,3869.814567,3869.820433,1,116094437,116094612,175,0.1962839076035491
42314,3869.823633,3869.829367,1,116094708,116094881,173,0.07688167058242092
42315,3869.830733,3869.838333,1,116094921,116095149,228,0.025326148029312885
42316,3869.848467,3869.854133,1,116095454,116095623,169,0.10881277271340052
42317,3869.872667,3869.885433,1,116096180,116096562,382,-0.07476837386191872
42318,3869.889033,3869.899433,1,116096670,116096982,312,0.02370268981631104
42319,3869.928333,3869.932367,1,116097849,116097971,122,-0.07329184626478832
42320,3869.933467,3869.943667,1,116098004,116098310,306,0.04455273850838813
42321,3869.945533,3869.9489,1,116098365,116098467,102,
42322,3869.9633,3869.968967,1,116098899,116099069,170,0.08842648558219929
42323,3869.987833,3869.9953,1,116099634,116099859,225,0.02680375696130035
42324,3870.0484,3870.0607,1,116101452,116101821,369,0.1131465437507725
42325,3870.099833,3870.1055,1,116102994,116103165,171,0.30237063761374555
42326,3870.1084,3870.113733,1,116103252,116103411,159,0.3606064161367347
42327,3870.1148,3870.122367,1,116103444,116103671,227,0.3440077516853125
