,onset,offset,label,onset_sample,offset_sample,length,corrcoeff
0,1.154633,1.1579,1,34638,34737,99,0.8194977083037307
1,6.368133,6.3796,1,191043,191388,345,0.6787615791299539
2,6.3988,6.4037,1,191964,192111,147,0.6107109865346901
3,6.410033,6.417067,1,192300,192512,212,0.7404971463536598
4,6.539433,6.577867,1,196182,197336,1154,0.6439669248443536
5,6.579567,6.583467,1,197387,197504,117,0.7144373848168977
6,6.597,6.6012,1,197910,198036,126,0.2582862577262447
7,6.702533,6.744233,1,201075,202326,1251,0.8379940028045463
8,6.766933,6.7846,1,203007,203538,531,0.36992869521862226
9,6.862233,6.873033,1,205866,206190,324,0.8835086850525132
10,6.874067,6.901133,1,206222,207033,811,0.8593154596757216
11,6.9278,6.953133,1,207834,208593,759,0.44726104377597714
12,7.039033,7.077767,1,211170,212333,1163,0.7560264296389279
13,7.091867,7.104233,1,212756,213126,370,0.35109374821678213
14,7.1097,7.1135,1,213291,213405,114,0.8182840100864522
15,7.118167,7.1392,1,213545,214176,631,0.19381132437559342
16,7.223,7.276767,1,216690,218303,1613,0.6368965263952475
17,7.291633,7.307767,1,218748,219233,485,0.5530266958000408
18,7.471833,7.498,1,224154,224940,786,0.2802165137175488
19,8.358667,8.361667,1,250760,250850,90,0.7942138169112746
20,10.139167,10.150167,1,304175,304505,330,0.3252439987121801
21,10.1756,10.191033,1,305268,305730,462,0.5782083891060099
22,12.488367,12.497867,1,374651,374936,285,0.4391851204742993
23,12.500867,12.5061,1,375026,375183,157,0.8898560560320038
24,12.562333,12.5681,1,376869,377043,174,0.9173491642799679
25,13.4176,13.4302,1,402528,402906,378,0.7107972491334359
26,13.445467,13.4596,1,403364,403788,424,0.5306751263542429
27,14.516133,14.521833,1,435483,435654,171,0.5672408822563176
28,14.530333,14.5345,1,435909,436035,126,0.928747073430503
29,15.389,15.399333,1,461670,461979,309,0.19266639510992487
30,15.402433,15.418633,1,462072,462558,486,0.5525941613541484
31,18.8997,18.903467,1,566991,567104,113,0.951969951049862
32,20.255367,20.2634,1,607661,607902,241,0.6518129136674232
33,20.277967,20.281367,1,608339,608441,102,0.8686359435322454
34,23.085733,23.089367,1,692571,692681,110,0.8741820650232535
35,23.175867,23.186,1,695276,695580,304,0.8989124888156874
36,25.277033,25.282767,1,758310,758483,173,0.703165630140906
37,26.552267,26.559333,1,796568,796779,211,0.77992684725546
38,31.085,31.0897,1,932550,932691,141,0.8142997601650441
39,31.1423,31.146867,1,934269,934406,137,0.8567480016046226
40,32.641133,32.651533,1,979233,979545,312,0.8533838783103949
41,33.371033,33.389267,1,1001130,1001678,548,0.7933619517014885
42,36.070233,36.079933,1,1082106,1082397,291,0.842003848916212
43,36.1106,36.122767,1,1083318,1083683,365,0.21927415732702588
44,36.124567,36.127967,1,1083737,1083839,102,0.5852442645745158
45,36.131533,36.15,1,1083945,1084500,555,0.2739362431532613
46,36.886133,36.891133,1,1106583,1106733,150,0.910148483250678
47,39.253833,39.271067,1,1177614,1178132,518,0.7295703086238108
48,40.817233,40.8216,1,1224516,1224648,132,0.7975196368511398
49,47.3092,47.312667,1,1419276,1419380,104,0.9137594638473986
50,47.402533,47.406267,1,1422075,1422188,113,0.8125037335502693
51,47.4198,47.4265,1,1422594,1422795,201,0.6614641158451914
52,48.019333,48.026467,1,1440579,1440794,215,0.7540412904065897
53,48.033433,48.040567,1,1441002,1441217,215,0.7726343043461561
54,50.292933,50.305733,1,1508787,1509171,384,0.11523349691868957
55,50.3105,50.3255,1,1509315,1509765,450,0.3168380422808511
56,54.1032,54.107833,1,1623096,1623234,138,0.8551833782424092
57,54.118567,54.125033,1,1623557,1623750,193,0.7365052609203336
58,54.151067,54.1644,1,1624532,1624932,400,0.12968835470448473
59,54.1663,54.1788,1,1624989,1625364,375,0.632324572151715
60,54.186167,54.192833,1,1625585,1625784,199,0.38642173142447694
61,54.2145,54.222067,1,1626435,1626662,227,0.2684769935641791
62,54.236167,54.251133,1,1627085,1627533,448,0.6911874572036186
63,55.3469,55.3512,1,1660407,1660536,129,0.6891129812156516
64,55.383,55.389467,1,1661490,1661684,194,0.693333280668786
65,55.671033,55.6742,1,1670130,1670226,96,0.7636036902582134
66,55.725567,55.731467,1,1671767,1671944,177,0.47408569148086854
67,55.7818,55.785433,1,1673454,1673562,108,0.8620348654629464
68,58.744533,58.7482,1,1762335,1762446,111,0.019449161687119392
69,59.805133,59.813833,1,1794153,1794414,261,0.2843147867188954
70,61.019367,61.0234,1,1830581,1830702,121,0.49538477951809595
71,62.8479,62.851633,1,1885437,1885548,111,0.7867331478702713
72,63.338867,63.342667,1,1900166,1900280,114,0.29428504094685864
73,63.464567,63.500133,1,1903937,1905003,1066,0.6692033182398887
74,63.5123,63.5244,1,1905369,1905732,363,0.37827594014839105
75,63.677633,63.683733,1,1910328,1910511,183,0.6158882551120491
76,63.8033,63.806933,1,1914099,1914207,108,0.2655081204825418
77,63.8911,63.896867,1,1916733,1916906,173,0.7172438150118482
78,63.9404,63.943967,1,1918212,1918319,107,0.22231601326405395
79,64.645533,64.650433,1,1939365,1939512,147,0.3995197687126858
80,64.831933,64.838333,1,1944957,1945149,192,0.4093693843651288
81,65.070567,65.080767,1,1952117,1952423,306,0.4374917047265291
82,65.081867,65.091233,1,1952456,1952736,280,0.7363123358809379
83,65.108967,65.1517,1,1953269,1954551,1282,0.39644593168443154
84,65.1616,65.181,1,1954848,1955430,582,0.19221060634513015
85,65.1836,65.3032,1,1955508,1959096,3588,0.5235730599204661
86,65.305067,65.309267,1,1959152,1959278,126,0.9490418865675644
87,65.321767,65.324967,1,1959653,1959749,96,0.9362913395315543
88,65.328,65.338033,1,1959840,1960140,300,0.8943974647799792
89,65.339467,65.355467,1,1960184,1960664,480,0.635461343448932
90,65.357033,65.360067,1,1960710,1960802,92,0.9381574169407081
91,65.361667,65.4533,1,1960850,1963599,2749,0.4525811372671906
92,65.460633,65.483067,1,1963818,1964492,674,0.6474011391352701
93,65.489267,65.516733,1,1964678,1965501,823,0.35652874456944844
94,65.552567,65.5557,1,1966577,1966671,94,0.9297538447342729
95,65.565,65.584033,1,1966950,1967520,570,0.9083262220830283
96,65.590967,65.637867,1,1967729,1969136,1407,0.40587780594714007
97,65.643933,65.654267,1,1969317,1969628,311,0.7621203266100068
98,65.6564,65.6636,1,1969692,1969908,216,0.6256656646271135
99,65.668,65.6715,1,1970040,1970144,104,0.8153179597262284
100,65.6948,65.712267,1,1970844,1971368,524,0.6855769864936471
101,65.7329,65.736733,1,1971987,1972101,114,0.8981655210028251
102,65.738067,65.760133,1,1972142,1972803,661,0.40448779405416896
103,65.7619,65.773,1,1972857,1973190,333,0.8529349345925487
104,65.778733,65.794133,1,1973361,1973823,462,0.7482146308918723
105,65.798767,65.810067,1,1973963,1974302,339,0.811746590681448
106,65.8114,65.8144,1,1974342,1974432,90,0.9448056303809916
107,65.824733,65.859467,1,1974741,1975784,1043,0.6460333195960835
108,65.862833,65.8782,1,1975884,1976346,462,0.8560940406069015
109,65.8907,65.915967,1,1976720,1977479,759,0.35539049161030545
110,65.921533,65.9276,1,1977645,1977828,183,0.9662284034649138
111,65.933833,65.9455,1,1978014,1978364,350,0.6889290595776217
112,65.9465,65.9763,1,1978395,1979288,893,0.5585762778030485
113,65.988467,66.006167,1,1979654,1980185,531,0.46163032585563285
114,66.0159,66.027233,1,1980477,1980816,339,0.9085242323936727
115,66.0297,66.039433,1,1980891,1981182,291,0.884172923448134
116,66.0471,66.0503,1,1981413,1981508,95,0.9524850827489673
117,66.066633,66.0736,1,1981998,1982208,210,0.5653648134849557
118,66.0772,66.0822,1,1982316,1982466,150,0.6293297713173803
119,66.353867,66.358733,1,1990616,1990761,145,0.27691351701050615
120,66.364767,66.369733,1,1990943,1991091,148,0.3962399746336298
121,66.381433,66.387533,1,1991442,1991625,183,0.2840983728740185
122,66.392733,66.4001,1,1991781,1992002,221,0.7491924107754824
123,66.4069,66.414533,1,1992206,1992435,229,0.7928190137723297
124,66.4161,66.4281,1,1992483,1992843,360,0.42735505732953066
125,66.4612,66.467033,1,1993836,1994010,174,0.002453375903773449
126,66.747133,66.7537,1,2002413,2002610,197,0.9870143996755721
127,66.788533,66.7942,1,2003655,2003826,171,0.24316281198156106
128,66.827933,66.832167,1,2004837,2004965,128,0.43909936683117656
129,67.307533,67.311833,1,2019225,2019354,129,0.696478311164374
130,67.346967,67.351833,1,2020409,2020554,145,0.3272937130289843
131,67.390933,67.394767,1,2021727,2021843,116,0.7260444377430134
132,68.256733,68.262367,1,2047701,2047871,170,0.8013472123730504
133,68.265867,68.272967,1,2047976,2048189,213,0.7431632130680269
134,68.274233,68.3414,1,2048226,2050241,2015,0.48332496635198985
135,68.347333,68.4119,1,2050419,2052357,1938,0.40921453810800423
136,68.4142,68.417867,1,2052425,2052536,111,0.5296017271042714
137,68.4216,68.425167,1,2052648,2052755,107,0.5034431401264835
138,68.432133,68.455067,1,2052963,2053652,689,0.8399160106357513
139,68.472333,68.4908,1,2054169,2054723,554,0.36502004642479163
140,68.504333,68.514333,1,2055129,2055429,300,0.15675669960853747
141,68.525367,68.5298,1,2055761,2055893,132,0.6840995257374752
142,68.5308,68.555,1,2055924,2056650,726,0.3652396795309592
143,68.558867,68.570467,1,2056766,2057114,348,0.12693930302644457
144,68.717267,68.729767,1,2061518,2061893,375,0.4736866570181984
145,68.831,68.836667,1,2064930,2065100,170,0.68242594594915
146,69.614267,69.618667,1,2088428,2088560,132,0.7942698852604203
147,69.6434,69.651667,1,2089302,2089550,248,0.8142164081906166
148,69.657233,69.6735,1,2089716,2090205,489,0.7807541407832305
149,69.680633,69.686833,1,2090418,2090604,186,0.808544306585186
150,69.689767,69.6934,1,2090693,2090802,109,0.7509374698015172
151,69.694533,69.700833,1,2090835,2091024,189,0.9183712144639951
152,69.707667,69.7452,1,2091230,2092356,1126,0.6915618293055603
153,69.748933,69.7526,1,2092467,2092578,111,0.8832919176762923
154,69.7559,69.7815,1,2092677,2093444,767,0.22354113621553107
155,69.783633,69.7931,1,2093508,2093792,284,0.5531680560985113
156,69.866333,69.874667,1,2095989,2096240,251,0.4574011759691792
157,69.8762,69.902367,1,2096286,2097071,785,0.6152235685120275
158,69.921833,69.932467,1,2097654,2097974,320,0.17215898819045186
159,70.012333,70.016267,1,2100369,2100488,119,0.3563200046554992
160,70.079567,70.085467,1,2102387,2102564,177,0.7929388178466936
161,70.136033,70.1407,1,2104080,2104221,141,0.7756577465422865
162,70.141867,70.163967,1,2104256,2104919,663,0.5154299221032131
163,70.1791,70.185533,1,2105373,2105565,192,0.6795116266149206
164,70.186967,70.2195,1,2105609,2106585,976,0.7627946662279153
165,70.229167,70.258233,1,2106875,2107746,871,0.3709059995804518
166,70.3198,70.323833,1,2109594,2109714,120,0.5331036046235881
167,70.351833,70.383767,1,2110554,2111513,959,0.6452989640917737
168,70.4052,70.4176,1,2112156,2112528,372,0.1904131127379913
169,70.449433,70.456367,1,2113482,2113691,209,0.20085610606650492
170,70.480833,70.488,1,2114424,2114640,216,0.17330813827820027
171,70.535367,70.571,1,2116061,2117130,1069,0.736859370333226
172,70.587133,70.5986,1,2117613,2117958,345,0.40574380153065853
173,70.599867,70.606267,1,2117996,2118188,192,0.012775385974048604
174,70.626833,70.6335,1,2118804,2119005,201,0.4705454988630025
175,70.656967,70.662833,1,2119709,2119884,175,0.30981549587062174
176,70.673367,70.677833,1,2120201,2120334,133,0.6763287118303013
177,70.685667,70.694533,1,2120570,2120835,265,0.7736042805070343
178,70.7053,70.7204,1,2121159,2121612,453,0.6504888726298927
179,70.7215,70.7252,1,2121645,2121756,111,0.9165450554874947
180,70.7309,70.7383,1,2121927,2122149,222,0.7084696892925819
181,70.770833,70.774533,1,2123124,2123235,111,0.3622735767138308
182,71.088467,71.093967,1,2132654,2132819,165,0.6650158161771745
183,71.678733,71.6991,1,2150361,2150973,612,0.38142739749506244
184,71.711033,71.727833,1,2151330,2151834,504,0.28597082897973497
185,71.778133,71.789833,1,2153343,2153694,351,0.32765902435239586
186,71.908533,71.9204,1,2157255,2157612,357,0.3673804731904421
187,71.946933,71.9522,1,2158407,2158566,159,0.6221772667676211
188,72.090033,72.107467,1,2162700,2163224,524,0.42867240657697153
189,72.137733,72.141333,1,2164131,2164239,108,0.8611961790733523
190,72.1428,72.146567,1,2164284,2164397,113,0.5208948041532182
191,72.148433,72.157433,1,2164452,2164722,270,0.10593342443081764
192,72.1714,72.185267,1,2165142,2165558,416,0.5987289905973803
193,72.454233,72.4573,1,2173626,2173719,93,0.22994134847977823
194,72.7753,72.781667,1,2183259,2183450,191,0.3359943554852599
195,72.868933,72.874867,1,2186067,2186246,179,0.7065689567640374
196,72.964667,72.9828,1,2188940,2189484,544,0.21406344346900205
197,72.9951,73.009267,1,2189853,2190278,425,0.4885967010508093
198,73.376567,73.3885,1,2201297,2201655,358,0.7656003561403294
199,73.390667,73.400167,1,2201720,2202005,285,0.22973765883311287
200,73.659667,73.664233,1,2209790,2209926,136,0.7262085483506062
201,73.6662,73.686067,1,2209986,2210582,596,0.47302729188885795
202,73.703467,73.721333,1,2211104,2211639,535,0.43725899171827803
203,73.763567,73.766833,1,2212907,2213004,97,0.32577403650578496
204,73.811633,73.816267,1,2214348,2214488,140,0.5917229433241465
205,73.8227,73.8358,1,2214681,2215074,393,0.2942943839192749
206,73.852067,73.867467,1,2215562,2216024,462,0.571983531827105
207,73.9034,73.9076,1,2217102,2217228,126,0.430817238336405
208,73.942533,73.9478,1,2218275,2218434,159,0.8436729073710614
209,74.1687,74.1759,1,2225061,2225277,216,0.3542508474852854
210,74.320933,74.339467,1,2229627,2230184,557,0.2700041303001097
211,74.414567,74.4203,1,2232437,2232609,172,0.38539858597682813
212,74.516933,74.5357,1,2235507,2236071,564,0.21540088632559373
213,74.546433,74.555933,1,2236392,2236677,285,0.25570224092138116
214,74.565167,74.5729,1,2236955,2237187,232,0.2414622575200783
215,74.600067,74.606367,1,2238002,2238191,189,0.25044638782423934
216,74.7551,74.760133,1,2242653,2242803,150,0.5797515720020252
217,74.768833,74.774033,1,2243064,2243220,156,0.40608680589812096
218,74.775867,74.794533,1,2243276,2243835,559,0.45308315414257255
219,74.796067,74.801633,1,2243882,2244048,166,-0.06998015026415821
220,75.9928,76.006033,1,2279784,2280180,396,0.0818853392267778
221,76.0573,76.074833,1,2281719,2282244,525,0.12616978996478925
222,76.079367,76.1081,1,2282381,2283243,862,0.2969905611361047
223,76.1157,76.129233,1,2283471,2283876,405,0.8846009614556152
224,76.486167,76.494767,1,2294585,2294843,258,0.3148813952970967
225,76.496,76.512467,1,2294880,2295374,494,0.46838068606648126
226,76.8158,76.821267,1,2304474,2304638,164,0.5408972245744831
227,77.8713,77.874333,1,2336139,2336229,90,0.3924405614902424
228,79.233667,79.411567,1,2377010,2382347,5337,0.18241809727141142
229,79.6337,79.654933,1,2389011,2389647,636,0.8648319591035274
230,79.656433,79.669667,1,2389692,2390090,398,0.8820339152544887
231,79.681567,79.6907,1,2390447,2390721,274,0.10015589808602582
232,79.7686,79.771933,1,2393058,2393157,99,0.3638581079322324
233,79.8596,79.874367,1,2395788,2396231,443,0.35014883054612855
234,79.909233,79.914933,1,2397276,2397447,171,0.20406238356816073
235,80.103767,80.120333,1,2403113,2403609,496,0.2648660769521681
236,80.1317,80.143333,1,2403951,2404299,348,0.8032179664054465
237,80.1531,80.160567,1,2404593,2404817,224,0.8360484564901992
238,80.1726,80.1907,1,2405178,2405721,543,0.8792964992693637
239,80.195133,80.232367,1,2405853,2406971,1118,0.5848357360894351
240,80.2334,80.2555,1,2407002,2407665,663,0.8180369572029748
241,80.276067,80.2805,1,2408282,2408415,133,0.924396305604833
242,80.2824,80.318333,1,2408472,2409549,1077,0.4071128301366956
243,80.886633,80.894767,1,2426598,2426843,245,0.440281006308767
244,80.9311,80.961167,1,2427933,2428835,902,0.8114614566221898
245,80.968033,80.9866,1,2429040,2429598,558,0.43365299789836115
246,81.186767,81.195733,1,2435603,2435871,268,0.7899199392534486
247,81.199133,81.203333,1,2435973,2436099,126,0.8967535445617872
248,81.2084,81.2133,1,2436252,2436399,147,0.83043792679227
249,81.2189,81.222933,1,2436567,2436687,120,-0.12445952580496378
250,81.2249,81.244767,1,2436747,2437343,596,0.11490108296853037
251,81.256867,81.267967,1,2437706,2438039,333,0.029001207209819007
252,81.331633,81.3382,1,2439948,2440146,198,0.8886356592066234
253,81.341067,81.365133,1,2440232,2440953,721,0.6756718730219352
254,81.3759,81.3907,1,2441277,2441721,444,-0.06710462322687709
255,83.087333,83.090967,1,2492619,2492729,110,0.07678738750899813
256,83.143567,83.165867,1,2494307,2494976,669,0.3888080041669222
257,83.774767,83.926033,1,2513243,2517780,4537,0.6918762594798541
258,83.9327,83.976,1,2517981,2519280,1299,0.5891863195897458
259,84.4546,84.463167,1,2533638,2533895,257,0.8583451829779634
260,84.4721,84.491067,1,2534163,2534732,569,0.8767295880377467
261,84.5059,84.5141,1,2535177,2535423,246,0.218910875388468
262,84.606533,84.6445,1,2538195,2539335,1140,0.6950584063426304
263,84.6511,84.6767,1,2539533,2540301,768,0.26827427131004244
264,84.724867,84.735867,1,2541746,2542076,330,0.1171949671121038
265,84.7526,84.7895,1,2542578,2543685,1107,0.5530841620891622
266,84.801933,84.8233,1,2544057,2544699,642,0.16075901814101748
267,84.921533,84.9437,1,2547645,2548311,666,0.5564730022901229
268,84.954133,84.985467,1,2548623,2549564,941,0.41801866952788386
269,85.006133,85.009567,1,2550183,2550287,104,0.871583082447081
270,85.143867,85.1743,1,2554316,2555229,913,0.7596542714812431
271,85.175567,85.185133,1,2555267,2555553,286,0.32687397240096394
272,85.2001,85.204933,1,2556003,2556147,144,-0.06619343303102584
273,85.2676,85.2965,1,2558028,2558895,867,0.340389704643122
274,85.3335,85.3712,1,2560005,2561136,1131,0.5968188801364496
275,85.391833,85.4045,1,2561754,2562135,381,0.5763321131272748
276,86.604767,86.755933,1,2598143,2602677,4534,0.6333135993399758
277,86.757933,86.761167,1,2602737,2602835,98,0.6386426266857331
278,86.764167,86.7905,1,2602925,2603715,790,0.5220168870413443
279,87.855633,87.860833,1,2635668,2635824,156,0.40750277404787005
280,87.873833,87.880133,1,2636214,2636403,189,0.5121096898699868
281,87.883567,87.8926,1,2636507,2636778,271,0.3542369039029665
282,88.217,88.224367,1,2646510,2646731,221,0.4656947702612582
283,88.499767,88.5154,1,2654993,2655462,469,0.5967223714128078
284,88.5374,88.5461,1,2656122,2656383,261,0.0970173489815109
285,88.583333,88.5864,1,2657499,2657592,93,0.40764867126481047
286,88.937967,88.9828,1,2668139,2669484,1345,0.5164971848708274
287,89.263567,89.269367,1,2677907,2678081,174,0.8369895757159673
288,89.276367,89.4292,1,2678291,2682876,4585,0.6828889494328967
289,89.430333,89.476,1,2682909,2684280,1371,0.7364292106828679
290,89.491567,89.494733,1,2684747,2684841,94,0.6779044689863497
291,89.733033,89.741533,1,2691990,2692245,255,0.2224917550343462
292,89.8676,89.899933,1,2696028,2696997,969,0.7231009038817607
293,89.905567,89.933467,1,2697167,2698004,837,0.1542297872785879
294,89.989433,90.045933,1,2699682,2701377,1695,0.49766616792191853
295,90.0576,90.062167,1,2701728,2701865,137,0.20664869236571498
296,90.0636,90.0773,1,2701908,2702319,411,0.1946117257770764
297,90.2045,90.2093,1,2706135,2706279,144,0.7846359256010961
298,90.2186,90.223667,1,2706558,2706710,152,0.9403610365460066
299,90.228967,90.237467,1,2706869,2707124,255,0.8152082487041215
300,90.2403,90.243667,1,2707209,2707310,101,0.5515712208857103
301,90.2717,90.274767,1,2708151,2708243,92,0.8692527570905546
302,90.5289,90.533533,1,2715867,2716005,138,0.2587572247529212
303,90.540567,90.5742,1,2716217,2717226,1009,0.5388124511504442
304,90.583467,90.615533,1,2717504,2718465,961,0.11762539661870523
305,90.868833,90.872367,1,2726064,2726171,107,0.19632984240035162
306,90.953,90.9945,1,2728590,2729835,1245,0.6670742809045811
307,91.005467,91.034733,1,2730164,2731041,877,0.17509040849464136
308,91.1466,91.178867,1,2734398,2735366,968,0.4978406785744719
309,91.1885,91.210233,1,2735655,2736306,651,0.08248537114479673
310,91.267767,91.271,1,2738033,2738130,97,0.7758844043855134
311,91.517133,91.5283,1,2745513,2745849,336,0.3876213504065337
312,91.543967,91.739333,1,2746319,2752179,5860,0.7247560687541417
313,91.7421,91.7669,1,2752263,2753007,744,0.6507769735044913
314,91.768467,91.781233,1,2753054,2753436,382,0.6107078156076422
315,91.906967,91.913333,1,2757209,2757399,190,0.49061799140647344
316,91.966333,91.9716,1,2758989,2759148,159,0.9186818082061528
317,91.9726,91.999333,1,2759178,2759979,801,0.6121896345835103
318,92.019,92.032733,1,2760570,2760981,411,0.21082222358037594
319,92.070333,92.077233,1,2762109,2762316,207,0.12607948631327717
320,92.092433,92.119467,1,2762772,2763584,812,0.38665373997558367
321,92.120467,92.162433,1,2763614,2764872,1258,0.2799695646200087
322,92.1849,92.203,1,2765547,2766090,543,0.25280889503750426
323,92.276933,92.283033,1,2768307,2768490,183,0.3452610643224634
324,92.783833,92.882867,1,2783514,2786486,2972,0.3584267551523314
325,92.884,92.912867,1,2786520,2787386,866,0.27757987382441585
326,92.923933,93.015933,1,2787717,2790477,2760,0.34431427804803316
327,93.017433,93.061333,1,2790522,2791839,1317,0.5014826169551506
328,93.2073,93.216133,1,2796219,2796483,264,0.9660192698700895
329,93.2441,93.2474,1,2797323,2797422,99,0.5624269164795749
330,94.415167,94.4241,1,2832455,2832723,268,0.8460928430336705
331,94.433567,94.443667,1,2833007,2833310,303,0.6269345819468993
332,94.448067,94.487567,1,2833442,2834627,1185,0.7329003261489608
333,94.493367,94.602167,1,2834801,2838065,3264,0.664756019753583
334,94.6223,94.674033,1,2838669,2840220,1551,0.5325677408308463
335,95.169233,95.185033,1,2855076,2855550,474,0.5164716797409222
336,95.189767,95.1928,1,2855693,2855784,91,0.5446958691978645
337,95.213933,95.226,1,2856417,2856780,363,0.26366122192865343
338,95.232533,95.257,1,2856975,2857710,735,0.7721957115144038
339,96.063433,96.082833,1,2881902,2882484,582,0.30839374709302453
340,96.101867,96.1145,1,2883056,2883435,379,0.24879928576652138
341,96.134467,96.144833,1,2884034,2884344,310,0.7416008201882919
342,96.1464,96.1533,1,2884392,2884599,207,0.8719043434145862
343,96.759367,96.9138,1,2902781,2907414,4633,0.7041557025269399
344,96.917233,96.934,1,2907516,2908020,504,0.6121237503615163
345,96.936,96.956133,1,2908080,2908683,603,0.49426084928362396
346,97.0066,97.013267,1,2910198,2910398,200,0.36114699158874286
347,97.018967,97.0333,1,2910569,2910999,430,0.8403437261847112
348,97.0346,97.046267,1,2911038,2911388,350,0.8798155417235596
349,97.385033,97.388167,1,2921550,2921645,95,-0.48481790657026225
350,97.874033,97.886167,1,2936220,2936585,365,0.302934600131861
351,99.016,99.0377,1,2970480,2971131,651,0.2671190770291248
352,100.752933,100.7571,1,3022587,3022713,126,0.6089924975511896
353,100.770067,100.7732,1,3023102,3023196,94,0.8798524020784737
354,100.778033,100.781267,1,3023340,3023438,98,0.711993307811534
355,100.801667,100.807167,1,3024050,3024215,165,0.5712905146726862
356,100.8671,100.873067,1,3026013,3026192,179,0.6895419280564464
357,100.991,100.997067,1,3029730,3029912,182,0.017803174192169674
358,101.196767,101.202767,1,3035903,3036083,180,0.7064935405181405
359,101.222233,101.389,1,3036666,3041670,5004,0.7390423733487866
360,101.3923,101.4339,1,3041769,3043017,1248,0.7045929304019152
361,101.4726,101.493233,1,3044178,3044796,618,0.48063484757457714
362,101.499667,101.5202,1,3044990,3045606,616,0.4276604020386974
363,101.615167,101.6214,1,3048455,3048642,187,0.8455868475933513
364,101.7406,101.744633,1,3052218,3052338,120,0.38814328582391583
365,101.843167,101.848133,1,3055295,3055443,148,0.8246520293965003
366,102.2056,102.213033,1,3066168,3066390,222,0.47831127794605965
367,102.3762,102.382167,1,3071286,3071465,179,0.5377025057012361
368,102.389167,102.399867,1,3071675,3071996,321,0.7659055262571377
369,102.413867,102.417633,1,3072416,3072528,112,0.6029422555947974
370,102.452567,102.4574,1,3073577,3073722,145,0.4090385885824449
371,102.499167,102.507333,1,3074975,3075219,244,0.004781558225290647
372,102.663633,102.6733,1,3079908,3080199,291,0.7601653058255616
373,103.8006,103.884433,1,3114018,3116532,2514,0.24340246955866737
374,103.911667,103.925867,1,3117350,3117776,426,0.08765680198874412
375,103.9416,103.966933,1,3118248,3119007,759,0.26229214241785187
376,103.9733,103.9775,1,3119199,3119325,126,0.41316751879166613
377,103.981167,103.996767,1,3119435,3119903,468,0.3147865806615387
378,104.017767,104.0513,1,3120533,3121539,1006,0.2550900339211242
379,104.060133,104.102067,1,3121803,3123062,1259,0.7141571516336368
380,104.104633,104.126767,1,3123138,3123803,665,0.34667317732396163
381,104.372533,104.397333,1,3131175,3131919,744,0.3547943674204657
382,104.4142,104.421233,1,3132426,3132636,210,0.7533803982220075
383,104.46,104.471567,1,3133800,3134147,347,0.5358187191562783
384,104.492767,104.649533,1,3134783,3139485,4702,0.6926071028367754
385,104.652933,104.676,1,3139587,3140280,693,0.5649175836001091
386,104.862367,104.869,1,3145871,3146070,199,0.7913000814055098
387,104.870333,104.8851,1,3146109,3146553,444,0.7296634622146912
388,104.8867,104.891933,1,3146601,3146757,156,0.8937162647597289
389,105.416067,105.4387,1,3162482,3163161,679,0.3977750710062863
390,105.672133,105.676233,1,3170163,3170286,123,0.5393418610704452
391,106.879367,107.031567,1,3206381,3210947,4566,0.7181207774690632
392,107.034633,107.089867,1,3211038,3212696,1658,0.6987714120134114
393,107.181967,107.203167,1,3215459,3216095,636,0.7519406073652071
394,107.210333,107.213533,1,3216309,3216405,96,0.9287705401589255
395,107.2301,107.2869,1,3216903,3218607,1704,0.16548968480327547
396,107.2942,107.3838,1,3218826,3221514,2688,0.286604015252735
397,107.389267,107.4547,1,3221678,3223641,1963,0.20513001491023997
398,107.458967,107.5447,1,3223769,3226341,2572,0.15292383742180735
399,107.559833,107.6723,1,3226794,3230169,3375,0.1618484231738601
400,107.6746,107.751067,1,3230238,3232532,2294,0.20464747364870642
401,107.779567,107.789933,1,3233387,3233697,310,0.6331561453378167
402,107.7928,107.811033,1,3233784,3234330,546,0.4602457660494846
403,107.8161,107.863133,1,3234483,3235893,1410,0.11603757651512638
404,107.8642,107.871633,1,3235926,3236148,222,0.04156714784443587
405,107.8808,107.896267,1,3236424,3236888,464,0.0848621094752891
406,107.899667,107.909567,1,3236990,3237287,297,0.2054785632784741
407,107.916167,107.929,1,3237485,3237870,385,0.6883184268759747
408,107.930833,107.9503,1,3237924,3238509,585,0.6306181502003068
409,107.9582,108.003467,1,3238746,3240104,1358,0.18429205158860842
410,108.0482,108.0521,1,3241446,3241563,117,0.4467360586995508
411,108.058267,108.091833,1,3241748,3242754,1006,0.192214413279305
412,108.0971,108.145467,1,3242913,3244364,1451,0.17527992610210893
413,108.496067,108.499867,1,3254882,3254996,114,0.9034153366425602
414,108.507167,108.517433,1,3255215,3255522,307,0.8506242691897751
415,108.549633,108.553133,1,3256488,3256593,105,0.8963553980113675
416,108.7279,108.761033,1,3261837,3262830,993,0.2798892048385424
417,108.7625,108.7675,1,3262875,3263025,150,0.5559280067884651
418,108.784467,108.794067,1,3263534,3263822,288,0.3196691649296172
419,108.828033,108.832633,1,3264840,3264978,138,0.5617225440711644
420,109.421033,109.426667,1,3282630,3282800,170,0.9798063646242857
421,109.4283,109.4554,1,3282849,3283662,813,0.41825048515260416
422,109.558367,109.566167,1,3286751,3286985,234,0.3354418584538297
423,109.6843,109.6971,1,3290529,3290913,384,0.42009301144251265
424,109.698133,109.7226,1,3290943,3291678,735,0.5531686155637285
425,109.739467,109.755267,1,3292184,3292658,474,0.3678701595015737
426,109.798467,109.8126,1,3293954,3294378,424,0.7084200478054457
427,110.306167,110.310567,1,3309185,3309317,132,0.31908333751979845
428,110.686267,110.741633,1,3320588,3322248,1660,0.15482340749818296
429,110.754367,110.7778,1,3322631,3323334,703,0.16969827269571852
430,110.780733,110.792433,1,3323421,3323772,351,0.8435186677449867
431,110.793633,110.823767,1,3323808,3324713,905,0.20224382806171118
432,110.8256,110.850733,1,3324768,3325521,753,0.582560208901364
433,110.8556,110.8755,1,3325668,3326265,597,0.28198436021071827
434,110.888967,110.959733,1,3326669,3328791,2122,0.32950345584181123
435,111.33,111.392133,1,3339900,3341763,1863,0.10947134934258142
436,111.405333,111.422167,1,3342159,3342665,506,0.1846179019391271
437,111.4381,111.474967,1,3343143,3344249,1106,0.23099996768169673
438,111.482467,111.5004,1,3344474,3345012,538,0.24347609456530256
439,111.562833,111.721033,1,3346884,3351630,4746,0.6523924012543455
440,111.7221,111.7469,1,3351663,3352407,744,0.7495882554431504
441,111.748133,111.751567,1,3352443,3352547,104,0.5449527817961758
442,111.984233,112.021033,1,3359526,3360630,1104,0.229583195939955
443,112.527067,112.530233,1,3375812,3375906,94,0.7046765617519622
444,114.0394,114.043233,1,3421182,3421296,114,0.5712902594946
445,114.6194,114.7013,1,3438582,3441039,2457,0.16312472809160192
446,114.705867,114.711733,1,3441176,3441351,175,0.5634870498706728
447,114.713567,114.7813,1,3441407,3443439,2032,0.20987473864426315
448,114.7882,114.819067,1,3443646,3444572,926,0.28160502355118366
449,114.821967,114.827833,1,3444659,3444834,175,0.859993335875485
450,114.833033,114.845967,1,3444990,3445379,389,0.8329436003054063
451,114.8517,114.865433,1,3445551,3445962,411,0.25130028532777315
452,114.8735,114.8955,1,3446205,3446865,660,0.6935232605990287
453,114.901433,114.914733,1,3447042,3447441,399,0.7223616435317347
454,114.9165,114.924567,1,3447495,3447737,242,0.9105668344213954
455,114.925633,114.967833,1,3447768,3449034,1266,0.8010720305231039
456,114.969333,114.9751,1,3449079,3449253,174,0.8105566491977931
457,114.9764,115.0005,1,3449292,3450015,723,0.6311551570406487
458,115.006533,115.0298,1,3450195,3450894,699,0.6340621353866553
459,115.030967,115.047767,1,3450929,3451433,504,0.8344559367869524
460,115.049933,115.059333,1,3451497,3451779,282,0.6512823967141372
461,115.077033,115.1152,1,3452310,3453456,1146,0.6990596711198449
462,115.137867,115.1464,1,3454136,3454392,256,0.8194394624531477
463,115.147667,115.178733,1,3454430,3455361,931,0.29488343038916937
464,115.180133,115.2227,1,3455403,3456681,1278,0.5201027594939037
465,115.231933,115.259067,1,3456957,3457772,815,0.22528910262715982
466,115.2998,115.318433,1,3458994,3459552,558,0.8868489328733392
467,115.321133,115.3343,1,3459633,3460029,396,0.610974596151897
468,115.344167,115.3687,1,3460325,3461061,736,0.15984588062254795
469,115.748067,115.753867,1,3472442,3472616,174,0.7955914380613174
470,115.8021,115.8332,1,3474063,3474996,933,0.6070104747776738
471,115.834467,115.847067,1,3475034,3475412,378,0.8925221234097918
472,115.895133,115.908733,1,3476853,3477261,408,0.8111676528029209
473,115.919567,115.9779,1,3477587,3479337,1750,0.7209182945145515
474,115.9795,115.983033,1,3479385,3479490,105,0.8553118354801059
475,115.9977,116.0175,1,3479931,3480525,594,0.32359390673191696
476,116.019667,116.052967,1,3480590,3481589,999,0.8356576295171282
477,116.075767,116.085033,1,3482273,3482550,277,0.5678576951615314
478,116.2803,116.284167,1,3488409,3488525,116,0.42900626105991024
479,116.3417,116.3488,1,3490251,3490464,213,0.6526530585732676
480,116.771067,116.774233,1,3503132,3503226,94,-0.04546572010282858
481,117.040567,117.052433,1,3511217,3511572,355,0.8669279767415473
482,117.4982,117.506833,1,3524946,3525204,258,0.7281715867957157
483,117.6518,117.655167,1,3529554,3529655,101,0.9656502690290018
484,117.656233,117.688967,1,3529686,3530669,983,0.5238473319963415
485,117.744133,117.7539,1,3532323,3532617,294,0.8687031397413049
486,117.7922,117.795933,1,3533766,3533877,111,0.900994060944443
487,117.809267,117.816467,1,3534278,3534494,216,0.3914014944735671
488,117.857733,117.860833,1,3535731,3535824,93,0.9066604697742591
489,118.051767,118.055533,1,3541553,3541665,112,0.31184082880310454
490,118.398567,118.401633,1,3551957,3552048,91,0.8128740435586223
491,118.6806,118.6863,1,3560418,3560589,171,0.8321859532808857
492,118.727233,118.736667,1,3561816,3562100,284,0.32113241277871485
493,118.746667,118.750067,1,3562400,3562502,102,0.7966359712699866
494,119.032333,119.037033,1,3570969,3571110,141,0.8615678875184651
495,119.0436,119.1044,1,3571308,3573132,1824,0.14115053170845934
496,119.122133,119.137333,1,3573663,3574119,456,0.26813262622487977
497,119.1518,119.253033,1,3574554,3577590,3036,0.18811092257434378
498,119.2544,119.281967,1,3577632,3578459,827,0.23969767745536188
499,119.306167,119.318733,1,3579185,3579561,376,0.7885925288829221
500,119.3206,119.327967,1,3579618,3579839,221,0.8843261668758559
501,119.3305,119.341867,1,3579915,3580256,341,0.8499025962031489
502,119.356167,119.372633,1,3580685,3581178,493,0.19240626839959427
503,120.334533,120.354167,1,3610035,3610625,590,0.35953119943998557
504,120.364133,120.3781,1,3610923,3611343,420,0.45965135429401294
505,120.383967,120.3965,1,3611519,3611895,376,0.44692783470617786
506,120.405667,120.4441,1,3612170,3613323,1153,0.15220922542317933
507,120.473333,120.5136,1,3614199,3615408,1209,0.8437229096513047
508,120.521167,120.539333,1,3615635,3616179,544,0.27896852825591684
509,120.637633,120.691967,1,3619128,3620759,1631,0.19316968203277982
510,120.700833,120.769467,1,3621024,3623084,2060,0.24669375615293915
511,120.778233,120.783533,1,3623346,3623505,159,0.8224788516286061
512,120.786533,120.859733,1,3623595,3625791,2196,0.1325949981513585
513,120.861833,120.894,1,3625854,3626820,966,0.23222305573463278
514,120.895,120.960233,1,3626850,3628806,1956,0.1729830891594205
515,120.979967,121.012433,1,3629399,3630372,973,0.6231280117013418
516,121.016333,121.072033,1,3630489,3632160,1671,0.18082868316164205
517,121.080033,121.094667,1,3632400,3632840,440,0.3866989409497036
518,121.100233,121.120433,1,3633006,3633612,606,0.7609343859788265
519,121.121833,121.1434,1,3633654,3634302,648,0.5159301711648417
520,121.1498,121.185433,1,3634494,3635562,1068,0.3408348997348057
521,121.189167,121.200933,1,3635675,3636027,352,0.22124472365383765
522,121.244233,121.2657,1,3637326,3637971,645,0.27530381391167597
523,121.266767,121.282133,1,3638003,3638463,460,0.37563020571843303
524,121.2911,121.341133,1,3638733,3640233,1500,0.24068876313483895
525,121.3729,121.388067,1,3641187,3641642,455,0.3711852411288007
526,121.391467,121.4008,1,3641744,3642024,280,0.0764753964977231
527,121.407767,121.424733,1,3642233,3642741,508,0.6343585392024645
528,121.434533,121.487167,1,3643035,3644615,1580,0.11512320032118482
529,121.542,121.5872,1,3646260,3647616,1356,0.452527789437455
530,121.5892,121.6369,1,3647676,3649107,1431,0.29335188513161237
531,121.7289,121.764933,1,3651867,3652947,1080,0.7107492959119268
532,121.778133,121.8025,1,3653343,3654075,732,0.3636099961867328
533,121.8035,121.807,1,3654105,3654210,105,0.76966140792412
534,121.979833,121.985667,1,3659394,3659570,176,0.8979788835697579
535,122.142533,122.1548,1,3664275,3664644,369,0.37274030336894276
536,122.2122,122.2266,1,3666366,3666798,432,0.42141370582083804
537,122.246267,122.2581,1,3667388,3667743,355,0.645931835301641
538,122.277567,122.300733,1,3668327,3669021,694,0.7194556713100623
539,122.3059,122.3232,1,3669177,3669696,519,0.8366076902863352
540,122.3248,122.370467,1,3669744,3671114,1370,0.5371374582615012
541,122.386133,122.400267,1,3671583,3672008,425,0.871983482833674
542,122.4015,122.426367,1,3672045,3672791,746,0.6441143635033343
543,122.432933,122.439667,1,3672987,3673190,203,0.7487454965672958
544,122.4605,122.464533,1,3673815,3673935,120,0.807836398339933
545,122.471,122.481533,1,3674130,3674445,315,0.7997148705936045
546,122.486567,122.493933,1,3674597,3674817,220,0.9033776610110652
547,122.495433,122.5048,1,3674862,3675144,282,0.8768341411635457
548,122.558733,122.562467,1,3676761,3676874,113,0.6528695228612115
549,122.621367,122.628533,1,3678641,3678855,214,0.8520675340461481
550,122.633667,122.673,1,3679010,3680190,1180,0.6005981830264228
551,122.709133,122.7139,1,3681273,3681417,144,0.8960081235501071
552,122.777367,122.781733,1,3683321,3683451,130,0.7622858729746947
553,122.789933,122.805767,1,3683697,3684173,476,0.582769680986947
554,122.806767,122.8498,1,3684203,3685494,1291,0.6281308103839125
555,122.8705,122.920267,1,3686115,3687608,1493,0.6118049616149837
556,122.922433,122.9301,1,3687672,3687903,231,0.7915082869666942
557,122.997767,123.004433,1,3689933,3690132,199,0.3471738611594825
558,123.005933,123.010933,1,3690177,3690327,150,0.8603743602720889
559,123.035067,123.098233,1,3691052,3692946,1894,0.5814837927493451
560,123.1227,123.1392,1,3693681,3694176,495,0.500151225277134
561,123.145567,123.162533,1,3694367,3694875,508,0.7467725671467976
562,123.169433,123.201667,1,3695082,3696050,968,0.5776467566200051
563,123.216633,123.224033,1,3696498,3696720,222,0.7239840665514173
564,123.226133,123.251233,1,3696783,3697536,753,0.33350418665387116
565,123.271733,123.275933,1,3698151,3698277,126,0.664517810547292
566,123.332933,123.3487,1,3699987,3700461,474,0.11362873753673601
567,123.737833,123.7471,1,3712134,3712413,279,0.48446353122398744
568,123.759767,123.771967,1,3712793,3713159,366,0.1615969516529027
569,123.8481,123.8647,1,3715443,3715941,498,0.7417767953576273
570,123.8674,123.88,1,3716022,3716400,378,0.470227927139462
571,123.887733,123.908933,1,3716631,3717267,636,0.27839806309509146
572,123.910567,123.9196,1,3717317,3717588,271,0.8314082795273208
573,123.922233,123.927667,1,3717666,3717830,164,0.8549706433985443
574,123.93,123.933467,1,3717900,3718004,104,0.8834098192066265
575,123.965633,123.970867,1,3718968,3719126,158,0.8866213949105031
576,124.180833,124.222133,1,3725424,3726663,1239,0.600220244669235
577,124.228933,124.268833,1,3726867,3728064,1197,0.14954068867439085
578,124.483833,124.4887,1,3734514,3734661,147,0.7499794142026883
579,124.518133,124.5232,1,3735543,3735696,153,0.6723137324997742
580,124.524767,124.529233,1,3735743,3735876,133,0.7854551962073911
581,124.530333,124.539967,1,3735909,3736199,290,0.5126121264218628
582,124.604233,124.608267,1,3738126,3738248,122,0.7986536361751714
583,124.7656,124.772,1,3742968,3743160,192,0.3822919725271938
584,124.8124,124.815633,1,3744372,3744468,96,0.3161535721012318
585,125.029033,125.0328,1,3750870,3750984,114,0.7888752994204083
586,125.111667,125.1159,1,3753350,3753477,127,0.7078063843563623
587,125.1871,125.195133,1,3755613,3755853,240,0.2348675443489147
588,125.2541,125.258333,1,3757623,3757749,126,0.9071455560778942
589,125.278567,125.3128,1,3758357,3759384,1027,0.2984791849260533
590,125.3155,125.338633,1,3759465,3760158,693,0.7613751968549728
591,125.340433,125.353733,1,3760212,3760611,399,0.7148627077394694
592,125.3881,125.4262,1,3761643,3762786,1143,0.5755612886307069
593,125.4277,125.492367,1,3762831,3764771,1940,0.30490312208140063
594,125.4951,125.507667,1,3764853,3765230,377,0.870358490427656
595,125.509,125.512567,1,3765270,3765377,107,0.5623654799484474
596,125.524167,125.528367,1,3765725,3765851,126,0.9429597038383516
597,125.5518,125.5666,1,3766554,3766998,444,0.7734412265688272
598,125.569333,125.5739,1,3767079,3767217,138,0.9510724694566279
599,125.5904,125.601,1,3767712,3768030,318,0.8567537926705581
600,125.6462,125.675333,1,3769386,3770259,873,0.6368542326203387
601,125.692033,125.732067,1,3770760,3771962,1202,0.39048323473857804
602,125.7366,125.8337,1,3772098,3775011,2913,0.2531662286430595
603,125.838767,125.8695,1,3775163,3776085,922,0.6888622411831734
604,125.872333,125.915067,1,3776169,3777452,1283,0.4301161630738556
605,125.919033,125.963833,1,3777570,3778914,1344,0.2589692840290484
606,125.970933,125.982,1,3779127,3779460,333,0.7498389410756909
607,125.983533,126.021133,1,3779505,3780633,1128,0.7739377713371689
608,126.033467,126.040567,1,3781004,3781217,213,0.6877782932830668
609,126.0532,126.0696,1,3781596,3782088,492,0.6613701465201405
610,126.0747,126.084133,1,3782241,3782523,282,0.6663595122271759
611,126.0959,126.128067,1,3782877,3783842,965,0.4005312404757892
612,126.131267,126.147433,1,3783938,3784422,484,0.3629819877479432
613,126.154333,126.191733,1,3784629,3785751,1122,0.3402004333173525
614,126.9611,126.9982,1,3808833,3809946,1113,0.23911890808744501
615,126.9992,127.030533,1,3809976,3810915,939,0.36306582693895945
616,127.032067,127.046467,1,3810962,3811394,432,0.16721321083147014
617,127.048,127.069567,1,3811440,3812087,647,0.3463798183443272
618,127.074967,127.0924,1,3812249,3812772,523,0.40412656399508
619,127.095767,127.106433,1,3812873,3813192,319,0.2610977533451054
620,127.117267,127.143067,1,3813518,3814292,774,0.41422393648958356
621,127.1443,127.190767,1,3814329,3815723,1394,0.16433157413061894
622,127.191967,127.241833,1,3815759,3817254,1495,0.6102429643899134
623,127.250533,127.2553,1,3817515,3817659,144,0.8126364808165251
624,127.260133,127.2647,1,3817803,3817941,138,0.17124167568171422
625,127.268567,127.272533,1,3818057,3818175,118,0.782771446643474
626,127.273833,127.278933,1,3818214,3818367,153,0.1531469453324777
627,127.286033,127.3462,1,3818580,3820386,1806,0.5533247256195308
628,127.348233,127.353067,1,3820446,3820592,146,0.9175028784143987
629,127.355833,127.499267,1,3820674,3824978,4304,0.5961659379589557
630,127.5015,127.5302,1,3825045,3825906,861,0.711845228834386
631,127.531867,127.5577,1,3825956,3826731,775,0.5389584063758605
632,127.572667,127.5786,1,3827180,3827358,178,0.8141742112721839
633,127.580467,127.617167,1,3827414,3828515,1101,0.5630363043450959
634,127.618333,127.626067,1,3828549,3828782,233,0.8022025407103222
635,127.629167,127.645167,1,3828875,3829355,480,0.747150604860878
636,127.6567,127.663367,1,3829701,3829901,200,0.7833623927074304
637,127.6671,127.671233,1,3830013,3830136,123,-0.3690763698663149
638,127.672433,127.677067,1,3830172,3830312,140,0.7115698722934108
639,127.678367,127.7154,1,3830351,3831462,1111,0.6971662718996365
640,127.718667,127.723533,1,3831560,3831705,145,0.7366812461469344
641,127.724567,127.7324,1,3831737,3831972,235,0.6309635205066524
642,127.7366,127.7445,1,3832098,3832335,237,0.7521621326820948
643,127.751167,127.7626,1,3832535,3832878,343,0.6316751917315386
644,127.7702,127.794633,1,3833106,3833838,732,0.7717526222787997
645,127.796167,127.8058,1,3833885,3834174,289,0.838770295166036
646,127.825967,127.829533,1,3834779,3834885,106,0.8663320334991673
647,127.840833,127.844967,1,3835224,3835349,125,0.912495819175691
648,127.8623,127.886267,1,3835869,3836588,719,0.7234625375764435
649,127.888533,127.9202,1,3836655,3837606,951,0.2532259109475111
650,127.932367,127.956367,1,3837971,3838691,720,0.26717661565442374
651,127.9577,127.979367,1,3838731,3839381,650,0.3356133538310789
652,127.981633,127.997267,1,3839448,3839918,470,0.3148583176794399
653,128.006033,128.014867,1,3840180,3840446,266,0.8175326380729925
654,128.0235,128.073767,1,3840705,3842213,1508,0.17511481573174095
655,128.0753,128.0802,1,3842259,3842405,146,0.8515529475351914
656,128.726067,128.729733,1,3861782,3861891,109,0.8150120791480298
657,129.003433,129.008433,1,3870102,3870252,150,0.808634138021314
658,130.0137,130.024667,1,3900411,3900740,329,0.8552548249239037
659,130.026333,130.032367,1,3900789,3900971,182,0.8158739694347263
660,130.0534,130.0596,1,3901602,3901787,185,0.8646364520004356
661,130.0619,130.066,1,3901857,3901980,123,0.9580327326290387
662,130.0678,130.118733,1,3902034,3903561,1527,0.23594178765187215
663,130.120667,130.237133,1,3903620,3907113,3493,0.36894274864152715
664,130.258233,130.313933,1,3907746,3909417,1671,0.15424958410584838
665,130.315033,130.367133,1,3909450,3911013,1563,0.1508854239302541
666,130.3693,130.394433,1,3911079,3911832,753,0.3754182302983563
667,130.4031,130.487167,1,3912093,3914615,2522,0.4616165613602889
668,130.489767,130.520433,1,3914693,3915612,919,0.5110464042709791
669,130.526033,130.547533,1,3915780,3916425,645,0.19803609054073842
670,130.5652,130.570867,1,3916956,3917126,170,0.7993102796574693
671,130.580933,130.6425,1,3917427,3919275,1848,0.39970178218641533
672,130.644033,130.7052,1,3919320,3921155,1835,0.37498501169084053
673,130.796333,130.804333,1,3923889,3924129,240,0.29654439233668645
674,130.806333,130.810467,1,3924189,3924314,125,0.721016457639113
675,130.902633,130.948367,1,3927078,3928451,1373,0.15884983826101157
676,130.952067,130.976733,1,3928562,3929301,739,0.40272017202000127
677,130.995467,131.058933,1,3929864,3931767,1903,0.2919414573374026
678,131.076167,131.086267,1,3932285,3932588,303,0.7544825616577266
679,131.1107,131.138267,1,3933321,3934148,827,0.40009680923391844
680,131.139267,131.161467,1,3934178,3934844,666,0.19222088182852073
681,131.164433,131.176167,1,3934932,3935285,353,0.752060963514858
682,131.1794,131.2041,1,3935381,3936123,742,0.6532610105694158
683,131.2166,131.2233,1,3936498,3936699,201,0.7593959129437379
684,131.252233,131.2595,1,3937566,3937785,219,0.8322302599774113
685,131.261333,131.268533,1,3937839,3938055,216,0.8466545401358057
686,131.2791,131.2821,1,3938373,3938463,90,0.9215999641334712
687,131.317733,131.321867,1,3939531,3939656,125,0.6844552918209744
688,131.7062,131.7343,1,3951186,3952028,842,0.6337390838045319
689,131.735533,131.739933,1,3952065,3952197,132,0.8489537867819164
690,131.7431,131.7464,1,3952293,3952392,99,0.7784309979200755
691,131.759367,131.764133,1,3952781,3952923,142,0.8500658594979675
692,131.848667,131.859733,1,3955460,3955791,331,0.7934846105216596
693,131.868167,131.8757,1,3956045,3956271,226,0.7057555312518118
694,132.057733,132.062167,1,3961731,3961865,134,0.747814691819333
695,132.063933,132.0828,1,3961917,3962483,566,0.6103659376875888
696,132.0907,132.109767,1,3962721,3963293,572,0.7889880823006381
697,132.112533,132.122,1,3963375,3963660,285,0.7247196145039774
698,132.1362,132.157967,1,3964086,3964739,653,0.8256297509356227
699,132.159633,132.216833,1,3964788,3966504,1716,0.5287403781700954
700,132.221233,132.243733,1,3966636,3967311,675,0.8143294258982464
701,132.247167,132.299533,1,3967415,3968985,1570,0.5235681846417669
702,132.300733,132.304033,1,3969021,3969120,99,0.8942458394066464
703,132.550133,132.553367,1,3976503,3976601,98,0.6467956090933722
704,132.568667,132.573733,1,3977060,3977211,151,0.9211334132036396
705,132.6572,132.673767,1,3979715,3980213,498,0.9294154642567755
706,132.867167,132.870333,1,3986015,3986109,94,0.7370912994001917
707,133.3221,133.3256,1,3999663,3999768,105,0.817682344564148
708,133.802133,133.8068,1,4014063,4014204,141,0.2580005008069604
709,133.831367,133.850567,1,4014941,4015517,576,0.16329441321292942
710,133.853933,133.859267,1,4015617,4015778,161,0.7910872933835292
711,133.8781,133.914533,1,4016342,4017435,1093,0.09315672659511282
712,133.917433,133.921967,1,4017522,4017659,137,0.8139685086063305
713,133.939833,133.944967,1,4018194,4018349,155,0.5643876891332098
714,133.948733,133.974833,1,4018461,4019244,783,0.10616353442166628
715,133.980033,134.005367,1,4019400,4020161,761,0.06660453561659546
716,134.0064,134.020233,1,4020192,4020606,414,0.4580788552552469
717,134.022367,134.0426,1,4020671,4021278,607,0.25123779501083676
718,134.053533,134.063367,1,4021605,4021901,296,0.9027800104534811
719,134.066133,134.0758,1,4021983,4022273,290,0.5343206586266189
720,134.079,134.087867,1,4022370,4022636,266,0.7607422612179459
721,134.453233,134.482533,1,4033596,4034475,879,0.5378638292943464
722,134.504167,134.5113,1,4035125,4035339,214,0.5666052950893099
723,134.5184,134.523067,1,4035552,4035692,140,0.33711367094365713
724,134.9258,134.9316,1,4047774,4047948,174,0.851154078605967
725,135.902133,135.942933,1,4077063,4078287,1224,0.3526459134830449
726,135.946767,136.0105,1,4078403,4080315,1912,0.30235485064110745
727,136.0121,136.016933,1,4080363,4080507,144,0.9695923768417042
728,136.0186,136.058967,1,4080557,4081769,1212,0.5766193162003822
729,136.060367,136.0915,1,4081811,4082745,934,0.2827525104665181
730,136.105933,136.110633,1,4083177,4083318,141,0.5171805779529587
731,136.2616,136.2683,1,4087847,4088049,202,0.5455599997092907
732,136.278633,136.2821,1,4088358,4088463,105,0.9652604344994057
733,136.3776,136.398733,1,4091328,4091961,633,0.595986760399379
734,136.401033,136.406533,1,4092030,4092195,165,-0.19224482975695173
735,136.7682,136.773567,1,4103046,4103207,161,0.1575489671441981
736,136.815567,136.8492,1,4104467,4105476,1009,0.23179421202985243
737,136.850533,136.891033,1,4105515,4106730,1215,0.41757681195956675
738,136.958933,136.962,1,4108767,4108859,92,0.9284780812353057
739,137.1747,137.181533,1,4115241,4115445,204,0.4351440901917552
740,137.184333,137.218933,1,4115529,4116567,1038,0.20664760771816576
741,137.235033,137.251,1,4117050,4117530,480,0.455703584025432
742,137.252067,137.2709,1,4117562,4118127,565,0.7382151784491797
743,137.2732,137.276267,1,4118196,4118288,92,0.8149306480758526
744,137.360833,137.367233,1,4120824,4121016,192,0.47070734088824934
745,137.371267,137.3746,1,4121138,4121237,99,-0.1407087189511883
746,137.376533,137.381433,1,4121295,4121442,147,0.6045446449672104
747,137.513933,137.584333,1,4125417,4127529,2112,0.3857984221097367
748,137.586633,137.593667,1,4127598,4127810,212,-0.21618932128956164
749,137.599433,137.6093,1,4127982,4128278,296,0.3276016105694458
750,137.6132,137.662767,1,4128396,4129883,1487,0.44509353581552974
751,137.664433,137.672533,1,4129932,4130175,243,0.8307153603988086
752,137.743267,137.746933,1,4132298,4132407,109,0.9574223013768929
753,137.808233,137.811233,1,4134246,4134336,90,0.7362651972665686
754,138.315367,138.319333,1,4149461,4149579,118,0.8009777482115548
755,138.325133,138.341633,1,4149753,4150248,495,-0.06923217662742435
756,138.345467,138.352333,1,4150364,4150569,205,-0.16295645342815732
757,139.535,139.549267,1,4186050,4186478,428,0.4362130360014748
758,139.5583,139.5637,1,4186749,4186911,162,0.5388069508478315
759,139.681567,139.685233,1,4190447,4190556,109,0.5946034103953046
760,139.6864,139.7731,1,4190591,4193193,2602,0.29062689078061793
761,139.778167,139.8065,1,4193345,4194195,850,0.32164302361602476
762,139.814333,139.845633,1,4194429,4195368,939,0.06748265768553233
763,139.848,139.865867,1,4195440,4195976,536,0.3714958038703296
764,139.868567,139.877567,1,4196057,4196327,270,0.452708478315592
765,139.889133,139.988267,1,4196673,4199648,2975,0.25560389351868223
766,140.016267,140.023233,1,4200488,4200696,208,0.6852553127317187
767,140.025367,140.028367,1,4200761,4200851,90,0.6425860574384819
768,140.0325,140.095433,1,4200975,4202862,1887,0.21072834984419359
769,140.096533,140.222633,1,4202895,4206678,3783,0.4104031310630173
770,140.224867,140.314367,1,4206746,4209431,2685,0.3280651492946729
771,140.3414,140.3449,1,4210242,4210347,105,0.3732284842770068
772,140.350133,140.415167,1,4210503,4212455,1952,0.30866079590959516
773,140.416233,140.422267,1,4212486,4212668,182,0.046986889641580674
774,140.425833,140.495133,1,4212774,4214853,2079,0.2623188019585771
775,140.4974,140.5016,1,4214922,4215048,126,0.9328130774924956
776,140.5138,140.650733,1,4215414,4219521,4107,0.170482325888536
777,140.6575,140.753267,1,4219725,4222598,2873,0.32581318762422395
778,140.7562,140.761567,1,4222686,4222847,161,0.8793951978301967
779,140.770833,140.869033,1,4223124,4226070,2946,0.2487349419376726
780,140.881733,140.8858,1,4226451,4226574,123,0.808788671894572
781,140.890133,140.895767,1,4226703,4226873,170,0.2864751048263188
782,140.907133,141.058933,1,4227213,4231767,4554,0.331430610220131
783,141.0639,141.067333,1,4231917,4232019,102,0.5438819607114456
784,141.074733,141.083167,1,4232241,4232495,254,0.8224860712366443
785,141.1196,141.183333,1,4233588,4235499,1911,0.4216687268205576
786,141.249,141.281667,1,4237470,4238450,980,0.34116553752160284
787,141.2844,141.333367,1,4238532,4240001,1469,0.4043781063562427
788,141.377367,141.3843,1,4241321,4241529,208,0.30225171046842186
789,141.419933,141.436667,1,4242597,4243100,503,0.6084938506357874
790,141.438,141.441067,1,4243140,4243232,92,0.8506819047753473
791,141.4589,141.4744,1,4243767,4244232,465,0.7332060722380904
792,141.504233,141.508067,1,4245126,4245242,116,0.7237832343004764
793,141.539,141.5537,1,4246170,4246611,441,0.7896295682684763
794,141.5643,141.5677,1,4246929,4247031,102,0.3978086875921997
795,141.605467,141.634733,1,4248164,4249041,877,0.7419292635655499
796,141.6459,141.6739,1,4249377,4250217,840,0.28176987480266036
797,142.0468,142.049867,1,4261404,4261496,92,0.8659529841991237
798,142.056633,142.060933,1,4261698,4261827,129,0.8110632880508558
799,142.074267,142.116467,1,4262228,4263494,1266,0.545730003232764
800,142.134033,142.137333,1,4264020,4264119,99,0.8057833865525393
801,142.1403,142.194767,1,4264209,4265843,1634,0.7839416621539882
802,142.2016,142.2601,1,4266048,4267803,1755,0.41143534474280413
803,142.264667,142.269433,1,4267940,4268082,142,0.8923217940777207
804,142.366933,142.380133,1,4271007,4271403,396,0.5377870617005012
805,142.7042,142.708867,1,4281126,4281266,140,0.9113802339354786
806,142.7995,142.8051,1,4283985,4284153,168,0.6443429980986703
807,142.818233,142.8255,1,4284546,4284765,219,0.5249152835240639
808,142.8465,142.8516,1,4285395,4285548,153,0.8242441275807619
809,142.853567,142.857167,1,4285607,4285715,108,0.7904507997624347
810,142.863233,142.878733,1,4285896,4286361,465,0.3516260392669869
811,143.01,143.014933,1,4290300,4290447,147,0.6369778837356781
812,143.314667,143.319133,1,4299440,4299573,133,0.7377967782217617
813,143.345533,143.3555,1,4300365,4300665,300,0.5361098361987645
814,143.3615,143.367667,1,4300845,4301030,185,0.5340490121164237
815,143.449267,143.452267,1,4303478,4303568,90,0.6600039430604449
816,143.4856,143.5674,1,4304568,4307022,2454,0.2163421837863428
817,143.5708,143.6333,1,4307124,4308999,1875,0.14744640713489143
818,143.643,143.666633,1,4309290,4309998,708,0.28282212861326933
819,143.668133,143.713133,1,4310043,4311393,1350,0.3790055073957565
820,143.9342,143.982567,1,4318026,4319477,1451,0.19910766280996506
821,143.9939,144.011267,1,4319817,4320338,521,0.3163621808668559
822,144.015367,144.0414,1,4320461,4321242,781,0.47311498000270286
823,144.076,144.079167,1,4322280,4322375,95,0.5117156935055803
824,144.080367,144.114,1,4322411,4323420,1009,0.2658468719548938
825,144.115333,144.1451,1,4323459,4324353,894,0.7601002592252337
826,144.169933,144.183467,1,4325097,4325504,407,0.8910954346480555
827,144.186467,144.191,1,4325594,4325730,136,0.577446866115732
828,144.213133,144.238,1,4326393,4327140,747,0.4351966363780647
829,144.2396,144.249767,1,4327188,4327493,305,0.793901672791058
830,144.263133,144.332133,1,4327893,4329963,2070,0.3048442104156965
831,144.3339,144.347433,1,4330017,4330422,405,0.33944884253554297
832,144.352267,144.356933,1,4330568,4330707,139,0.9422245916870198
833,144.358433,144.369767,1,4330752,4331093,341,0.03733526510992916
834,144.377167,144.426967,1,4331315,4332809,1494,0.2962110654058615
835,144.430633,144.4492,1,4332918,4333476,558,0.5754161586506684
836,144.451633,144.464433,1,4333548,4333932,384,0.3455593557883087
837,144.466667,144.485,1,4334000,4334550,550,0.4796169363650531
838,144.4866,144.495367,1,4334598,4334861,263,0.4792516217130253
839,144.4973,144.584067,1,4334919,4337522,2603,0.18373376102995806
840,144.587133,144.616767,1,4337613,4338503,890,0.25384960601600554
841,144.619767,144.630167,1,4338593,4338905,312,0.5824813172636452
842,144.634367,144.679767,1,4339031,4340393,1362,0.4545358094821431
843,144.6812,144.721767,1,4340436,4341653,1217,0.3184728042479841
844,144.7235,144.7489,1,4341705,4342467,762,0.37936490519296845
845,144.943833,144.964733,1,4348314,4348941,627,0.5901524330453396
846,144.979567,145.036967,1,4349387,4351109,1722,0.2443776456227767
847,145.0382,145.136967,1,4351146,4354109,2963,0.1160836379434018
848,145.141333,145.186867,1,4354239,4355606,1367,0.5970842728407169
849,145.188033,145.210167,1,4355640,4356305,665,0.4299969135463339
850,145.212033,145.221067,1,4356360,4356632,272,0.6259048288712897
851,145.705,145.7093,1,4371150,4371279,129,0.7597279029180798
852,146.1294,146.135867,1,4383882,4384076,194,0.4659932865203547
853,146.1941,146.1972,1,4385823,4385916,93,0.9571222231057173
854,146.211733,146.2349,1,4386351,4387047,696,0.3437981757672798
855,146.2447,146.247733,1,4387341,4387431,90,0.9164626824838623
856,146.4673,146.474433,1,4394019,4394232,213,0.3085754615538768
857,147.0177,147.029933,1,4410531,4410897,366,0.6938284004859769
858,147.043,147.049967,1,4411290,4411499,209,0.8237758170679952
859,147.0531,147.068867,1,4411593,4412066,473,0.6546177398857003
860,147.0737,147.0858,1,4412211,4412574,363,0.920398483404609
861,147.086933,147.090767,1,4412607,4412723,116,0.7798002980843503
862,147.091767,147.0954,1,4412753,4412862,109,0.9031715207384152
863,147.099767,147.1062,1,4412993,4413186,193,0.8746687828143659
864,147.1093,147.1133,1,4413279,4413399,120,0.7535416811512878
865,147.121767,147.128133,1,4413653,4413843,190,0.8363025995116112
866,147.143033,147.168267,1,4414290,4415048,758,0.16268086939173013
867,147.6595,147.673667,1,4429785,4430210,425,-0.025205401529962174
868,147.682933,147.688233,1,4430487,4430646,159,0.5044468445325474
869,147.694167,147.709533,1,4430825,4431285,460,0.20891191259305414
870,147.710767,147.729967,1,4431323,4431899,576,0.21628744921524506
871,147.7453,147.791867,1,4432359,4433756,1397,0.5345005741162809
872,147.797167,147.8084,1,4433915,4434252,337,0.0953116927744993
873,147.8145,147.826,1,4434435,4434780,345,0.6881417141080938
874,148.046667,148.0501,1,4441400,4441503,103,0.7635428507862194
875,148.153433,148.161933,1,4444602,4444857,255,0.2900094581438196
876,148.172167,148.196733,1,4445165,4445901,736,0.648740098391514
877,148.2025,148.2114,1,4446075,4446342,267,0.4593185416550092
878,148.218,148.246267,1,4446540,4447388,848,0.4031007132722394
879,148.381,148.386333,1,4451430,4451589,159,0.8965389833932019
880,148.398567,148.4075,1,4451957,4452225,268,0.5298466434775414
881,148.4196,148.424733,1,4452588,4452741,153,0.6887922084380138
882,148.432767,148.438533,1,4452983,4453155,172,0.599811809801734
883,148.555633,148.574033,1,4456668,4457220,552,0.7117901065008083
884,148.575533,148.5885,1,4457265,4457655,390,0.56964340980744
885,148.6921,148.696433,1,4460763,4460892,129,0.7657084931853682
886,148.754967,148.817933,1,4462649,4464537,1888,0.2320970195490336
887,148.830467,148.8401,1,4464914,4465203,289,0.10848192078395416
888,148.904,148.934833,1,4467120,4468044,924,0.26513519784132955
889,148.943733,148.984633,1,4468311,4469538,1227,0.3078852877543336
890,148.987467,148.9986,1,4469624,4469958,334,0.2427483386581864
891,149.070467,149.098967,1,4472114,4472969,855,0.6354554988764083
892,149.107767,149.151867,1,4473233,4474556,1323,0.3542447224991609
893,149.1551,149.171767,1,4474653,4475153,500,0.1744127187530751
894,149.2373,149.269933,1,4477119,4478097,978,0.19354540390867858
895,149.274333,149.318467,1,4478229,4479554,1325,0.2955760975722227
896,149.328367,149.3428,1,4479851,4480284,433,0.21352961602539502
897,149.417633,149.425433,1,4482528,4482762,234,0.7848977517696739
898,149.4272,149.453633,1,4482816,4483608,792,0.6578931248565726
899,149.4655,149.4908,1,4483965,4484724,759,0.35312933024744125
900,150.021933,150.025167,1,4500657,4500755,98,0.8246053448383093
901,150.126167,150.134267,1,4503785,4504028,243,0.34372945670639055
902,150.211767,150.2178,1,4506353,4506534,181,0.7273937461242316
903,150.218933,150.226267,1,4506567,4506788,221,0.8413147591544963
904,150.2407,150.2444,1,4507221,4507332,111,0.8063692321596596
905,150.245733,150.252067,1,4507371,4507562,191,0.7817130699405088
906,150.318467,150.3225,1,4509554,4509675,121,0.6276338515379492
907,150.372633,150.3786,1,4511178,4511358,180,0.8743360809640095
908,150.381567,150.455267,1,4511447,4513658,2211,0.4738290359615511
909,150.460667,150.469433,1,4513820,4514082,262,0.6556163985050091
910,150.479567,150.514633,1,4514387,4515438,1051,0.9106846470264858
911,150.532367,150.537233,1,4515971,4516116,145,0.866070130027635
912,150.6074,150.6107,1,4518222,4518321,99,0.2726729591462045
913,151.228333,151.233633,1,4536849,4537008,159,0.6331253174530037
914,151.5947,151.5991,1,4547841,4547973,132,0.8514519448598433
915,151.828633,151.834333,1,4554858,4555029,171,0.9076647930113928
916,152.004667,152.0077,1,4560140,4560231,91,0.8234610601260542
917,153.3566,153.359767,1,4600698,4600793,95,0.22836454738191372
918,153.376233,153.504533,1,4601286,4605135,3849,0.23226207246182917
919,153.508,153.515233,1,4605240,4605456,216,0.19871852561279169
920,153.5198,153.624667,1,4605594,4608740,3146,0.17863718822005484
921,153.628033,153.6514,1,4608840,4609542,702,0.2339568376137921
922,153.653633,153.667167,1,4609608,4610015,407,0.49560108885915755
923,153.674767,153.770333,1,4610243,4613109,2866,0.2225472139748856
924,153.775,153.7907,1,4613250,4613721,471,0.5001864777619405
925,153.792833,153.821567,1,4613784,4614647,863,0.6339620880466946
926,153.829167,153.853033,1,4614875,4615590,715,0.462317518806838
927,153.8629,153.867,1,4615887,4616010,123,0.6990287473684782
928,153.9465,153.949567,1,4618395,4618487,92,0.5960083743134327
929,155.233633,155.254067,1,4657008,4657622,614,0.28786070369687183
930,155.2695,155.2789,1,4658085,4658367,282,0.3214134961701413
931,155.2847,155.2877,1,4658541,4658631,90,0.7227970026417225
932,155.290667,155.293967,1,4658720,4658819,99,0.8122945369864216
933,155.341967,155.345967,1,4660259,4660379,120,0.8620403706768911
934,155.3476,155.3517,1,4660428,4660551,123,0.9713276435407269
935,155.4777,155.486033,1,4664331,4664580,249,0.8375577192664536
936,155.492133,155.496433,1,4664763,4664892,129,0.7432368152363176
937,155.535833,155.542533,1,4666074,4666275,201,0.7162799068001109
938,155.677833,155.7863,1,4670334,4673589,3255,0.32953620194818245
939,155.790033,155.853633,1,4673700,4675608,1908,0.20060577861809
940,155.861567,155.880367,1,4675847,4676411,564,0.9321794192967978
941,155.975967,155.979767,1,4679279,4679393,114,0.8798942402883437
942,155.989,156.0112,1,4679670,4680336,666,0.4647549748457799
943,156.0148,156.042533,1,4680444,4681275,831,0.027116593805012086
944,156.049667,156.053233,1,4681490,4681596,106,0.7889767927931595
945,156.099767,156.104533,1,4682993,4683135,142,0.885976656134588
946,156.107833,156.115733,1,4683234,4683471,237,0.7909628418887926
947,156.118967,156.123133,1,4683569,4683693,124,0.7460761414995598
948,156.144767,156.177733,1,4684343,4685331,988,0.4841673489290755
949,156.181433,156.1853,1,4685442,4685559,117,0.8712991669223126
950,156.191767,156.233633,1,4685753,4687008,1255,0.40349835707853715
951,156.372,156.3765,1,4691160,4691295,135,0.7759538254540445
952,156.622533,156.631067,1,4698675,4698932,257,0.902827285302239
953,156.666667,156.677467,1,4700000,4700324,324,0.9227422185314814
954,156.6964,156.7009,1,4700892,4701027,135,0.21521222930470485
955,156.713633,156.7204,1,4701408,4701612,204,0.7223880382239604
956,156.7214,156.727433,1,4701642,4701822,180,0.8852793474116328
957,156.7436,156.7526,1,4702308,4702578,270,0.4649933593938809
958,156.775067,156.7838,1,4703252,4703514,262,0.925058480001546
959,156.9068,156.913867,1,4707204,4707416,212,0.6737839750289563
960,156.984833,156.988033,1,4709544,4709640,96,0.9062798834747158
961,158.241233,158.252067,1,4747236,4747562,326,0.8628924363226085
962,158.253567,158.271133,1,4747607,4748133,526,0.8121215396365158
963,158.2736,158.279233,1,4748208,4748376,168,0.827423210462971
964,158.305067,158.309733,1,4749152,4749291,139,0.8158497467451982
965,158.311267,158.314433,1,4749338,4749432,94,0.8271550474487835
966,158.334633,158.349333,1,4750038,4750479,441,0.7699314487376379
967,158.4154,158.427067,1,4752462,4752812,350,0.8435665807869795
968,158.429233,158.434367,1,4752876,4753031,155,0.7719884729598453
969,158.437267,158.440867,1,4753118,4753226,108,0.934042995222394
970,158.442467,158.4486,1,4753274,4753458,184,0.899790442674816
971,158.5046,158.5101,1,4755138,4755303,165,0.6837157017832539
972,158.656633,158.666067,1,4759698,4759982,284,0.4713240246021937
973,159.135633,159.224367,1,4774068,4776731,2663,0.38037100419689474
974,159.2334,159.2387,1,4777002,4777161,159,0.8067829147580106
975,159.2404,159.246167,1,4777212,4777385,173,0.8883080572936839
976,159.2476,159.2521,1,4777428,4777563,135,0.8527214961188482
977,159.258,159.266533,1,4777740,4777995,255,0.9150910695444711
978,159.283733,159.2882,1,4778511,4778646,135,0.6722242858632319
979,159.2904,159.293467,1,4778712,4778804,92,0.590219902543413
980,159.295,159.304267,1,4778850,4779128,278,0.6388489788856744
981,159.306267,159.312267,1,4779188,4779368,180,0.8194567717355773
982,159.3197,159.322867,1,4779591,4779686,95,0.9143474172664355
983,159.330433,159.334867,1,4779912,4780046,134,0.9296860882892151
984,159.3566,159.371267,1,4780698,4781138,440,0.7391497027733182
985,159.372767,159.384567,1,4781183,4781537,354,0.8091026073240187
986,159.387933,159.418233,1,4781637,4782546,909,0.46738853073057535
987,159.4193,159.431,1,4782579,4782930,351,0.357744049079571
988,159.436467,159.4409,1,4783094,4783227,133,0.934680434060067
989,159.4494,159.475833,1,4783482,4784274,792,0.024454609755006393
990,159.4774,159.482867,1,4784322,4784486,164,0.7958852508075082
991,159.4863,159.510833,1,4784589,4785324,735,0.11229876697796427
992,159.517667,159.576533,1,4785530,4787295,1765,0.2723850132292541
993,159.584667,159.629167,1,4787540,4788875,1335,0.8135477717962449
994,159.634667,159.654967,1,4789040,4789649,609,0.3730771096842964
995,159.706767,159.827433,1,4791203,4794822,3619,0.5091792858177865
996,159.835633,159.8588,1,4795068,4795764,696,0.25537140847151113
997,159.8636,159.891267,1,4795908,4796738,830,0.3334489597696914
998,159.8959,159.920733,1,4796877,4797621,744,0.2985352702189949
999,159.922633,159.989933,1,4797678,4799697,2019,0.31492758302111945
1000,159.992933,160.009233,1,4799787,4800276,489,0.43350236409179754
1001,160.1819,160.1867,1,4805457,4805601,144,0.16911706333448162
1002,160.189667,160.2197,1,4805690,4806591,901,0.1737035709086873
1003,160.221733,160.2798,1,4806651,4808394,1743,0.1931748623938217
1004,160.285967,160.289733,1,4808579,4808691,112,0.5642493851468872
1005,160.304467,160.3424,1,4809134,4810272,1138,0.15568565344807053
1006,160.345933,160.354133,1,4810377,4810623,246,0.5118143630464781
1007,160.360567,160.424167,1,4810817,4812725,1908,0.27876230551149045
1008,160.4307,160.4345,1,4812921,4813035,114,0.7902049801518299
1009,160.4449,160.455567,1,4813347,4813667,320,0.5652545220155342
1010,160.4795,160.482867,1,4814385,4814486,101,0.8960848521570239
1011,160.7163,160.720367,1,4821489,4821611,122,0.9458555064023869
1012,160.7215,160.727667,1,4821645,4821830,185,0.7295809814868663
1013,160.729433,160.733433,1,4821882,4822002,120,0.45105615546172545
1014,160.735867,160.740733,1,4822076,4822221,145,0.46560505080956105
1015,160.7422,160.746967,1,4822266,4822409,143,0.6603238763526623
1016,160.7484,160.755367,1,4822452,4822661,209,0.5973430577618818
1017,160.774067,160.7778,1,4823222,4823334,112,0.8454759542934301
1018,160.8284,160.8745,1,4824852,4826235,1383,0.17225742577806283
1019,160.8764,160.892933,1,4826292,4826787,495,0.2890553436565824
1020,160.904933,160.914333,1,4827147,4827429,282,0.752578950496218
1021,160.930333,160.943367,1,4827909,4828301,392,0.5430285897845014
1022,160.954133,160.958767,1,4828623,4828763,140,0.9280170535937708
1023,160.9689,160.974067,1,4829067,4829222,155,0.8069145638940413
1024,160.980467,160.9837,1,4829414,4829511,97,0.537725633082895
1025,160.997167,161.010367,1,4829915,4830311,396,0.3347311334951129
1026,161.013233,161.033233,1,4830396,4830996,600,0.2826651217792309
1027,161.043967,161.054533,1,4831319,4831635,316,0.48239894846228015
1028,161.057933,161.085067,1,4831737,4832552,815,0.2072440069076009
1029,161.631967,161.635967,1,4848959,4849079,120,0.8615289192321993
1030,161.9414,162.029467,1,4858242,4860884,2642,0.19731332478573302
1031,162.031467,162.036867,1,4860944,4861106,162,0.7672564764203946
1032,162.0398,162.157267,1,4861194,4864718,3524,0.24249875437694016
1033,162.163067,162.167367,1,4864892,4865021,129,0.8689154366720385
1034,162.176267,162.180567,1,4865288,4865417,129,0.833219616408193
1035,162.1921,162.2575,1,4865763,4867725,1962,0.37231284144697735
1036,162.2646,162.3328,1,4867938,4869984,2046,0.3067075105343421
1037,162.3708,162.375433,1,4871124,4871262,138,0.9649633495811125
1038,162.377233,162.434533,1,4871316,4873035,1719,0.2979226102083356
1039,162.4405,162.519767,1,4873215,4875593,2378,0.26767020161869465
1040,162.520867,162.524333,1,4875626,4875729,103,0.9097316528300098
1041,162.585567,162.5935,1,4877567,4877805,238,0.4817612750200481
1042,162.603933,162.6099,1,4878117,4878297,180,0.6785407168907273
1043,162.629467,162.633467,1,4878884,4879004,120,0.7756993096249668
1044,162.6361,162.649767,1,4879083,4879493,410,0.7460048330123843
1045,162.6852,162.69,1,4880556,4880700,144,0.2830320193237378
1046,162.7139,162.8295,1,4881417,4884885,3468,0.27736570864520654
1047,162.8608,162.942533,1,4885824,4888275,2451,0.17543927961961864
1048,162.947133,163.039067,1,4888413,4891172,2759,0.1734080461361516
1049,163.040933,163.056933,1,4891227,4891707,480,0.2818445019031108
1050,163.061967,163.1314,1,4891859,4893942,2083,0.308388515231151
1051,163.1354,163.140133,1,4894062,4894203,141,0.37420853101933416
1052,163.215,163.221067,1,4896450,4896632,182,0.4875698572759036
1053,163.222067,163.2519,1,4896662,4897557,895,0.6006615076617827
1054,163.253133,163.274867,1,4897593,4898246,653,0.49429506456012556
1055,163.278833,163.298733,1,4898364,4898961,597,0.25280468640146636
1056,163.311533,163.315367,1,4899345,4899461,116,0.8576418718059888
1057,163.3246,163.339133,1,4899738,4900173,435,0.5149381235042381
1058,163.3925,163.4015,1,4901775,4902045,270,0.7143069928671352
1059,163.404667,163.417633,1,4902140,4902528,388,0.856918105347188
1060,163.4187,163.4219,1,4902561,4902657,96,0.7279715536633078
1061,163.433133,163.463867,1,4902993,4903916,923,0.3101177336165993
1062,163.465533,163.469067,1,4903965,4904072,107,0.7136285258958487
1063,163.5294,163.533033,1,4905882,4905990,108,0.6034542523530347
1064,163.7773,163.814367,1,4913319,4914431,1112,0.5751542170429621
1065,163.8267,163.8645,1,4914801,4915935,1134,0.30338116163890333
1066,164.065033,164.0697,1,4921950,4922091,141,0.880860119419848
1067,164.0825,164.1248,1,4922475,4923744,1269,0.2879706986257246
1068,164.145633,164.150133,1,4924368,4924503,135,0.9534529543988163
1069,164.170267,164.173433,1,4925108,4925202,94,0.988628250058195
1070,164.1896,164.336467,1,4925688,4930094,4406,0.531189046165062
1071,164.3383,164.3666,1,4930149,4930998,849,0.4285708686050249
1072,164.3677,164.4126,1,4931031,4932378,1347,0.6682256229292811
1073,164.432767,164.4861,1,4932983,4934583,1600,0.4645775757741351
1074,164.502633,164.591867,1,4935078,4937756,2678,0.7815530245366626
1075,164.5931,164.5995,1,4937793,4937985,192,0.7613545170824705
1076,164.600933,164.673967,1,4938027,4940219,2192,0.5994250959484632
1077,164.675233,164.726867,1,4940256,4941806,1550,0.4337197242143948
1078,164.728333,164.752867,1,4941849,4942586,737,0.6737658167913875
1079,164.755,164.760833,1,4942650,4942824,174,0.7540016402033072
1080,164.763267,164.769667,1,4942898,4943090,192,0.6102552796330352
1081,164.774667,164.788033,1,4943240,4943640,400,0.8318169093788604
1082,164.789467,164.795767,1,4943684,4943873,189,0.9231597571292016
1083,164.800833,164.803967,1,4944024,4944119,95,0.873947360283496
1084,164.809267,164.8398,1,4944278,4945194,916,0.780378236769523
1085,164.842867,164.848367,1,4945286,4945451,165,0.4058010106021508
1086,164.857367,164.952967,1,4945721,4948589,2868,0.3811085704718534
1087,164.954233,164.970333,1,4948626,4949109,483,0.12105455982174883
1088,164.976667,165.056,1,4949300,4951680,2380,0.03593449791810921
1089,165.057067,165.072367,1,4951712,4952171,459,0.8257127418050213
1090,165.076667,165.094867,1,4952300,4952846,546,0.29047713488194465
1091,165.108667,165.139467,1,4953260,4954184,924,0.6697049068926456
1092,165.1406,165.154267,1,4954218,4954628,410,0.7978948070996092
1093,165.156233,165.1681,1,4954686,4955043,357,0.9051380916803409
1094,165.1833,165.194733,1,4955499,4955841,342,0.8056342846703306
1095,165.210833,165.215233,1,4956324,4956456,132,0.7740001039985271
1096,165.216233,165.236767,1,4956486,4957103,617,0.8143406396577816
1097,165.309467,165.3149,1,4959284,4959447,163,0.7243708872664613
1098,165.382133,165.4009,1,4961463,4962027,564,0.7049841146491194
1099,165.4198,165.431067,1,4962594,4962932,338,0.7694796444735745
1100,165.461633,165.515767,1,4963848,4965473,1625,0.4101848074299017
1101,165.586567,165.591633,1,4967597,4967748,151,0.7614035969502873
1102,165.634,165.637333,1,4969020,4969119,99,0.2915771019449969
1103,165.638767,165.648967,1,4969163,4969469,306,0.6718532688199652
1104,165.734867,165.743633,1,4972046,4972308,262,0.8744576878826716
1105,165.7588,165.7627,1,4972764,4972881,117,0.8847103285308145
1106,166.073,166.076867,1,4982190,4982306,116,0.8108542352314231
1107,166.804167,166.8072,1,5004125,5004216,91,0.7856365006027711
1108,166.880033,166.883633,1,5006400,5006508,108,0.8184941326788028
1109,166.9306,166.970333,1,5007918,5009109,1191,0.3953020971939769
1110,166.9821,166.9924,1,5009463,5009772,309,0.8521419368058722
1111,166.9971,167.0394,1,5009913,5011182,1269,0.6483257824678997
1112,167.160867,167.167567,1,5014826,5015027,201,0.4062504312503956
1113,167.2049,167.2143,1,5016147,5016429,282,0.8732485682651027
1114,167.2214,167.226733,1,5016642,5016801,159,0.5687099412684796
1115,167.228067,167.231667,1,5016842,5016950,108,0.804482297357955
1116,167.305033,167.318833,1,5019150,5019564,414,0.3444853120974626
1117,168.5042,168.509933,1,5055126,5055297,171,0.5875708932319708
1118,168.758933,168.770933,1,5062767,5063127,360,0.3762393231394824
1119,168.779067,168.784767,1,5063372,5063543,171,0.6324595120624501
1120,169.3058,169.3193,1,5079174,5079579,405,0.7855738598921944
1121,169.321067,169.3967,1,5079632,5081901,2269,0.3338553953101209
1122,169.401033,169.429533,1,5082030,5082885,855,-0.020914949329329635
1123,169.431567,169.464,1,5082947,5083920,973,0.08408889083728525
1124,169.477567,169.547067,1,5084327,5086412,2085,0.2262610799458385
1125,169.551267,169.557267,1,5086538,5086718,180,0.7949982033668803
1126,169.5587,169.563367,1,5086761,5086901,140,0.9344866835290772
1127,169.564733,169.575867,1,5086941,5087276,335,0.8703477257842688
1128,169.6059,169.6441,1,5088177,5089323,1146,0.6213265584445395
1129,169.650033,169.6785,1,5089500,5090355,855,0.36726498615270736
1130,169.702967,169.710467,1,5091089,5091314,225,0.9096874880280329
1131,169.743567,169.759633,1,5092307,5092788,481,0.1285472685404737
1132,169.794633,169.797933,1,5093838,5093937,99,0.8240133470247601
1133,170.5515,170.629567,1,5116545,5118887,2342,-0.03724988973882918
1134,170.645267,170.6934,1,5119358,5120802,1444,0.14126389777303183
1135,170.697667,170.713767,1,5120930,5121413,483,0.32121833606795774
1136,170.7149,170.7265,1,5121447,5121795,348,0.5234486652740876
1137,170.7344,170.741,1,5122032,5122230,198,0.31427482737638446
1138,170.748367,170.793867,1,5122451,5123816,1365,0.42330056222054246
1139,170.7976,170.823967,1,5123928,5124719,791,0.5083793418479003
1140,170.835267,170.844667,1,5125058,5125340,282,0.2345944166633705
1141,170.847867,170.854733,1,5125436,5125641,205,0.35252367433902226
1142,170.856,170.862267,1,5125680,5125868,188,0.5275027031916955
1143,170.867333,170.8994,1,5126019,5126982,963,0.03703546929903002
1144,170.901967,170.905967,1,5127059,5127179,120,0.7367855755133949
1145,170.9107,170.935733,1,5127321,5128071,750,0.11035029695540116
1146,170.942667,170.9695,1,5128280,5129085,805,0.32539546696719535
1147,170.9706,170.9982,1,5129118,5129946,828,0.1856803625452291
1148,171.010567,171.018,1,5130317,5130540,223,0.3240716259132234
1149,171.0284,171.033433,1,5130852,5131002,150,0.7390840314148622
1150,171.0435,171.099867,1,5131305,5132996,1691,0.2761892848646526
1151,171.107367,171.143,1,5133221,5134290,1069,0.6322401338619853
1152,171.2021,171.209567,1,5136063,5136287,224,0.6855852946001267
1153,171.2158,171.222167,1,5136474,5136665,191,0.9078569024862355
1154,171.229067,171.234033,1,5136872,5137020,148,0.7906459642058484
1155,171.2475,171.256967,1,5137425,5137709,284,0.5539469790558069
1156,171.2584,171.269933,1,5137752,5138097,345,0.8652627148044113
1157,171.2828,171.300033,1,5138484,5139000,516,0.42730598503865147
1158,171.307,171.3363,1,5139210,5140089,879,0.27357327723472086
1159,171.346567,171.401,1,5140397,5142030,1633,0.29688221072598886
1160,171.4135,171.480933,1,5142405,5144427,2022,0.12034957705116975
1161,171.488467,171.528133,1,5144654,5145843,1189,0.21974880996358023
1162,171.633133,171.6368,1,5148993,5149104,111,0.8462053963400011
1163,171.8175,171.825467,1,5154525,5154764,239,0.6156993665514274
1164,171.8275,171.8309,1,5154825,5154927,102,0.6671664024044919
1165,171.8322,171.841767,1,5154966,5155253,287,-0.2405560689599499
1166,171.848967,171.852267,1,5155469,5155568,99,0.5568658350319856
1167,171.873067,171.878033,1,5156192,5156340,148,0.7674496667529985
1168,172.065,172.074267,1,5161950,5162228,278,0.23151392801767454
1169,172.519233,172.5259,1,5175576,5175777,201,0.6929898865611317
1170,172.5731,172.581167,1,5177193,5177435,242,0.8501393747036329
1171,172.600967,172.604633,1,5178029,5178138,109,0.8304908249300743
1172,172.6287,172.660667,1,5178861,5179820,959,0.6454281383898571
1173,172.669567,172.688767,1,5180087,5180663,576,0.839912238027977
1174,172.692333,172.696067,1,5180769,5180882,113,0.9497012970803469
1175,172.756767,172.761,1,5182703,5182830,127,0.833578532317339
1176,172.796567,172.8014,1,5183897,5184042,145,0.278472401542244
1177,172.8198,172.823967,1,5184594,5184719,125,0.8969262655371337
1178,172.8286,172.852067,1,5184858,5185562,704,0.798422835652896
1179,172.936833,172.94,1,5188104,5188200,96,0.7619800202422833
1180,172.948633,172.957467,1,5188458,5188724,266,0.6912694658423532
1181,172.959867,172.970467,1,5188796,5189114,318,0.7896338579460216
1182,173.0853,173.092833,1,5192559,5192784,225,0.6550105264595987
1183,173.193933,173.198433,1,5195817,5195952,135,0.7911799050156766
1184,173.262267,173.286367,1,5197868,5198591,723,0.8202778417883007
1185,173.3082,173.3548,1,5199246,5200644,1398,0.2837607512145818
1186,173.359033,173.371133,1,5200770,5201133,363,0.585936550452459
1187,173.372733,173.3975,1,5201181,5201925,744,0.17519092939471093
1188,173.401733,173.425467,1,5202051,5202764,713,-0.03445726387068878
1189,173.430333,173.445933,1,5202909,5203377,468,0.5420191675695
1190,173.450133,173.454433,1,5203503,5203632,129,0.9483775260131537
1191,173.463333,173.499967,1,5203899,5204999,1100,0.23768909025960952
1192,173.514633,173.528233,1,5205438,5205846,408,0.6648307700192024
1193,173.530533,173.561467,1,5205915,5206844,929,0.7592361388085056
1194,173.569267,173.592967,1,5207078,5207789,711,0.664973917886364
1195,173.733067,173.747833,1,5211992,5212434,442,0.03371501530677995
1196,173.7624,173.853633,1,5212872,5215608,2736,0.08453321756869747
1197,173.870067,173.873467,1,5216102,5216204,102,0.8150398526278785
1198,173.874867,173.9733,1,5216246,5219199,2953,0.3050131380014031
1199,173.9756,173.979267,1,5219268,5219378,110,0.2787792238913055
1200,174.072167,174.077767,1,5222165,5222333,168,0.7892547716806158
1201,174.083533,174.086533,1,5222505,5222595,90,0.6606780193273675
1202,174.154933,174.167767,1,5224647,5225033,386,0.12684343979194374
1203,174.190867,174.1947,1,5225726,5225841,115,-0.06632967073929566
1204,174.2035,174.209133,1,5226105,5226273,168,0.6395989847477526
1205,174.228133,174.239567,1,5226843,5227187,344,0.8475332087231779
1206,174.293933,174.301133,1,5228817,5229033,216,0.8427503138597765
1207,174.3829,174.386267,1,5231487,5231588,101,0.6864617967293625
1208,174.660967,174.6677,1,5239829,5240031,202,0.7219633830341762
1209,174.6814,174.686567,1,5240442,5240597,155,0.9481390746195494
1210,174.885733,174.889167,1,5246571,5246675,104,0.835480706436444
1211,174.909,174.918,1,5247270,5247540,270,0.539670747203404
1212,174.994733,175.0005,1,5249841,5250015,174,0.6598262623544856
1213,175.0826,175.085767,1,5252478,5252573,95,0.7323730800079221
1214,175.4073,175.410767,1,5262219,5262323,104,0.9192070453165185
1215,175.4661,175.469267,1,5263983,5264078,95,0.8576344333919786
1216,175.4779,175.492567,1,5264337,5264777,440,0.797028477373343
1217,175.5172,175.522867,1,5265516,5265686,170,0.844537774803489
1218,175.526733,175.5386,1,5265801,5266158,357,0.6984829754275943
1219,175.541567,175.551367,1,5266247,5266541,294,0.6026042218135833
1220,175.553,175.693867,1,5266590,5270816,4226,0.30678022091812424
1221,175.736033,175.7477,1,5272080,5272431,351,0.8297830649322643
1222,175.823233,175.830333,1,5274696,5274909,213,0.8323241986377133
1223,175.833633,175.960433,1,5275008,5278812,3804,0.6627150378925959
1224,175.975,175.978,1,5279250,5279340,90,0.6865796272234723
1225,175.979133,175.983033,1,5279373,5279490,117,0.902090870797637
1226,175.985667,175.994067,1,5279570,5279822,252,0.7700288188920841
1227,175.995333,176.0112,1,5279859,5280336,477,0.7527204565416827
1228,176.018767,176.042267,1,5280563,5281268,705,0.80768416443896
1229,176.043633,176.047033,1,5281308,5281410,102,0.8892354574216433
1230,176.076,176.080033,1,5282280,5282400,120,0.7515829900937243
1231,176.1005,176.136533,1,5283015,5284095,1080,0.5741509090194697
1232,176.2159,176.2192,1,5286477,5286576,99,0.8991267302926244
1233,176.296267,176.310833,1,5288888,5289324,436,0.351710679072848
1234,176.3122,176.3181,1,5289366,5289543,177,0.7607415481019708
1235,176.470333,176.475433,1,5294109,5294262,153,0.7764099031555425
1236,176.711133,176.716633,1,5301333,5301498,165,0.4580005760964178
1237,177.0286,177.0329,1,5310858,5310987,129,0.8782280718331696
1238,177.0607,177.0657,1,5311821,5311971,150,0.9432354484306565
1239,177.203667,177.2564,1,5316110,5317692,1582,0.34021390609483837
1240,177.267133,177.3184,1,5318013,5319552,1539,0.2845663810869606
1241,177.320633,177.391733,1,5319618,5321751,2133,0.24235396291532496
1242,177.398767,177.4608,1,5321963,5323824,1861,0.3965795652105324
1243,177.4651,177.502467,1,5323953,5325074,1121,0.2876357890622128
1244,177.565,177.569867,1,5326950,5327096,146,0.6390138064283585
1245,177.5711,177.597,1,5327133,5327910,777,0.5750792291230038
1246,177.726567,177.7302,1,5331797,5331906,109,0.8670735413194792
1247,177.8753,177.8826,1,5336259,5336478,219,0.8060706478179839
1248,177.962033,177.9924,1,5338860,5339772,912,0.8190858343807192
1249,177.9959,178.011067,1,5339877,5340332,455,0.9372170607538616
1250,178.024567,178.0536,1,5340737,5341608,871,0.3961460929760061
1251,178.064233,178.0716,1,5341926,5342148,222,0.5135855171331934
1252,178.1395,178.146733,1,5344185,5344401,216,0.7704866734244917
1253,178.2603,178.266433,1,5347809,5347992,183,0.828143836612679
1254,178.272733,178.281567,1,5348181,5348447,266,0.8068148772868009
1255,178.283067,178.287133,1,5348492,5348613,121,0.6908933916890928
1256,178.3087,178.3208,1,5349261,5349624,363,0.5673718486412564
1257,179.087333,179.098267,1,5372619,5372948,329,0.16860123040174824
1258,179.1064,179.1126,1,5373192,5373378,186,0.4471190112934118
1259,179.115167,179.1189,1,5373455,5373567,112,0.6464734663629502
1260,179.1335,179.168167,1,5374005,5375045,1040,0.225016195136896
1261,179.169467,179.1921,1,5375084,5375763,679,0.38575484776454727
1262,179.1969,179.215133,1,5375907,5376453,546,0.15973306488656283
1263,179.2217,179.225533,1,5376651,5376765,114,0.9214319220634125
1264,179.232133,179.306033,1,5376963,5379180,2217,0.2909435256406741
1265,179.498467,179.5119,1,5384954,5385357,403,0.022224103399228784
1266,179.514233,179.5305,1,5385426,5385915,489,0.21451741468625546
1267,179.533367,179.546467,1,5386001,5386394,393,0.4254316842262247
1268,179.5485,179.563833,1,5386455,5386914,459,0.3528526355350835
1269,179.599867,179.640167,1,5387996,5389205,1209,0.36517225787723034
1270,179.650033,179.6651,1,5389500,5389953,453,0.8188690619770015
1271,179.6663,179.689533,1,5389989,5390685,696,0.28346216565529103
1272,182.618267,182.621633,1,5478548,5478648,100,0.15317971767934954
1273,182.635933,182.6787,1,5479077,5480361,1284,-0.007501488169199819
1274,182.706367,182.716267,1,5481191,5481488,297,0.39895394829319736
1275,182.738133,182.755233,1,5482143,5482656,513,0.3264767381865857
1276,182.763467,182.77,1,5482904,5483100,196,0.40364810400108897
1277,182.779633,182.796333,1,5483388,5483889,501,0.29407990606330614
1278,182.807933,182.837667,1,5484237,5485130,893,0.27281619565955295
1279,182.842833,182.8605,1,5485284,5485815,531,0.017766052566104324
1280,182.862033,182.907033,1,5485860,5487210,1350,0.22589474598267853
1281,182.923633,182.930967,1,5487708,5487929,221,0.8467112000004308
1282,182.940933,182.9862,1,5488227,5489586,1359,0.3622819205314864
1283,182.9979,183.009033,1,5489937,5490270,333,0.29947920866654804
1284,183.014367,183.0183,1,5490431,5490549,118,0.4448966817801001
1285,183.339567,183.395733,1,5500187,5501871,1684,0.0433835992932933
1286,183.397067,183.4027,1,5501912,5502081,169,0.6321237308846008
1287,183.406433,183.420833,1,5502192,5502624,432,0.09002364646939305
1288,183.4222,183.4259,1,5502666,5502777,111,0.9043867923454648
1289,183.428267,183.455033,1,5502848,5503650,802,0.2843338917556076
1290,183.4611,183.4749,1,5503833,5504247,414,0.7372822390953965
1291,183.4779,183.5068,1,5504337,5505204,867,0.09155980171347386
1292,183.507933,183.511633,1,5505237,5505348,111,0.7039838735350625
1293,183.514,183.564133,1,5505420,5506923,1503,0.21464189512937293
1294,183.580933,183.5844,1,5507427,5507532,105,0.8306837395714608
1295,183.589233,183.603267,1,5507676,5508098,422,0.5913298346892452
1296,183.707667,183.854467,1,5511230,5515634,4404,0.0366050133900175
1297,183.879833,183.8985,1,5516394,5516955,561,0.20163956683955736
1298,183.906033,184.039667,1,5517180,5521190,4010,0.03474304116476632
1299,184.056833,184.060333,1,5521704,5521809,105,0.8622008038734423
1300,184.065867,184.0699,1,5521976,5522097,121,0.9027667641361655
1301,184.112633,184.156,1,5523378,5524680,1302,0.5052003120710625
1302,184.163667,184.169033,1,5524910,5525070,160,0.24888577125656947
1303,184.172,184.225133,1,5525160,5526753,1593,0.24063460018080882
1304,184.254333,184.276567,1,5527629,5528297,668,0.17672670858986594
1305,184.304433,184.312333,1,5529132,5529369,237,0.7019569907020405
1306,184.3139,184.345167,1,5529417,5530355,938,0.14275282538181966
1307,184.3491,184.3915,1,5530473,5531745,1272,0.1498208096313728
1308,184.404967,184.410233,1,5532149,5532306,157,0.7553988359413056
1309,184.4153,184.4385,1,5532459,5533155,696,0.5908072854800452
1310,184.4421,184.445433,1,5533263,5533362,99,0.5130209959157555
1311,184.45,184.526167,1,5533500,5535785,2285,0.3419369339130316
1312,184.5307,184.584133,1,5535921,5537523,1602,0.22805343687359814
1313,184.587133,184.5913,1,5537613,5537739,126,0.8878091699116498
1314,184.622233,184.6427,1,5538666,5539281,615,0.14738842374922342
1315,184.6541,184.703933,1,5539623,5541117,1494,0.15967529585463364
1316,184.712733,184.7174,1,5541381,5541522,141,0.07601184691308385
1317,184.722233,184.7469,1,5541666,5542407,741,0.6731452644204461
1318,184.7542,184.781567,1,5542626,5543447,821,0.4131814363257491
1319,184.7878,184.809533,1,5543634,5544285,651,0.39363220668673204
1320,184.815967,184.851,1,5544479,5545530,1051,0.38854722034355954
1321,184.853167,184.9078,1,5545595,5547234,1639,0.5595811807432224
1322,184.908867,185.010133,1,5547266,5550303,3037,0.4534401666437762
1323,185.016767,185.126233,1,5550503,5553786,3283,0.4150151934457945
1324,185.147267,185.1518,1,5554418,5554554,136,0.8069794889405554
1325,185.152967,185.1845,1,5554589,5555535,946,0.2634238471143556
1326,185.1857,185.249133,1,5555571,5557473,1902,0.1764855787345779
1327,185.2687,185.272333,1,5558061,5558169,108,0.9403509133626857
1328,185.273633,185.346133,1,5558208,5560383,2175,0.31652988616998096
1329,185.347933,185.367067,1,5560437,5561012,575,0.18876753358936943
1330,185.373467,185.378333,1,5561204,5561349,145,0.8948175946270198
1331,185.385067,185.388367,1,5561552,5561651,99,0.8026609201172034
1332,185.3896,185.434567,1,5561688,5563037,1349,0.5962336370407556
1333,185.446467,185.466567,1,5563394,5563997,603,0.35773760567524676
1334,185.468167,185.4729,1,5564045,5564187,142,0.883429388128421
1335,185.6068,185.613833,1,5568204,5568414,210,0.3651857949536366
1336,185.720767,185.764733,1,5571623,5572941,1318,0.5133589014624701
1337,185.7708,185.7968,1,5573124,5573904,780,0.19807376417222664
1338,185.799333,185.8054,1,5573979,5574162,183,0.35806238025413073
1339,185.811267,185.826433,1,5574338,5574792,454,0.22289659195369474
1340,185.8555,185.860133,1,5575665,5575803,138,0.8345155957604878
1341,185.861733,185.9049,1,5575851,5577147,1296,0.19393615867211803
1342,185.9082,185.9142,1,5577246,5577426,180,0.9127276382335396
1343,185.922833,185.926967,1,5577684,5577809,125,0.8032473548106286
1344,185.928,185.934633,1,5577840,5578038,198,0.9269629005003391
1345,185.936267,185.953333,1,5578088,5578599,511,0.4257144184306956
1346,185.9589,185.967067,1,5578767,5579012,245,0.7953323672781257
1347,185.9748,185.989,1,5579244,5579670,426,0.35897612972574905
1348,185.9912,185.998833,1,5579736,5579964,228,0.38672285129308376
1349,185.999833,186.017233,1,5579994,5580516,522,0.21065647592762618
1350,186.018433,186.075167,1,5580552,5582255,1703,0.236373551446113
1351,186.137133,186.144133,1,5584113,5584323,210,0.8101167231784325
1352,186.3588,186.4321,1,5590764,5592963,2199,0.4021744435651036
1353,186.454133,186.458733,1,5593623,5593761,138,0.8457704768948273
1354,186.461867,186.475367,1,5593856,5594261,405,0.4338231510494425
1355,186.478067,186.4869,1,5594342,5594607,265,0.36099576321805144
1356,186.5118,186.518833,1,5595354,5595564,210,0.9189726083375765
1357,186.5203,186.524433,1,5595609,5595732,123,0.62832582596127
1358,186.526467,186.5297,1,5595794,5595891,97,0.6130996432029977
1359,186.541567,186.545133,1,5596247,5596353,106,0.08182170934121005
1360,186.558633,186.561833,1,5596758,5596854,96,0.32503897392644876
1361,186.657433,186.6668,1,5599722,5600004,282,0.8002223929847168
1362,188.3106,188.316367,1,5649318,5649491,173,0.19738207987714057
1363,188.325067,188.3399,1,5649752,5650197,445,0.20223522757703966
1364,188.605333,188.609133,1,5658159,5658273,114,0.8228181773752409
1365,188.610867,188.620433,1,5658326,5658612,286,0.34668174808837726
1366,188.7357,188.7494,1,5662071,5662482,411,0.8669013619168804
1367,188.857667,188.8659,1,5665730,5665977,247,0.07185648142607919
1368,189.1155,189.136933,1,5673465,5674107,642,0.28394154551311435
1369,189.191167,189.1988,1,5675735,5675964,229,0.07769389925190226
1370,189.423067,189.432133,1,5682692,5682963,271,0.2039798158154628
1371,189.597167,189.6007,1,5687915,5688021,106,0.5863128161299287
1372,189.678533,189.681533,1,5690355,5690445,90,0.8508989472990315
1373,189.695533,189.702067,1,5690865,5691062,197,0.8541707927816073
1374,189.8395,189.842767,1,5695185,5695283,98,0.9039568983155544
1375,189.882467,189.9055,1,5696474,5697165,691,0.5844818716999469
1376,189.955,189.973233,1,5698650,5699196,546,0.7507691977087624
1377,190.0087,190.019167,1,5700261,5700575,314,0.6255874497613823
1378,190.030167,190.0442,1,5700905,5701326,421,0.5867291120114652
1379,190.085033,190.1036,1,5702550,5703108,558,0.24084344389597076
1380,190.104633,190.123833,1,5703138,5703714,576,0.10921916493896511
1381,190.1538,190.1657,1,5704614,5704971,357,0.3713501232941111
1382,190.1697,190.180933,1,5705091,5705427,336,0.1833679955047079
1383,190.208967,190.222867,1,5706269,5706686,417,0.17494507300145962
1384,190.226133,190.238833,1,5706783,5707164,381,-0.013027931127943667
1385,190.265567,190.288933,1,5707967,5708667,700,0.4708559670220581
1386,190.294267,190.297967,1,5708828,5708939,111,0.5681813295778718
1387,190.346033,190.3523,1,5710380,5710569,189,0.5847158217245843
1388,190.357267,190.360567,1,5710718,5710817,99,0.5472147257088311
1389,190.365933,190.3703,1,5710977,5711109,132,0.19007168275268627
1390,190.378467,190.3832,1,5711354,5711496,142,0.5253565547360965
1391,190.404867,190.422367,1,5712146,5712671,525,0.18233419450402225
1392,190.424933,190.429367,1,5712747,5712881,134,0.12878988374521566
1393,190.4612,190.472833,1,5713836,5714184,348,0.3366155811816761
1394,190.475167,190.487567,1,5714255,5714627,372,0.207376296168317
1395,190.528967,190.537633,1,5715869,5716128,259,0.43514969821633315
1396,190.609333,190.6229,1,5718279,5718687,408,0.16548674674859118
1397,190.668567,190.6724,1,5720057,5720172,115,0.428915763305366
1398,190.981733,190.984933,1,5729451,5729547,96,0.8499877182697035
1399,191.1278,191.132533,1,5733834,5733975,141,0.8760935950563672
1400,191.147133,191.1555,1,5734413,5734665,252,0.058472032386783425
1401,191.2231,191.226167,1,5736693,5736785,92,0.834369068168532
1402,191.3223,191.3285,1,5739669,5739855,186,0.6714858696558286
1403,191.398367,191.4015,1,5741951,5742045,94,0.9295386925416588
1404,191.413933,191.421,1,5742417,5742630,213,0.6392164705715541
1405,191.479767,191.5179,1,5744393,5745537,1144,0.1564774990786219
1406,191.519267,191.534833,1,5745578,5746044,466,0.6432319908896209
1407,191.5952,191.598633,1,5747856,5747958,102,0.8594409537000172
1408,191.622067,191.6263,1,5748662,5748789,127,0.8429728466684876
1409,191.7106,191.722733,1,5751318,5751681,363,0.24901689893570328
1410,191.750933,191.7541,1,5752527,5752623,96,0.5631535568221806
1411,191.771267,191.7821,1,5753138,5753463,325,0.7214034361111656
1412,191.787967,191.7927,1,5753639,5753781,142,0.6287173755225054
1413,191.833667,191.8368,1,5755010,5755104,94,0.8819280809238284
1414,191.850367,191.853933,1,5755511,5755617,106,-0.04199782496847095
1415,191.873633,191.877,1,5756208,5756310,102,0.6938308460170225
1416,191.8902,191.895633,1,5756706,5756868,162,0.8675269430863273
1417,191.9008,191.931367,1,5757024,5757941,917,0.8447555000555408
1418,191.980033,191.987167,1,5759400,5759615,215,0.45795174991572535
1419,192.0095,192.0156,1,5760285,5760468,183,0.8061981590487446
1420,192.031167,192.0608,1,5760935,5761824,889,0.7942304253971538
1421,192.130367,192.1348,1,5763911,5764044,133,0.6711833317208472
1422,192.1494,192.154033,1,5764482,5764620,138,0.529535746241464
1423,192.165567,192.175,1,5764967,5765250,283,0.3314231213130567
1424,192.185467,192.190667,1,5765564,5765720,156,0.9254650903138649
1425,192.235767,192.240733,1,5767073,5767221,148,0.6499799544896566
1426,192.243367,192.2724,1,5767301,5768172,871,0.5132226386571204
1427,192.273767,192.2771,1,5768213,5768313,100,0.7160916359211112
1428,192.3242,192.3387,1,5769726,5770161,435,0.7938775067216787
1429,192.391067,192.395367,1,5771732,5771861,129,0.6428108850845308
1430,192.464433,192.4685,1,5773932,5774055,123,0.911685525277363
1431,192.471133,192.478833,1,5774133,5774364,231,0.7167573363673178
1432,192.4842,192.49,1,5774526,5774700,174,0.9524123990253117
1433,192.498333,192.504,1,5774949,5775120,171,0.5182081333270747
1434,192.520967,192.525067,1,5775629,5775752,123,0.9242667257887778
1435,192.603033,192.6132,1,5778090,5778396,306,0.08727999365561882
1436,192.634167,192.639333,1,5779025,5779179,154,0.8661703229771838
1437,192.687533,192.6914,1,5780625,5780742,117,0.6054309933844361
1438,192.694667,192.710333,1,5780840,5781309,469,0.864589873738083
1439,192.714,192.739167,1,5781420,5782175,755,0.39815384729520015
1440,192.768867,192.7749,1,5783066,5783247,181,0.6922772884223823
1441,192.777667,192.7842,1,5783330,5783526,196,0.9193978140546365
1442,192.791867,192.797333,1,5783756,5783919,163,0.786724796363369
1443,192.839233,192.842567,1,5785176,5785277,101,0.8617893060417712
1444,193.018933,193.022133,1,5790567,5790663,96,0.9948895341911975
1445,193.126067,193.1375,1,5793782,5794125,343,0.6034543661085292
1446,193.201533,193.206833,1,5796045,5796204,159,0.7274498951302659
1447,193.245733,193.265067,1,5797371,5797952,581,0.6184576124755764
1448,193.271233,193.274733,1,5798136,5798241,105,0.8634885099195196
1449,193.297067,193.3016,1,5798912,5799048,136,0.7485483587337809
1450,193.3034,193.319,1,5799102,5799570,468,0.48706484206453343
1451,193.336,193.342733,1,5800080,5800281,201,0.5902543338759543
1452,193.361233,193.434667,1,5800836,5803040,2204,0.5115559834526148
1453,193.442033,193.451067,1,5803260,5803532,272,0.958153762336057
1454,193.4838,193.487,1,5804514,5804610,96,0.5967903545306738
1455,193.5052,193.5388,1,5805156,5806164,1008,0.5513336845062333
1456,193.558467,193.573733,1,5806754,5807211,457,0.8171025852164714
1457,193.575167,193.580533,1,5807255,5807415,160,0.9843655489588545
1458,193.610133,193.629233,1,5808303,5808876,573,0.6685918045076343
1459,193.6448,193.657667,1,5809344,5809730,386,0.7829332245330919
1460,193.662967,193.673367,1,5809889,5810201,312,0.38405145616872066
1461,193.680533,193.7019,1,5810415,5811057,642,0.7974129976746754
1462,193.704133,193.709133,1,5811123,5811273,150,0.6382704682998313
1463,193.710233,193.714333,1,5811306,5811429,123,0.8169203457449024
1464,193.728633,193.731967,1,5811858,5811959,101,0.9742773627661682
1465,193.751867,193.767667,1,5812556,5813030,474,0.3062678939873263
1466,193.795767,193.8006,1,5813873,5814018,145,0.7932693324313024
1467,193.8284,193.842267,1,5814852,5815268,416,0.8973514348985723
1468,193.845367,193.850767,1,5815361,5815523,162,0.06622362523893505
1469,193.878133,193.9012,1,5816343,5817036,693,0.5896482833363486
1470,193.902267,193.905633,1,5817068,5817168,100,0.6638083798804657
1471,193.907067,193.918333,1,5817212,5817549,337,0.8949248859728246
1472,193.92,193.923133,1,5817600,5817693,93,0.8166612028929585
1473,193.928033,193.941467,1,5817840,5818244,404,0.26911715347780657
1474,193.946033,193.954633,1,5818380,5818638,258,0.4997913280396729
1475,193.961567,193.985567,1,5818847,5819567,720,0.9000632543179174
1476,193.987167,193.991667,1,5819615,5819750,135,0.8961657483791321
1477,194.029533,194.035433,1,5820885,5821062,177,0.07364999327245178
1478,194.039067,194.0427,1,5821172,5821281,109,0.6543366954676607
1479,194.122933,194.1274,1,5823687,5823822,135,0.4407720860972568
1480,194.131167,194.1519,1,5823935,5824557,622,0.8528886673934167
1481,194.1572,194.162267,1,5824716,5824868,152,0.34034269187058785
1482,194.169967,194.182067,1,5825099,5825462,363,0.31816840535730573
1483,194.292433,194.322633,1,5828772,5829678,906,0.6935487138936325
1484,194.325033,194.328067,1,5829750,5829842,92,0.6140662781524676
1485,194.492967,194.4981,1,5834789,5834943,154,0.7983253700596689
1486,194.5414,194.548533,1,5836242,5836455,213,0.2773714422842013
1487,194.5498,194.553133,1,5836494,5836593,99,0.817482098213729
1488,195.029567,195.0466,1,5850887,5851398,511,0.5579412121111909
1489,195.0507,195.059733,1,5851521,5851791,270,0.8353066530596487
1490,195.071367,195.083067,1,5852141,5852492,351,0.34265689728093435
1491,195.095567,195.100967,1,5852867,5853029,162,0.5894480233965012
1492,195.164833,195.1814,1,5854944,5855442,498,0.12198944123313735
1493,195.185333,195.209933,1,5855559,5856297,738,0.5104578408297015
1494,195.222567,195.2613,1,5856677,5857839,1162,0.3257402911009642
1495,195.271633,195.279633,1,5858148,5858388,240,0.8517867805117278
1496,195.281,195.308033,1,5858430,5859240,810,0.6092477377358266
1497,195.3129,195.354533,1,5859387,5860635,1248,0.5101815937094676
1498,195.356067,195.3674,1,5860682,5861022,340,0.9155582440293113
1499,195.3684,195.400233,1,5861052,5862006,954,0.6798226495018519
1500,195.417867,195.435433,1,5862536,5863062,526,0.9419811581960815
1501,195.437167,195.445267,1,5863115,5863358,243,0.8482906509213066
1502,195.448,195.461867,1,5863440,5863856,416,0.9048397031472049
1503,195.469133,195.4765,1,5864073,5864295,222,0.9618796750551207
1504,195.490867,195.504433,1,5864726,5865132,406,0.4768758050003696
1505,195.643333,195.646467,1,5869299,5869394,95,0.8636334320416037
1506,195.686767,195.6951,1,5870603,5870853,250,0.17274810670055962
1507,195.696833,195.700067,1,5870904,5871002,98,0.9230381327124735
1508,195.705667,195.734933,1,5871170,5872047,877,0.3479969695174177
1509,195.736467,195.740567,1,5872094,5872217,123,0.8276493610776249
1510,195.744733,195.7678,1,5872341,5873034,693,0.8050849807137059
1511,195.7868,195.790267,1,5873604,5873708,104,0.8483944803849166
1512,195.7989,195.8066,1,5873967,5874198,231,0.6131762562462502
1513,195.843033,195.848533,1,5875290,5875455,165,0.6275623456621098
1514,195.8858,195.9169,1,5876574,5877507,933,0.7164549070918317
1515,195.923033,195.930967,1,5877690,5877929,239,0.47462749314830277
1516,196.033767,196.037833,1,5881013,5881134,121,0.37488689321613566
1517,196.042367,196.0472,1,5881271,5881416,145,0.7345169918176221
1518,196.056067,196.073933,1,5881682,5882217,535,0.8702379366771578
1519,196.131433,196.138733,1,5883942,5884161,219,0.7871166497487839
1520,196.143633,196.150467,1,5884308,5884514,206,0.937453047129205
1521,196.167267,196.1712,1,5885018,5885136,118,0.9652430063502383
1522,196.178,196.1873,1,5885340,5885619,279,0.8232236248163418
1523,196.191433,196.194633,1,5885742,5885838,96,0.9490104899893346
1524,196.201667,196.205333,1,5886050,5886159,109,0.8560728157229884
1525,196.206433,196.235967,1,5886192,5887079,887,0.865973806695121
1526,196.2408,196.247933,1,5887224,5887437,213,0.4547254185484367
1527,196.3704,196.374367,1,5891112,5891231,119,0.9511174222470358
1528,196.375433,196.378533,1,5891262,5891355,93,0.8517301094817582
1529,196.380467,196.3845,1,5891414,5891535,121,0.7902509802116287
1530,196.385867,196.397133,1,5891576,5891913,337,0.7415316513007975
1531,196.399567,196.4079,1,5891987,5892237,250,0.3603131573731505
1532,196.4124,196.423533,1,5892372,5892705,333,0.817929346366356
1533,196.427067,196.430733,1,5892812,5892921,109,0.9590283729979338
1534,196.431833,196.436333,1,5892954,5893089,135,0.7846187945219196
1535,196.4439,196.454,1,5893317,5893620,303,0.8093438345052637
1536,196.5459,196.551533,1,5896377,5896545,168,0.34956217181586574
1537,196.564033,196.5671,1,5896920,5897013,93,0.9008498995403961
1538,196.575067,196.5822,1,5897252,5897466,214,0.6611610741012225
1539,196.611567,196.621433,1,5898347,5898642,295,0.24404593105362823
1540,196.738533,196.745667,1,5902155,5902370,215,0.5658242144145185
1541,196.875167,196.882933,1,5906255,5906487,232,0.4289749397716972
1542,196.891933,196.897533,1,5906757,5906925,168,0.8707184334838145
1543,197.669033,197.6732,1,5930070,5930196,126,0.6058906798953393
1544,197.850267,197.8613,1,5935508,5935839,331,0.7829854924899563
1545,197.862833,197.8732,1,5935884,5936196,312,0.7141898402951627
1546,197.877867,197.883,1,5936336,5936490,154,0.4727408814718397
1547,197.8938,197.9016,1,5936814,5937048,234,0.19976808870381907
1548,197.915133,197.920767,1,5937453,5937623,170,0.2879939042477648
1549,197.9744,197.9824,1,5939232,5939472,240,0.5636216500448246
1550,198.0834,198.087133,1,5942502,5942613,111,0.8640218482827834
1551,198.181967,198.201133,1,5945459,5946033,574,0.31458538708176426
1552,198.399833,198.403167,1,5951994,5952095,101,0.8942062384937479
1553,198.4133,198.4179,1,5952399,5952537,138,0.43933690047684787
1554,198.435733,198.443567,1,5953071,5953307,236,0.5682236851120311
1555,198.447833,198.452067,1,5953434,5953562,128,0.5275153016932704
1556,198.458733,198.4835,1,5953761,5954505,744,0.3929857208528123
1557,198.571833,198.575167,1,5957154,5957255,101,0.6542583598384886
1558,198.6577,198.662767,1,5959731,5959883,152,0.6913671921093661
1559,198.720033,198.7267,1,5961600,5961801,201,0.5986598624422932
1560,198.7897,198.793567,1,5963691,5963807,116,0.6570035394279983
1561,198.808967,198.812667,1,5964269,5964380,111,0.9298924323848332
1562,198.857933,198.8634,1,5965737,5965902,165,0.08632391223551418
1563,198.925933,198.9302,1,5967777,5967906,129,0.7121876340611426
1564,198.953567,198.956667,1,5968607,5968700,93,0.5425247203114267
1565,199.021433,199.024633,1,5970642,5970738,96,0.8227896711771491
1566,199.104967,199.108133,1,5973149,5973243,94,0.7623885172537391
1567,199.270533,199.280233,1,5978115,5978406,291,0.6426629586710277
1568,199.5136,199.5175,1,5985408,5985525,117,0.740900532007811
1569,199.5213,199.525667,1,5985639,5985770,131,0.7827354131917007
1570,200.250033,200.2662,1,6007500,6007986,486,0.4561742628926378
1571,200.268833,200.274533,1,6008064,6008235,171,0.6923589968313167
1572,200.291433,200.2976,1,6008742,6008928,186,0.03906291559977344
1573,200.309967,200.317733,1,6009299,6009531,232,0.054943861544737224
1574,200.3442,200.351167,1,6010326,6010535,209,0.6545460267427915
1575,200.399267,200.414033,1,6011978,6012420,442,0.41233436654083305
1576,200.415233,200.418567,1,6012456,6012557,101,0.8218748486186747
1577,200.448033,200.454833,1,6013440,6013644,204,0.3965614719405014
1578,200.5728,200.5775,1,6017184,6017325,141,0.5231597913223959
1579,200.607633,200.6164,1,6018228,6018492,264,0.7765570399581933
1580,200.642967,200.647467,1,6019289,6019424,135,0.7958664707420396
1581,200.672933,200.6761,1,6020187,6020283,96,0.4430206422788902
1582,200.679633,200.6941,1,6020388,6020823,435,0.5057526236312949
1583,200.695567,200.705167,1,6020867,6021155,288,0.8463825647444917
1584,200.735033,200.7386,1,6022050,6022158,108,0.7479172457215477
1585,200.7401,200.763367,1,6022203,6022901,698,0.7451088366067601
1586,200.764867,200.771267,1,6022946,6023138,192,0.8771291914497313
1587,200.795167,200.7982,1,6023855,6023946,91,-0.2255521138342509
1588,200.807733,200.814633,1,6024231,6024438,207,0.5616641778342522
1589,200.872367,200.875833,1,6026171,6026274,103,0.5238496745072296
1590,200.888833,200.892667,1,6026664,6026780,116,0.804507920381234
1591,200.898533,200.9124,1,6026955,6027372,417,0.5746691257763464
1592,200.913433,200.926,1,6027402,6027780,378,0.37779812046445466
1593,200.974,200.981233,1,6029220,6029436,216,0.12201873348314028
1594,200.997967,201.000967,1,6029939,6030029,90,0.27252355532674943
1595,201.042233,201.0453,1,6031266,6031359,93,0.9006406849574712
1596,201.047667,201.0685,1,6031430,6032055,625,0.7259720227161863
1597,201.072967,201.0787,1,6032189,6032361,172,0.5701628036090478
1598,201.103767,201.1116,1,6033113,6033348,235,0.5408480377784562
1599,201.125333,201.132267,1,6033759,6033968,209,0.49597402963723647
1600,201.3351,201.358467,1,6040053,6040754,701,0.33604024456703757
1601,201.465733,201.481533,1,6043971,6044445,474,0.36113423618195645
1602,201.482633,201.499533,1,6044478,6044985,507,0.840699949999818
1603,201.5007,201.505567,1,6045021,6045167,146,0.8946204778850179
1604,201.5111,201.515433,1,6045333,6045462,129,0.2504365689888405
1605,201.5577,201.561067,1,6046731,6046832,101,0.7832519793576858
1606,201.605667,201.6108,1,6048170,6048324,154,0.7336690207698714
1607,201.614,201.6376,1,6048420,6049128,708,0.4894895955886273
1608,201.742933,201.773533,1,6052287,6053205,918,0.26097167381051134
1609,201.7934,201.797133,1,6053802,6053913,111,0.4797435134137636
1610,201.8211,201.829133,1,6054633,6054873,240,0.2567476334461613
1611,201.8947,201.898333,1,6056841,6056949,108,0.9251222951285076
1612,201.932967,201.9373,1,6057989,6058119,130,0.744523870386854
1613,201.942133,201.9464,1,6058263,6058392,129,0.6878487588183008
1614,201.9491,201.961933,1,6058473,6058857,384,0.7192751994439873
1615,202.039533,202.0521,1,6061185,6061563,378,0.46670307834691704
1616,202.054333,202.0588,1,6061629,6061764,135,0.8989400310668612
1617,202.109567,202.113933,1,6063287,6063417,130,0.7350698280294422
1618,202.1773,202.1804,1,6065319,6065412,93,0.7755062901391949
1619,202.183667,202.207933,1,6065510,6066237,727,0.8285380085118977
1620,202.315467,202.326633,1,6069464,6069798,334,0.1704822950201209
1621,202.3292,202.340433,1,6069876,6070212,336,0.863805552768211
1622,202.345067,202.3486,1,6070352,6070458,106,0.8981150680702069
1623,202.3943,202.397667,1,6071829,6071930,101,0.7849732307727505
1624,202.4879,202.499933,1,6074637,6074997,360,0.505903021391897
1625,202.505633,202.511833,1,6075168,6075354,186,0.8371998945498897
1626,202.5261,202.533333,1,6075783,6075999,216,0.496956880644644
1627,202.546433,202.549733,1,6076392,6076491,99,0.5538450028092013
1628,202.550933,202.555533,1,6076527,6076665,138,0.7621009457346772
1629,202.5587,202.563867,1,6076761,6076916,155,0.7655929699459995
1630,202.569367,202.5768,1,6077081,6077304,223,0.7034867235576882
1631,202.6132,202.6183,1,6078396,6078549,153,0.8294719277783804
1632,202.620533,202.636,1,6078615,6079080,465,0.8327411000329435
1633,202.688767,202.6938,1,6080663,6080814,151,0.5955693058832807
1634,202.769267,202.7942,1,6083078,6083826,748,0.5804186918493845
1635,202.797367,202.8016,1,6083921,6084048,127,0.7273645663855787
1636,202.8432,202.8479,1,6085296,6085437,141,0.29473802675669275
1637,202.9585,202.966267,1,6088755,6088988,233,0.35797720548750495
1638,202.974233,202.989833,1,6089226,6089694,468,0.19777767863733262
1639,203.042333,203.071,1,6091269,6092130,861,0.38080115638037393
1640,203.0764,203.0856,1,6092292,6092568,276,0.2125617019491036
1641,203.089567,203.093367,1,6092687,6092801,114,0.5970580935433327
1642,203.110433,203.122267,1,6093312,6093668,356,0.8225348738997961
1643,203.125,203.1287,1,6093750,6093861,111,0.8883364040433518
1644,203.175967,203.179867,1,6095279,6095396,117,0.8035174707778051
1645,203.265433,203.280167,1,6097962,6098405,443,0.8834975856834559
1646,203.437967,203.443133,1,6103139,6103293,154,0.7480686660992704
1647,203.4446,203.461533,1,6103338,6103845,507,0.7667404206584493
1648,203.4626,203.4713,1,6103878,6104139,261,0.7374829563070424
1649,203.510033,203.529333,1,6105300,6105879,579,0.7188388947103785
1650,203.600833,203.604467,1,6108024,6108134,110,0.7597739873994334
1651,203.612133,203.621367,1,6108363,6108641,278,0.5747716832923712
1652,203.622467,203.638367,1,6108674,6109151,477,0.6922777107592827
1653,203.719933,203.725533,1,6111597,6111765,168,0.8284133131379329
1654,203.7277,203.735533,1,6111831,6112065,234,0.6029218395374877
1655,203.7946,203.800067,1,6113838,6114002,164,0.5879963223174587
1656,203.8061,203.8101,1,6114183,6114303,120,0.8385258502082563
1657,203.8112,203.815467,1,6114336,6114464,128,0.8305528541314885
1658,203.867433,203.871567,1,6116022,6116147,125,0.6480192500372838
1659,203.995033,203.999933,1,6119850,6119997,147,0.7236468479844878
1660,204.009067,204.0292,1,6120272,6120876,604,0.6429501056350607
1661,204.196667,204.205067,1,6125900,6126152,252,0.3912947415916949
1662,204.268,204.271367,1,6128040,6128141,101,0.4646592961125128
1663,204.274133,204.288467,1,6128223,6128654,431,0.42638917605899823
1664,204.315833,204.331433,1,6129474,6129942,468,0.22726791582577383
1665,204.333733,204.337933,1,6130011,6130137,126,0.7312977991320518
1666,204.453367,204.467833,1,6133601,6134034,433,0.697517831866379
1667,204.483,204.488367,1,6134490,6134651,161,0.2741418979883761
1668,204.521267,204.53,1,6135638,6135900,262,0.8092327603457612
1669,204.943933,204.9531,1,6148317,6148593,276,0.3328075075123565
1670,205.018167,205.0237,1,6150545,6150711,166,0.8294311233655586
1671,205.038067,205.0414,1,6151142,6151242,100,0.24708927315604856
1672,205.244667,205.2547,1,6157340,6157641,301,0.6823621855496423
1673,205.262167,205.2728,1,6157865,6158184,319,0.8962572057579947
1674,205.2953,205.3017,1,6158859,6159051,192,0.79931395260789
1675,205.3044,205.308,1,6159132,6159240,108,0.9645254126113679
1676,205.3114,205.316067,1,6159342,6159482,140,0.8691039510481964
1677,205.3438,205.3479,1,6160314,6160437,123,0.5393072838791703
1678,205.369333,205.375767,1,6161079,6161273,194,0.17761809638901593
1679,205.385533,205.399933,1,6161565,6161997,432,0.7082618393574459
1680,205.403333,205.4109,1,6162099,6162327,228,0.8337536105336916
1681,205.4128,205.4252,1,6162384,6162756,372,0.7875668719922733
1682,205.431767,205.435067,1,6162953,6163052,99,0.30713016118142916
1683,205.516767,205.5204,1,6165503,6165612,109,0.09229724707668523
1684,205.5524,205.555667,1,6166572,6166670,98,0.7066984780555434
1685,205.5986,205.6102,1,6167958,6168306,348,0.523558586352863
1686,205.759233,205.762633,1,6172776,6172878,102,0.7376796582050199
1687,205.8183,205.830333,1,6174549,6174909,360,0.7070369483432976
1688,205.8403,205.8449,1,6175209,6175347,138,0.9490355969407358
1689,205.868167,205.871267,1,6176045,6176138,93,0.7686976580457806
1690,205.888967,205.893267,1,6176669,6176798,129,0.5727651758803652
1691,205.947967,205.961033,1,6178439,6178830,391,0.6848092508033241
1692,206.004167,206.0074,1,6180125,6180222,97,0.3751394103638747
1693,206.018233,206.022167,1,6180546,6180665,119,0.4499387644565779
1694,206.082833,206.088767,1,6182484,6182663,179,0.7702026822113858
1695,206.0898,206.098233,1,6182694,6182946,252,0.8204466283303917
1696,206.100833,206.106233,1,6183024,6183186,162,0.9238108411930771
1697,206.1197,206.122767,1,6183591,6183683,92,0.7231098450657771
1698,206.1479,206.1575,1,6184437,6184725,288,0.45977269028635875
1699,206.172833,206.187267,1,6185184,6185618,434,0.7333724810921992
1700,206.1895,206.1974,1,6185685,6185922,237,0.592300882822925
1701,206.2306,206.238833,1,6186918,6187164,246,0.8467045274885977
1702,206.2817,206.285933,1,6188451,6188577,126,0.8428205599770189
1703,206.299167,206.317633,1,6188975,6189528,553,0.5533642081799938
1704,206.3194,206.327967,1,6189582,6189839,257,0.40853703716065304
1705,206.384633,206.395467,1,6191538,6191864,326,0.8208064475203585
1706,206.433733,206.436867,1,6193011,6193106,95,0.9310213909196379
1707,206.4457,206.4495,1,6193371,6193485,114,0.8962686538490451
1708,206.468867,206.4742,1,6194066,6194226,160,0.23022261795017596
1709,206.511367,206.515133,1,6195341,6195453,112,0.47280273719511284
1710,206.544967,206.576967,1,6196349,6197309,960,0.6927007111238266
1711,206.6965,206.722633,1,6200895,6201678,783,0.6561396254289777
1712,206.744667,206.747833,1,6202340,6202434,94,0.7299536686758741
1713,206.765167,206.7716,1,6202955,6203148,193,0.8824632076151792
1714,206.779433,206.7871,1,6203382,6203613,231,0.3765206245482066
1715,206.810967,206.817433,1,6204329,6204522,193,0.42412047961656024
1716,206.8535,206.883533,1,6205605,6206505,900,0.6902807714429636
1717,206.930733,206.937633,1,6207921,6208128,207,0.47372215684634383
1718,206.984533,207.000833,1,6209535,6210024,489,0.27237877868981714
1719,207.0063,207.014733,1,6210189,6210441,252,0.6162151846158386
1720,207.0239,207.041767,1,6210717,6211253,536,0.24898804226573545
1721,207.087167,207.091,1,6212615,6212730,115,0.2387912336894581
1722,207.165033,207.1717,1,6214950,6215151,201,0.6698216076602668
1723,207.1858,207.2021,1,6215574,6216063,489,0.6841427603488629
1724,207.2118,207.2155,1,6216354,6216465,111,0.10449402744971208
1725,207.240433,207.246633,1,6217212,6217398,186,0.24532654052871816
1726,207.2503,207.259633,1,6217509,6217788,279,0.36062744052496126
1727,207.270833,207.273833,1,6218124,6218214,90,0.7750944964281863
1728,207.324433,207.333733,1,6219732,6220011,279,0.16063729924411288
1729,207.3375,207.3434,1,6220125,6220302,177,0.11816024751123243
1730,207.358333,207.367433,1,6220749,6221022,273,0.2927340555540946
1731,207.383133,207.410667,1,6221493,6222320,827,0.07524650060101072
1732,207.5063,207.5155,1,6225189,6225465,276,0.448860394268462
1733,207.528533,207.5338,1,6225855,6226014,159,0.7983114436466691
1734,207.538067,207.542267,1,6226142,6226268,126,0.788344068164812
1735,207.558067,207.568967,1,6226742,6227069,327,0.23764010734067928
1736,207.5823,207.587433,1,6227469,6227622,153,0.53116741472979
1737,208.3381,208.342833,1,6250143,6250284,141,0.6024044578965758
1738,209.571933,209.5761,1,6287157,6287283,126,0.885321088057455
1739,209.594,209.5996,1,6287820,6287988,168,0.2599640504380327
1740,209.6196,209.6305,1,6288588,6288915,327,0.2272492426566646
1741,209.642867,209.646133,1,6289286,6289383,97,0.9620097644000972
1742,209.700033,209.704033,1,6291000,6291120,120,0.023094801651499904
1743,209.830467,209.8355,1,6294914,6295065,151,0.7051882100462307
1744,209.859333,209.8666,1,6295779,6295998,219,0.5810890548280835
1745,209.891767,209.8962,1,6296753,6296886,133,0.5250514031236018
1746,209.976733,209.995067,1,6299301,6299852,551,0.11088679895713426
1747,210.284633,210.288867,1,6308538,6308666,128,0.11729776391023426
1748,210.4592,210.462333,1,6313776,6313869,93,0.9277648559335097
1749,210.466567,210.4728,1,6313997,6314184,187,0.7457490565884816
1750,210.5042,210.508733,1,6315126,6315261,135,0.8106590374975486
1751,210.787033,210.792233,1,6323610,6323766,156,0.8791717397933477
1752,210.8417,210.846733,1,6325251,6325401,150,0.8467332619467542
1753,210.864333,210.8675,1,6325929,6326025,96,0.8124024342837565
1754,210.8804,210.886667,1,6326412,6326600,188,0.41435794826725686
1755,210.8924,210.897733,1,6326772,6326931,159,0.6941349430311489
1756,210.922567,210.9298,1,6327677,6327894,217,0.846964976007641
1757,210.931367,210.939233,1,6327941,6328176,235,0.8189415364059027
1758,210.975767,210.980833,1,6329273,6329424,151,0.8153741919671594
1759,211.003833,211.010567,1,6330114,6330317,203,0.36943306584342916
1760,211.0227,211.027333,1,6330681,6330819,138,0.2683489907220613
1761,211.0329,211.0429,1,6330987,6331287,300,0.4660762449803804
1762,211.047333,211.0761,1,6331419,6332283,864,0.6241352039702439
1763,211.0772,211.087267,1,6332316,6332618,302,0.569617670364937
1764,211.108067,211.1151,1,6333242,6333453,211,0.6102214098331046
1765,211.119733,211.1343,1,6333591,6334029,438,0.6853041842883345
1766,211.1493,211.158433,1,6334479,6334752,273,0.4582725065763215
1767,211.182267,211.197733,1,6335468,6335931,463,0.9040018377590179
1768,211.2001,211.204467,1,6336003,6336134,131,0.9152377550291441
1769,211.2502,211.254067,1,6337506,6337622,116,0.38894574785388464
1770,211.299967,211.3336,1,6338999,6340008,1009,0.6213600719422997
1771,211.374067,211.3774,1,6341222,6341322,100,0.8998692204335517
1772,211.401833,211.4114,1,6342054,6342342,288,0.5733134255656914
1773,211.4305,211.433667,1,6342915,6343010,95,0.7126208844758383
1774,211.4445,211.449933,1,6343335,6343497,162,0.6983491483603311
1775,211.451267,211.4793,1,6343538,6344379,841,0.8477647624564145
1776,211.5097,211.513067,1,6345291,6345392,101,0.013969307669752632
1777,211.537067,211.542933,1,6346112,6346287,175,0.5791018079723641
1778,211.546867,211.556667,1,6346406,6346700,294,0.3516728112662399
1779,211.564267,211.572867,1,6346928,6347186,258,0.3583214242615684
1780,211.585067,211.5892,1,6347552,6347676,124,0.7922839807644663
1781,211.590467,211.6094,1,6347714,6348282,568,0.8157784378025413
1782,211.612567,211.6157,1,6348377,6348471,94,0.9652140530263363
1783,211.640733,211.648667,1,6349221,6349460,239,0.8749868527884938
1784,211.661633,211.669333,1,6349848,6350079,231,0.8125301927134314
1785,211.686833,211.6904,1,6350604,6350712,108,0.9070765941616968
1786,211.713633,211.733933,1,6351408,6352017,609,0.8373443867766688
1787,211.7371,211.7606,1,6352113,6352818,705,0.9170628880019607
1788,211.7631,211.774567,1,6352893,6353237,344,0.8117705798475016
1789,211.776367,211.779933,1,6353291,6353397,106,0.8769081652448588
1790,211.785433,211.788667,1,6353562,6353660,98,0.9541161998399132
1791,211.793633,211.797733,1,6353808,6353931,123,0.8069830443009385
1792,211.8023,211.811567,1,6354069,6354347,278,0.8441793357423147
1793,211.812733,211.816167,1,6354381,6354485,104,0.8461756923733948
1794,211.823233,211.8351,1,6354696,6355053,357,0.9507300971725289
1795,211.836467,211.840367,1,6355094,6355211,117,0.7197356945694819
1796,211.852567,211.8651,1,6355577,6355953,376,0.8639116756330558
1797,211.881033,211.9054,1,6356430,6357162,732,0.8505694205300225
1798,211.922367,211.929433,1,6357671,6357882,211,0.7087304608474653
1799,211.931833,211.9351,1,6357954,6358053,99,0.7946312551529873
1800,211.9408,211.946633,1,6358224,6358398,174,0.5806607599718778
1801,212.029533,212.040767,1,6360885,6361223,338,0.45928158818467324
1802,212.050667,212.056867,1,6361520,6361706,186,0.8151504056693842
1803,212.084867,212.0918,1,6362546,6362754,208,0.5349737706442748
1804,212.164267,212.1705,1,6364928,6365115,187,0.7842502797095919
1805,212.174633,212.193333,1,6365238,6365799,561,0.8709979045654546
1806,212.208433,212.2218,1,6366252,6366654,402,0.3953011620117946
1807,212.225433,212.2337,1,6366762,6367011,249,0.5827421611283299
1808,212.308233,212.341567,1,6369246,6370247,1001,0.8212892782897554
1809,212.358333,212.3824,1,6370749,6371472,723,0.3677291415090461
1810,212.383567,212.3997,1,6371507,6371991,484,0.6322423975345552
1811,212.437233,212.459767,1,6373116,6373793,677,0.28446880897717036
1812,212.460933,212.490567,1,6373827,6374717,890,0.3446027454684192
1813,212.495133,212.498733,1,6374853,6374961,108,0.8004750534980168
1814,212.514067,212.5449,1,6375422,6376347,925,0.6347489415560208
1815,212.5477,212.554233,1,6376431,6376626,195,0.4243232438055354
1816,212.561767,212.566933,1,6376853,6377007,154,0.8729316344852095
1817,212.618,212.637167,1,6378540,6379115,575,0.7049601460501348
1818,212.6397,212.654633,1,6379191,6379638,447,0.6501753632545447
1819,212.669133,212.672133,1,6380073,6380163,90,0.9276144336249466
1820,212.676867,212.697033,1,6380306,6380910,604,0.6847990985410118
1821,212.769767,212.7738,1,6383093,6383214,121,0.586596626626346
1822,212.789667,212.8013,1,6383690,6384039,349,0.7385564056354367
1823,212.826067,212.846433,1,6384782,6385392,610,0.5770951833905906
1824,212.890167,212.993733,1,6386705,6389811,3106,0.6078839691758153
1825,212.999767,213.003133,1,6389993,6390093,100,0.9560293558679732
1826,213.0161,213.0355,1,6390483,6391065,582,0.7911445821040947
1827,213.037367,213.0404,1,6391121,6391212,91,0.8240774286042323
1828,213.042,213.2881,1,6391260,6398643,7383,0.4701026325591387
1829,213.289833,213.3204,1,6398694,6399612,918,0.7942204890210386
1830,213.3214,213.349133,1,6399642,6400473,831,0.8032463609886441
1831,213.3558,213.3588,1,6400674,6400764,90,0.9102003704835376
1832,213.3638,213.3692,1,6400914,6401076,162,0.721926133081288
1833,213.371433,213.3796,1,6401142,6401388,246,0.6511929378580569
1834,213.3817,213.408067,1,6401451,6402242,791,0.5302743623242644
1835,213.4125,213.4325,1,6402375,6402975,600,0.8247390465822977
1836,213.434033,213.462767,1,6403020,6403883,863,0.7475853540930782
1837,213.468067,213.471133,1,6404042,6404133,91,0.8874773209967902
1838,213.475567,213.514033,1,6404267,6405420,1153,0.43773244014783547
1839,213.519833,213.566833,1,6405594,6407004,1410,0.8360672221631121
1840,213.5711,213.593133,1,6407133,6407793,660,0.4136766185974168
1841,213.599833,213.607133,1,6407994,6408213,219,0.7754243930111545
1842,213.608567,213.615233,1,6408257,6408456,199,0.09179791490264415
1843,213.618467,213.6293,1,6408554,6408879,325,0.1940945595391237
1844,213.632767,213.647067,1,6408983,6409412,429,0.6634515486378377
1845,213.655,213.659167,1,6409650,6409775,125,0.03347756328192283
1846,213.6638,213.668667,1,6409914,6410060,146,0.8355871237121597
1847,213.6742,213.6849,1,6410226,6410547,321,0.7315172494255917
1848,213.686,213.703767,1,6410580,6411113,533,0.5785292808781209
1849,213.710833,213.7195,1,6411324,6411585,261,0.7406407038838908
1850,213.7222,213.7398,1,6411666,6412194,528,0.6408671753711763
1851,213.7428,213.768833,1,6412284,6413064,780,0.5053532389338606
1852,213.784533,213.788067,1,6413535,6413642,107,0.8664602274199777
1853,213.7944,213.838433,1,6413832,6415152,1320,0.44629226470998706
1854,213.858667,213.911533,1,6415760,6417345,1585,0.3092108765116054
1855,213.919733,213.937333,1,6417591,6418119,528,0.8325244438747945
1856,213.938833,213.953167,1,6418164,6418595,431,0.7462539859665074
1857,213.9607,214.023433,1,6418821,6420702,1881,0.44355720738015425
1858,214.031067,214.035433,1,6420932,6421062,130,-0.4359647434326976
1859,214.0392,214.082167,1,6421176,6422465,1289,0.19456585843297097
1860,214.090633,214.102933,1,6422718,6423087,369,0.7016870941795889
1861,214.1076,214.112033,1,6423228,6423360,132,0.5950178944717143
1862,214.116233,214.138433,1,6423486,6424152,666,0.6301105286491387
1863,214.148467,214.176233,1,6424454,6425286,832,0.09303922084480969
1864,214.177267,214.185567,1,6425318,6425567,249,0.7514272672607519
1865,214.187333,214.199067,1,6425619,6425972,353,0.5434678125958756
1866,214.208733,214.214533,1,6426261,6426435,174,0.682657790974188
1867,214.2158,214.223167,1,6426474,6426695,221,0.5266829254799643
1868,214.586167,214.589633,1,6437585,6437688,103,-0.3705016759213611
1869,214.5921,214.602,1,6437763,6438060,297,0.6903388246056269
1870,214.6032,214.649633,1,6438096,6439488,1392,0.6570515076696806
1871,214.654133,214.677667,1,6439623,6440330,707,0.11449866386645075
1872,214.679233,214.692333,1,6440376,6440769,393,0.3398254597843502
1873,214.6948,214.718333,1,6440844,6441549,705,0.08431803328948587
1874,214.733533,214.736967,1,6442005,6442109,104,0.6702140773858419
1875,214.740867,214.746067,1,6442226,6442382,156,0.6733774965380362
1876,214.750767,214.7606,1,6442523,6442818,295,0.9300025027505217
1877,214.762067,214.7734,1,6442862,6443202,340,0.6376545755188723
1878,214.794067,214.8018,1,6443822,6444054,232,0.7529934434702417
1879,214.865067,214.868967,1,6445952,6446069,117,0.34386615008882865
1880,214.913533,214.9195,1,6447405,6447585,180,0.3675566470874837
1881,214.936733,214.940467,1,6448101,6448214,113,0.7290277547658475
1882,214.964767,214.977933,1,6448943,6449337,394,0.767486213263774
1883,215.016567,215.027967,1,6450497,6450839,342,0.7772119787481029
1884,215.031967,215.063867,1,6450959,6451916,957,0.5693273512062508
1885,215.067667,215.0757,1,6452030,6452271,241,0.5328522486629956
1886,215.0964,215.104033,1,6452892,6453120,228,0.7226109749996665
1887,215.114333,215.123933,1,6453429,6453717,288,0.5231728501226743
1888,215.265733,215.269733,1,6457971,6458091,120,0.733757545597174
1889,215.4696,215.5074,1,6464088,6465222,1134,0.4579020915656768
1890,215.514167,215.533767,1,6465425,6466013,588,0.7282516366092657
1891,215.544533,215.5492,1,6466335,6466476,141,0.7681948693920014
1892,215.5704,215.573767,1,6467112,6467213,101,0.8373874472991992
1893,215.575033,215.5783,1,6467250,6467349,99,0.8771817099867749
1894,215.579467,215.583333,1,6467384,6467499,115,0.5784395790664287
1895,215.584767,215.588567,1,6467543,6467657,114,0.6449618400276559
1896,215.606033,215.644967,1,6468180,6469349,1169,0.45734166054895425
1897,215.6581,215.661167,1,6469743,6469835,92,0.27635946251643245
1898,215.6648,215.677933,1,6469944,6470337,393,0.2617086309550206
1899,215.8656,215.87,1,6475968,6476100,132,0.4665249291834696
1900,216.004567,216.009167,1,6480137,6480275,138,0.8230951196875903
1901,216.1574,216.167467,1,6484722,6485024,302,0.45149321374475204
1902,216.176533,216.190567,1,6485295,6485717,422,0.19461554761522704
1903,216.242033,216.247267,1,6487260,6487418,158,0.6473068672887986
1904,216.265667,216.270367,1,6487970,6488111,141,0.5330332675459021
1905,216.282067,216.300933,1,6488462,6489027,565,0.3342518406025721
1906,216.312133,216.345867,1,6489363,6490376,1013,0.7981891900142258
1907,216.389333,216.3939,1,6491679,6491817,138,0.463901804637974
1908,216.407667,216.412633,1,6492230,6492378,148,0.676921926162927
1909,216.4225,216.4274,1,6492675,6492822,147,0.7328080511301107
1910,216.431133,216.46,1,6492933,6493800,867,0.39284040987580754
1911,216.462033,216.4676,1,6493860,6494028,168,0.6335181939111457
1912,216.469767,216.4989,1,6494093,6494967,874,0.8363378244899781
1913,216.519067,216.5307,1,6495572,6495921,349,0.7494262896344085
1914,216.572567,216.577867,1,6497177,6497336,159,0.15466745393193473
1915,216.582767,216.593267,1,6497483,6497798,315,0.2043124573366882
1916,216.603367,216.608467,1,6498101,6498254,153,0.8743628284303011
1917,216.610633,216.638733,1,6498318,6499161,843,0.6747383412650734
1918,216.641167,216.647133,1,6499235,6499413,178,0.8803796095830516
1919,216.659,216.670667,1,6499770,6500120,350,0.19755813308144618
1920,216.674833,216.694333,1,6500244,6500829,585,0.2538998829857328
1921,216.701367,216.7071,1,6501041,6501213,172,0.8131622294373412
1922,216.719333,216.7353,1,6501579,6502059,480,0.39661529544820145
1923,216.759967,216.764667,1,6502799,6502940,141,0.7337566277502912
1924,216.766433,216.791233,1,6502992,6503736,744,0.38439027276637966
1925,216.809867,216.821033,1,6504296,6504630,334,0.14473739872660624
1926,216.8225,216.831267,1,6504675,6504938,263,0.1449630549859033
1927,216.8471,216.857667,1,6505413,6505730,317,0.3760550691993699
1928,216.859367,216.867767,1,6505781,6506033,252,0.4051136272108857
1929,216.869933,216.883667,1,6506097,6506510,413,0.8174111725441449
1930,216.912933,216.921967,1,6507387,6507659,272,0.572850711035894
1931,216.9232,216.926567,1,6507696,6507797,101,0.9094921839574346
1932,216.9293,217.1244,1,6507879,6513732,5853,0.6089297088261871
1933,217.142267,217.147767,1,6514268,6514433,165,0.8827704154400122
1934,217.148833,217.3652,1,6514464,6520956,6492,0.33242988272416946
1935,217.3735,217.5562,1,6521205,6526686,5481,0.23163609151126527
1936,217.557533,217.674433,1,6526725,6530232,3507,0.36013207185526497
1937,217.6777,217.882667,1,6530331,6536480,6149,0.14685638518871477
1938,217.886933,217.933133,1,6536607,6537993,1386,0.3388900798755
1939,217.934433,217.938733,1,6538032,6538161,129,0.45192203263091635
1940,217.9401,218.001433,1,6538203,6540042,1839,0.5673916304799328
1941,218.003367,218.1324,1,6540101,6543972,3871,0.2986679728126445
1942,218.134,218.2269,1,6544020,6546807,2787,0.36537914040340347
1943,218.229867,218.2369,1,6546896,6547107,211,0.36749974418133247
1944,218.246,218.258567,1,6547380,6547757,377,0.2030341992297741
1945,218.2615,218.378967,1,6547845,6551369,3524,0.38882609025986065
1946,218.383967,218.390467,1,6551519,6551714,195,0.4032471086325957
1947,218.391733,218.398433,1,6551751,6551952,201,0.8284369386642874
1948,218.399867,218.423033,1,6551996,6552690,694,0.8684347155681322
1949,218.600567,218.604867,1,6558017,6558146,129,0.802098286570084
1950,218.645367,218.6488,1,6559361,6559464,103,0.8172790610427386
1951,218.708333,218.711667,1,6561249,6561350,101,0.8272754897149794
1952,218.726233,218.731733,1,6561786,6561951,165,0.3629519016993262
1953,218.861667,218.870367,1,6565850,6566111,261,0.2763410115720315
1954,218.878067,218.882933,1,6566342,6566487,145,0.7691424116718761
1955,218.912733,218.918567,1,6567381,6567557,176,0.8284037265415789
1956,219.0042,219.012667,1,6570126,6570380,254,0.3950565995384395
1957,219.127833,219.132067,1,6573834,6573962,128,0.7950715289795762
1958,219.2642,219.288333,1,6577926,6578649,723,0.6009919407148036
1959,219.330467,219.340233,1,6579914,6580206,292,0.20444019552503653
1960,219.3653,219.405267,1,6580959,6582158,1199,0.16333451816268596
1961,219.439933,219.452133,1,6583197,6583563,366,0.48360865660305674
1962,219.4802,219.488,1,6584406,6584640,234,0.0660924847707468
1963,219.4902,219.500733,1,6584706,6585021,315,0.2331368647062443
1964,219.503067,219.511567,1,6585092,6585347,255,0.5197590679374666
1965,219.5176,219.521,1,6585528,6585630,102,0.7712394384934349
1966,219.561533,219.577733,1,6586845,6587331,486,0.5260025654961256
1967,219.609633,219.619267,1,6588288,6588578,290,0.04829039127224685
1968,219.627233,219.6344,1,6588816,6589032,216,0.21431811502844772
1969,219.639133,219.642333,1,6589173,6589269,96,0.6633294307223812
1970,219.6444,219.665033,1,6589332,6589950,618,0.6704556836830409
1971,219.6979,219.709367,1,6590937,6591281,344,0.5084576909938043
1972,219.766767,219.777333,1,6593003,6593319,316,0.23727310088122996
1973,219.795633,219.825267,1,6593868,6594758,890,0.6781679850340986
1974,219.851267,219.871,1,6595538,6596130,592,0.48769857040630127
1975,219.913633,219.920067,1,6597408,6597602,194,0.7342267741318105
1976,219.9338,219.950733,1,6598014,6598521,507,0.07626844421228371
1977,219.958567,219.9948,1,6598757,6599844,1087,0.029920992131631154
1978,220.002567,220.018667,1,6600077,6600560,483,0.065129383086267
1979,220.027333,220.033567,1,6600819,6601007,188,0.8308162902006613
1980,220.0373,220.045433,1,6601119,6601362,243,0.7631427350767689
1981,220.184567,220.2004,1,6605537,6606012,475,0.3481066727311109
1982,220.205233,220.211867,1,6606156,6606356,200,0.7869905513528528
1983,220.2981,220.3215,1,6608943,6609645,702,0.7170974748349505
1984,220.324067,220.332133,1,6609722,6609963,241,0.6430157508130891
1985,220.426533,220.4406,1,6612795,6613218,423,0.705361040105807
1986,220.441733,220.449667,1,6613251,6613490,239,0.568384319621425
1987,220.5064,220.517267,1,6615192,6615518,326,0.5659274725181204
1988,220.559833,220.574333,1,6616794,6617229,435,0.7596657415711157
1989,220.606633,220.614067,1,6618198,6618422,224,-0.1683326856407822
1990,220.6405,220.6436,1,6619215,6619308,93,0.37592634238094497
1991,221.606567,221.6108,1,6648197,6648324,127,0.5945064813397187
1992,221.6205,221.625033,1,6648615,6648750,135,0.7661043714838368
1993,221.630667,221.6364,1,6648920,6649092,172,0.009424871717061571
1994,221.637733,221.643967,1,6649131,6649319,188,0.03364128336771965
1995,221.647,221.657467,1,6649410,6649724,314,-0.1055228297689301
1996,221.6781,221.6825,1,6650343,6650475,132,0.5505091405254571
1997,221.738267,221.750267,1,6652148,6652508,360,0.7112396116208629
1998,221.752367,221.760067,1,6652571,6652802,231,0.6419357872106459
1999,221.773,221.778633,1,6653190,6653358,168,0.8953742864616078
2000,221.787933,221.793467,1,6653637,6653804,167,0.6858992799435528
2001,221.805233,221.8283,1,6654156,6654849,693,0.36783021364718366
2002,221.837833,221.842533,1,6655134,6655275,141,0.32147232411585236
2003,221.8637,221.8694,1,6655911,6656082,171,0.7563427996087402
2004,221.883967,221.887867,1,6656519,6656636,117,0.9083141928600664
2005,221.889267,221.9248,1,6656678,6657744,1066,0.6437041946381105
2006,221.9292,221.936667,1,6657876,6658100,224,0.8218993895145754
2007,221.941533,221.977833,1,6658245,6659334,1089,0.2623116404623553
2008,221.978933,221.991,1,6659367,6659730,363,0.22583489953528235
2009,222.0136,222.021267,1,6660408,6660638,230,0.17066058605842804
2010,222.0328,222.041667,1,6660984,6661250,266,0.6375525236401428
2011,222.051533,222.098833,1,6661545,6662964,1419,0.377071819902846
2012,222.1054,222.126533,1,6663162,6663795,633,0.4590282856932347
2013,222.1398,222.1457,1,6664194,6664371,177,0.0153325880696589
2014,222.1475,222.2118,1,6664425,6666354,1929,0.02129847644512065
2015,222.229567,222.245267,1,6666887,6667358,471,0.6495549899948003
2016,222.2681,222.303767,1,6668043,6669113,1070,0.6992766947052446
2017,222.306167,222.321333,1,6669185,6669639,454,0.7158932354865725
2018,222.332433,222.425833,1,6669972,6672774,2802,0.3558384091007161
2019,222.443,222.4539,1,6673290,6673617,327,0.1862892358718708
2020,222.4555,222.471467,1,6673665,6674144,479,0.6591400362179436
2021,222.4776,222.481633,1,6674328,6674448,120,0.8629540152389584
2022,222.493267,222.5185,1,6674798,6675555,757,0.35933961501619865
2023,222.526433,222.535333,1,6675792,6676059,267,0.1559852540060379
2024,222.541,222.547967,1,6676230,6676439,209,0.44719801522881747
2025,222.559033,222.5717,1,6676770,6677151,381,0.1895232590556208
2026,222.584133,222.5911,1,6677523,6677733,210,0.6719014076048465
2027,222.5956,222.598967,1,6677868,6677969,101,0.8883808015548157
2028,222.600167,222.621333,1,6678005,6678639,634,0.6219120382598323
2029,222.6452,222.6484,1,6679356,6679452,96,0.4885711815574305
2030,222.6559,222.6666,1,6679677,6679998,321,0.7580475114509211
2031,222.710567,222.716667,1,6681317,6681500,183,0.30763527678822006
2032,222.985,223.0219,1,6689550,6690657,1107,0.3738799169533681
2033,223.0458,223.057633,1,6691374,6691728,354,0.5000566157563742
2034,223.072167,223.077033,1,6692165,6692310,145,0.847005932696408
2035,223.100533,223.108033,1,6693015,6693240,225,0.8193192009482382
2036,223.1348,223.146267,1,6694044,6694388,344,0.5557406201194108
2037,223.150367,223.159933,1,6694511,6694797,286,0.6697634649897221
2038,223.161,223.1743,1,6694830,6695229,399,0.5644453284306474
2039,223.1911,223.204033,1,6695733,6696120,387,0.07576520075049441
2040,223.244467,223.254867,1,6697334,6697646,312,0.10038949577823959
2041,223.262367,223.2654,1,6697871,6697962,91,-0.03201286161911951
2042,223.731567,223.734767,1,6711947,6712043,96,0.9084449248229536
2043,223.7425,223.7457,1,6712275,6712371,96,0.8182512654587379
2044,223.747167,223.7605,1,6712415,6712815,400,0.4121634500725395
2045,223.7653,223.786733,1,6712959,6713601,642,0.15114773529762066
2046,224.129867,224.1362,1,6723896,6724086,190,0.6559910444701225
2047,224.308633,224.325933,1,6729258,6729777,519,0.32212122757050066
2048,224.332233,224.344167,1,6729966,6730325,359,0.34517419771075764
2049,224.3834,224.3909,1,6731502,6731727,225,0.14858144042473342
2050,224.394533,224.401567,1,6731835,6732047,212,0.35965890670120954
2051,224.4056,224.444967,1,6732168,6733349,1181,0.2550547881297642
2052,224.445967,224.461567,1,6733379,6733847,468,-0.16726389158826988
2053,224.654233,224.659533,1,6739626,6739785,159,0.6408514445795239
2054,224.861367,224.875367,1,6745841,6746261,420,0.20568816095305953
2055,224.900467,224.9039,1,6747014,6747117,103,0.7619615480080065
2056,224.9085,224.922167,1,6747255,6747665,410,0.44267708720130466
2057,225.1904,225.195967,1,6755712,6755879,167,0.4245356526435792
2058,225.251033,225.265933,1,6757530,6757977,447,0.792617579461637
2059,225.298367,225.312233,1,6758951,6759366,415,0.3961014519470406
2060,225.3246,225.329667,1,6759738,6759890,152,0.5339409053684637
2061,225.331467,225.3345,1,6759944,6760035,91,0.6620777848307604
2062,225.3362,225.343667,1,6760086,6760310,224,0.5546477977126016
2063,225.346067,225.351767,1,6760382,6760553,171,0.19229210594480722
2064,225.382567,225.429267,1,6761477,6762878,1401,0.14381556156826528
2065,225.434,225.4639,1,6763020,6763917,897,0.2520639767892695
2066,225.4714,225.478567,1,6764142,6764357,215,0.7784343658457387
2067,225.497067,225.5009,1,6764912,6765027,115,0.36253186780874547
2068,225.508167,225.5246,1,6765245,6765738,493,0.2332520556055193
2069,225.535333,225.539167,1,6766059,6766175,116,0.8302806484361032
2070,225.544567,225.5486,1,6766337,6766458,121,0.6036303696197568
2071,225.5514,225.5639,1,6766542,6766917,375,0.7296513262133766
2072,225.6027,225.6073,1,6768081,6768219,138,0.1359199168092942
2073,225.608367,225.677567,1,6768251,6770327,2076,0.589115591854605
2074,225.708567,225.719867,1,6771257,6771596,339,0.37521146283499784
2075,225.749733,225.755667,1,6772491,6772670,179,0.8242137129290283
2076,225.7582,225.761633,1,6772746,6772848,102,0.8165349506392879
2077,225.769433,225.773133,1,6773082,6773193,111,0.8219130629114751
2078,225.871467,225.877333,1,6776144,6776319,175,0.6387379869948312
2079,225.879067,225.8947,1,6776372,6776841,469,0.6582870360205995
2080,225.898733,225.903433,1,6776961,6777102,141,0.6990862677405263
2081,225.984867,225.992567,1,6779546,6779777,231,0.4364302571869886
2082,225.998533,226.0066,1,6779955,6780198,243,-0.024101121817022304
2083,226.012767,226.021067,1,6780383,6780632,249,0.8211116417358107
2084,226.0221,226.027667,1,6780663,6780830,167,-0.0969873336629253
2085,226.031067,226.0445,1,6780932,6781335,403,0.8033133063858717
2086,226.0469,226.051633,1,6781407,6781548,141,0.8433591841164615
2087,226.0862,226.099433,1,6782586,6782982,396,0.5197744928533216
2088,226.1259,226.1366,1,6783777,6784098,321,0.14432182128295593
2089,226.140667,226.149433,1,6784220,6784482,262,0.038610266301144135
2090,226.151067,226.187833,1,6784532,6785634,1102,0.686828168398183
2091,226.280067,226.290467,1,6788402,6788714,312,0.49654518628493577
2092,226.295233,226.301233,1,6788856,6789036,180,0.29168591414917105
2093,226.305933,226.341367,1,6789177,6790241,1064,0.7156118503695406
2094,226.3688,226.394567,1,6791064,6791837,773,0.4674912773819806
2095,226.3957,226.3994,1,6791871,6791982,111,0.8759965112572066
2096,226.428333,226.453233,1,6792849,6793596,747,0.3375376806781692
2097,226.455333,226.473,1,6793659,6794190,531,0.7361311077685077
2098,226.483767,226.489333,1,6794513,6794679,166,0.3580121614730727
2099,226.4955,226.499667,1,6794865,6794990,125,0.7402971509921127
2100,226.514533,226.5635,1,6795435,6796905,1470,-0.03991364826490877
2101,226.564767,226.569067,1,6796943,6797072,129,0.3404584382941481
2102,226.574933,226.582867,1,6797247,6797486,239,0.08622280859640269
2103,226.5841,226.591267,1,6797523,6797738,215,0.23030474678966942
2104,226.595233,226.606833,1,6797856,6798204,348,-0.03999728475572714
2105,226.607867,226.612067,1,6798236,6798362,126,0.2874403394499943
2106,226.6153,226.619467,1,6798459,6798584,125,0.5541437769554793
2107,226.631067,226.660767,1,6798932,6799823,891,0.8498508755881242
2108,226.6769,226.7165,1,6800307,6801495,1188,0.33692823131448524
2109,226.774,226.7925,1,6803220,6803775,555,0.04905413490305322
2110,226.795767,226.866933,1,6803873,6806007,2134,0.21809697573168527
2111,226.874367,226.884167,1,6806231,6806525,294,0.17493169528650995
2112,226.8945,226.897967,1,6806835,6806939,104,0.8096462425025146
2113,227.0381,227.0441,1,6811143,6811323,180,0.2961376832558905
2114,227.089667,227.093567,1,6812690,6812807,117,0.6798200033839098
2115,227.241467,227.2695,1,6817244,6818085,841,0.3301737652649605
2116,227.2878,227.2941,1,6818634,6818823,189,0.27423791001786635
2117,227.2951,227.300533,1,6818853,6819015,162,0.3869448514737878
2118,227.3094,227.315033,1,6819282,6819450,168,0.05611648356407697
2119,227.327233,227.331933,1,6819816,6819957,141,0.7266300192636684
2120,227.363267,227.367233,1,6820898,6821016,118,0.8356510670625804
2121,227.404467,227.407467,1,6822134,6822224,90,0.9547135853174529
2122,227.428067,227.434167,1,6822842,6823025,183,0.8516004322825024
2123,227.492033,227.495333,1,6824760,6824859,99,0.7528293550619066
2124,227.665767,227.671533,1,6829973,6830145,172,0.05656725406684421
2125,227.6755,227.682333,1,6830265,6830469,204,0.04548985353892956
2126,227.685767,227.6941,1,6830573,6830823,250,-0.225267909353592
2127,227.7077,227.7111,1,6831231,6831333,102,0.6452648509339326
2128,227.7125,227.715533,1,6831375,6831465,90,-0.2245935450774142
2129,227.718533,227.7499,1,6831555,6832497,942,0.10312029894946217
2130,227.762333,227.7772,1,6832869,6833316,447,0.16108775999592853
2131,227.783633,227.793,1,6833508,6833790,282,0.724300941351296
2132,229.2321,229.238,1,6876963,6877140,177,0.4316595295263833
2133,229.255767,229.2617,1,6877673,6877851,178,0.12792780102341314
2134,229.592033,229.604733,1,6887760,6888141,381,0.40726256219598633
2135,229.6318,229.6364,1,6888954,6889092,138,0.15374013072094952
2136,229.6431,229.651233,1,6889293,6889536,243,-0.012215343605435264
2137,229.6528,229.6657,1,6889584,6889971,387,0.0639215521178301
2138,229.697567,229.701733,1,6890927,6891051,124,0.6922762604971106
2139,229.704967,229.725567,1,6891149,6891767,618,0.5726202347317721
2140,229.731067,229.7377,1,6891932,6892131,199,0.5486973681970915
2141,229.741833,229.748133,1,6892254,6892443,189,0.7751502164331423
2142,229.751567,229.765033,1,6892547,6892950,403,0.06346006422901608
2143,229.769133,229.7859,1,6893073,6893577,504,0.40431455360413787
2144,229.793333,229.799333,1,6893799,6893979,180,0.36400666120081404
2145,229.805967,229.819833,1,6894179,6894594,415,0.4421673713127098
2146,229.827333,229.832833,1,6894819,6894984,165,0.6062331844016219
2147,229.838933,229.847867,1,6895167,6895436,269,0.6243420853154432
2148,229.8489,229.852533,1,6895467,6895575,108,0.8982604733433103
2149,229.853667,229.8588,1,6895610,6895764,154,0.807584055323603
2150,229.900433,229.906433,1,6897012,6897192,180,0.5730312732082882
2151,229.9151,229.924033,1,6897453,6897720,267,0.3572956182280627
2152,229.950067,229.9536,1,6898502,6898608,106,0.10528990436302663
2153,230.2479,230.26,1,6907437,6907800,363,0.6024193572258468
2154,230.2834,230.2923,1,6908502,6908769,267,0.44279495149247433
2155,230.298333,230.310967,1,6908949,6909329,380,-0.09127806223819881
2156,230.312267,230.315967,1,6909368,6909479,111,0.6998885339215889
2157,230.324967,230.343667,1,6909749,6910310,561,0.30238534121062477
2158,230.402,230.4138,1,6912060,6912414,354,0.5927335340517546
2159,230.4211,230.425533,1,6912633,6912765,132,0.9602096101340547
2160,230.4325,230.4399,1,6912975,6913197,222,0.5824234088893568
2161,230.4529,230.462833,1,6913587,6913884,297,0.4544765946582405
2162,230.4639,230.466967,1,6913917,6914009,92,0.7754341437226927
2163,230.490467,230.493667,1,6914714,6914810,96,0.866495732561989
2164,230.494733,230.497867,1,6914841,6914936,95,0.8972500422387271
2165,230.5052,230.509967,1,6915156,6915299,143,0.213074968755608
2166,230.524833,230.5285,1,6915744,6915855,111,0.3993838705852188
2167,230.901833,230.905267,1,6927054,6927158,104,0.20321651873321597
2168,230.937433,230.941533,1,6928122,6928245,123,0.8450927289055898
2169,230.942767,230.9539,1,6928283,6928617,334,-0.0252572527461826
2170,230.9561,230.959367,1,6928683,6928781,98,-0.3850755855858779
2171,230.992633,230.9975,1,6929778,6929925,147,0.13135977186199344
2172,230.9989,231.0598,1,6929967,6931794,1827,0.13842622595016632
2173,231.0645,231.073033,1,6931935,6932190,255,0.36283109233523136
2174,231.0775,231.088533,1,6932325,6932655,330,0.31874209356678573
2175,231.2076,231.212533,1,6936228,6936375,147,0.7846256916986234
2176,231.2403,231.245567,1,6937209,6937367,158,0.5855494872504319
2177,231.361267,231.3645,1,6940838,6940935,97,0.8424173231788575
2178,231.448367,231.464267,1,6943451,6943928,477,0.5289211294669666
2179,231.509967,231.516033,1,6945299,6945480,181,0.8977144228978826
2180,231.7733,231.785567,1,6953199,6953567,368,0.32535429128391197
2181,231.8023,231.805333,1,6954069,6954159,90,0.5126723686858001
2182,231.810333,231.845567,1,6954309,6955367,1058,0.472055477026267
2183,231.849067,231.852933,1,6955472,6955587,115,0.8557673746069333
2184,231.857067,231.8788,1,6955712,6956364,652,0.13127425990868427
2185,231.890433,231.900333,1,6956712,6957009,297,0.3679222172241061
2186,231.9068,231.914933,1,6957204,6957447,243,0.36849643488791295
2187,231.932467,231.9357,1,6957974,6958071,97,0.8438608578702363
2188,231.9376,231.950233,1,6958128,6958506,378,0.6171724524811348
2189,231.9583,231.977367,1,6958749,6959321,572,0.8643086045506397
2190,232.25,232.253667,1,6967500,6967610,110,-0.06685463378320834
2191,232.265033,232.277733,1,6967950,6968331,381,0.11150887533235747
2192,232.291667,232.2973,1,6968750,6968919,169,0.04561604928140515
2193,232.305667,232.3104,1,6969170,6969312,142,0.28923477969004524
2194,232.3143,232.362433,1,6969429,6970872,1443,0.5666750233806456
2195,232.366767,232.394133,1,6971003,6971823,820,0.1520081867946427
2196,232.404433,232.412433,1,6972132,6972372,240,0.23598572533019688
2197,232.451733,232.4972,1,6973551,6974916,1365,0.47186353022094385
2198,232.500233,232.5132,1,6975006,6975396,390,0.5171662594788323
2199,232.515967,232.5548,1,6975479,6976644,1165,0.1623385103013363
2200,232.561,232.565733,1,6976830,6976971,141,0.48623849634775773
2201,232.573567,232.581167,1,6977207,6977435,228,0.6179488090569505
2202,232.588,232.616333,1,6977640,6978489,849,0.21247246791479724
2203,232.6383,232.6568,1,6979149,6979704,555,0.5925727401723794
2204,232.659267,232.669133,1,6979778,6980073,295,0.34548410750372455
2205,232.672233,232.677867,1,6980166,6980336,170,0.8822114467513642
2206,232.679067,232.689333,1,6980372,6980679,307,0.16080324846947244
2207,232.705367,232.763867,1,6981161,6982916,1755,0.1744837004754351
2208,232.783933,232.7887,1,6983517,6983661,144,0.7542012497785286
2209,232.789767,232.804467,1,6983693,6984134,441,0.22000659991523333
2210,232.8127,232.815967,1,6984381,6984479,98,0.509528748492094
2211,232.818233,232.823067,1,6984546,6984692,146,0.5952741835360515
2212,232.827933,232.854433,1,6984837,6985632,795,0.2925824869194559
2213,232.856133,232.878433,1,6985683,6986352,669,0.27088495525628176
2214,232.887533,232.893467,1,6986625,6986804,179,0.5776071809408361
2215,232.8969,232.9354,1,6986907,6988062,1155,0.32471422300457187
2216,233.044867,233.0542,1,6991346,6991626,280,-0.3265086357585233
2217,233.059533,233.075367,1,6991785,6992261,476,0.49305320092674365
2218,233.090467,233.099367,1,6992714,6992981,267,0.10741039824532614
2219,233.134333,233.137567,1,6994029,6994127,98,0.5703352846956647
2220,233.168467,233.173233,1,6995054,6995196,142,0.8410479217720056
2221,233.378967,233.382233,1,7001369,7001466,97,0.7235634451981489
2222,233.839067,233.8421,1,7015172,7015263,91,0.4446102231521472
2223,234.168567,234.172233,1,7025057,7025166,109,0.37571559698690477
2224,234.350233,234.3588,1,7030506,7030764,258,0.007804023695529213
2225,234.469067,234.497567,1,7034072,7034927,855,0.49869810704603423
2226,234.5285,234.532533,1,7035855,7035975,120,0.3066020868122969
2227,234.5346,234.544133,1,7036038,7036323,285,0.5313320227444496
2228,234.555433,234.5686,1,7036662,7037058,396,0.33801664140787596
2229,234.572433,234.5757,1,7037172,7037271,99,0.8857881635906686
2230,234.583367,234.588233,1,7037501,7037646,145,0.26781154334438245
2231,234.594467,234.597767,1,7037834,7037933,99,0.8866739537692996
2232,234.598767,234.604667,1,7037963,7038140,177,0.8559553485843792
2233,234.661367,234.666667,1,7039841,7040000,159,0.8416507730663261
2234,234.680267,234.694367,1,7040408,7040831,423,0.2502444251058784
2235,234.696533,234.7343,1,7040895,7042029,1134,0.6202188464291855
2236,234.748267,234.7808,1,7042448,7043424,976,0.09521299219442976
2237,234.782167,234.8197,1,7043465,7044591,1126,0.2914923271029027
2238,234.822567,234.825767,1,7044677,7044773,96,0.7639994528191685
2239,234.828767,234.8409,1,7044863,7045227,364,0.5861383900749786
2240,234.841933,234.8589,1,7045257,7045767,510,0.4974299119075558
2241,234.882033,234.908467,1,7046460,7047254,794,0.33808143123947154
2242,234.9118,234.919,1,7047354,7047570,216,0.7435588264343029
2243,234.941333,234.952933,1,7048239,7048587,348,0.12713022585782324
2244,234.954933,234.962467,1,7048647,7048874,227,0.23105644813618387
2245,234.9668,234.976033,1,7049004,7049280,276,0.6956956969177943
2246,234.977067,234.984867,1,7049312,7049546,234,0.8248832140491258
2247,234.9872,235.006967,1,7049616,7050209,593,0.3628316643672983
2248,235.025333,235.052367,1,7050759,7051571,812,0.2862049290698257
2249,235.0543,235.057433,1,7051629,7051722,93,0.8999501800818828
2250,235.0898,235.0949,1,7052694,7052847,153,0.8356264632650191
2251,235.1004,235.1104,1,7053012,7053312,300,0.42161628387501354
2252,235.133933,235.168267,1,7054017,7055048,1031,0.6031324429754387
2253,235.180733,235.2074,1,7055421,7056222,801,0.3027514179374679
2254,235.229233,235.2383,1,7056876,7057149,273,0.662162069439155
2255,235.2436,235.248567,1,7057308,7057457,149,0.41487365320740915
2256,235.259767,235.2706,1,7057793,7058118,325,0.11117053226333355
2257,235.271833,235.277833,1,7058154,7058334,180,0.2928012605081147
2258,235.279233,235.289867,1,7058376,7058696,320,0.5951577708340648
2259,235.2934,235.3233,1,7058802,7059699,897,0.7330894407417966
2260,235.324367,235.3524,1,7059731,7060572,841,0.358464437131715
2261,235.355333,235.381133,1,7060659,7061433,774,0.2815142720079647
2262,235.4125,235.423333,1,7062375,7062699,324,0.27991105498170726
2263,235.479667,235.483367,1,7064390,7064501,111,0.7676322709281523
2264,235.514933,235.5314,1,7065447,7065942,495,0.32173881038469826
2265,235.546467,235.551133,1,7066394,7066533,139,0.7342317780678788
2266,235.559767,235.5734,1,7066793,7067202,409,0.4254024559438198
2267,235.578367,235.581867,1,7067351,7067456,105,0.3701599035788236
2268,235.5831,235.599933,1,7067493,7067997,504,0.253509993158211
2269,235.600967,235.6053,1,7068029,7068159,130,0.8317480854672078
2270,235.6166,235.6261,1,7068498,7068783,285,0.5005911036602222
2271,235.630133,235.6435,1,7068903,7069305,402,0.8318712073479029
2272,235.6598,235.687367,1,7069794,7070621,827,0.15176083071620702
2273,235.689067,235.699433,1,7070672,7070982,310,0.19699833725840324
2274,235.7027,235.706233,1,7071081,7071186,105,0.8408605557565539
2275,235.715833,235.721267,1,7071474,7071638,164,0.40143655713826626
2276,235.723233,235.726433,1,7071696,7071792,96,0.23963006353461092
2277,235.727867,235.740267,1,7071836,7072208,372,0.2212903300044545
2278,235.744967,235.7501,1,7072349,7072503,154,0.27018737244942437
2279,235.7834,235.7908,1,7073502,7073724,222,0.6490137047438754
2280,235.791933,235.8183,1,7073757,7074549,792,0.7089433537402553
2281,235.8335,235.861567,1,7075005,7075847,842,0.5700610695970919
2282,235.915133,235.9219,1,7077453,7077657,204,0.7160104038865833
2283,235.932667,235.936,1,7077980,7078080,100,0.8355482530591183
2284,235.975133,235.978233,1,7079253,7079346,93,0.565088943526033
2285,235.996167,236.005467,1,7079885,7080164,279,0.7266466099859745
2286,236.0487,236.0661,1,7081461,7081983,522,0.27930970220805534
2287,236.098633,236.108767,1,7082958,7083263,305,0.7502789080982851
2288,236.110867,236.122167,1,7083326,7083665,339,0.5230908295436255
2289,236.154767,236.159067,1,7084643,7084772,129,0.6579808761715282
2290,236.165467,236.186333,1,7084964,7085589,625,0.46507620208867945
2291,236.196467,236.199867,1,7085894,7085996,102,0.684562600315822
2292,236.2439,236.248733,1,7087317,7087461,144,0.8910057305176948
2293,236.2566,236.288333,1,7087698,7088649,951,0.18022850452729494
2294,236.3095,236.315033,1,7089285,7089450,165,0.6780189548714146
2295,236.3172,236.343433,1,7089516,7090302,786,0.2524831801350663
2296,236.393833,236.396967,1,7091814,7091909,95,0.45805979127607577
2297,236.4153,236.4568,1,7092459,7093704,1245,0.09172307555883882
2298,236.4712,236.494267,1,7094136,7094828,692,0.07462716073234037
2299,236.5108,236.520267,1,7095324,7095608,284,0.8029516972405825
2300,236.523667,236.906733,1,7095710,7107201,11491,0.3427805412513915
2301,236.910667,237.033833,1,7107320,7111014,3694,0.5462111455609794
2302,237.0401,237.0436,1,7111203,7111308,105,0.751570717782672
2303,237.0447,237.103267,1,7111341,7113098,1757,0.663282893566657
2304,237.106967,237.178433,1,7113209,7115352,2143,0.5298656809567495
2305,237.2058,237.2185,1,7116174,7116555,381,0.8371471819430408
2306,237.225767,237.230567,1,7116773,7116917,144,0.6592582083485258
2307,237.2608,237.264367,1,7117824,7117931,107,0.6308681899563984
2308,237.265933,237.269033,1,7117977,7118070,93,0.9009141165587417
2309,237.270367,237.283633,1,7118111,7118508,397,0.8959132695441441
2310,237.285133,237.383,1,7118553,7121490,2937,0.40643219977939643
2311,237.3912,237.443367,1,7121736,7123301,1565,0.4795276665237913
2312,237.466567,237.476867,1,7123997,7124306,309,0.4115657671557501
2313,237.498733,237.503567,1,7124961,7125107,146,0.8051061207586829
2314,237.504633,238.023567,1,7125138,7140707,15569,0.5066848024112759
2315,238.0251,238.043533,1,7140753,7141305,552,0.6433271893424114
2316,238.054933,238.160467,1,7141647,7144814,3167,0.4781615228808344
2317,238.173467,238.334533,1,7145204,7150035,4831,0.39945377340520843
2318,238.346533,239.028767,1,7150395,7170863,20468,0.3808418113916495
2319,239.041733,239.045767,1,7171251,7171373,122,0.3506723342562767
2320,239.1729,239.177733,1,7175187,7175331,144,0.3903633113787969
2321,239.236933,239.2413,1,7177107,7177239,132,0.7392861000735343
2322,239.523933,239.5332,1,7185717,7185996,279,0.34113411664198656
2323,239.5364,239.589833,1,7186092,7187694,1602,0.3336879555509889
2324,239.5927,239.613267,1,7187781,7188398,617,0.5710519555955323
2325,239.6247,239.668033,1,7188741,7190040,1299,0.40501818925634064
2326,239.682267,239.6969,1,7190468,7190907,439,0.6229862324248974
2327,239.702967,239.7288,1,7191089,7191864,775,0.3997760222796182
2328,239.7298,239.735767,1,7191894,7192073,179,0.9074512884845504
2329,239.743133,239.7593,1,7192293,7192779,486,0.5375843055210809
2330,239.772,239.788433,1,7193160,7193652,492,0.20028486200149226
2331,239.8078,239.860267,1,7194234,7195808,1574,0.20055901357411213
2332,239.861667,239.871033,1,7195850,7196130,280,0.579257051928844
2333,239.873367,239.877667,1,7196201,7196330,129,0.17640418581628614
2334,239.892167,239.903367,1,7196765,7197101,336,0.30876114788862713
2335,239.9248,239.9303,1,7197744,7197909,165,0.821010583814451
2336,239.9339,239.947,1,7198017,7198410,393,0.680989673267135
2337,239.956767,239.964367,1,7198703,7198931,228,0.5747426119549734
2338,239.966667,239.973033,1,7199000,7199190,190,0.5163236105754784
2339,239.9864,240.002567,1,7199592,7200077,485,0.4878918343315121
2340,240.0232,240.066633,1,7200696,7201998,1302,0.1955601192937266
2341,240.0677,240.070833,1,7202031,7202124,93,0.08307548474181727
2342,240.075033,240.081933,1,7202250,7202457,207,0.3588521648129216
2343,240.083367,240.0912,1,7202501,7202736,235,0.2935298387013068
2344,240.0981,240.105933,1,7202943,7203177,234,0.29419424762384455
2345,240.1078,240.145367,1,7203234,7204361,1127,0.6083130734085801
2346,240.157,240.174633,1,7204710,7205238,528,0.3065135755987827
2347,240.5922,240.605167,1,7217766,7218155,389,0.366701379641011
2348,240.607033,240.623,1,7218210,7218690,480,0.7731595936038974
2349,240.625467,240.633167,1,7218764,7218995,231,0.7975970485837827
2350,240.6344,240.6431,1,7219032,7219293,261,0.6057907483300644
2351,240.655967,240.667133,1,7219679,7220013,334,0.29304949287481813
2352,240.740467,240.7445,1,7222214,7222335,121,0.6139234813065719
2353,240.754067,240.760067,1,7222622,7222802,180,0.28145323611220857
2354,240.765,240.773967,1,7222950,7223219,269,0.7435565854267299
2355,240.7753,240.779133,1,7223259,7223373,114,0.7423141821508062
2356,240.782,240.7874,1,7223460,7223622,162,0.4561418112313348
2357,240.797933,240.814267,1,7223937,7224428,491,0.24494832593429672
2358,240.867167,240.8758,1,7226015,7226274,259,0.3639177018878053
2359,240.8858,240.920133,1,7226574,7227603,1029,0.6702955109685171
2360,240.949967,240.965767,1,7228499,7228973,474,0.40583593709793253
2361,241.0725,241.0806,1,7232175,7232418,243,0.49491427390957315
2362,241.123867,241.1331,1,7233716,7233993,277,0.40972049549689005
2363,241.2203,241.244133,1,7236609,7237323,714,0.45644964789672693
2364,241.245233,241.258233,1,7237356,7237746,390,0.8619837046422053
2365,241.266767,241.292067,1,7238003,7238762,759,0.6016388134947632
2366,241.3749,241.378667,1,7241247,7241360,113,0.6586464094111854
2367,241.7748,241.780267,1,7253244,7253408,164,0.6422052169617938
2368,241.809967,241.8373,1,7254299,7255119,820,0.5576052429254535
2369,241.850733,241.853733,1,7255521,7255611,90,0.8492064938853109
2370,241.856067,241.965867,1,7255682,7258976,3294,0.5526880176959138
2371,241.9795,242.029933,1,7259385,7260897,1512,0.3946185697622158
2372,242.103333,242.108333,1,7263099,7263249,150,0.6465899933783251
2373,242.1226,242.135133,1,7263678,7264053,375,0.8841486187268679
2374,242.149,242.166,1,7264470,7264980,510,0.4477708167515267
2375,242.167,242.1855,1,7265010,7265565,555,0.4814105568868938
2376,242.188733,242.1926,1,7265661,7265778,117,0.7319795733997978
2377,242.207167,242.228733,1,7266215,7266861,646,0.7571729948483196
2378,242.2527,242.2756,1,7267581,7268268,687,0.1362956525556532
2379,242.3094,242.3155,1,7269282,7269465,183,0.8550122798832055
2380,242.3283,242.338067,1,7269849,7270142,293,0.505689305953793
2381,242.339533,242.367267,1,7270185,7271018,833,0.6833670642229672
2382,242.374733,242.3781,1,7271241,7271343,102,0.7359067484315137
2383,242.3828,242.4051,1,7271484,7272153,669,0.3285970833152735
2384,242.431867,242.435067,1,7272956,7273052,96,0.5843275033998393
2385,242.467833,242.471167,1,7274034,7274135,101,0.8601189304840439
2386,242.4726,242.478167,1,7274178,7274345,167,0.413654866155473
2387,242.481833,242.4921,1,7274454,7274763,309,0.5075826134298986
2388,242.508133,242.515367,1,7275243,7275461,218,0.8040696725523311
2389,242.527367,242.5493,1,7275821,7276479,658,0.2997705288897062
2390,242.569033,242.574033,1,7277070,7277220,150,0.5533156062392101
2391,242.5878,242.636333,1,7277634,7279089,1455,0.6179349683895704
2392,242.640867,242.672833,1,7279226,7280184,958,0.013733936557078049
2393,242.701167,242.765533,1,7281035,7282965,1930,0.6320720628918924
2394,242.775033,242.800633,1,7283250,7284018,768,0.21455819501944493
2395,242.8023,242.812333,1,7284069,7284369,300,0.12106997184545346
2396,242.848233,242.858633,1,7285446,7285758,312,0.08031176578825905
2397,242.860333,242.8656,1,7285809,7285968,159,0.06931996930845624
2398,242.872267,242.912233,1,7286168,7287366,1198,0.4641383368132765
2399,242.923133,242.936433,1,7287693,7288092,399,0.25331977031679903
2400,242.941233,242.960267,1,7288236,7288808,572,0.682543259034248
2401,242.990933,243.0046,1,7289727,7290138,411,0.40030326525373916
2402,243.006167,243.017267,1,7290185,7290518,333,0.0521228838944344
2403,243.0235,243.0298,1,7290705,7290894,189,0.8287646000728167
2404,243.0308,243.0583,1,7290924,7291749,825,0.5009213151666184
2405,243.076567,243.093067,1,7292297,7292792,495,0.23249063817987317
2406,243.127367,243.1852,1,7293821,7295556,1735,0.391073764642799
2407,243.1862,243.194333,1,7295586,7295829,243,0.8188931265543847
2408,243.196367,243.200333,1,7295891,7296009,118,0.3264501032315325
2409,243.203,243.241633,1,7296090,7297248,1158,0.2232909336107013
2410,243.276233,243.2899,1,7298286,7298697,411,0.143990776768095
2411,243.291933,243.299333,1,7298757,7298979,222,0.20378262184899817
2412,243.301067,243.3124,1,7299032,7299372,340,0.6074763554269421
2413,243.3168,243.334367,1,7299504,7300031,527,0.3241031476129454
2414,243.3363,243.340933,1,7300089,7300227,138,0.6783426303037284
2415,243.357833,243.382167,1,7300734,7301465,731,-0.0017316190255936609
2416,243.4063,243.416067,1,7302189,7302482,293,0.40550901185718846
2417,243.446467,243.466467,1,7303394,7303994,600,0.3055593523991457
2418,243.468267,243.494333,1,7304048,7304829,781,0.7087015949904778
2419,243.520467,243.5431,1,7305614,7306293,679,0.1841013230010207
2420,243.551033,243.560233,1,7306530,7306806,276,0.6305795568108127
2421,243.604267,243.610267,1,7308128,7308308,180,0.5225759328056871
2422,243.6322,243.635967,1,7308966,7309079,113,0.5521006834862359
2423,243.644467,243.647467,1,7309334,7309424,90,0.9184459095422254
2424,243.6587,243.663567,1,7309761,7309907,146,0.656657241672908
2425,243.681633,243.688433,1,7310448,7310652,204,0.7155909073321597
2426,243.6897,243.7208,1,7310691,7311624,933,0.316822272999808
2427,243.7804,243.7845,1,7313412,7313535,123,0.2190341117473058
2428,243.791367,243.801067,1,7313741,7314032,291,0.0852254877596477
2429,243.802533,243.826233,1,7314075,7314786,711,0.8801664836673744
2430,243.828733,243.834,1,7314861,7315020,159,0.7133389789059694
2431,243.838233,243.8419,1,7315146,7315257,111,0.7412862917179533
2432,243.8591,243.8737,1,7315773,7316211,438,0.49509312648036874
2433,244.0184,244.022467,1,7320552,7320674,122,0.6926497289238127
2434,244.026833,244.0879,1,7320804,7322637,1833,0.10478720742426526
2435,244.089567,244.130467,1,7322687,7323914,1227,0.22787018944021
2436,244.137867,244.169567,1,7324136,7325087,951,0.001731997420091229
2437,244.189533,244.251767,1,7325685,7327553,1868,0.29358413680794077
2438,244.2702,244.278033,1,7328106,7328340,234,0.25599560235267127
2439,244.285467,244.307967,1,7328564,7329239,675,0.12815542445083117
2440,244.323633,244.3595,1,7329708,7330785,1077,0.3347067584914319
2441,244.361333,244.374933,1,7330839,7331247,408,0.26130866262271896
2442,244.397033,244.460967,1,7331910,7333829,1919,0.23019752425946668
2443,244.462433,244.469733,1,7333872,7334091,219,0.4619755486904326
2444,244.4721,244.4788,1,7334163,7334364,201,0.7775144133153886
2445,244.553367,244.560833,1,7336601,7336824,223,0.31287208840828323
2446,244.799533,244.8118,1,7343985,7344354,369,0.616794742980147
2447,244.897767,244.901333,1,7346933,7347039,106,0.541369678342247
2448,244.902633,244.905667,1,7347078,7347170,92,0.7145053259103482
2449,244.912767,244.9233,1,7347383,7347699,316,0.2333320590072393
2450,244.9274,244.9628,1,7347822,7348884,1062,0.11886808223007987
2451,245.039933,245.045533,1,7351197,7351365,168,0.7265774403644258
2452,245.0742,245.0824,1,7352226,7352472,246,0.5490031156554579
2453,245.0973,245.1069,1,7352919,7353207,288,0.14899980538319385
2454,245.1223,245.126267,1,7353669,7353788,119,0.26366801962478525
2455,245.153133,245.250533,1,7354593,7357515,2922,0.2435733540335541
2456,245.287067,245.444867,1,7358612,7363346,4734,0.2757000298224242
2457,245.4461,245.471433,1,7363383,7364142,759,0.8432997397804917
2458,245.476767,245.481833,1,7364303,7364454,151,0.842416651252912
2459,245.486,245.4894,1,7364580,7364682,102,0.6679812325189141
2460,245.5256,245.529367,1,7365768,7365881,113,0.8909672847111879
2461,245.5309,245.535467,1,7365927,7366064,137,0.8046366724828558
2462,245.537867,245.936933,1,7366136,7378107,11971,0.27053608141052055
2463,245.9436,246.007,1,7378308,7380210,1902,0.46133257349896617
2464,246.0276,246.035033,1,7380828,7381050,222,0.8794174547455965
2465,246.036267,246.3096,1,7381088,7389288,8200,0.17661890223377066
2466,246.3185,246.322333,1,7389555,7389669,114,0.9222902898152512
2467,246.323333,246.3304,1,7389699,7389912,213,0.4138212393273899
2468,246.389433,246.394533,1,7391682,7391835,153,0.9321215724763064
2469,246.400167,246.497467,1,7392005,7394924,2919,0.8335992948326264
2470,246.572767,246.593067,1,7397183,7397792,609,0.7312004908546723
2471,246.609367,246.6132,1,7398281,7398396,115,0.4634405002329131
2472,246.695633,246.700567,1,7400868,7401017,149,0.2658519508715081
2473,246.7107,246.715267,1,7401321,7401458,137,0.6450258456920605
2474,246.723267,246.732,1,7401698,7401960,262,0.7208669429251661
2475,246.736367,246.7484,1,7402091,7402452,361,0.5461422212780614
2476,246.749733,246.753967,1,7402491,7402619,128,0.6913427842151967
2477,246.761367,246.765067,1,7402841,7402952,111,0.5221190271730584
2478,246.773867,246.781333,1,7403216,7403439,223,0.6066949911491819
2479,246.911533,246.915433,1,7407345,7407462,117,0.9193833518261724
2480,246.918133,246.928833,1,7407543,7407864,321,0.8683254753263129
2481,246.936767,246.9433,1,7408103,7408299,196,0.9549992823587445
2482,246.955167,246.963533,1,7408655,7408905,250,0.7520308626154999
2483,246.964567,246.9859,1,7408937,7409577,640,0.65626119292379
2484,246.990367,247.005933,1,7409711,7410177,466,0.6292625779078252
2485,247.116367,247.134167,1,7413491,7414025,534,0.15397373203462053
2486,247.139267,247.1472,1,7414178,7414416,238,0.8638663047113568
2487,247.1657,247.169833,1,7414971,7415094,123,0.3917199953710137
2488,247.174633,247.181433,1,7415238,7415442,204,0.5836501766401104
2489,247.2048,247.231233,1,7416144,7416936,792,0.17564044553764402
2490,247.2437,247.247633,1,7417311,7417428,117,0.9075423512137667
2491,247.2566,247.271667,1,7417698,7418150,452,0.26141975106581755
2492,247.2779,247.281533,1,7418337,7418445,108,0.2486111677473593
2493,247.2937,247.3016,1,7418811,7419048,237,0.7737827428258227
2494,247.3053,247.308533,1,7419159,7419255,96,0.9392571500675249
2495,247.318033,247.3214,1,7419540,7419642,102,0.8593651822238646
2496,247.3324,247.357333,1,7419972,7420719,747,0.5299520244722512
2497,247.370733,247.374933,1,7421121,7421247,126,0.8056485123075832
2498,247.3812,247.388433,1,7421436,7421652,216,0.5115444543121244
2499,247.409567,247.413967,1,7422287,7422419,132,-0.20391993525623886
2500,247.422267,247.443,1,7422668,7423290,622,0.05388500283760877
2501,247.454467,247.459933,1,7423634,7423797,163,0.6712904978506513
2502,247.462333,247.466133,1,7423869,7423983,114,0.9527307899189716
2503,247.469867,247.4855,1,7424096,7424565,469,0.19906443642373264
2504,247.491933,247.504233,1,7424757,7425126,369,0.12130497181965048
2505,247.9437,247.948333,1,7438311,7438449,138,0.6329706026269212
2506,247.9505,247.953933,1,7438515,7438617,102,0.7619053185534764
2507,247.959233,247.962367,1,7438776,7438871,95,0.36545056083265504
2508,247.967567,247.971467,1,7439027,7439144,117,0.6987419740588725
2509,247.9957,247.9997,1,7439871,7439991,120,0.4901034227815226
2510,248.033967,248.037033,1,7441019,7441110,91,0.7187304276668978
2511,248.126467,248.129933,1,7443794,7443897,103,0.19778578614378406
2512,248.134267,248.197967,1,7444028,7445939,1911,-0.10542008829084788
2513,248.206133,248.214433,1,7446183,7446432,249,-0.033369741205198866
2514,248.2179,248.242533,1,7446537,7447275,738,0.20024464323308214
2515,248.2584,248.275967,1,7447752,7448279,527,0.09260715105099045
2516,248.277467,248.3529,1,7448324,7450587,2263,0.168812404367746
2517,248.354067,248.395933,1,7450622,7451877,1255,0.4250643278113269
2518,248.397067,248.4551,1,7451912,7453653,1741,0.1471605728051788
2519,248.459367,248.49,1,7453781,7454700,919,0.794475700580075
2520,248.4912,248.504367,1,7454736,7455131,395,0.8324974446790523
2521,248.510633,248.531367,1,7455318,7455941,623,-0.017712895681908095
2522,248.5378,248.613267,1,7456134,7458398,2264,0.25713820154013894
2523,248.6201,248.6407,1,7458603,7459221,618,0.1855808832169401
2524,248.6424,248.6566,1,7459272,7459698,426,0.0999865012945278
2525,248.6609,248.665067,1,7459827,7459952,125,0.704327574807232
2526,248.6693,248.6859,1,7460079,7460577,498,0.39282165883877596
2527,248.687467,248.7633,1,7460624,7462899,2275,0.37427891960707316
2528,248.7723,248.7763,1,7463169,7463289,120,0.6242612750391046
2529,248.803833,248.817267,1,7464114,7464518,404,0.47611818852856547
2530,248.819367,248.8288,1,7464581,7464864,283,0.4601670010992108
2531,248.840767,248.867733,1,7465223,7466031,808,0.758501711400974
2532,248.8692,248.8781,1,7466076,7466343,267,0.8534227554865496
2533,248.893333,248.9164,1,7466799,7467492,693,0.4247815948102767
2534,248.994967,249.0185,1,7469849,7470555,706,0.2335908660447674
2535,249.020933,249.026933,1,7470627,7470807,180,0.9063089237274525
2536,249.029933,249.0377,1,7470897,7471131,234,0.5787565954212542
2537,249.043033,249.0599,1,7471290,7471797,507,0.44640963461655997
2538,249.064633,249.079333,1,7471938,7472379,441,0.5494293693268862
2539,249.1587,249.162533,1,7474761,7474875,114,0.8939434141925899
2540,249.163533,249.174833,1,7474905,7475244,339,0.9064582056770103
2541,249.176233,249.200733,1,7475286,7476021,735,0.7023948861323294
2542,249.208667,249.227233,1,7476260,7476816,556,0.542777810255302
2543,249.264767,249.277567,1,7477943,7478327,384,0.5655019100932445
2544,249.3362,249.346167,1,7480086,7480385,299,0.5641436384035391
2545,249.347667,249.352833,1,7480430,7480584,154,0.9737764895644617
2546,249.360367,249.374733,1,7480811,7481241,430,0.7693568529778124
2547,249.376633,249.391833,1,7481298,7481754,456,0.5071634858140963
2548,249.392833,249.4013,1,7481784,7482039,255,0.6857140958659856
2549,249.503367,249.542433,1,7485101,7486272,1171,0.8076079417810005
2550,249.5546,249.566,1,7486638,7486980,342,0.2628848618268975
2551,250.0984,250.1062,1,7502952,7503186,234,0.2801249660030438
2552,250.1535,250.159533,1,7504605,7504785,180,0.5316817864140205
2553,250.160933,250.2238,1,7504827,7506714,1887,0.2066890912066813
2554,250.225967,250.2435,1,7506779,7507305,526,0.2650660155748663
2555,250.273867,250.358267,1,7508216,7510748,2532,0.04074434856682147
2556,250.359433,250.401167,1,7510782,7512035,1253,-0.1374861785334947
2557,250.402233,250.4115,1,7512066,7512345,279,-0.2722032268731322
2558,250.419067,250.422367,1,7512572,7512671,99,0.7432485374321112
2559,250.425,250.5009,1,7512750,7515027,2277,0.2303233108780718
2560,250.505767,250.512533,1,7515173,7515375,202,0.4255091645276258
2561,250.532633,250.5804,1,7515978,7517412,1434,0.2459101473856929
2562,250.5827,250.6184,1,7517481,7518552,1071,0.4208148025564012
2563,250.6231,250.626733,1,7518693,7518801,108,0.5459399794803823
2564,250.628633,250.633167,1,7518858,7518995,137,0.7499483001954198
2565,250.638767,250.651533,1,7519163,7519545,382,0.36301735242994676
2566,250.652833,250.724667,1,7519584,7521740,2156,0.3464779029967601
2567,250.730333,250.741033,1,7521909,7522230,321,0.13070257820005782
2568,250.745167,250.7747,1,7522355,7523241,886,0.17130534950961931
2569,250.785033,250.7885,1,7523550,7523655,105,0.9366973744926461
2570,250.789833,250.8135,1,7523694,7524405,711,0.18275732722354737
2571,250.818933,250.823867,1,7524567,7524716,149,0.7418730553428963
2572,250.842633,250.968767,1,7525278,7529063,3785,0.45784016328530747
2573,250.976267,251.061633,1,7529288,7531848,2560,0.5703545646277551
2574,251.0693,251.082433,1,7532079,7532472,393,0.7975009602508063
2575,251.101967,251.601267,1,7533059,7548038,14979,0.369514017457598
2576,251.617467,251.659967,1,7548524,7549799,1275,0.6385987616387337
2577,251.667733,251.670767,1,7550031,7550123,92,0.9342655346210149
2578,251.672467,251.677567,1,7550174,7550327,153,0.9612692492198551
2579,251.678733,251.757333,1,7550361,7552719,2358,0.4979893310740448
2580,251.7722,251.8672,1,7553166,7556016,2850,0.7264625106785942
2581,251.916,252.0721,1,7557480,7562163,4683,0.4483630561868765
2582,252.085333,252.4245,1,7562559,7572735,10176,0.5770353498149907
2583,252.439767,252.481,1,7573193,7574430,1237,0.5121351845485993
2584,252.483,252.547833,1,7574490,7576434,1944,0.3855545041027563
2585,252.5633,252.569533,1,7576899,7577085,186,0.8817723619166162
2586,252.591867,252.596333,1,7577756,7577889,133,0.7412543946241621
2587,252.603333,252.625833,1,7578099,7578774,675,0.23744276356792535
2588,252.6292,252.646233,1,7578876,7579386,510,0.8448975326082062
2589,252.654433,252.671267,1,7579632,7580138,506,0.20642267676062026
2590,252.675533,252.690233,1,7580265,7580706,441,0.21627693342180707
2591,252.6987,252.722533,1,7580961,7581675,714,0.2405591434315591
2592,252.727833,252.734933,1,7581834,7582047,213,0.6090504727883461
2593,252.743767,252.749533,1,7582313,7582485,172,0.8777333269386228
2594,252.7614,252.791667,1,7582842,7583750,908,0.11619509042220164
2595,252.794533,252.799233,1,7583835,7583976,141,0.7780669490124783
2596,252.810533,252.8138,1,7584315,7584414,99,0.7656737763483263
2597,252.8169,252.8309,1,7584507,7584927,420,0.45783420805998504
2598,252.834367,252.8661,1,7585031,7585983,952,0.6706009789593065
2599,252.870333,252.901867,1,7586109,7587056,947,0.3020043881522596
2600,252.9061,252.910433,1,7587183,7587312,129,0.8444289990202928
2601,252.9117,252.9229,1,7587351,7587687,336,0.7237656681125355
2602,252.966067,252.9759,1,7588982,7589277,295,0.6779768322441437
2603,252.998767,253.008033,1,7589963,7590240,277,0.5345311430577824
2604,253.064467,253.068867,1,7591934,7592066,132,0.7293403733738731
2605,253.161433,253.1647,1,7594842,7594941,99,0.28714356734419344
2606,253.431633,253.440467,1,7602948,7603214,266,0.1779393872250622
2607,253.5115,253.5176,1,7605345,7605528,183,0.6571427559243722
2608,253.528967,253.537167,1,7605869,7606115,246,0.8914206867046053
2609,253.5534,253.5662,1,7606602,7606986,384,0.2294687712892557
2610,253.964,253.9695,1,7618920,7619085,165,0.8467432591081511
2611,253.980133,254.050333,1,7619403,7621509,2106,0.16045678101760652
2612,254.0529,254.082033,1,7621587,7622460,873,0.49247380190723294
2613,254.0838,254.097967,1,7622514,7622939,425,0.7013732293267546
2614,254.109567,254.137933,1,7623287,7624137,850,0.523717431982374
2615,254.153633,254.157867,1,7624608,7624736,128,0.8158399022627982
2616,254.165133,254.1795,1,7624953,7625385,432,0.6347165142478142
2617,254.224333,254.232567,1,7626729,7626977,248,0.12367508146998223
2618,254.240433,254.256267,1,7627212,7627688,476,0.4532094627728621
2619,254.257567,254.2709,1,7627727,7628127,400,0.4133803456457647
2620,254.2755,254.312233,1,7628265,7629366,1101,0.3212625280300259
2621,254.313233,254.326833,1,7629396,7629804,408,0.7089196277534993
2622,254.335333,254.3545,1,7630059,7630635,576,0.3167548005062959
2623,254.356033,254.3592,1,7630680,7630776,96,0.8190525656886383
2624,254.363367,254.375267,1,7630901,7631258,357,0.8438667569871506
2625,254.3837,254.415733,1,7631511,7632471,960,0.6764919077777944
2626,254.4194,254.4257,1,7632582,7632771,189,0.7891341427594752
2627,254.449,254.475767,1,7633470,7634273,803,0.5109668746899917
2628,254.488667,254.495,1,7634660,7634850,190,0.7673031645830891
2629,254.500333,254.5567,1,7635009,7636701,1692,0.26852542111686867
2630,254.558033,254.593767,1,7636740,7637813,1073,0.2848896518494681
2631,254.6012,254.6292,1,7638036,7638876,840,0.31899631356353586
2632,254.630367,254.666367,1,7638911,7639991,1080,0.5448342185707528
2633,254.671167,254.6952,1,7640135,7640856,721,0.7369559120005468
2634,254.702967,254.7064,1,7641089,7641192,103,0.9327969456096851
2635,254.711033,254.721933,1,7641330,7641657,327,0.5516812480446587
2636,254.738467,254.8044,1,7642154,7644132,1978,0.3288114465795313
2637,254.812367,254.8408,1,7644371,7645224,853,0.2096878619424262
2638,254.842567,254.846567,1,7645277,7645397,120,0.803937633953254
2639,254.8515,254.870133,1,7645545,7646103,558,0.21022399702111264
2640,254.871233,254.876767,1,7646136,7646303,167,0.37586059401677396
2641,254.8843,254.9073,1,7646529,7647219,690,0.7256271055188694
2642,254.9083,254.912967,1,7647249,7647389,140,0.8353847489519471
2643,254.9233,254.9431,1,7647699,7648293,594,0.3149657942599626
2644,254.946067,255.0127,1,7648382,7650381,1999,0.2581185483396421
2645,255.015133,255.025533,1,7650453,7650765,312,0.8752446335430913
2646,255.0509,255.058733,1,7651527,7651761,234,0.43972826786392233
2647,255.060267,255.074767,1,7651808,7652243,435,0.761038331952728
2648,255.099767,255.111333,1,7652993,7653339,346,0.2749249598877948
2649,255.119067,255.131467,1,7653572,7653944,372,0.7772829698967256
2650,255.133,255.139767,1,7653990,7654193,203,0.7751974318648269
2651,255.161733,255.186533,1,7654851,7655595,744,0.19140048583480998
2652,255.188633,255.203633,1,7655658,7656108,450,0.6712451964384876
2653,255.205033,255.219733,1,7656150,7656591,441,0.2978836966317074
2654,255.224267,255.264833,1,7656728,7657944,1216,0.3001153519851419
2655,255.266633,255.2714,1,7657998,7658142,144,0.6059691613956978
2656,255.2857,255.323867,1,7658571,7659716,1145,0.22308445977843538
2657,255.337433,255.347933,1,7660122,7660437,315,0.19904002856413908
2658,255.3517,255.359133,1,7660551,7660773,222,0.3595656121245158
2659,255.360433,255.368733,1,7660812,7661061,249,0.806399039322445
2660,255.370033,255.3974,1,7661100,7661922,822,0.7903631173199492
2661,255.403033,255.4069,1,7662090,7662207,117,0.6989404711016043
2662,255.4184,255.436767,1,7662552,7663103,551,0.3119365268345611
2663,255.437833,255.451333,1,7663134,7663539,405,0.4143549237383298
2664,255.474233,255.487667,1,7664226,7664630,404,0.2467392250228268
2665,255.4951,255.499033,1,7664853,7664970,117,0.28206538868237885
2666,255.5148,255.552133,1,7665444,7666563,1119,0.22926067491525348
2667,255.553267,255.590367,1,7666598,7667711,1113,0.19944124177779465
2668,255.607833,255.627533,1,7668234,7668825,591,0.17916081223318273
2669,255.673633,255.698733,1,7670208,7670961,753,0.35341437776192114
2670,255.7272,255.750333,1,7671816,7672509,693,0.40588689899185715
2671,255.838233,255.847,1,7675146,7675410,264,0.2295393283467253
2672,255.856067,255.897533,1,7675682,7676925,1243,0.751700735961234
2673,255.9047,255.9308,1,7677141,7677924,783,0.38770992377300056
2674,255.933433,255.9427,1,7678002,7678281,279,0.22922956538606715
2675,256.016133,256.046267,1,7680483,7681388,905,0.39244053757050634
2676,256.080267,256.087933,1,7682408,7682637,229,0.8433668547450522
2677,256.100933,256.1043,1,7683027,7683129,102,0.3846390967773374
2678,256.151933,256.156133,1,7684557,7684683,126,0.8052032621535167
2679,256.481267,256.485267,1,7694438,7694558,120,0.5958303563592984
2680,256.490633,256.511233,1,7694718,7695336,618,0.6310362315597489
2681,256.5126,256.5176,1,7695378,7695528,150,0.8493116675868694
2682,256.526633,256.530167,1,7695798,7695905,107,0.8070198742275085
2683,256.537367,256.557467,1,7696121,7696724,603,0.32981430091278724
2684,257.258567,257.262767,1,7717757,7717883,126,0.4369025257802142
2685,257.287233,257.292133,1,7718616,7718763,147,0.2531045271109718
2686,257.7199,257.816533,1,7731597,7734495,2898,-0.011764488109617123
2687,257.820133,257.8418,1,7734603,7735253,650,0.20220821664765382
2688,257.842967,257.8508,1,7735289,7735524,235,0.7078639989847042
2689,257.858933,257.878733,1,7735767,7736361,594,0.03114958362381161
2690,257.881767,257.892333,1,7736453,7736769,316,0.3359828356987493
2691,257.893533,257.944433,1,7736805,7738332,1527,0.19866650373703829
2692,257.945633,257.964433,1,7738368,7738932,564,0.3457946332148435
2693,257.990833,258.031933,1,7739724,7740957,1233,0.28597623745705875
2694,258.387367,258.397267,1,7751621,7751918,297,0.5587111533789014
2695,258.432233,258.4951,1,7752966,7754852,1886,0.11639188687361929
2696,258.4978,258.505467,1,7754933,7755164,231,0.6976301339211184
2697,258.513867,258.540867,1,7755416,7756226,810,0.32238251537434365
2698,258.542133,258.5707,1,7756263,7757121,858,0.07993638204006899
2699,258.5742,258.6473,1,7757226,7759418,2192,0.3352247541149974
2700,258.666167,258.7025,1,7759985,7761075,1090,0.6574305393958934
2701,258.707833,258.770733,1,7761234,7763121,1887,0.16755555776083517
2702,258.799667,258.841033,1,7763990,7765230,1240,0.1474057928130305
2703,258.849967,258.8569,1,7765499,7765707,208,0.6894133344636815
2704,258.863433,258.9282,1,7765902,7767846,1944,0.4506288009730716
2705,258.939867,258.944467,1,7768196,7768334,138,0.9377768826757573
2706,259.168233,259.1713,1,7775046,7775138,92,0.8793362140340895
2707,259.492,259.4974,1,7784760,7784922,162,0.3495853362893563
2708,259.501767,259.519767,1,7785053,7785593,540,0.18706527266720724
2709,259.5277,259.591233,1,7785830,7787736,1906,0.4267859277084142
2710,259.594133,259.632967,1,7787823,7788989,1166,0.3555226411667896
2711,259.646633,259.6585,1,7789398,7789755,357,0.6493518989078494
2712,259.674633,259.677967,1,7790238,7790339,101,0.5833699119950492
2713,259.6827,259.700667,1,7790481,7791020,539,0.316384541263166
2714,259.7017,259.7091,1,7791051,7791272,221,0.4723189038672641
2715,259.715233,259.720733,1,7791456,7791621,165,0.40374691052556927
2716,259.767433,259.770733,1,7793022,7793121,99,0.06688549915179216
2717,259.809067,259.8237,1,7794272,7794710,438,0.29567743798943136
2718,259.835067,259.840133,1,7795052,7795203,151,0.4959179076417833
2719,259.991167,260.002933,1,7799735,7800087,352,0.38632247369817213
2720,260.014167,260.028833,1,7800425,7800864,439,0.5650526700461243
2721,260.036433,260.049767,1,7801092,7801493,401,0.7382762147935374
2722,260.060833,260.087867,1,7801824,7802636,812,0.5492208860355877
2723,260.090667,260.0954,1,7802720,7802861,141,0.4534027910104739
2724,260.138033,260.1464,1,7804140,7804392,252,0.44509995501314575
2725,260.1565,260.190967,1,7804695,7805729,1034,0.3752746975751686
2726,260.214933,260.2446,1,7806447,7807338,891,0.44853326509624153
2727,260.245733,260.279033,1,7807371,7808370,999,0.2901256985410175
2728,260.2817,260.2891,1,7808451,7808673,222,0.4505322171112448
2729,260.311133,260.356467,1,7809333,7810694,1361,0.707664908817414
2730,260.3579,260.391,1,7810736,7811730,994,0.1231463118925984
2731,260.407167,260.417067,1,7812215,7812512,297,0.517007459970483
2732,260.4276,260.472733,1,7812827,7814181,1354,0.3175823980451337
2733,260.475833,260.544133,1,7814274,7816323,2049,0.13980375522869923
2734,260.558367,260.5653,1,7816751,7816958,207,0.5732858676014753
2735,260.569833,260.609133,1,7817094,7818273,1179,0.18991557213306512
2736,260.614633,260.6187,1,7818438,7818561,123,0.49569520529355354
2737,260.626967,260.641533,1,7818809,7819245,436,0.2819662563805636
2738,260.6451,260.673433,1,7819353,7820202,849,0.15294510256934832
2739,260.678833,260.7415,1,7820364,7822244,1880,0.19551267093035257
2740,260.767767,260.7739,1,7823033,7823217,184,0.7943123147514815
2741,260.7751,260.800967,1,7823253,7824029,776,0.7392312484911084
2742,260.8038,260.845533,1,7824114,7825365,1251,0.1810615576684115
2743,260.887333,260.890633,1,7826619,7826718,99,0.22095061039697309
2744,260.9194,260.9328,1,7827582,7827984,402,0.5254418007630002
2745,260.933933,260.946633,1,7828017,7828398,381,0.9024906014476296
2746,260.964367,261.000067,1,7828931,7830002,1071,0.4554473672006173
2747,261.003667,261.007233,1,7830110,7830216,106,0.3504391166592194
2748,261.009,261.062567,1,7830270,7831877,1607,0.31182072426748325
2749,261.065133,261.069333,1,7831953,7832079,126,0.8491537206781761
2750,261.074833,261.107367,1,7832244,7833221,977,0.33833941177352045
2751,261.113033,261.141633,1,7833390,7834248,858,0.10889623980623601
2752,261.1432,261.1843,1,7834295,7835529,1234,0.49080665106934607
2753,261.194967,261.2383,1,7835849,7837148,1299,0.22711913252434526
2754,261.247467,261.259,1,7837424,7837770,346,0.29957916414008545
2755,261.262467,261.272667,1,7837874,7838180,306,0.42327285055178243
2756,261.274333,261.2931,1,7838229,7838792,563,0.5764623961730345
2757,261.298167,261.310333,1,7838945,7839309,364,0.7311596821881432
2758,261.3154,261.318433,1,7839462,7839552,90,0.715575496000845
2759,261.3277,261.3539,1,7839831,7840617,786,0.1831380950072315
2760,261.355067,261.362333,1,7840652,7840869,217,0.4297804243469115
2761,261.365233,261.369767,1,7840956,7841093,137,0.8036674134205324
2762,261.385867,261.3954,1,7841576,7841862,286,0.3204876322960842
2763,261.402033,261.406833,1,7842060,7842204,144,0.3493049133832061
2764,261.4117,261.4308,1,7842351,7842923,572,0.8041634557043725
2765,261.432,261.4519,1,7842960,7843557,597,0.6081366819569111
2766,261.470267,261.496933,1,7844108,7844907,799,0.4268283451242535
2767,261.5156,261.522067,1,7845468,7845662,194,0.33801687731427954
2768,261.523267,261.531133,1,7845698,7845933,235,0.29129893645256466
2769,261.542367,261.5464,1,7846271,7846392,121,0.27934401723240276
2770,261.557533,261.562267,1,7846725,7846868,143,0.7204236989576448
2771,261.5638,261.5675,1,7846914,7847025,111,0.8478638759545201
2772,261.568567,261.576167,1,7847057,7847285,228,0.6264908451190987
2773,261.5899,261.597367,1,7847697,7847921,224,0.7938637228069649
2774,261.6008,261.6054,1,7848024,7848161,137,0.6951941823189033
2775,261.614767,261.636667,1,7848443,7849100,657,0.23546566011418396
2776,261.638167,261.649333,1,7849145,7849479,334,0.07347621595827762
2777,261.6682,261.687733,1,7850046,7850631,585,0.16090689364763425
2778,261.720667,261.724233,1,7851620,7851726,106,0.8188293339150848
2779,261.729467,261.767467,1,7851884,7853024,1140,0.155362622073359
2780,261.771433,261.776067,1,7853142,7853282,140,0.7726858289155711
2781,261.7784,261.821967,1,7853351,7854659,1308,0.22384574119330322
2782,261.933833,261.9369,1,7858014,7858106,92,0.7214210653646448
2783,262.118733,262.1226,1,7863561,7863677,116,0.9081686484700505
2784,262.1258,262.172033,1,7863774,7865160,1386,0.11620080045409327
2785,262.1829,262.235067,1,7865487,7867052,1565,0.15849403937846643
2786,262.240367,262.243833,1,7867211,7867314,103,0.5300827955202844
2787,262.6116,262.625767,1,7878348,7878773,425,0.5096502130355997
2788,262.6368,262.6421,1,7879104,7879263,159,0.683852098334506
2789,262.6431,262.659767,1,7879293,7879793,500,0.5865365195358098
2790,262.6668,262.6755,1,7880004,7880265,261,0.5334677797530981
2791,262.722933,262.7284,1,7881687,7881852,165,0.7120525757526173
2792,262.744733,262.7901,1,7882341,7883703,1362,0.07487944353584265
2793,262.807033,262.8161,1,7884210,7884483,273,0.24932713914618265
2794,262.831267,262.853033,1,7884938,7885590,652,0.04226364511617326
2795,262.854933,262.920067,1,7885647,7887602,1955,0.05369680661953983
2796,262.944267,262.981767,1,7888328,7889453,1125,0.26311134223475197
2797,262.989967,263.021067,1,7889699,7890632,933,0.2752505146023556
2798,263.029333,263.033,1,7890879,7890990,111,0.8599354950189376
2799,263.082,263.092233,1,7892460,7892766,306,0.024278899663028097
2800,263.094233,263.150733,1,7892826,7894521,1695,-0.007749897990963834
2801,263.175333,263.179133,1,7895259,7895373,114,0.6375144068424141
2802,263.182967,263.198167,1,7895489,7895945,456,0.3883281882123514
2803,263.2045,263.272467,1,7896135,7898174,2039,0.1260425208953913
2804,263.273567,263.279867,1,7898207,7898396,189,0.4556458317427354
2805,263.282733,263.378733,1,7898481,7901361,2880,0.16332101029263332
2806,263.4052,263.4187,1,7902155,7902561,406,0.0013477021402551795
2807,263.419833,263.438967,1,7902594,7903169,575,0.2792666918101
2808,263.476933,263.5104,1,7904307,7905312,1005,0.16718339099252338
2809,263.516167,263.5207,1,7905485,7905620,135,0.2745092425836484
2810,263.533833,263.540667,1,7906014,7906220,206,0.6304212981464025
2811,263.564533,263.571,1,7906935,7907130,195,0.721502820791419
2812,263.5809,263.6033,1,7907427,7908099,672,0.4897516762796783
2813,263.696933,263.7041,1,7910907,7911122,215,0.2303060769174762
2814,263.707367,263.7166,1,7911221,7911498,277,0.10063349726899996
2815,263.717767,263.722533,1,7911533,7911675,142,0.7578843014969188
2816,263.7236,263.758967,1,7911707,7912769,1062,0.3897564301085899
2817,263.777,263.7825,1,7913310,7913475,165,0.641775533162726
2818,263.7837,263.788567,1,7913511,7913657,146,0.3845643865484724
2819,263.860133,263.912733,1,7915803,7917381,1578,0.0954977444193428
2820,263.9147,263.9191,1,7917440,7917573,133,0.41891984648272707
2821,263.925267,263.973767,1,7917758,7919213,1455,0.19291614913286176
2822,263.989,264.040133,1,7919669,7921203,1534,0.27820943737394993
2823,264.0455,264.141033,1,7921365,7924230,2865,0.31589414869049864
2824,264.1781,264.532133,1,7925342,7935963,10621,0.5229716765602853
2825,264.5371,264.544333,1,7936113,7936329,216,0.8807612702358714
2826,264.5858,264.593133,1,7937574,7937793,219,0.7136488743658204
2827,264.668867,264.850433,1,7940066,7945512,5446,0.40360900700878694
2828,264.863167,265.007433,1,7945895,7950222,4327,0.5195392387277085
2829,265.016933,265.021767,1,7950507,7950653,146,0.8896897012077202
2830,265.022967,265.068833,1,7950689,7952064,1375,0.6672553668282816
2831,265.0752,265.104,1,7952256,7953120,864,0.5765953202242675
2832,265.111633,265.543667,1,7953348,7966310,12962,0.45399238597280694
2833,265.5558,265.669367,1,7966673,7970081,3408,0.5729750372451634
2834,265.713233,265.718033,1,7971396,7971540,144,0.7911177320865793
2835,265.727567,265.733367,1,7971827,7972001,174,0.8682650100691041
2836,265.834167,265.8376,1,7975025,7975128,103,0.9592530588420727
2837,265.871433,265.920367,1,7976142,7977611,1469,0.22494214989959907
2838,265.933667,265.9369,1,7978010,7978106,96,0.9113303858518091
2839,265.942167,265.975667,1,7978265,7979270,1005,0.541842860110341
2840,265.984367,266.0017,1,7979531,7980051,520,0.23918789686354375
2841,266.0226,266.034033,1,7980678,7981020,342,0.8713588244911736
2842,266.0361,266.112967,1,7981082,7983389,2307,0.3146925149044111
2843,266.119667,266.138567,1,7983590,7984157,567,0.07121455198625663
2844,266.143267,266.146933,1,7984298,7984407,109,0.3443126890614256
2845,266.152233,266.1646,1,7984566,7984938,372,0.6657715046249475
2846,266.169167,266.1733,1,7985075,7985198,123,0.7960357373020427
2847,266.174667,266.199967,1,7985240,7985999,759,0.24846329249801172
2848,266.222433,266.2465,1,7986672,7987395,723,0.21808956276608846
2849,266.252267,266.2577,1,7987568,7987731,163,0.44719173166010107
2850,266.265867,266.278067,1,7987976,7988342,366,0.7002953367119135
2851,266.2877,266.291433,1,7988630,7988742,112,0.9100244375243743
2852,266.380433,266.423233,1,7991412,7992696,1284,0.11480762493618647
2853,266.4308,266.4831,1,7992923,7994492,1569,0.21113216815536748
2854,266.4866,266.500833,1,7994598,7995024,426,0.2560180561757499
2855,266.503767,266.509433,1,7995113,7995282,169,0.6595128630984198
2856,266.512467,266.543867,1,7995374,7996316,942,0.3231820266896932
2857,266.548833,266.556167,1,7996464,7996685,221,0.5167198179619308
2858,266.558333,266.602233,1,7996749,7998066,1317,0.21503233525264084
2859,266.616533,266.635167,1,7998495,7999055,560,0.5628144326304525
2860,266.6382,266.674033,1,7999145,8000220,1075,0.6211560539714676
2861,266.676767,266.681033,1,8000303,8000430,127,0.9330725160896874
2862,266.684267,266.7162,1,8000528,8001486,958,0.14117356819749688
2863,266.7188,266.733733,1,8001564,8002011,447,0.06068591656310492
2864,266.743233,266.752933,1,8002296,8002587,291,0.3438781426498647
2865,266.765667,266.769367,1,8002970,8003081,111,0.86512376733197
2866,266.770833,266.822033,1,8003124,8004660,1536,0.1683925644255487
2867,266.827633,266.844567,1,8004828,8005337,509,0.06947744078622876
2868,266.8496,266.859,1,8005488,8005769,281,0.296778782614448
2869,266.8615,266.8768,1,8005844,8006304,460,0.17031998988792535
2870,266.885767,266.911167,1,8006573,8007335,762,0.14901076696689905
2871,266.9135,266.9235,1,8007405,8007705,300,0.383442906148569
2872,266.924533,266.9989,1,8007735,8009967,2232,0.1542953206286889
2873,267.004333,267.068433,1,8010129,8012052,1923,0.15859553944674207
2874,267.075033,267.091167,1,8012250,8012735,485,0.09625761727588286
2875,267.1075,267.136733,1,8013225,8014101,876,-0.0050203392837180755
2876,267.152367,267.172933,1,8014571,8015187,616,0.11120938200060211
2877,267.185033,267.189833,1,8015550,8015694,144,0.6634713385675294
2878,267.194733,267.232567,1,8015841,8016977,1136,0.0593099838732344
2879,267.268633,267.293567,1,8018058,8018807,749,0.22960724581980665
2880,267.302533,267.310067,1,8019075,8019302,227,0.7960425761111671
2881,267.3302,267.3362,1,8019906,8020086,180,0.46920173669889537
2882,267.364333,267.370767,1,8020929,8021123,194,0.5531629239061102
2883,267.376333,267.389267,1,8021289,8021678,389,0.8146551001775106
2884,267.390267,267.421,1,8021708,8022630,922,0.5275049703522939
2885,267.4289,267.456267,1,8022867,8023688,821,0.23254296747610095
2886,267.4781,267.537067,1,8024342,8026112,1770,0.4995976786634402
2887,267.542167,267.545233,1,8026265,8026356,91,0.7689146058254304
2888,267.554733,267.574467,1,8026641,8027234,593,0.2518458093059184
2889,267.5759,267.589167,1,8027277,8027675,398,0.5488494599768687
2890,267.639567,267.6462,1,8029187,8029386,199,0.35587213761804226
2891,267.664833,267.706867,1,8029944,8031206,1262,0.7928731966341528
2892,267.714533,267.753833,1,8031435,8032614,1179,0.1890266237350276
2893,267.759967,267.771,1,8032799,8033130,331,0.05656537826097848
2894,267.841833,267.845633,1,8035254,8035368,114,0.28838503451947806
2895,267.8479,267.857967,1,8035436,8035739,303,0.5717465618112001
2896,267.888733,267.893267,1,8036661,8036798,137,0.32681813804167636
2897,268.2365,268.285533,1,8047094,8048565,1471,0.021040984996359872
2898,268.287833,268.3008,1,8048634,8049023,389,0.48773844067572103
2899,268.304333,268.309033,1,8049129,8049270,141,0.24474704649842377
2900,268.3142,268.324433,1,8049426,8049732,306,0.39418932962112074
2901,268.327767,268.428867,1,8049833,8052866,3033,0.1761131045888904
2902,268.441733,268.4469,1,8053251,8053407,156,0.8276601034885477
2903,268.450367,268.4688,1,8053511,8054064,553,0.19825603370412523
2904,268.4981,268.502,1,8054943,8055060,117,0.6571708495012099
2905,268.504367,268.509167,1,8055131,8055275,144,0.7171203687174881
2906,268.561067,268.586567,1,8056832,8057597,765,0.009701023206765802
2907,268.5877,268.5915,1,8057630,8057745,115,0.31563445537733614
2908,268.699533,268.721167,1,8060985,8061635,650,0.06837736253638117
2909,268.722167,268.725867,1,8061665,8061776,111,0.3946459579605031
2910,268.746067,268.758733,1,8062382,8062761,379,0.6926461821460997
2911,268.7664,268.801433,1,8062991,8064042,1051,0.19176178670204547
2912,268.846933,268.8839,1,8065407,8066516,1109,0.1102322088044876
2913,268.928533,268.959067,1,8067855,8068772,917,0.21982411238951305
2914,268.964333,268.970367,1,8068929,8069111,182,0.8352893999838732
2915,268.995333,268.9995,1,8069859,8069985,126,0.7768290320328319
2916,269.0362,269.056867,1,8071086,8071706,620,0.6702682926174351
2917,269.444967,269.5201,1,8083349,8085603,2254,0.1781706963206177
2918,269.525767,269.5605,1,8085773,8086815,1042,0.15197619342352578
2919,269.562267,269.587767,1,8086868,8087633,765,0.15876497973434875
2920,269.5916,269.599333,1,8087748,8087979,231,0.4078636752049614
2921,269.6064,269.6811,1,8088192,8090433,2241,0.09345661765513431
2922,269.700233,269.7492,1,8091006,8092475,1469,0.35973674147840207
2923,269.751367,269.864633,1,8092541,8095938,3397,0.5046288374956458
2924,269.865667,269.906167,1,8095970,8097185,1215,0.6816044172830762
2925,269.9086,269.984033,1,8097257,8099520,2263,0.36027226392833994
2926,269.989633,270.233367,1,8099688,8107001,7313,0.5840307205704136
2927,270.2364,270.2397,1,8107092,8107191,99,0.8987571496084997
2928,270.2651,270.282933,1,8107953,8108487,534,0.6236054338558107
2929,270.284,270.295033,1,8108520,8108850,330,0.8648563632879115
2930,270.3131,270.414633,1,8109393,8112438,3045,0.5143967751086882
2931,270.4159,270.4794,1,8112477,8114382,1905,0.5816181409073374
2932,270.480433,270.489367,1,8114412,8114681,269,0.48241441780268146
2933,270.5237,270.526867,1,8115711,8115806,95,0.7830551977248793
2934,270.528333,270.544633,1,8115849,8116338,489,0.7950134984527704
2935,270.564833,270.739267,1,8116944,8122178,5234,0.38582528653743364
2936,270.925433,270.9313,1,8127762,8127939,177,0.7160642029354554
2937,270.937867,270.944533,1,8128136,8128335,199,0.5903614896181959
2938,270.949533,270.955033,1,8128485,8128650,165,0.7552093578193662
2939,270.979533,270.983767,1,8129385,8129513,128,0.7546788376048305
2940,270.984767,271.021933,1,8129543,8130657,1114,0.34732414395804173
2941,271.0288,271.065667,1,8130864,8131970,1106,0.5574778975162638
2942,271.0672,271.1224,1,8132016,8133672,1656,0.44848136048169407
2943,271.129833,271.136,1,8133894,8134080,186,0.7603790697388246
2944,271.137733,271.1412,1,8134131,8134236,105,0.8727987760347983
2945,271.1602,271.182233,1,8134805,8135466,661,0.8537188015732002
2946,271.261533,271.272733,1,8137845,8138181,336,0.5548065906780757
2947,271.279267,271.297267,1,8138378,8138918,540,0.46930769116109594
2948,271.3048,271.417467,1,8139144,8142524,3380,0.3283675726310172
2949,271.426,271.480933,1,8142780,8144427,1647,0.7125181214548548
2950,271.518267,271.527733,1,8145548,8145831,283,0.6859218076505764
2951,271.5321,271.641967,1,8145963,8149259,3296,0.4402837919823332
2952,271.6515,271.6938,1,8149545,8150814,1269,0.6872108954875095
2953,271.745967,271.775167,1,8152379,8153255,876,0.684469128084529
2954,271.7802,271.801867,1,8153405,8154056,651,0.7774098432373494
2955,271.805633,271.813633,1,8154168,8154408,240,0.9716297594591958
2956,271.8541,271.8574,1,8155623,8155721,98,0.8096331946964879
2957,271.859133,271.8912,1,8155773,8156736,963,0.786611013863778
2958,271.929633,271.935533,1,8157888,8158065,177,0.5921754155681829
2959,271.936633,271.970633,1,8158098,8159118,1020,0.6395959890789408
2960,271.994233,272.092667,1,8159826,8162780,2954,0.5586161633024957
2961,272.094067,272.0989,1,8162822,8162967,145,0.3375999002042066
2962,272.100633,272.104633,1,8163018,8163138,120,0.7672364668715067
2963,272.260067,272.382167,1,8167802,8171465,3663,0.6178290318717967
2964,272.6443,272.647367,1,8179329,8179421,92,0.2026634454969528
2965,272.6506,272.739967,1,8179518,8182199,2681,0.7433115092005939
2966,272.741433,272.761133,1,8182242,8182833,591,0.6260408215854433
2967,272.7633,272.769133,1,8182899,8183073,174,0.6602673992747643
2968,272.772667,272.7768,1,8183180,8183303,123,0.6756301701759752
2969,272.851833,272.912467,1,8185554,8187374,1820,0.5397736572914823
2970,272.915133,273.051267,1,8187453,8191538,4085,0.48995284365454145
2971,273.0525,273.073933,1,8191575,8192217,642,0.5267098290224255
2972,273.106833,273.1271,1,8193204,8193812,608,0.21517452539353357
2973,273.289433,273.2929,1,8198682,8198786,104,0.41029328292072337
2974,273.453433,273.458267,1,8203602,8203748,146,0.7217728400425617
2975,273.489267,273.495933,1,8204678,8204877,199,0.9107589731371304
2976,273.5939,273.5991,1,8207817,8207973,156,0.8809971223419565
2977,273.673433,273.716467,1,8210202,8211494,1292,0.24505403246956758
2978,273.742533,273.7498,1,8212275,8212494,219,0.2838111595312375
2979,273.751767,273.778933,1,8212553,8213367,814,0.7484992263159295
2980,273.7914,273.798933,1,8213742,8213967,225,0.14501136834263836
2981,273.843767,273.8525,1,8215313,8215575,262,0.9149649204690085
2982,273.854033,273.858433,1,8215620,8215752,132,0.8660373795969017
2983,273.870433,273.873833,1,8216112,8216214,102,0.840451222453195
2984,273.900867,273.9139,1,8217026,8217417,391,0.3159224121367132
2985,273.991333,273.998233,1,8219739,8219946,207,0.03454606392697464
2986,274.0123,274.0223,1,8220368,8220668,300,0.8180671990905771
2987,274.04,274.057233,1,8221200,8221716,516,0.6100804852337931
2988,274.1969,274.200533,1,8225907,8226015,108,0.850422264455407
2989,274.316933,274.332367,1,8229507,8229971,464,0.5296174306306694
2990,274.334567,274.348267,1,8230037,8230448,411,0.6551807548248241
2991,274.363067,274.390933,1,8230892,8231727,835,0.232487803838066
2992,274.422733,274.4265,1,8232681,8232794,113,0.5251177508006163
2993,274.4383,274.450867,1,8233149,8233526,377,0.46578258852473364
2994,274.452533,274.472167,1,8233575,8234165,590,0.5397572359868745
2995,274.477633,274.513333,1,8234328,8235399,1071,0.03635385238708114
2996,274.5178,274.523533,1,8235534,8235705,171,0.299844074481938
2997,274.536933,274.547567,1,8236107,8236427,320,0.2773545965704406
2998,274.580333,274.583333,1,8237409,8237499,90,0.7118149201557296
2999,274.593167,274.6568,1,8237795,8239703,1908,0.13280894347293118
3000,274.6601,274.678233,1,8239803,8240346,543,0.2307903824831622
3001,274.679733,274.6855,1,8240391,8240565,174,0.2902399997604356
3002,274.690533,274.790333,1,8240715,8243709,2994,0.16318729658681355
3003,274.8312,274.865233,1,8244936,8245956,1020,0.5882196881437024
3004,274.8663,274.869467,1,8245989,8246084,95,0.8255969231828335
3005,274.872767,274.896367,1,8246183,8246891,708,0.061706474919547866
3006,274.8978,274.916967,1,8246934,8247509,575,0.31017796427598077
3007,274.938,274.999533,1,8248140,8249985,1845,0.363309537028364
3008,275.000833,275.005267,1,8250024,8250158,134,0.8522887325117554
3009,275.0128,275.041133,1,8250384,8251233,849,0.3083022030598591
3010,275.048433,275.053833,1,8251452,8251614,162,0.8569640257877954
3011,275.0559,275.068333,1,8251677,8252049,372,0.4370967922882089
3012,275.1095,275.124833,1,8253285,8253744,459,0.23937583822026848
3013,275.129433,275.147033,1,8253882,8254410,528,0.5209453974895486
3014,275.168367,275.177567,1,8255051,8255327,276,0.5809194940287133
3015,275.1786,275.1932,1,8255358,8255796,438,0.28676941893045343
3016,275.612433,275.693533,1,8268372,8270805,2433,0.22795673710447964
3017,275.701967,275.719133,1,8271059,8271573,514,0.18000141431133945
3018,275.7269,275.842867,1,8271807,8275286,3479,0.1319505391211618
3019,275.848367,275.856167,1,8275451,8275685,234,0.4508203882238953
3020,275.864,275.867867,1,8275919,8276036,117,0.7562511051712397
3021,275.8922,275.922067,1,8276766,8277662,896,0.5718313014569377
3022,275.9315,275.9374,1,8277945,8278122,177,0.646643709505241
3023,275.938433,275.9809,1,8278152,8279427,1275,0.1250342332633746
3024,276.0338,276.089667,1,8281014,8282690,1676,0.061443472775870915
3025,276.097367,276.100633,1,8282921,8283018,97,0.18443019301693359
3026,276.101633,276.108433,1,8283048,8283252,204,0.636864574261895
3027,276.109967,276.130633,1,8283299,8283918,619,-0.030211571729519045
3028,276.132067,276.156267,1,8283962,8284688,726,0.15969582571901134
3029,276.1876,276.201933,1,8285627,8286057,430,0.004451921670978984
3030,276.206833,276.214367,1,8286204,8286431,227,-0.018632982347936353
3031,276.216033,276.312367,1,8286480,8289371,2891,0.15037342096252557
3032,276.314233,276.3448,1,8289426,8290344,918,0.6095193297210536
3033,276.376067,276.3843,1,8291282,8291529,247,0.7205043472143222
3034,276.4027,276.4299,1,8292080,8292896,816,0.34080961538131604
3035,276.435167,276.443967,1,8293055,8293319,264,0.2924693125611605
3036,276.455267,276.4613,1,8293658,8293839,181,0.5542734486622453
3037,276.4798,276.6101,1,8294394,8298303,3909,0.26968993656970913
3038,276.6121,276.6536,1,8298363,8299607,1244,0.43626186516743687
3039,276.6565,276.713167,1,8299695,8301395,1700,0.1593199912156577
3040,276.715567,276.7291,1,8301467,8301873,406,0.3689159206998858
3041,276.739033,276.800567,1,8302170,8304017,1847,0.17695417978894687
3042,276.807833,276.819233,1,8304234,8304576,342,0.2826384517729935
3043,276.824367,276.841433,1,8304731,8305242,511,0.2311085533824829
3044,276.858233,276.871767,1,8305746,8306153,407,0.1695159438422673
3045,276.8754,276.896133,1,8306262,8306883,621,0.6681243187608563
3046,276.902467,276.907867,1,8307074,8307236,162,0.7452566843175935
3047,276.921467,276.9425,1,8307644,8308275,631,0.07547570378076354
3048,276.9545,276.9669,1,8308635,8309007,372,0.7354630182899358
3049,276.968767,277.015633,1,8309063,8310468,1405,0.02143688701140397
3050,277.024,277.060967,1,8310720,8311829,1109,0.5028299275570789
3051,277.064333,277.103033,1,8311929,8313090,1161,0.18750762241221033
3052,277.127867,277.138833,1,8313836,8314164,328,0.5371743964310963
3053,277.140933,277.1489,1,8314227,8314467,240,0.45656648343199985
3054,277.1499,277.158333,1,8314497,8314749,252,0.6890776356104302
3055,277.161567,277.265667,1,8314847,8317970,3123,0.2559807339196795
3056,277.267933,277.286733,1,8318037,8318601,564,0.48762162297369643
3057,277.288433,277.299833,1,8318652,8318994,342,0.3979704110261912
3058,277.315667,277.3248,1,8319470,8319743,273,0.7983963727383031
3059,277.376667,277.392333,1,8321300,8321769,469,0.4560247609205641
3060,277.5196,277.552433,1,8325588,8326572,984,0.7501208421381437
3061,277.557,277.5645,1,8326710,8326935,225,0.6102489648594505
3062,277.5693,277.595267,1,8327079,8327858,779,0.2220761036654375
3063,278.162367,278.215833,1,8344871,8346474,1603,0.3896335566047742
3064,280.708,280.758767,1,8421240,8422763,1523,0.043856969050357034
3065,280.7718,280.798633,1,8423154,8423958,804,0.17205627933160808
3066,280.800367,280.828167,1,8424011,8424845,834,0.203266992666536
3067,280.832967,280.841833,1,8424989,8425254,265,-0.09712075464445058
3068,280.8568,280.895133,1,8425704,8426853,1149,0.0814875049106473
3069,280.897933,280.943767,1,8426937,8428313,1376,0.40923424362486294
3070,280.947767,280.971067,1,8428433,8429132,699,0.20287500581478157
3071,280.983767,280.992033,1,8429513,8429760,247,0.5462501640243563
3072,280.9957,281.007867,1,8429871,8430236,365,0.59746850920982
3073,281.009033,281.0248,1,8430270,8430744,474,0.4942471578446117
3074,281.026,281.030733,1,8430780,8430921,141,0.8787632487920052
3075,281.032067,281.061433,1,8430962,8431842,880,0.6029600423059697
3076,281.062833,281.0712,1,8431884,8432136,252,0.8351190811692206
3077,281.074133,281.288467,1,8432223,8438654,6431,0.3577688865557189
3078,281.302133,281.330233,1,8439063,8439906,843,0.6385084153758995
3079,281.3313,281.3766,1,8439939,8441298,1359,0.6524409472247
3080,281.383267,281.399767,1,8441498,8441993,495,0.8788796062309335
3081,281.4037,281.457567,1,8442111,8443727,1616,0.2688642463879478
3082,281.467233,281.5009,1,8444016,8445027,1011,0.6538663015252892
3083,281.5024,281.5449,1,8445072,8446347,1275,0.703510694296829
3084,281.5472,281.583967,1,8446416,8447519,1103,0.8621441458710729
3085,281.5877,281.702967,1,8447631,8451089,3458,0.40479434756530064
3086,281.704467,281.7085,1,8451134,8451255,121,0.5791719649084468
3087,281.7131,281.72,1,8451393,8451600,207,0.5713013154253852
3088,281.726733,281.742933,1,8451801,8452287,486,0.7716316063752169
3089,281.745733,281.7586,1,8452371,8452758,387,0.7518317288264353
3090,281.764367,281.7778,1,8452931,8453334,403,0.7954019536599667
3091,281.780633,281.786667,1,8453418,8453600,182,0.8924282408937286
3092,281.794633,281.8388,1,8453838,8455164,1326,0.22037904293090116
3093,281.8398,281.8438,1,8455194,8455314,120,0.7879192260572617
3094,281.8451,281.8837,1,8455353,8456511,1158,0.6327906334719005
3095,281.887167,281.913833,1,8456615,8457414,799,0.33772800473546516
3096,281.9178,281.927267,1,8457534,8457818,284,0.7657531507794451
3097,281.931233,281.9553,1,8457936,8458659,723,0.8091245102576061
3098,281.9567,281.975533,1,8458701,8459265,564,0.6815145263828554
3099,281.9793,282.0603,1,8459379,8461809,2430,0.5549920797531205
3100,282.065233,282.075,1,8461956,8462250,294,0.8240554065462364
3101,282.0761,282.081533,1,8462283,8462445,162,0.7658402404874801
3102,282.082567,282.122933,1,8462477,8463687,1210,0.505569633772614
3103,282.124333,282.135467,1,8463729,8464064,335,0.8417319219020236
3104,282.136967,282.184833,1,8464109,8465544,1435,0.6446345386388576
3105,282.189533,282.205033,1,8465685,8466150,465,0.7080158141129593
3106,282.214833,282.244,1,8466444,8467320,876,0.37833765299943267
3107,282.2479,282.2578,1,8467437,8467734,297,0.4301117492249429
3108,282.266267,282.277867,1,8467988,8468336,348,0.4895503614895548
3109,282.282933,282.287933,1,8468487,8468637,150,0.8809542202131859
3110,282.289,282.294833,1,8468670,8468844,174,0.8245740226628562
3111,282.2985,282.302267,1,8468955,8469068,113,0.7274838560804053
3112,282.305833,282.325367,1,8469174,8469761,587,0.16581532091615653
3113,282.3305,282.3349,1,8469915,8470047,132,0.772392859591684
3114,282.337067,282.353,1,8470112,8470590,478,0.6442233098148811
3115,282.375633,282.383233,1,8471268,8471496,228,0.7433624790994368
3116,282.386233,282.392033,1,8471586,8471760,174,0.7264763418370951
3117,283.402133,283.416067,1,8502063,8502482,419,0.5499306221752416
3118,283.452933,283.459667,1,8503587,8503790,203,0.11069195324722705
3119,283.554533,283.565767,1,8506635,8506973,338,0.6261288839873828
3120,283.850033,283.858867,1,8515500,8515766,266,0.657908856695826
3121,283.887867,283.895067,1,8516636,8516852,216,0.6340059420116392
3122,283.8978,283.908067,1,8516934,8517242,308,0.7133772263291132
3123,284.765,284.768133,1,8542950,8543043,93,0.19830135254344175
3124,284.818733,284.833767,1,8544561,8545013,452,0.7148795624496768
3125,284.8357,284.846667,1,8545071,8545400,329,0.4937101787740853
3126,284.861267,284.875633,1,8545838,8546268,430,0.19323822260981888
3127,284.922833,284.934633,1,8547684,8548038,354,0.11644410647572741
3128,284.943067,284.9539,1,8548292,8548617,325,0.7763637349423805
3129,284.9559,284.982867,1,8548677,8549486,809,0.6480685756649466
3130,284.984133,284.988033,1,8549523,8549640,117,0.7433393900905952
3131,284.9959,285.018033,1,8549877,8550540,663,0.3319639103048484
3132,285.020333,285.030867,1,8550609,8550926,317,0.5969630455554917
3133,285.088267,285.1176,1,8552648,8553528,880,0.630232360986829
3134,285.1202,285.131533,1,8553606,8553945,339,0.7096109571512857
3135,285.1437,285.163,1,8554311,8554890,579,0.6067738057162945
3136,285.176533,285.181167,1,8555295,8555435,140,0.1928931586337115
3137,285.1847,285.1913,1,8555541,8555739,198,0.542577040400164
3138,285.248867,285.252733,1,8557466,8557581,115,0.4949191750213628
3139,285.254133,285.295567,1,8557623,8558867,1244,0.6536406027856321
3140,285.3,285.325467,1,8559000,8559764,764,0.23215144730173776
3141,285.328767,285.342567,1,8559863,8560277,414,0.34086575197342794
3142,285.383667,285.399767,1,8561510,8561993,483,0.1313186508430029
3143,285.4008,285.405967,1,8562024,8562179,155,0.759291144311807
3144,285.4095,285.4144,1,8562285,8562432,147,0.8839787303898405
3145,285.417533,285.448933,1,8562525,8563467,942,0.6636850222837256
3146,285.470633,285.4791,1,8564118,8564373,255,0.8190316251657855
3147,285.4814,285.484767,1,8564442,8564543,101,0.8729880856349039
3148,285.5541,285.566733,1,8566623,8567001,378,0.4327003685464005
3149,285.5767,285.5811,1,8567301,8567433,132,0.3832577947734824
3150,285.584367,285.597167,1,8567531,8567915,384,0.8228935229013083
3151,285.598167,285.621867,1,8567945,8568656,711,0.7764854595656498
3152,285.632333,285.654867,1,8568969,8569646,677,-0.019270788107856145
3153,285.666867,285.678433,1,8570006,8570352,346,0.5894544548462136
3154,285.734633,285.742,1,8572038,8572260,222,0.793050145161591
3155,285.7448,285.784233,1,8572344,8573526,1182,0.3639319104808802
3156,285.7874,285.8263,1,8573622,8574789,1167,0.2620411266083126
3157,285.8636,285.871467,1,8575908,8576144,236,0.5827981082888467
3158,285.905667,285.910467,1,8577170,8577314,144,0.06956098971650126
3159,285.915433,285.931767,1,8577462,8577953,491,0.6596961605207642
3160,286.0087,286.028433,1,8580261,8580852,591,0.3793947117531139
3161,286.277067,286.280533,1,8588312,8588415,103,0.8717981486005257
3162,287.6991,287.703067,1,8630973,8631092,119,0.03733898119884918
3163,293.886967,293.895633,1,8816609,8816868,259,0.32062963483605106
3164,293.8993,293.9049,1,8816979,8817147,168,0.9644167791472326
3165,293.908133,293.9146,1,8817243,8817438,195,0.7389120803470415
3166,293.918133,293.9392,1,8817543,8818176,633,0.34465949374328153
3167,293.982767,293.986033,1,8819483,8819580,97,0.8902534843305855
3168,294.185467,294.256567,1,8825564,8827697,2133,0.13954706245908205
3169,294.270467,294.3218,1,8828114,8829654,1540,0.09173231872906301
3170,294.322833,294.3341,1,8829684,8830023,339,0.39714201418557815
3171,294.348933,294.361167,1,8830467,8830835,368,0.19260549934989366
3172,294.3629,294.381933,1,8830887,8831457,570,0.720886342432613
3173,294.425667,294.4432,1,8832770,8833296,526,0.653455061366624
3174,296.382,296.3921,1,8891460,8891763,303,0.5644416564322872
3175,296.421533,296.455667,1,8892645,8893670,1025,-0.003745711345613944
3176,296.5251,296.538433,1,8895753,8896152,399,0.15774501009898853
3177,297.057067,297.0736,1,8911712,8912208,496,0.2177582773006049
3178,297.119567,297.124433,1,8913587,8913732,145,0.763330870932931
3179,297.125467,297.1576,1,8913764,8914728,964,0.20313821297515644
3180,297.164733,297.1796,1,8914941,8915388,447,0.1714165045892922
3181,297.184867,297.2479,1,8915546,8917437,1891,0.12462501307818698
3182,297.258933,297.2662,1,8917767,8917986,219,0.6312545625837562
3183,297.270267,297.275533,1,8918108,8918265,157,0.47814104455304013
3184,297.2827,297.330667,1,8918481,8919920,1439,0.17346563370944532
3185,297.346733,297.3532,1,8920401,8920596,195,0.2563221631073152
3186,297.36,297.374367,1,8920800,8921231,431,0.24846359372942733
3187,297.385933,297.4106,1,8921577,8922318,741,0.24028067124054464
3188,297.419533,297.513033,1,8922585,8925390,2805,0.25077335316672955
3189,297.5461,297.557,1,8926383,8926710,327,0.7524791546110118
3190,297.558567,297.578733,1,8926757,8927361,604,0.7298844234934921
3191,297.583133,297.586433,1,8927493,8927592,99,0.4605203886243124
3192,297.595833,297.6201,1,8927874,8928603,729,0.24278134391100362
3193,297.640767,297.6438,1,8929223,8929314,91,0.2434694366614307
3194,297.652833,297.656267,1,8929584,8929688,104,0.35297398730483187
3195,297.923733,297.927567,1,8937711,8937827,116,0.49500079783688444
3196,297.9339,297.9743,1,8938017,8939229,1212,0.33764266071159144
3197,297.976133,298.022367,1,8939283,8940671,1388,0.18159456155540563
3198,298.026133,298.0445,1,8940783,8941335,552,0.05682301781569338
3199,298.0656,298.069233,1,8941968,8942076,108,0.8022558934496857
3200,298.0736,298.111567,1,8942208,8943347,1139,0.4234305906025131
3201,298.117933,298.1491,1,8943537,8944473,936,0.08258744608740398
3202,298.152967,298.162133,1,8944589,8944863,274,0.024444048565451373
3203,298.1762,298.182133,1,8945286,8945463,177,0.20590765408825218
3204,298.2085,298.2561,1,8946255,8947683,1428,0.3878915464408323
3205,298.2572,298.262933,1,8947716,8947887,171,0.6843979970960029
3206,298.269967,298.296333,1,8948099,8948889,790,0.1177945007219229
3207,298.298433,298.3071,1,8948952,8949213,261,0.22357899034409626
3208,298.381867,298.427333,1,8951456,8952819,1363,0.7390009476923743
3209,298.4364,298.455833,1,8953092,8953674,582,0.2867469293737594
3210,298.4615,298.468867,1,8953845,8954066,221,0.04451218517853422
3211,298.5468,298.590967,1,8956404,8957729,1325,0.6188576972545353
3212,298.592967,298.5962,1,8957789,8957886,97,0.7990808357274677
3213,298.606633,298.630667,1,8958198,8958920,722,0.294400198229437
3214,298.639767,298.650967,1,8959193,8959529,336,-0.06292900753233967
3215,298.747333,298.7533,1,8962419,8962599,180,0.7195046683227961
3216,298.877867,298.8831,1,8966336,8966493,157,0.5649108985003553
3217,298.9075,298.912367,1,8967225,8967371,146,0.839187819755979
3218,298.9544,298.962,1,8968632,8968860,228,0.21084301334835484
3219,298.9643,298.969333,1,8968929,8969079,150,0.28343319468591116
3220,298.984833,298.990233,1,8969544,8969706,162,0.6562787410344662
3221,298.991933,299.001233,1,8969757,8970036,279,0.6236255835428606
3222,299.003167,299.009133,1,8970095,8970273,178,0.9406649475595333
3223,299.0153,299.020967,1,8970459,8970629,170,0.7404017610378966
3224,299.125567,299.136633,1,8973767,8974098,331,0.7047732890479489
3225,299.137767,299.171767,1,8974133,8975153,1020,0.6195207800533213
3226,299.197667,299.2028,1,8975930,8976084,154,0.6707794553863768
3227,299.215667,299.223367,1,8976470,8976701,231,0.28048601378395976
3228,299.224433,299.2456,1,8976732,8977368,636,0.12375299487304486
3229,299.2474,299.265733,1,8977422,8977971,549,0.12550488047751293
3230,299.290467,299.2983,1,8978714,8978949,235,0.47232651770287964
3231,299.313467,299.325067,1,8979404,8979752,348,0.5168054680489269
3232,299.326433,299.331067,1,8979792,8979932,140,0.7592447705521194
3233,299.3687,299.3765,1,8981061,8981295,234,0.8662168589677436
3234,299.442033,299.4479,1,8983260,8983437,177,0.3369953969765442
3235,299.459533,299.463467,1,8983785,8983904,119,0.7236648117519554
3236,299.466233,299.495533,1,8983986,8984865,879,0.7825871318416561
3237,299.544267,299.5592,1,8986328,8986776,448,0.7240394308954492
3238,299.608867,299.620667,1,8988266,8988620,354,0.32816930924580795
3239,299.6277,299.6612,1,8988831,8989836,1005,0.22561616898922468
3240,299.662333,299.6677,1,8989869,8990031,162,0.6956801105413539
3241,299.719933,299.746,1,8991597,8992380,783,0.6627657320154686
3242,299.754367,299.757733,1,8992631,8992731,100,0.9412056000567074
3243,299.839367,299.845567,1,8995181,8995367,186,0.7639886587353694
3244,299.867633,299.882,1,8996028,8996460,432,0.5057580653942724
3245,299.9351,299.9437,1,8998053,8998311,258,0.07338063380622976
3246,299.9527,299.960467,1,8998581,8998814,233,-0.056321153445582445
3247,300.1046,300.108233,1,9003138,9003246,108,0.702775816368976
3248,300.1095,300.114633,1,9003285,9003438,153,0.4159020794550545
3249,300.1586,300.166433,1,9004758,9004992,234,-0.21340418967171698
3250,300.431067,300.436233,1,9012932,9013086,154,0.6863084243722248
3251,300.530033,300.5416,1,9015900,9016248,348,0.35480632840995674
3252,300.594467,300.6006,1,9017834,9018018,184,0.034195530777968594
3253,300.687767,300.729367,1,9020633,9021881,1248,0.40711472258828435
3254,300.7744,300.7816,1,9023232,9023448,216,0.1638049866372789
3255,300.8721,300.884067,1,9026163,9026522,359,0.5219770518408906
3256,300.885933,300.964067,1,9026577,9028922,2345,0.13265650790260544
3257,300.9832,301.003233,1,9029496,9030096,600,0.12034464809934953
3258,301.005733,301.017133,1,9030171,9030513,342,0.28205474309711004
3259,301.0764,301.093033,1,9032292,9032790,498,0.6928394466879897
3260,301.094067,301.114167,1,9032822,9033425,603,0.11471173896010564
3261,301.117733,301.124267,1,9033531,9033728,197,0.5676148271995148
3262,301.126733,301.132967,1,9033801,9033989,188,0.14157264544723538
3263,301.167367,301.1761,1,9035021,9035283,262,0.2347922931527063
3264,302.297167,302.3131,1,9068915,9069393,478,0.10490223644605698
3265,302.337833,302.371233,1,9070134,9071136,1002,0.16265473646477638
3266,302.407267,302.484433,1,9072218,9074532,2314,0.09884152165906024
3267,302.485867,302.514667,1,9074576,9075440,864,-0.013417502736075672
3268,302.5264,302.546,1,9075792,9076380,588,-0.17846426149771716
3269,302.554433,302.568967,1,9076632,9077069,437,-0.06150362559718927
3270,302.570267,302.581867,1,9077108,9077456,348,0.04869726194198971
3271,302.583167,302.604967,1,9077495,9078149,654,0.19743474818522277
3272,302.6237,302.6286,1,9078711,9078858,147,0.1416725622376941
3273,302.632233,302.689833,1,9078966,9080694,1728,0.14616591042361696
3274,302.6909,302.721467,1,9080727,9081644,917,0.3224258543736979
3275,302.7239,302.729,1,9081717,9081870,153,0.890066810060327
3276,302.798967,302.802667,1,9083969,9084080,111,0.04449644348117703
3277,302.8165,302.8357,1,9084495,9085071,576,0.23351252926555338
3278,302.844533,302.866,1,9085335,9085980,645,0.658679524277669
3279,303.190733,303.273167,1,9095721,9098195,2474,0.08113094189621452
3280,303.280067,303.2886,1,9098402,9098658,256,0.2358920945869723
3281,303.3074,303.324967,1,9099222,9099749,527,0.2600007025100162
3282,303.339933,303.3616,1,9100197,9100848,651,0.08850077842762764
3283,303.366067,303.380933,1,9100982,9101427,445,-0.09769504242067732
3284,303.3823,303.491267,1,9101469,9104738,3269,0.1376768287081282
3285,303.4959,303.5142,1,9104877,9105426,549,0.26689580001517227
3286,303.554467,303.5676,1,9106634,9107028,394,0.2409041095699537
3287,303.589467,303.661233,1,9107684,9109836,2152,0.27241345439380227
3288,303.664,303.672,1,9109920,9110160,240,0.20758421935697072
3289,303.673233,303.679133,1,9110196,9110373,177,0.5377294566020491
3290,303.680333,303.6846,1,9110409,9110538,129,0.5049995129665389
3291,303.7036,303.7175,1,9111108,9111525,417,0.5041810318454178
3292,303.738933,303.755233,1,9112167,9112656,489,0.02199889529302825
3293,303.785333,303.807933,1,9113559,9114237,678,0.25177142523006646
3294,303.8808,303.892133,1,9116424,9116763,339,0.6668857119552151
3295,304.3894,304.4988,1,9131682,9134964,3282,0.11952379365768774
3296,304.501633,304.589533,1,9135048,9137685,2637,0.20816290330436482
3297,304.644167,304.651033,1,9139325,9139530,205,0.6601642069213375
3298,304.691467,304.7016,1,9140744,9141048,304,0.6825567353709661
3299,304.9241,305.013033,1,9147723,9150390,2667,0.1166092509135182
3300,305.0437,305.0561,1,9151311,9151683,372,0.06443676698375632
3301,305.057333,305.065333,1,9151719,9151959,240,0.4107540434195313
3302,305.0689,305.13,1,9152067,9153900,1833,0.062332477479759285
3303,305.131133,305.1414,1,9153933,9154242,309,0.2608797197497366
3304,305.146233,305.152833,1,9154386,9154584,198,0.7227051020069972
3305,305.156967,305.210167,1,9154709,9156305,1596,0.15815319103430886
3306,305.212533,305.2706,1,9156375,9158118,1743,0.22110863777000667
3307,305.273267,305.3546,1,9158198,9160638,2440,0.09182774217373102
3308,305.3575,305.365867,1,9160725,9160976,251,0.7020580329011435
3309,305.3828,305.4721,1,9161484,9164163,2679,0.17493865971059186
3310,305.4734,305.484467,1,9164202,9164534,332,0.35072849297314557
3311,305.485533,305.491333,1,9164565,9164739,174,0.7016300835561093
3312,305.525967,305.531733,1,9165779,9165951,172,0.7969236829278301
3313,305.532833,305.577333,1,9165984,9167319,1335,0.5801447473711521
3314,305.582667,305.6161,1,9167480,9168483,1003,0.2212935823539196
3315,305.636567,305.642833,1,9169097,9169284,187,0.7352320230215401
3316,305.654633,305.659633,1,9169638,9169788,150,0.753198949307786
3317,305.708333,305.7293,1,9171249,9171879,630,0.5714070121754633
3318,305.761367,305.789267,1,9172841,9173678,837,0.5942444815055439
3319,305.9207,305.932833,1,9177621,9177984,363,0.5567189498508092
3320,305.935133,305.938267,1,9178053,9178148,95,0.9220346685008394
3321,305.950067,306.006533,1,9178502,9180195,1693,0.14176519148493444
3322,306.019333,306.052833,1,9180579,9181584,1005,0.06720879078504594
3323,306.088933,306.0923,1,9182667,9182769,102,0.5089162413428349
3324,306.1182,306.1378,1,9183546,9184134,588,0.6026523715000068
3325,306.1403,306.149833,1,9184209,9184494,285,0.3737645286146853
3326,306.233933,306.292667,1,9187017,9188780,1763,0.08525898735561577
3327,306.3019,306.309133,1,9189057,9189273,216,0.5299578699551364
3328,306.312,306.3169,1,9189360,9189507,147,0.6682797395289525
3329,306.318467,306.3479,1,9189554,9190437,883,0.2092112669534861
3330,306.3537,306.359767,1,9190611,9190793,182,0.33481124537407453
3331,306.3609,306.439633,1,9190827,9193188,2361,0.293873145134706
3332,306.4421,306.453933,1,9193263,9193617,354,0.5567843460213832
3333,306.455233,306.4605,1,9193656,9193815,159,0.8216867369928796
3334,306.480967,306.514167,1,9194429,9195425,996,0.37291312196649273
3335,306.5153,306.523733,1,9195459,9195711,252,0.27019204927271834
3336,306.532033,306.575033,1,9195960,9197250,1290,0.07049055690096673
3337,306.5786,306.588267,1,9197358,9197648,290,0.12889084885176716
3338,306.592867,306.622933,1,9197786,9198687,901,0.04137311503066319
3339,306.6556,306.667067,1,9199668,9200012,344,0.28766415725539507
3340,306.675967,306.696033,1,9200279,9200880,601,0.30994647948069876
3341,306.699267,306.732433,1,9200978,9201972,994,0.2233985414878712
3342,306.754367,306.7732,1,9202631,9203196,565,0.33024159420870225
3343,306.775,306.7921,1,9203250,9203763,513,0.18522922648373955
3344,306.881867,306.971933,1,9206456,9209157,2701,0.05047577220960469
3345,306.977067,307.0271,1,9209312,9210813,1501,0.11779292641485742
3346,307.0295,307.032867,1,9210885,9210986,101,0.9531139152622617
3347,307.046967,307.2032,1,9211409,9216096,4687,0.07376561367484943
3348,307.220067,307.227333,1,9216602,9216819,217,0.014943200439447748
3349,307.239133,307.306133,1,9217173,9219183,2010,0.011893353434632176
3350,307.3121,307.3594,1,9219363,9220782,1419,0.2418236705569668
3351,307.4661,307.470533,1,9223983,9224115,132,0.8821676916062284
3352,307.499567,307.5045,1,9224987,9225135,148,0.6800578165527994
3353,307.541533,307.5446,1,9226245,9226338,93,0.8995528242190679
3354,307.5503,307.5579,1,9226509,9226737,228,0.790769210081693
3355,307.7212,307.725733,1,9231636,9231771,135,0.1928789040573762
3356,307.751467,307.759467,1,9232544,9232784,240,-0.1241730700913294
3357,307.7609,307.7754,1,9232827,9233262,435,0.4094499857176299
3358,307.7915,307.8064,1,9233745,9234192,447,0.09133564281168521
3359,307.8081,307.826733,1,9234243,9234801,558,0.21875660214528617
3360,307.838567,307.8416,1,9235157,9235248,91,0.9032481273724768
3361,307.8513,307.874133,1,9235539,9236223,684,0.6698115982051887
3362,307.994467,308.001933,1,9239834,9240057,223,0.3668323261635119
3363,308.0144,308.050833,1,9240432,9241524,1092,0.23578379060811513
3364,308.055967,308.078467,1,9241679,9242354,675,0.3854763720478736
3365,308.097433,308.115633,1,9242922,9243468,546,0.6647300851181284
3366,308.118433,308.122933,1,9243552,9243687,135,0.8311625278963469
3367,308.126133,308.130533,1,9243783,9243915,132,0.9495043940868019
3368,308.141267,308.1515,1,9244238,9244545,307,0.6404694515717734
3369,309.415567,309.4264,1,9282467,9282792,325,0.45093834345993944
3370,309.4503,309.4623,1,9283509,9283869,360,0.3076643473727552
3371,309.4856,309.510533,1,9284568,9285315,747,-0.02001551659113822
3372,309.529233,309.549233,1,9285876,9286476,600,0.30838125807725525
3373,309.561167,309.5679,1,9286835,9287037,202,0.7076060751614003
3374,309.573067,309.614767,1,9287192,9288443,1251,0.22119540212995614
3375,309.617467,309.645033,1,9288524,9289350,826,0.3135588782282224
3376,309.664667,309.6707,1,9289940,9290121,181,0.08999978600092753
3377,309.6721,309.678,1,9290163,9290340,177,0.28404915855402124
3378,309.704567,309.7868,1,9291137,9293604,2467,0.10519703055328734
3379,309.787833,309.798167,1,9293634,9293945,311,0.22772998106072734
3380,309.831733,309.853067,1,9294951,9295592,641,0.1464642119789109
3381,309.8618,309.8995,1,9295854,9296985,1131,0.2784039050017185
3382,309.902367,309.9309,1,9297071,9297927,856,0.15964750909053751
3383,309.9321,309.939,1,9297963,9298170,207,0.20060625481913294
3384,309.984233,310.004367,1,9299526,9300131,605,0.2876148808996816
3385,310.0086,310.045767,1,9300258,9301373,1115,0.2555453643329674
3386,310.056333,310.076433,1,9301689,9302292,603,0.20950323240942378
3387,310.0786,310.087733,1,9302358,9302631,273,0.34422813308390887
3388,310.151267,310.192333,1,9304538,9305769,1231,0.3031121322040126
3389,310.193933,310.247433,1,9305817,9307422,1605,0.11303685787778683
3390,310.248933,310.2781,1,9307467,9308343,876,0.07723515013952267
3391,310.279567,310.282733,1,9308387,9308481,94,0.7780432991761126
3392,310.337133,310.3556,1,9310113,9310668,555,0.3118859509494473
3393,310.3643,310.3781,1,9310929,9311343,414,0.1797235708511319
3394,310.448267,310.455833,1,9313448,9313674,226,0.30088761203560926
3395,310.5983,310.695733,1,9317949,9320871,2922,0.18796622685124523
3396,310.726033,310.7937,1,9321780,9323811,2031,0.158370023811319
3397,310.7965,310.820833,1,9323895,9324624,729,0.8567948934040684
3398,310.823133,310.8322,1,9324693,9324966,273,0.7431400408797871
3399,310.843367,310.849967,1,9325301,9325499,198,0.8028547963119761
3400,310.861733,310.866267,1,9325851,9325988,137,0.8187207972136116
3401,311.314967,311.407467,1,9339449,9342224,2775,0.07835987725110172
3402,311.418333,311.434767,1,9342549,9343043,494,0.14229251778600988
3403,311.443467,311.4514,1,9343304,9343542,238,0.21335609348237353
3404,311.4544,311.4789,1,9343632,9344367,735,0.26638362256541087
3405,311.486033,311.585333,1,9344580,9347559,2979,0.18236896448031073
3406,311.836167,311.9288,1,9355085,9357864,2779,0.11539574678089315
3407,311.9299,311.957033,1,9357897,9358710,813,0.2970299812777493
3408,311.969167,311.988933,1,9359075,9359667,592,0.3287692253738076
3409,311.990567,312.0117,1,9359717,9360351,634,0.049746979870108676
3410,312.014833,312.019633,1,9360444,9360588,144,0.4544146487141613
3411,312.0341,312.121267,1,9361023,9363638,2615,0.09800211620297286
3412,312.1226,312.138567,1,9363678,9364157,479,0.04089221593415246
3413,312.140033,312.144133,1,9364200,9364323,123,0.7592022757767153
3414,312.166933,312.2086,1,9365007,9366258,1251,0.1104638157801076
3415,312.222467,312.241467,1,9366674,9367244,570,0.2782952782501753
3416,312.277633,312.287067,1,9368328,9368612,284,0.15201078392996534
3417,312.300333,312.3049,1,9369009,9369147,138,0.869309377752429
3418,312.311133,312.336867,1,9369333,9370106,773,0.3705977445469582
3419,312.350767,312.3989,1,9370523,9371967,1444,0.12039974219466734
3420,312.435167,312.450267,1,9373055,9373508,453,0.6456885045851831
3421,312.451733,312.464667,1,9373551,9373940,389,0.6875160421577731
3422,312.470167,312.4916,1,9374105,9374748,643,0.09985318340910128
3423,312.551,312.562067,1,9376530,9376862,332,0.7754505291710776
3424,312.6561,312.700267,1,9379683,9381008,1325,0.1535175781684829
3425,312.701567,312.708433,1,9381047,9381252,205,0.8195135834416469
3426,312.7304,312.775433,1,9381912,9383262,1350,0.2629509395624792
3427,312.783833,312.792733,1,9383514,9383781,267,0.3396703631609108
3428,312.7953,312.8212,1,9383859,9384636,777,0.1691049913745453
3429,312.8222,312.908567,1,9384666,9387257,2591,0.0670699009724552
3430,312.916533,312.9658,1,9387495,9388974,1479,0.10236381723969815
3431,312.97,313.0041,1,9389100,9390123,1023,0.1849612740360397
3432,313.007633,313.013833,1,9390228,9390414,186,0.3195703203649621
3433,313.822867,313.831467,1,9414686,9414944,258,-0.054272383400531025
3434,313.834,313.8847,1,9415020,9416541,1521,-0.050068586909750294
3435,313.886533,313.901733,1,9416595,9417051,456,-0.018556129298619724
3436,313.909333,313.9166,1,9417279,9417498,219,0.668749226889182
3437,313.9275,313.996933,1,9417825,9419907,2082,0.1285279246231735
3438,314.003667,314.031867,1,9420110,9420956,846,0.1481975733864168
3439,314.033267,314.037467,1,9420998,9421124,126,0.8602623071231654
3440,314.039233,314.136633,1,9421176,9424098,2922,0.16519318272830108
3441,314.668267,314.739933,1,9440048,9442197,2149,0.16206328838604084
3442,314.740933,314.817933,1,9442227,9444537,2310,0.259886011230663
3443,314.854433,314.972567,1,9445632,9449177,3545,0.12924378347955948
3444,314.973933,314.986333,1,9449217,9449589,372,0.13318598376548244
3445,315.0022,315.023,1,9450066,9450690,624,0.18417718734601043
3446,315.0248,315.030567,1,9450744,9450917,173,0.8421537708456477
3447,315.0481,315.065567,1,9451443,9451967,524,0.04916508408196486
3448,315.087133,315.104133,1,9452613,9453123,510,0.13906670011701244
3449,315.142867,315.191467,1,9454286,9455744,1458,0.21620728032954648
3450,315.1959,315.199733,1,9455877,9455991,114,0.9131812089821495
3451,315.203233,315.228,1,9456096,9456840,744,0.7419095627476423
3452,315.249667,315.2637,1,9457490,9457911,421,0.6222160398076755
3453,315.275767,315.278967,1,9458273,9458369,96,0.8701479188037871
3454,315.295267,315.345467,1,9458858,9460364,1506,0.6232634650221186
3455,315.350367,315.379867,1,9460511,9461396,885,0.2799629518212371
3456,315.384233,315.411033,1,9461526,9462330,804,0.12003763762257748
3457,315.4133,315.4164,1,9462399,9462492,93,0.7808005148169537
3458,315.422433,315.4594,1,9462672,9463782,1110,0.6197728988980348
3459,315.464733,315.494067,1,9463941,9464822,881,0.16206835219764978
3460,315.499167,315.5179,1,9464975,9465537,562,0.5034287351254203
3461,315.524767,315.543933,1,9465743,9466317,574,0.08445229109645461
3462,315.5487,315.584933,1,9466461,9467547,1086,0.23119508907788378
3463,315.5884,315.620367,1,9467652,9468611,959,0.07992879833052968
3464,315.625367,315.6379,1,9468761,9469137,376,0.12882534425766215
3465,315.646167,315.679933,1,9469385,9470397,1012,0.13183101881780565
3466,315.6814,315.718133,1,9470442,9471543,1101,0.47667732286857045
3467,315.730567,315.754733,1,9471917,9472641,724,0.30684355791517365
3468,315.755767,315.7631,1,9472673,9472893,220,0.18454186485566543
3469,315.813433,315.816567,1,9474402,9474497,95,0.6886790031840626
3470,315.830967,315.834833,1,9474929,9475044,115,0.7742995686863373
3471,315.836267,315.8761,1,9475088,9476283,1195,0.7213165313723402
3472,315.887,315.913633,1,9476610,9477408,798,0.10669577299675986
3473,315.916,315.923933,1,9477480,9477717,237,0.16306967322470697
3474,315.9908,316.000433,1,9479724,9480012,288,0.3712428328699525
3475,316.001833,316.025533,1,9480054,9480765,711,0.6761701540905083
3476,316.064433,316.077067,1,9481932,9482312,380,0.7249718217314456
3477,316.081133,316.0863,1,9482433,9482589,156,0.900573441700652
3478,316.0873,316.093467,1,9482619,9482804,185,0.8281649564930743
3479,316.423967,316.513833,1,9492719,9495414,2695,0.18902289315272783
3480,316.519367,316.534967,1,9495581,9496049,468,0.47845634826550765
3481,316.546567,316.590867,1,9496397,9497726,1329,0.05910553008110344
3482,316.598133,316.604733,1,9497943,9498141,198,0.2282747551600967
3483,316.609933,316.6477,1,9498297,9499431,1134,0.4157800831121881
3484,316.660833,316.7574,1,9499824,9502722,2898,0.16232948804861724
3485,316.7597,316.762833,1,9502791,9502884,93,0.7365659018259181
3486,316.7771,316.844633,1,9503313,9505338,2025,0.33179022946629233
3487,316.869933,316.8979,1,9506097,9506937,840,0.17180178093928322
3488,316.8993,316.927,1,9506979,9507810,831,0.1681480144268507
3489,316.9282,316.931267,1,9507846,9507938,92,0.9468765825119473
3490,316.9382,316.9784,1,9508146,9509352,1206,0.29937589635197853
3491,316.986067,317.0058,1,9509582,9510174,592,0.5940633340648792
3492,317.011333,317.034967,1,9510339,9511049,710,0.34054618943075154
3493,317.0806,317.0852,1,9512418,9512556,138,0.8502760475269863
3494,317.0941,317.1034,1,9512823,9513102,279,0.1822127190239431
3495,317.1087,317.142967,1,9513261,9514289,1028,0.31180585847056125
3496,317.144367,317.160067,1,9514331,9514802,471,0.23090100713159048
3497,317.161533,317.1764,1,9514845,9515292,447,0.30993262598590904
3498,317.179267,317.192767,1,9515378,9515783,405,0.5288213977110483
3499,317.200833,317.2138,1,9516024,9516414,390,0.70341009503225
3500,317.223933,317.262833,1,9516717,9517884,1167,0.19861491265220793
3501,317.264767,317.2743,1,9517943,9518229,286,0.32135650700127516
3502,317.2764,317.286333,1,9518292,9518589,297,0.8310150098627702
3503,317.500833,317.586267,1,9525024,9527588,2564,0.22625359385964966
3504,317.591,317.620433,1,9527730,9528612,882,0.5052143479586906
3505,317.631467,317.778333,1,9528944,9533349,4405,0.13630859128331935
3506,317.7807,317.783867,1,9533421,9533516,95,0.3600203798369142
3507,317.9124,317.916567,1,9537372,9537497,125,0.3501078738811921
3508,318.1741,318.180767,1,9545223,9545423,200,0.48949958167214824
3509,318.190933,318.199467,1,9545727,9545984,257,0.11798164472987058
3510,318.202133,318.274167,1,9546063,9548225,2162,0.22249945654556055
3511,318.280333,318.290867,1,9548409,9548726,317,0.5125510999564616
3512,318.3074,318.354367,1,9549222,9550631,1409,0.26093595121302526
3513,318.355733,318.3596,1,9550671,9550788,117,0.8557273295278802
3514,318.365133,318.375733,1,9550953,9551271,318,0.13588918510539305
3515,318.3829,318.412967,1,9551487,9552389,902,0.2194221915572968
3516,318.414767,318.515533,1,9552443,9555465,3022,0.025419502548342025
3517,318.5577,318.581367,1,9556731,9557441,710,0.09755909916106312
3518,318.5858,318.609167,1,9557574,9558275,701,-0.02384676946227942
3519,318.6415,318.646333,1,9559245,9559389,144,0.6948124659408715
3520,318.6813,318.701333,1,9560439,9561039,600,0.25238583952527466
3521,318.702567,318.777967,1,9561077,9563339,2262,-0.018539056411379942
3522,318.792033,318.8025,1,9563760,9564075,315,0.4245963207430866
3523,318.8806,318.8852,1,9566418,9566556,138,0.7365400825258255
3524,318.914,318.923867,1,9567420,9567716,296,0.8887698138128151
3525,319.403333,319.457933,1,9582099,9583737,1638,0.2870107176800057
3526,319.567367,319.5773,1,9587021,9587319,298,0.6965399845581168
3527,319.590467,319.603533,1,9587714,9588105,391,0.7993263023622713
3528,319.614167,319.627267,1,9588425,9588818,393,0.5757963866966155
3529,319.641233,319.645433,1,9589236,9589362,126,0.9776011960162864
3530,319.662967,319.669267,1,9589889,9590078,189,0.4651068677658418
3531,319.705567,319.7344,1,9591167,9592032,865,-0.021309520187589498
3532,319.7355,319.7492,1,9592065,9592476,411,0.41519060502992045
3533,319.755667,319.772267,1,9592670,9593168,498,0.0647490224521865
3534,319.7741,319.778633,1,9593223,9593358,135,0.8529167785924305
3535,319.7968,319.8117,1,9593904,9594351,447,0.16005657954616004
3536,319.813033,319.823867,1,9594390,9594716,326,0.5481709385960288
3537,319.8268,319.8405,1,9594804,9595215,411,0.5535106079112202
3538,319.8438,319.848567,1,9595314,9595457,143,0.6489784220301185
3539,319.8506,319.853733,1,9595518,9595611,93,0.9356359398736065
3540,319.861167,319.9089,1,9595835,9597267,1432,0.10494601785979804
3541,319.911067,319.930667,1,9597332,9597920,588,0.5836260827932259
3542,320.013733,320.041533,1,9600411,9601245,834,0.09576620120241656
3543,320.043333,320.0474,1,9601299,9601422,123,0.9043241685479378
3544,320.049533,320.1181,1,9601485,9603543,2058,0.1586767909494886
3545,320.121633,320.125633,1,9603648,9603768,120,0.31236075640858546
3546,320.130333,320.153067,1,9603909,9604592,683,0.21433835684009467
3547,320.168967,320.188733,1,9605069,9605661,592,-0.0882273737037334
3548,320.190333,320.196667,1,9605709,9605900,191,0.04278901977207181
3549,320.1979,320.223467,1,9605937,9606704,767,-0.01122114680286193
3550,320.230567,320.3009,1,9606917,9609027,2110,0.3186317336480997
3551,320.3021,320.313,1,9609063,9609390,327,0.7500040510371816
3552,320.3288,320.363767,1,9609864,9610913,1049,0.6550730282209916
3553,320.372167,320.4064,1,9611165,9612192,1027,0.09285581759239374
3554,320.4102,320.420533,1,9612306,9612615,309,0.20255202117928459
3555,320.422333,320.429267,1,9612669,9612878,209,0.5996262826688697
3556,320.438567,320.444433,1,9613157,9613332,175,0.1307325601612173
3557,320.4685,320.473667,1,9614055,9614210,155,0.6464388638713333
3558,320.4772,320.5226,1,9614316,9615678,1362,-0.02222067251630684
3559,320.550767,320.5849,1,9616523,9617547,1024,0.28367491569762765
3560,320.587733,320.595467,1,9617631,9617864,233,0.4541420031267014
3561,320.846133,320.849267,1,9625383,9625478,95,0.6678393100441068
3562,320.850867,320.857267,1,9625526,9625718,192,0.7800130923523513
3563,320.9283,320.934067,1,9627849,9628022,173,0.668901564479489
3564,320.936833,321.012633,1,9628104,9630378,2274,0.003386004664472753
3565,321.035133,321.051433,1,9631053,9631542,489,0.2535976237177528
3566,321.063233,321.084733,1,9631896,9632541,645,0.2627245047888363
3567,321.094867,321.168133,1,9632846,9635043,2197,0.0757339711695272
3568,321.179267,321.195,1,9635378,9635850,472,0.22642965872571327
3569,321.2184,321.224567,1,9636552,9636737,185,0.802008723993247
3570,321.229833,321.279033,1,9636894,9638370,1476,0.11478925477876785
3571,321.382467,321.482867,1,9641474,9644486,3012,0.12057245229036742
3572,321.494267,321.501033,1,9644828,9645030,202,0.17064045774593137
3573,321.509,321.5395,1,9645270,9646185,915,0.13804958532461942
3574,321.541,321.554933,1,9646230,9646647,417,0.11747537114608776
3575,321.568767,321.603333,1,9647063,9648099,1036,-0.04509916618407525
3576,321.605833,321.6413,1,9648174,9649239,1065,0.2007789258448982
3577,321.643133,321.708833,1,9649293,9651264,1971,0.18987608388442473
3578,322.094933,322.124833,1,9662847,9663744,897,0.14134909602245968
3579,322.134833,322.153433,1,9664044,9664602,558,0.028969251745869257
3580,322.171533,322.182667,1,9665145,9665480,335,0.2900706115655908
3581,322.184,322.198633,1,9665520,9665958,438,0.18817516867323456
3582,322.2005,322.233,1,9666015,9666990,975,0.19274398755579047
3583,322.244867,322.269167,1,9667346,9668075,729,0.17602395325180933
3584,322.2762,322.2861,1,9668286,9668583,297,0.30436354101232727
3585,322.2907,322.2938,1,9668721,9668814,93,0.7745321989518936
3586,322.303633,322.313,1,9669108,9669390,282,0.16421020836655403
3587,322.314267,322.3253,1,9669428,9669759,331,0.3672427263432248
3588,322.328733,322.343933,1,9669861,9670317,456,0.47631773353606227
3589,322.3478,322.360867,1,9670434,9670826,392,0.5987383838650625
3590,322.378033,322.401767,1,9671340,9672053,713,0.34512718479579096
3591,322.4054,322.4172,1,9672162,9672516,354,0.3354413445494192
3592,322.445933,322.4491,1,9673377,9673473,96,0.7352635571642014
3593,322.4571,322.470567,1,9673713,9674117,404,0.24352694008070988
3594,322.475,322.506267,1,9674250,9675188,938,0.5529025222405962
3595,322.5259,322.554767,1,9675777,9676643,866,0.25041012316994077
3596,322.601733,322.6117,1,9678051,9678351,300,0.22859147912729616
3597,322.6131,322.619233,1,9678393,9678576,183,0.823070917155011
3598,322.633467,322.646567,1,9679004,9679397,393,0.8083460433862326
3599,322.650633,322.661367,1,9679518,9679841,323,0.49823911074463173
3600,322.688933,322.7019,1,9680667,9681057,390,0.5842960302451615
3601,322.708567,322.716833,1,9681257,9681504,247,0.740976678122676
3602,323.0498,323.090567,1,9691494,9692717,1223,0.3314370508421479
3603,323.097633,323.1012,1,9692928,9693036,108,0.8279584573228485
3604,323.108567,323.154033,1,9693257,9694620,1363,0.46959515808868874
3605,323.174333,323.191967,1,9695229,9695759,530,0.6880765511714069
3606,323.250933,323.265033,1,9697527,9697950,423,0.5756509468940665
3607,323.270133,323.3374,1,9698103,9700122,2019,0.18856179389696623
3608,323.354733,323.373433,1,9700641,9701202,561,0.3776704659149742
3609,323.3978,323.503667,1,9701934,9705110,3176,0.2836354644833167
3610,323.5347,323.553633,1,9706041,9706608,567,0.3807230815923595
3611,324.009033,324.013067,1,9720270,9720392,122,0.6260179910629611
3612,324.014567,324.0816,1,9720437,9722448,2011,0.07388560661771049
3613,324.082933,324.086333,1,9722487,9722589,102,0.966382521706669
3614,324.0899,324.147567,1,9722697,9724427,1730,0.27530646212866083
3615,324.162233,324.24,1,9724866,9727200,2334,0.04205887673548237
3616,324.674533,324.735167,1,9740235,9742055,1820,0.03203893305593164
3617,324.737967,324.753933,1,9742139,9742617,478,0.14091317660330166
3618,324.756,324.7592,1,9742680,9742776,96,0.7781453225926116
3619,324.7671,324.7722,1,9743013,9743166,153,0.6757844861038037
3620,324.774033,324.782133,1,9743220,9743463,243,0.5685279006512802
3621,324.789567,324.9378,1,9743687,9748134,4447,0.13812576442230545
3622,324.9493,324.985333,1,9748479,9749559,1080,0.044173870590880765
3623,324.9889,325.0127,1,9749667,9750381,714,0.13469601193579364
3624,325.0137,325.021233,1,9750411,9750636,225,0.7102722502158662
3625,325.0411,325.0847,1,9751233,9752541,1308,0.18844493117519956
3626,325.124033,325.131267,1,9753720,9753938,218,0.8313620564969464
3627,325.141933,325.149233,1,9754257,9754476,219,0.5145328206184892
3628,325.174367,325.178033,1,9755231,9755340,109,0.834136792741697
3629,325.449,325.472633,1,9763470,9764178,708,0.1454992344901274
3630,325.5115,325.5259,1,9765345,9765777,432,0.37030312400185705
3631,325.5282,325.618433,1,9765846,9768552,2706,0.1745759751718966
3632,325.6211,325.632067,1,9768633,9768962,329,0.5868000019923764
3633,325.6527,325.666167,1,9769581,9769985,404,0.6112485674932289
3634,325.683467,325.717233,1,9770504,9771516,1012,0.2971890645727116
3635,325.727533,325.7323,1,9771825,9771969,144,0.745570862187471
3636,325.758333,325.798867,1,9772749,9773966,1217,0.16658579612789234
3637,325.8097,325.814067,1,9774291,9774422,131,0.07937608424858579
3638,325.843567,325.882333,1,9775307,9776469,1162,0.19527543908579964
3639,325.9006,325.9039,1,9777018,9777117,99,0.946749229825561
3640,325.904933,325.9285,1,9777147,9777855,708,0.20030146992387934
3641,325.932367,325.9462,1,9777971,9778386,415,0.5316864742341862
3642,326.4282,326.505433,1,9792846,9795162,2316,0.08522858413985487
3643,326.508267,326.513233,1,9795248,9795396,148,0.3349201437758387
3644,326.527933,326.544333,1,9795837,9796329,492,0.3000875902009436
3645,326.545467,326.549267,1,9796364,9796478,114,0.9545411922602725
3646,326.5572,326.5928,1,9796716,9797784,1068,0.4395906409397201
3647,326.597333,326.686967,1,9797919,9800609,2690,0.11955652275594644
3648,327.2928,327.296133,1,9818784,9818883,99,0.03692727203248764
3649,327.297567,327.302567,1,9818927,9819077,150,0.33800057686667306
3650,327.311233,327.367267,1,9819336,9821018,1682,0.1473381358273391
3651,327.368367,327.381967,1,9821051,9821459,408,0.21277237891230275
3652,327.4145,327.4195,1,9822435,9822585,150,0.8529773625876615
3653,327.457533,327.461367,1,9823725,9823841,116,0.6070892813940507
3654,327.463967,327.478633,1,9823919,9824358,439,0.6078944563109588
3655,327.482433,327.497233,1,9824472,9824916,444,0.4869119263754852
3656,327.672533,327.687933,1,9830175,9830637,462,0.16036533845830275
3657,327.709333,327.7456,1,9831279,9832368,1089,0.07291884083370233
3658,327.782933,327.795567,1,9833487,9833867,380,0.18777996327936436
3659,327.797167,327.811833,1,9833915,9834354,439,0.26106371618263474
3660,328.175533,328.1826,1,9845265,9845478,213,0.17308649919751176
3661,328.196933,328.2721,1,9845907,9848163,2256,0.11677779167830947
3662,328.277167,328.288267,1,9848315,9848648,333,0.22220714945177306
3663,328.306933,328.3166,1,9849207,9849498,291,0.8566744266065294
3664,328.3183,328.3802,1,9849549,9851406,1857,0.2759628619571138
3665,328.382733,328.402167,1,9851481,9852065,584,0.3712948780051211
3666,328.8453,328.859467,1,9865359,9865784,425,0.21514172599590464
3667,328.860833,328.865,1,9865824,9865950,126,0.9761645112613274
3668,328.8844,328.936867,1,9866532,9868106,1574,0.11553334075879342
3669,328.938033,328.943767,1,9868140,9868313,173,0.7444139768925581
3670,328.9538,328.969433,1,9868614,9869082,468,0.059383775556522335
3671,328.9778,329.064267,1,9869334,9871928,2594,0.059276330579852946
3672,329.070467,329.0741,1,9872114,9872223,109,0.9415716089768342
3673,329.0781,329.087633,1,9872343,9872628,285,0.5876522927656309
3674,329.099433,329.1357,1,9872982,9874071,1089,0.1973299977395706
3675,329.1615,329.2152,1,9874845,9876456,1611,0.5734914596587254
3676,329.2167,329.242467,1,9876501,9877274,773,-0.017471065534178085
3677,329.251367,329.261867,1,9877541,9877856,315,-0.05392406957471251
3678,329.264567,329.3175,1,9877937,9879525,1588,0.3777192152607756
3679,329.3248,329.345567,1,9879744,9880367,623,0.17343401116707147
3680,329.356233,329.365233,1,9880686,9880956,270,0.04165305978053868
3681,329.372033,329.3835,1,9881160,9881505,345,0.07722973493827466
3682,329.3895,329.3934,1,9881685,9881802,117,0.7730183034881644
3683,329.396667,329.410733,1,9881900,9882321,421,0.3856258297427841
3684,329.412467,329.479033,1,9882374,9884370,1996,0.05917978336463908
3685,329.5039,329.515633,1,9885117,9885468,351,0.1376208892547326
3686,329.516967,329.631467,1,9885509,9888944,3435,0.19270464127442904
3687,329.633633,329.708233,1,9889008,9891246,2238,0.30677163486364273
3688,329.716867,329.756433,1,9891506,9892692,1186,0.2686088288440022
3689,329.793,329.813833,1,9893790,9894414,624,0.15349516464803703
3690,329.8183,329.8585,1,9894549,9895755,1206,0.309457788911765
3691,329.863167,329.913267,1,9895895,9897398,1503,-0.05088313274026003
3692,329.9751,329.9781,1,9899253,9899343,90,0.8278200483368148
3693,329.982133,330.0248,1,9899463,9900744,1281,0.7249005673481875
3694,330.029933,330.061467,1,9900897,9901844,947,0.23862618267619226
3695,330.070133,330.078,1,9902103,9902340,237,0.46265323704988465
3696,330.360433,330.367433,1,9910812,9911022,210,0.7466356845562119
3697,330.3841,330.389367,1,9911523,9911681,158,0.2936845256613896
3698,330.394833,330.434967,1,9911844,9913049,1205,0.034476869909437276
3699,330.4361,330.4463,1,9913083,9913389,306,0.6892760579138266
3700,330.4509,330.469867,1,9913527,9914096,569,0.20687438705209388
3701,330.479167,330.566833,1,9914375,9917004,2629,0.12772644296238275
3702,330.570833,330.575433,1,9917124,9917262,138,0.7677463987400857
3703,330.5857,330.59,1,9917571,9917700,129,0.33471588005172
3704,330.6709,330.6742,1,9920127,9920226,99,0.7829711473948127
3705,330.699233,330.7237,1,9920976,9921711,735,0.3388954806430005
3706,330.7313,330.735933,1,9921939,9922077,138,0.5198355790008886
3707,330.7618,330.7855,1,9922854,9923565,711,-0.02656524792401313
3708,330.802133,330.806067,1,9924063,9924182,119,0.784674663961598
3709,330.814433,330.835633,1,9924432,9925068,636,0.11122199220799155
3710,330.847967,330.8703,1,9925439,9926109,670,0.21925630628301163
3711,330.875267,330.883833,1,9926258,9926514,256,0.3119220249501574
3712,330.932667,330.951433,1,9927980,9928542,562,0.3142084614525661
3713,330.9644,330.9866,1,9928932,9929598,666,0.32128897759373437
3714,331.0042,331.024,1,9930126,9930720,594,-0.029172720512752614
3715,331.0308,331.047367,1,9930924,9931421,497,0.06672161712957585
3716,331.058467,331.062133,1,9931754,9931863,109,0.7059085501854869
3717,331.084633,331.102433,1,9932538,9933072,534,0.06653785019720035
3718,331.118933,331.1222,1,9933567,9933666,99,0.8698093826690358
3719,331.153,331.1568,1,9934590,9934704,114,0.6402737371934119
3720,331.184367,331.195367,1,9935531,9935861,330,0.4361303801433432
3721,331.196767,331.205167,1,9935903,9936155,252,-0.04114275536543606
3722,331.208767,331.293067,1,9936263,9938792,2529,0.1906877719277819
3723,331.310633,331.320233,1,9939318,9939606,288,0.35304124145389143
3724,331.3238,331.3546,1,9939714,9940638,924,0.1557988913910445
3725,331.368633,331.433667,1,9941058,9943010,1952,0.0940560779535329
3726,331.435,331.4513,1,9943050,9943539,489,0.3516395800072933
3727,331.4594,331.462933,1,9943782,9943887,105,0.7023181274619359
3728,331.475267,331.478433,1,9944258,9944352,94,0.6637637301099061
3729,331.4876,331.494433,1,9944628,9944832,204,0.7759960167028052
3730,331.522433,331.527267,1,9945672,9945818,146,0.8935064644631452
3731,331.529133,331.535733,1,9945873,9946071,198,0.5909098400646847
3732,331.540433,331.552733,1,9946212,9946581,369,0.4303318065711109
3733,331.608267,331.6545,1,9948248,9949635,1387,0.0921910411260111
3734,331.681133,331.6844,1,9950433,9950532,99,0.23671287459803653
3735,331.723533,331.7343,1,9951705,9952029,324,-0.01921714848376757
3736,331.738933,331.7495,1,9952167,9952485,318,0.5769345586620149
3737,331.7517,331.762933,1,9952551,9952887,336,0.6326972742586169
3738,332.484933,332.5738,1,9974547,9977214,2667,-0.047369590379187476
3739,332.578367,332.850533,1,9977351,9985515,8164,0.06725662721228014
3740,332.872,332.878867,1,9986160,9986366,206,0.4065268645220236
3741,332.882867,332.8907,1,9986486,9986721,235,0.7516273242130243
3742,332.902733,332.9077,1,9987081,9987231,150,0.44988791120209504
3743,333.4103,333.428033,1,10002309,10002840,531,0.15503256848631922
3744,333.4331,333.492467,1,10002993,10004774,1781,0.08994730415836447
3745,333.4969,333.500367,1,10004907,10005011,104,0.9600170716779005
3746,333.501933,333.505233,1,10005057,10005156,99,0.49931717184297186
3747,333.508967,333.515767,1,10005269,10005473,204,0.8384060902183493
3748,333.524233,333.566567,1,10005726,10006997,1271,0.197968320497945
3749,333.5802,333.659633,1,10007406,10009788,2382,0.036809700056021154
3750,333.663733,333.6814,1,10009911,10010442,531,0.22271230632882216
3751,333.701633,333.7324,1,10011048,10011972,924,0.042883391317566105
3752,333.749067,333.7605,1,10012472,10012815,343,0.29069669195148196
3753,333.7647,333.770767,1,10012941,10013123,182,0.9268787827318576
3754,333.802033,333.815467,1,10014060,10014464,404,-0.012130265167252376
3755,333.869767,333.8823,1,10016093,10016469,376,0.4877829311572503
3756,333.8866,333.916167,1,10016598,10017485,887,0.55924907164825
3757,333.9414,333.946033,1,10018242,10018380,138,0.8703831020358666
3758,333.978467,333.9872,1,10019354,10019616,262,0.6724709868382434
3759,334.0729,334.0782,1,10022187,10022346,159,0.2991729683251767
3760,334.487233,334.566,1,10034616,10036980,2364,0.13624853741293552
3761,334.5683,334.577867,1,10037049,10037336,287,0.8089768752239314
3762,334.585533,334.6329,1,10037565,10038987,1422,0.2228663197273082
3763,334.633933,334.6377,1,10039017,10039131,114,0.9467477882040979
3764,334.655467,334.706467,1,10039664,10041194,1530,0.18397742822948682
3765,334.714033,334.765867,1,10041420,10042976,1556,0.13067707315361834
3766,334.782733,334.907567,1,10043481,10047227,3746,0.08916138167417605
3767,334.936267,334.9401,1,10048088,10048203,115,0.6773532438356306
3768,334.958133,334.971867,1,10048743,10049156,413,0.40460227808207133
3769,334.9775,334.980967,1,10049325,10049429,104,0.9470818482245786
3770,335.006133,335.031567,1,10050183,10050947,764,0.22910007257104437
3771,335.042567,335.049467,1,10051277,10051484,207,0.09163813775114055
3772,335.1002,335.1828,1,10053006,10055484,2478,0.09613133736469145
3773,335.1925,335.235533,1,10055775,10057065,1290,0.3239798618046696
3774,335.241733,335.313233,1,10057251,10059396,2145,0.10378339519224818
3775,335.3185,335.3942,1,10059555,10061826,2271,0.18887629929712493
3776,335.463533,335.468033,1,10063905,10064040,135,0.8041945120009265
3777,335.710067,335.763333,1,10071302,10072899,1597,0.0962534243562057
3778,335.765933,335.769767,1,10072977,10073093,116,0.6965872099142411
3779,335.7743,335.7891,1,10073229,10073673,444,0.30929311108717666
3780,335.7957,335.805433,1,10073871,10074162,291,0.04001553305426805
3781,335.8099,335.971133,1,10074297,10079133,4836,0.24083327515887967
3782,335.986667,336.033033,1,10079600,10080990,1390,0.22563993263464183
3783,336.048167,336.101533,1,10081445,10083045,1600,0.16884362919022475
3784,336.1291,336.1744,1,10083873,10085232,1359,0.3558139821004058
3785,336.1831,336.1917,1,10085493,10085751,258,0.9262452948407136
3786,336.201767,336.2104,1,10086053,10086312,259,0.7266109744834292
3787,336.637833,336.652567,1,10099134,10099577,443,0.6321768589139872
3788,336.6603,336.734267,1,10099809,10102028,2219,0.20826330029029358
3789,336.7359,336.740167,1,10102077,10102205,128,0.7377180696480804
3790,336.7487,336.766233,1,10102461,10102986,525,0.47244634767353316
3791,336.7676,336.772633,1,10103028,10103178,150,0.8092896125952393
3792,336.7745,336.794833,1,10103235,10103844,609,0.23306330202742923
3793,336.816367,336.849033,1,10104491,10105470,979,0.19622131569797843
3794,336.850267,336.861533,1,10105508,10105845,337,0.3960930946396462
3795,336.869367,336.953433,1,10106081,10108602,2521,0.14868294764986628
3796,336.979033,336.983367,1,10109370,10109501,131,0.4963797041208236
3797,336.9871,337.046733,1,10109613,10111401,1788,0.17016820611863362
3798,337.0521,337.092833,1,10111563,10112784,1221,0.1934307847734492
3799,337.157633,337.214867,1,10114728,10116446,1718,0.13165728936494095
3800,337.242133,337.251467,1,10117263,10117544,281,0.4341683766020185
3801,337.267767,337.399467,1,10118033,10121984,3951,0.06663307971606773
3802,337.464733,337.490567,1,10123941,10124717,776,0.23970771890414003
3803,337.5018,337.529867,1,10125054,10125896,842,0.2924578535923885
3804,337.5365,337.554233,1,10126095,10126626,531,0.128123346830947
3805,337.587167,337.605867,1,10127615,10128176,561,0.17374726896006018
3806,337.6072,337.613167,1,10128216,10128395,179,-0.05545634298828252
3807,337.622967,337.630967,1,10128689,10128929,240,0.07078958095355906
3808,337.632,337.636,1,10128960,10129080,120,0.9155253906836287
3809,337.6371,337.641133,1,10129113,10129233,120,0.8682677466534365
3810,337.690833,337.7241,1,10130724,10131723,999,0.07235011823459214
3811,337.735733,337.8292,1,10132071,10134876,2805,0.15602312977640487
3812,337.847267,337.8611,1,10135418,10135833,415,0.25362088349890977
3813,337.8621,337.880767,1,10135863,10136423,560,-0.032243400989359676
3814,337.904233,337.9177,1,10137126,10137531,405,0.6250044427710593
3815,337.929433,338.0164,1,10137882,10140492,2610,0.12926785488052253
3816,338.018667,338.026567,1,10140560,10140797,237,0.5482043408507243
3817,338.031967,338.036133,1,10140959,10141083,124,0.9014574278233353
3818,338.037167,338.0708,1,10141115,10142124,1009,0.7669147118179563
3819,338.0718,338.106,1,10142154,10143180,1026,0.0884511620424592
3820,338.131267,338.1527,1,10143938,10144581,643,0.1011019614302923
3821,338.154067,338.157133,1,10144622,10144713,91,0.9470870289332745
3822,338.1607,338.1844,1,10144821,10145532,711,0.1390969421057047
3823,338.191967,338.216167,1,10145759,10146485,726,0.26563120171367877
3824,338.217833,338.245133,1,10146534,10147353,819,0.21970061698953974
3825,338.2642,338.269167,1,10147926,10148075,149,0.6951892636652887
3826,338.403933,338.438433,1,10152117,10153152,1035,0.4258177898713623
3827,338.445567,338.466933,1,10153367,10154007,640,0.5012060556155429
3828,338.474267,338.480033,1,10154228,10154400,172,0.5573563036433863
3829,338.489033,338.4929,1,10154670,10154787,117,0.46985668026720384
3830,338.5261,338.5305,1,10155783,10155915,132,0.7601300654267953
3831,338.534433,338.5731,1,10156032,10157193,1161,0.6711546599037923
3832,338.5849,338.604133,1,10157547,10158123,576,0.4528474559414847
3833,338.626633,338.630367,1,10158798,10158911,113,0.850452072894368
3834,338.661567,338.664933,1,10159847,10159947,100,0.0010194272335579814
3835,338.710267,338.715667,1,10161308,10161470,162,0.5193662169100012
3836,338.718,338.7603,1,10161540,10162809,1269,0.1677408944325225
3837,338.761367,338.809133,1,10162841,10164273,1432,0.12582783019804025
3838,338.816033,338.825267,1,10164480,10164758,278,0.32853240052242305
3839,338.8292,338.8334,1,10164876,10165002,126,0.37529628613759686
3840,338.910267,338.932167,1,10167308,10167965,657,0.8543956355655076
3841,338.9349,338.9586,1,10168047,10168758,711,0.5848878445115964
3842,338.9763,338.9927,1,10169289,10169781,492,0.8270041733502089
3843,339.1012,339.104867,1,10173036,10173146,110,-0.17892715663390887
3844,339.282233,339.286933,1,10178466,10178607,141,0.19146103243964752
3845,339.298333,339.3122,1,10178949,10179366,417,0.3900763186680347
3846,339.314833,339.319567,1,10179444,10179587,143,0.3072811572923891
3847,339.339333,339.343667,1,10180179,10180310,131,0.8999553241356718
3848,339.365133,339.3769,1,10180953,10181307,354,0.08055138861301073
3849,339.418867,339.422533,1,10182566,10182675,109,0.5725470152315181
3850,339.427233,339.462,1,10182816,10183860,1044,0.48974816621469114
3851,339.4951,339.499133,1,10184853,10184973,120,0.5316759172038242
3852,339.522033,339.532267,1,10185660,10185968,308,0.10326917302529853
3853,339.575367,339.5817,1,10187261,10187451,190,0.14170123572480167
3854,339.595567,339.615,1,10187867,10188450,583,0.4431459510238846
3855,339.616267,339.621433,1,10188488,10188642,154,0.6154186286523107
3856,339.623867,339.635333,1,10188716,10189059,343,0.6490596683788896
3857,339.7195,339.727567,1,10191585,10191827,242,0.3351822863108029
3858,339.7572,339.777,1,10192716,10193310,594,0.7205071003397108
3859,339.782,339.7866,1,10193460,10193598,138,0.31104964625138753
3860,339.789967,339.7968,1,10193699,10193904,205,0.8228549250134982
3861,339.865633,339.875333,1,10195968,10196259,291,0.12314674786403733
3862,339.9,339.9034,1,10197000,10197102,102,0.5387621964125233
3863,339.9138,339.9525,1,10197414,10198575,1161,0.7530586915040876
3864,339.9854,340.009,1,10199562,10200270,708,0.21096291485291463
3865,340.019333,340.0312,1,10200579,10200936,357,0.3797928926544375
3866,340.032233,340.041333,1,10200966,10201239,273,0.6848667340167505
3867,340.080867,340.086233,1,10202426,10202586,160,0.831931883728998
3868,340.0885,340.097433,1,10202655,10202922,267,0.8609304034231345
3869,340.1038,340.112933,1,10203114,10203387,273,0.5307644925280662
3870,340.119,340.1266,1,10203570,10203798,228,0.9074843998327513
3871,340.140367,340.166067,1,10204211,10204982,771,0.2675749532232135
3872,340.169067,340.173933,1,10205072,10205217,145,0.5481985638992863
3873,340.203333,340.217133,1,10206099,10206513,414,0.07650924030375758
3874,340.218367,340.238467,1,10206551,10207154,603,0.26485575551162327
3875,340.2688,340.310133,1,10208064,10209303,1239,0.2946415666430915
3876,340.332167,340.368533,1,10209965,10211055,1090,0.27969350056932446
3877,340.4336,340.436933,1,10213008,10213107,99,0.2650901910638993
3878,341.059367,341.126433,1,10231781,10233792,2011,-0.12475891887153916
3879,341.1291,341.154233,1,10233873,10234626,753,0.23454880161523056
3880,341.159733,341.168733,1,10234791,10235061,270,0.19432342429629798
3881,341.1699,341.188167,1,10235097,10235645,548,0.3095921055814047
3882,341.192467,341.227033,1,10235774,10236810,1036,0.04939237211916301
3883,341.230267,341.276067,1,10236908,10238282,1374,0.11206306505877539
3884,341.280767,341.2876,1,10238423,10238628,205,0.7461369381102925
3885,341.288633,341.3526,1,10238658,10240578,1920,0.20737231162497408
3886,341.353967,341.375333,1,10240619,10241259,640,0.7092432455271941
3887,341.406767,341.413867,1,10242203,10242416,213,0.4812774238317105
3888,341.421433,341.431933,1,10242642,10242957,315,0.08982169112446754
3889,341.440733,341.443867,1,10243221,10243316,95,0.7087636989204592
3890,341.4515,341.474167,1,10243545,10244225,680,0.23287625524528094
3891,341.477233,341.492267,1,10244316,10244768,452,0.1270764266978285
3892,341.508433,341.537867,1,10245252,10246136,884,0.4007655721052227
3893,342.390733,342.399867,1,10271721,10271996,275,0.18850706227595432
3894,342.414933,342.5184,1,10272447,10275552,3105,0.14190387053541573
3895,342.5233,342.5332,1,10275699,10275996,297,0.6566599498533039
3896,342.537,342.5736,1,10276110,10277208,1098,0.1410159950044611
3897,342.583233,342.588833,1,10277496,10277664,168,0.47705915696787143
3898,342.592833,342.5979,1,10277784,10277937,153,0.6439470813168255
3899,342.615633,342.7265,1,10278468,10281795,3327,0.13487257945384
3900,342.767833,342.8067,1,10283034,10284201,1167,0.09697958201037658
3901,342.8081,342.811567,1,10284243,10284347,104,0.8016376844978245
3902,342.8313,342.8677,1,10284939,10286031,1092,-0.02483195528927609
3903,342.870233,342.886233,1,10286106,10286586,480,0.388293974536736
3904,343.051,343.1205,1,10291530,10293615,2085,0.0005437821880052623
3905,343.137067,343.149067,1,10294112,10294472,360,0.2574290301302823
3906,343.150233,343.1821,1,10294506,10295463,957,0.09750055409182422
3907,343.183633,343.193833,1,10295508,10295814,306,0.20573108343814278
3908,343.196933,343.216167,1,10295907,10296485,578,0.28262055704339445
3909,343.220833,343.286,1,10296624,10298580,1956,0.08585633875859197
3910,343.292567,343.304033,1,10298777,10299120,343,0.29562036272979414
3911,343.7562,343.760167,1,10312686,10312805,119,0.5776582253046427
3912,343.7828,343.787733,1,10313484,10313631,147,0.6164941386040597
3913,343.826267,343.867567,1,10314788,10316027,1239,0.35457192076170874
3914,343.870767,343.873833,1,10316123,10316214,91,0.37378831198612483
3915,343.960367,344.040467,1,10318811,10321214,2403,0.1627752969797154
3916,344.0415,344.090667,1,10321245,10322720,1475,0.23726995229692469
3917,344.092767,344.1641,1,10322783,10324923,2140,0.24284315889716968
3918,344.1748,344.211533,1,10325244,10326345,1101,0.3113470931473193
3919,344.212833,344.246733,1,10326384,10327401,1017,0.21927430734105258
3920,344.254333,344.3213,1,10327629,10329639,2010,0.11457143664186092
3921,344.3313,344.363133,1,10329939,10330893,954,0.06958064770923023
3922,344.3774,344.4,1,10331322,10332000,678,0.08044374503465002
3923,344.440267,344.456967,1,10333208,10333709,501,0.16535636657291403
3924,344.4598,344.477033,1,10333794,10334310,516,0.21012637297838796
3925,344.532667,344.5855,1,10335980,10337565,1585,0.2511093968422292
3926,344.587733,344.634233,1,10337631,10339026,1395,0.11485933988487487
3927,344.655467,344.661533,1,10339664,10339845,181,0.07183916883211305
3928,344.662533,344.668633,1,10339875,10340058,183,0.8864901017154505
3929,344.6724,344.718733,1,10340172,10341561,1389,0.18781045856110146
3930,344.7199,344.741933,1,10341597,10342257,660,0.4780132758299227
3931,344.7462,344.7818,1,10342386,10343454,1068,0.18976816970034927
3932,344.818333,344.826467,1,10344549,10344794,245,0.10885223412137375
3933,344.831633,344.838633,1,10344948,10345158,210,0.6436573571729822
3934,344.849367,344.9486,1,10345481,10348458,2977,0.1588354011790353
3935,344.963833,345.0338,1,10348914,10351014,2100,0.13430526252091377
3936,345.039833,345.056133,1,10351194,10351683,489,0.4595441657082185
3937,345.0577,345.081233,1,10351731,10352436,705,0.24596940993359698
3938,345.1018,345.138067,1,10353054,10354142,1088,0.15095745001264677
3939,345.1486,345.172767,1,10354458,10355183,725,0.07234517030602917
3940,345.174133,345.177133,1,10355223,10355313,90,0.5174654648347525
3941,345.189067,345.2091,1,10355672,10356273,601,0.07610171046672876
3942,345.3181,345.3213,1,10359543,10359639,96,0.7851668982317275
3943,345.366767,345.3797,1,10361003,10361391,388,0.5616643533005475
3944,345.3808,345.384867,1,10361424,10361546,122,0.4212829497245632
3945,345.387167,345.391767,1,10361615,10361753,138,0.47764395229611833
3946,345.393733,345.4301,1,10361811,10362903,1092,0.2473698541286462
3947,345.444033,345.4619,1,10363320,10363857,537,0.4051934990196028
3948,345.573333,345.580133,1,10367199,10367403,204,0.8772727677218677
3949,345.6281,345.643567,1,10368843,10369307,464,0.6725396519819861
3950,345.779867,345.783367,1,10373396,10373501,105,0.49423365909588335
3951,345.8207,345.882167,1,10374621,10376465,1844,0.1791588788588396
3952,345.885067,345.9006,1,10376552,10377018,466,0.3415893266964393
3953,345.902133,345.918467,1,10377063,10377554,491,0.5101986619374543
3954,345.920267,345.9859,1,10377608,10379577,1969,0.2554542204709609
3955,345.9875,346.089667,1,10379625,10382690,3065,0.1569833808183749
3956,346.136067,346.141767,1,10384082,10384253,171,0.6319259776272889
3957,346.149533,346.153067,1,10384485,10384592,107,0.7651507726361875
3958,346.157833,346.168767,1,10384734,10385063,329,0.5359007185695982
3959,346.193,346.225633,1,10385790,10386768,978,0.45364738471687677
3960,346.663167,346.744233,1,10399895,10402326,2431,0.14708595034138977
3961,346.748,346.7556,1,10402440,10402668,228,0.4900835586975633
3962,346.7612,346.796933,1,10402836,10403907,1071,0.30297160810893226
3963,346.801533,346.8442,1,10404045,10405326,1281,0.19152020010334558
3964,346.845567,346.873333,1,10405367,10406199,832,0.2506688340044053
3965,346.882067,346.976133,1,10406462,10409283,2821,0.20731960460116905
3966,347.770033,347.855433,1,10433100,10435662,2562,0.23630330395751975
3967,347.859633,348.0651,1,10435788,10441953,6165,0.17681809976001464
3968,349.1241,349.176533,1,10473723,10475295,1572,0.07107792675820253
3969,349.178133,349.269267,1,10475343,10478078,2735,0.23350817808633387
3970,349.282033,349.3685,1,10478460,10481055,2595,0.24976400800917667
3971,350.099667,350.178733,1,10502990,10505361,2371,0.08940949166857504
3972,350.179733,350.247833,1,10505391,10507434,2043,0.23703162541484277
3973,350.2649,350.268367,1,10507947,10508051,104,0.6951106427238154
3974,350.270533,350.387167,1,10508115,10511615,3500,0.09996959458396507
3975,350.3882,350.398667,1,10511646,10511960,314,0.35712224408186466
3976,350.4169,350.4397,1,10512507,10513191,684,0.021434486034364986
3977,350.463733,350.486633,1,10513911,10514598,687,0.0522530134068675
3978,350.498533,350.544633,1,10514955,10516338,1383,0.14415194472297638
3979,350.579533,350.593,1,10517385,10517790,405,0.4879927721690927
3980,350.5942,350.606767,1,10517826,10518203,377,0.9115643630167142
3981,350.6152,350.6199,1,10518456,10518597,141,0.8564813003085658
3982,350.621567,350.624767,1,10518647,10518743,96,0.9785985964408739
3983,350.6263,350.651067,1,10518789,10519532,743,0.495932696542916
3984,350.659967,350.667567,1,10519799,10520027,228,-0.011502928428149515
3985,350.713567,350.7173,1,10521407,10521519,112,0.8411744952145818
3986,350.724633,350.728867,1,10521738,10521866,128,0.8292909101031376
3987,350.7662,350.786967,1,10522986,10523609,623,0.2756222692562413
3988,350.797833,350.803433,1,10523934,10524102,168,0.21979974920238013
3989,351.3484,351.4764,1,10540452,10544292,3840,0.22245143594368838
3990,351.477433,351.481467,1,10544322,10544444,122,0.6970419629074577
3991,351.4864,351.606467,1,10544592,10548194,3602,0.05102243012406316
3992,351.637567,351.644467,1,10549127,10549334,207,0.08201365759698984
3993,351.664067,351.667133,1,10549922,10550013,91,0.42671438883730534
3994,352.169533,352.284233,1,10565085,10568526,3441,0.1571706605425699
3995,352.2859,352.3562,1,10568577,10570686,2109,0.13558087688828568
3996,352.371833,352.5224,1,10571154,10575672,4518,0.23952761404973916
3997,352.532667,352.5987,1,10575980,10577961,1981,0.09273331349088115
3998,352.617967,352.6238,1,10578539,10578714,175,0.961967945720898
3999,352.670867,352.674733,1,10580126,10580241,115,0.8081366188932476
4000,352.682933,352.6958,1,10580487,10580874,387,0.4225305861696746
4001,352.701967,352.7095,1,10581059,10581285,226,0.8237220699121559
4002,352.711767,352.717033,1,10581353,10581510,157,0.38188588398854756
4003,353.517333,353.6382,1,10605519,10609146,3627,0.14967517971990268
4004,353.64,353.6544,1,10609200,10609632,432,0.26767013483849716
4005,353.657467,353.674333,1,10609724,10610229,505,0.24530247553009396
4006,353.6766,353.680233,1,10610298,10610406,108,0.6717907173935094
4007,353.683667,353.686967,1,10610510,10610609,99,0.9111814189208336
4008,353.703267,353.808233,1,10611098,10614246,3148,0.15656338418667046
4009,353.838767,353.848533,1,10615163,10615455,292,0.4997649538781294
4010,353.8516,353.859633,1,10615548,10615788,240,0.5432808490867345
4011,353.861033,353.867233,1,10615830,10616016,186,0.7755572365005042
4012,353.9022,353.935167,1,10617066,10618055,989,0.2870467200084215
4013,353.938133,353.943667,1,10618143,10618310,167,0.4425672234730249
4014,353.980533,354.008767,1,10619415,10620263,848,0.1473713470475593
4015,354.040133,354.0482,1,10621203,10621446,243,0.6798153560551776
4016,354.062333,354.068633,1,10621869,10622058,189,0.4975541467788227
4017,354.085267,354.0885,1,10622558,10622655,97,0.6915184696319716
4018,354.3074,354.389067,1,10629222,10631672,2450,0.10858269995519035
4019,354.3907,354.4061,1,10631721,10632183,462,0.2920312509383428
4020,354.4074,354.429367,1,10632222,10632881,659,0.15769683707063423
4021,354.432767,354.457733,1,10632983,10633731,748,0.33884501635370406
4022,354.464,354.512033,1,10633920,10635360,1440,0.16387216310267905
4023,354.514933,354.5202,1,10635447,10635606,159,0.9560164646570235
4024,354.526433,354.5393,1,10635792,10636179,387,0.34132530630604063
4025,354.5427,354.570767,1,10636281,10637123,842,0.2148586361202767
4026,354.572533,354.656433,1,10637175,10639692,2517,0.22263725809647542
4027,354.686733,354.690467,1,10640601,10640714,113,0.7092035182433973
4028,354.713967,354.717567,1,10641419,10641527,108,0.7767452447150842
4029,355.779967,356.0014,1,10673399,10680042,6643,0.1517582197187192
4030,356.006667,356.094567,1,10680200,10682837,2637,0.16275097767310986
4031,356.103133,356.124,1,10683093,10683720,627,0.20849152619526476
4032,356.1535,356.158167,1,10684605,10684745,140,0.7668672420865371
4033,356.171233,356.178567,1,10685136,10685357,221,0.6247694301920813
4034,356.180033,356.188933,1,10685400,10685667,267,0.5717150904053181
4035,356.216667,356.219867,1,10686500,10686596,96,0.5279475653821271
4036,356.223567,356.243833,1,10686707,10687314,607,0.6861262716615668
4037,356.2723,356.276867,1,10688169,10688306,137,0.8358310462878447
4038,356.281767,356.285767,1,10688453,10688573,120,0.49323508096746205
4039,356.3293,356.387,1,10689879,10691610,1731,0.2534730317615671
4040,356.3912,356.411,1,10691736,10692330,594,0.29633058206164065
4041,356.4135,356.4194,1,10692405,10692582,177,0.20877638085502423
4042,356.449533,356.567133,1,10693485,10697013,3528,0.1856504550966191
4043,356.5805,356.6143,1,10697415,10698429,1014,-0.022510467592471706
4044,356.615433,356.619033,1,10698462,10698570,108,0.6762584586131781
4045,356.6265,356.648833,1,10698795,10699464,669,0.11217654646323075
4046,356.6605,356.692533,1,10699815,10700775,960,0.06754744932413398
4047,356.730933,356.741933,1,10701927,10702257,330,0.30676526705865403
4048,356.746167,356.7585,1,10702385,10702755,370,0.8524190763205248
4049,356.7595,356.7625,1,10702785,10702875,90,0.8946813329525488
4050,356.7782,356.7951,1,10703346,10703853,507,0.6514290036896879
4051,356.939867,357.005,1,10708196,10710150,1954,-0.07309294350850402
4052,357.0068,357.021933,1,10710204,10710657,453,-0.06891829188051303
4053,357.024733,357.031533,1,10710741,10710945,204,0.22224757943760778
4054,357.0454,357.050567,1,10711362,10711517,155,0.28294402573840305
4055,357.066233,357.1505,1,10711986,10714515,2529,0.1186027365869264
4056,357.155533,357.1684,1,10714665,10715052,387,0.7480759795616473
4057,357.1711,357.176867,1,10715133,10715306,173,0.9384718787354411
4058,357.6,357.6046,1,10728000,10728138,138,0.39677431986461087
4059,357.6096,357.683433,1,10728288,10730502,2214,0.19723058145193975
4060,357.689933,357.7075,1,10730697,10731225,528,0.2349737636339634
4061,357.727833,357.8065,1,10731834,10734195,2361,0.23827921498384755
4062,357.810133,357.8144,1,10734303,10734432,129,0.8541102636464682
4063,357.815633,357.8812,1,10734468,10736436,1968,0.2738816312700738
4064,357.908167,357.92,1,10737245,10737600,355,0.7969578552867893
4065,357.921033,357.945467,1,10737630,10738364,734,0.7860458564912328
4066,357.954633,357.975867,1,10738638,10739276,638,0.29232772597283824
4067,357.985167,357.996533,1,10739555,10739895,340,0.6674862744120634
4068,358.019967,358.0241,1,10740599,10740723,124,0.226671078349662
4069,358.0436,358.084467,1,10741308,10742534,1226,0.4209983245397189
4070,358.0869,358.090967,1,10742607,10742729,122,0.7117438458785733
4071,358.098267,358.1271,1,10742948,10743813,865,0.2537367936146384
4072,358.1437,358.147233,1,10744311,10744416,105,0.9141900140276887
4073,358.161,358.1648,1,10744830,10744944,114,0.8692861238273835
4074,358.2176,358.238133,1,10746528,10747143,615,0.42711032370205804
4075,358.285567,358.295633,1,10748567,10748868,301,0.8304406865334432
4076,358.296633,358.3074,1,10748898,10749222,324,0.8751591137549443
4077,358.3087,358.311733,1,10749261,10749351,90,0.9118851969035542
4078,358.347067,358.350433,1,10750412,10750512,100,0.9270061402988313
4079,358.351567,358.357133,1,10750547,10750713,166,0.7696258873132158
4080,358.3726,358.3778,1,10751178,10751334,156,0.623121650399424
4081,358.382433,358.389033,1,10751472,10751670,198,0.8682408922073777
4082,358.3907,358.4146,1,10751721,10752438,717,0.7934757115036066
4083,358.416533,358.421,1,10752495,10752630,135,0.6692715721977507
4084,358.426333,358.455267,1,10752789,10753658,869,0.223764893181259
4085,358.458567,358.467067,1,10753757,10754012,255,0.6076469846895955
4086,358.531667,358.577833,1,10755950,10757334,1384,0.42057789938121054
4087,358.595,358.620867,1,10757850,10758626,776,0.24174092944594128
4088,358.669167,358.6927,1,10760075,10760781,706,0.21502627953870573
4089,358.697367,358.7367,1,10760921,10762101,1180,0.1692002292202534
4090,358.7447,358.7724,1,10762341,10763172,831,0.3436903046105176
4091,358.810133,358.813467,1,10764303,10764404,101,0.6666053424233912
4092,358.814933,358.8359,1,10764447,10765077,630,0.24567641886556518
4093,358.842033,358.8491,1,10765260,10765473,213,0.5728366317796092
4094,358.853633,358.892,1,10765608,10766760,1152,0.7468581785631196
4095,358.9022,358.930833,1,10767066,10767924,858,0.41879782356904616
4096,359.0235,359.033733,1,10770705,10771011,306,0.6719361256798814
4097,359.034867,359.049633,1,10771046,10771488,442,0.7546691890988619
4098,359.052733,359.060333,1,10771581,10771809,228,0.8295657716617013
4099,359.066967,359.078667,1,10772009,10772360,351,0.8534714547994368
4100,359.094267,359.114733,1,10772828,10773441,613,0.37738204292451843
4101,359.260133,359.265633,1,10777803,10777968,165,0.9695085512355882
4102,359.275033,359.296433,1,10778250,10778892,642,0.7042846328430922
4103,359.299567,359.3059,1,10778987,10779177,190,0.8492949455760711
4104,359.3195,359.3312,1,10779585,10779936,351,0.5548422782372584
4105,359.3824,359.3854,1,10781472,10781562,90,0.8383938660444284
4106,359.4006,359.4344,1,10782018,10783032,1014,0.19482142676397304
4107,359.435467,359.452033,1,10783064,10783560,496,0.7245574431264605
4108,359.4576,359.503167,1,10783728,10785095,1367,0.09719180391787405
4109,359.508333,359.5355,1,10785249,10786065,816,0.11487082753358488
4110,359.6085,359.6927,1,10788255,10790781,2526,0.12761160849131684
4111,359.706933,359.7576,1,10791207,10792728,1521,0.03311858861179763
4112,359.7661,359.814267,1,10792983,10794428,1445,0.20410871473811573
4113,359.8179,359.896167,1,10794537,10796885,2348,0.10346029758870083
4114,359.8984,359.912267,1,10796952,10797368,416,0.2216701273790202
4115,359.9245,359.929367,1,10797735,10797881,146,0.8698761077973421
4116,359.9609,359.972433,1,10798827,10799172,345,0.7221403560214935
4117,359.990133,360.003633,1,10799703,10800108,405,0.28871459608702765
4118,360.029233,360.049233,1,10800876,10801476,600,0.3350061233561798
4119,360.112467,360.116433,1,10803374,10803492,118,0.7909717392688944
4120,360.184533,360.231767,1,10805535,10806953,1418,0.24877455261917494
4121,360.242867,360.248267,1,10807286,10807448,162,0.19035466445821092
4122,360.255933,360.262267,1,10807677,10807868,191,0.2072475574425361
4123,360.2868,360.316467,1,10808604,10809494,890,0.26005289440059604
4124,360.331067,360.367233,1,10809932,10811016,1084,0.265994259663887
4125,360.433833,360.464567,1,10813014,10813937,923,0.2357923568580664
4126,360.506133,360.613033,1,10815183,10818390,3207,0.2466696902984077
4127,360.632533,360.698567,1,10818975,10820957,1982,0.03866867035930266
4128,360.700567,360.795067,1,10821017,10823852,2835,0.13546030496099834
4129,360.826433,360.831133,1,10824792,10824933,141,0.6895894587866944
4130,360.856,360.915533,1,10825680,10827465,1785,0.1755405323529798
4131,360.9244,360.9574,1,10827732,10828722,990,0.21914699548575914
4132,361.002767,361.035367,1,10830083,10831061,978,0.19396610545700738
4133,361.036467,361.040467,1,10831094,10831214,120,0.9433198634193936
4134,361.082233,361.0942,1,10832466,10832826,360,0.8178598275137705
4135,361.095833,361.101133,1,10832874,10833033,159,0.5986149650825471
4136,361.232633,361.235833,1,10836978,10837074,96,0.8404838883447894
4137,361.250667,361.264133,1,10837520,10837923,403,0.21755443421065498
4138,361.271433,361.301067,1,10838142,10839032,890,0.5486384989470833
4139,361.314267,361.3291,1,10839428,10839873,445,0.5410064480656585
4140,361.3351,361.352033,1,10840053,10840560,507,0.5767964116953624
4141,361.361233,361.3736,1,10840836,10841208,372,0.5351648032349312
4142,361.385367,361.4139,1,10841561,10842417,856,0.2462332318199819
4143,361.4737,361.485167,1,10844211,10844555,344,0.11260702921173646
4144,361.510433,361.525267,1,10845312,10845758,446,0.08012000914893512
4145,361.5332,361.580867,1,10845996,10847426,1430,0.1754758313341389
4146,361.593133,361.609167,1,10847793,10848275,482,0.49598701826033453
4147,361.633867,361.661267,1,10849016,10849838,822,0.2151534102715056
4148,361.6661,361.6851,1,10849983,10850553,570,0.831442544327839
4149,361.861533,361.869233,1,10855845,10856076,231,-0.151857330972563
4150,361.960567,361.967833,1,10858817,10859034,217,0.780940209180975
4151,361.9915,362.0042,1,10859745,10860126,381,0.7290149266736652
4152,362.012633,362.0177,1,10860378,10860531,153,0.8510296829723355
4153,362.0187,362.032667,1,10860561,10860980,419,0.8107334857166426
4154,362.041533,362.0457,1,10861245,10861371,126,0.8523125512459139
4155,362.0469,362.0513,1,10861407,10861539,132,0.8384933264418026
4156,362.0524,362.075967,1,10861572,10862279,707,0.7928492641663386
4157,362.0806,362.145633,1,10862418,10864368,1950,0.48488627519819494
4158,362.158333,362.1633,1,10864749,10864899,150,0.7410172069780878
4159,363.360433,363.364633,1,10900812,10900938,126,0.3761319290631812
4160,364.228767,364.2827,1,10926863,10928481,1618,0.3691188998165747
4161,364.306767,364.319767,1,10929203,10929593,390,-0.0010392924233169256
4162,364.332167,364.3452,1,10929965,10930356,391,0.13990522961137294
4163,364.346333,364.373033,1,10930389,10931190,801,0.12769129151174344
4164,364.374867,364.406733,1,10931246,10932201,955,0.47353842673908036
4165,364.408733,364.442667,1,10932261,10933280,1019,0.20741083688260661
4166,364.449033,364.4643,1,10933470,10933929,459,0.5988424934087854
4167,364.469733,364.4788,1,10934091,10934364,273,0.4999489874053473
4168,364.482533,364.531867,1,10934475,10935956,1481,0.20055281866339358
4169,364.535333,364.5523,1,10936059,10936569,510,0.2987814791141741
4170,364.553767,364.5645,1,10936613,10936935,322,0.06344528151294586
4171,364.5732,364.6959,1,10937196,10940877,3681,0.3678470926016661
4172,364.700933,364.808467,1,10941027,10944254,3227,0.726883117924637
4173,364.8096,365.095967,1,10944288,10952879,8591,0.48574660699687733
4174,365.0992,365.4887,1,10952976,10964661,11685,0.43969608059524207
4175,365.503767,365.530933,1,10965113,10965927,814,0.3792459365397327
4176,365.5333,365.546233,1,10965999,10966386,387,0.8822954437242609
4177,365.547367,365.573467,1,10966421,10967204,783,0.4684153932222559
4178,365.584133,365.5872,1,10967523,10967616,93,0.4342596456641834
4179,365.647067,365.6543,1,10969412,10969629,217,0.8728853140275253
4180,365.6568,365.6616,1,10969704,10969848,144,0.8361043178234796
4181,365.663,365.7542,1,10969890,10972626,2736,0.8188897294290566
4182,365.7817,365.785867,1,10973451,10973576,125,0.7804887449109853
4183,365.798233,365.807567,1,10973946,10974227,281,0.27988357209828374
4184,365.8086,365.820933,1,10974258,10974627,369,0.7847101048423812
4185,365.822733,365.837567,1,10974681,10975127,446,0.6513303303114446
4186,365.8387,365.8675,1,10975161,10976025,864,0.3649819523634966
4187,365.8834,365.8917,1,10976502,10976751,249,0.08137784102074617
4188,365.894167,365.924833,1,10976825,10977744,919,0.29539084447054603
4189,365.925833,365.9475,1,10977774,10978425,651,0.4014001151333816
4190,365.951033,365.978833,1,10978530,10979364,834,0.0314770037146634
4191,366.018067,366.048467,1,10980542,10981454,912,0.6645207622887934
4192,366.049767,366.072433,1,10981493,10982172,679,0.5515780200163859
4193,366.0775,366.113967,1,10982325,10983419,1094,0.3478946185369637
4194,366.132,366.164833,1,10983960,10984944,984,0.47005109275285284
4195,366.1692,366.1991,1,10985076,10985973,897,0.6109223549491483
4196,366.204467,366.2318,1,10986134,10986954,820,0.27416072313935524
4197,366.2341,366.237333,1,10987023,10987119,96,0.08554073066180064
4198,366.239033,366.250167,1,10987170,10987505,335,0.642844210776974
4199,366.255367,366.2602,1,10987661,10987806,145,0.48809464386438706
4200,366.2646,366.294033,1,10987938,10988820,882,0.2882343970795715
4201,366.295467,366.3255,1,10988864,10989765,901,0.7464533784413409
4202,366.3378,366.3643,1,10990134,10990929,795,0.21856065785823733
4203,366.3742,366.381133,1,10991226,10991433,207,0.319473316357791
4204,366.3896,366.397667,1,10991688,10991930,242,0.8564663105082028
4205,366.400167,366.418767,1,10992005,10992563,558,0.28768755590645917
4206,366.424033,366.427867,1,10992720,10992836,116,0.7450517780721765
4207,366.430567,366.445033,1,10992917,10993350,433,0.8343544828773071
4208,366.446033,366.466333,1,10993380,10993989,609,0.6239311907987025
4209,366.477833,366.501167,1,10994334,10995035,701,0.2870205602324423
4210,366.548033,366.576733,1,10996440,10997301,861,0.09901610596393158
4211,366.5778,366.589633,1,10997334,10997688,354,0.5209779911105687
4212,366.591233,366.6075,1,10997736,10998225,489,0.5969903022147482
4213,366.6088,366.613167,1,10998264,10998395,131,0.5987901343249161
4214,366.616833,366.643,1,10998504,10999290,786,0.2506118675310867
4215,366.6627,366.668967,1,10999881,11000069,188,0.7476145089717656
4216,366.6791,366.687,1,11000373,11000610,237,0.6707247814347688
4217,366.698567,366.7042,1,11000957,11001126,169,0.8474468422239069
4218,366.707,366.7512,1,11001210,11002536,1326,0.2043446285691105
4219,366.752733,366.760067,1,11002581,11002802,221,0.3357331669725216
4220,366.767867,366.819033,1,11003036,11004570,1534,0.27930481791876416
4221,366.830533,366.8343,1,11004915,11005029,114,0.43080867787809035
4222,366.8393,366.852767,1,11005179,11005583,404,0.49031810990711017
4223,366.855433,366.861367,1,11005662,11005841,179,0.8433364927549912
4224,366.863267,366.897033,1,11005898,11006910,1012,0.5818171326900056
4225,366.905833,366.908967,1,11007174,11007269,95,0.860855493292178
4226,366.9146,366.961,1,11007438,11008830,1392,0.46669434560994916
4227,366.973667,367.053533,1,11009210,11011605,2395,0.37852419624462125
4228,367.058267,367.064033,1,11011748,11011920,172,0.7548797844681189
4229,367.065167,367.0705,1,11011955,11012115,160,0.6196725453572776
4230,367.072733,367.077633,1,11012181,11012328,147,0.6450048720459711
4231,367.083633,367.093633,1,11012508,11012808,300,0.6690227954424739
4232,367.0972,367.113033,1,11012916,11013390,474,0.48559987512274033
4233,367.115567,367.119267,1,11013467,11013578,111,0.7138082429250424
4234,367.139733,367.1533,1,11014191,11014599,408,0.18520624803808036
4235,367.172,367.178767,1,11015160,11015363,203,0.688624756872386
4236,367.2039,367.208333,1,11016117,11016249,132,0.7883826924880976
4237,367.2096,367.2161,1,11016288,11016483,195,0.9392029503316844
4238,367.238433,367.278367,1,11017152,11018351,1199,0.2740472157327063
4239,367.3384,367.345133,1,11020152,11020353,201,0.41636762611939204
4240,367.3501,367.382667,1,11020503,11021480,977,0.43875716251531865
4241,367.389,367.424333,1,11021670,11022729,1059,0.2278046039677439
4242,367.463433,367.507467,1,11023902,11025224,1322,0.09218331658082758
4243,367.5201,367.5574,1,11025603,11026722,1119,0.2682230443079011
4244,367.559567,367.573667,1,11026787,11027210,423,-0.04035213705773464
4245,367.575233,367.607,1,11027256,11028210,954,0.003751669921975581
4246,367.608267,367.615167,1,11028248,11028455,207,0.24452953290497054
4247,367.6162,367.6939,1,11028486,11030817,2331,0.15748121129682366
4248,367.706633,367.717967,1,11031198,11031539,341,0.41337982779544086
4249,367.746367,367.751133,1,11032391,11032533,142,0.16119448414172513
4250,367.7537,367.7731,1,11032611,11033193,582,0.236955593388961
4251,367.8957,367.9292,1,11036871,11037876,1005,0.3982450113693825
4252,367.9381,367.974933,1,11038143,11039247,1104,0.12674808949410285
4253,367.976367,367.9889,1,11039291,11039667,376,0.3325477127958441
4254,367.990367,368.0354,1,11039711,11041062,1351,0.06137595556190899
4255,368.042633,368.0504,1,11041278,11041512,234,0.7634702144944503
4256,368.053867,368.0714,1,11041616,11042142,526,0.29992743582686043
4257,368.078267,368.1495,1,11042348,11044485,2137,0.3050311983887283
4258,368.1527,368.349367,1,11044581,11050481,5900,0.5273649750383266
4259,368.363933,368.373867,1,11050917,11051216,299,0.7250894122052447
4260,368.400333,368.403567,1,11052009,11052107,98,0.9304990625959453
4261,368.448467,368.5141,1,11053454,11055423,1969,0.5261192390156643
4262,368.516933,368.520433,1,11055507,11055612,105,0.8199931288318256
4263,368.5249,368.533,1,11055747,11055990,243,0.654897630926017
4264,368.5523,368.5555,1,11056569,11056665,96,0.7206808659791508
4265,368.6073,368.612067,1,11058219,11058362,143,0.8196981605232644
4266,368.6522,368.655233,1,11059566,11059656,90,0.839321538961392
4267,368.656967,368.660433,1,11059709,11059812,103,0.8621520068944462
4268,368.6904,368.6974,1,11060712,11060922,210,0.8480571245445562
4269,368.989533,368.996067,1,11069685,11069882,197,0.5495545874146714
4270,369.008,369.014867,1,11070240,11070446,206,0.4835970233955217
4271,369.018633,369.028367,1,11070558,11070851,293,0.7941203849251477
4272,369.078133,369.0817,1,11072343,11072451,108,0.8209476236572032
4273,369.139467,369.1443,1,11074184,11074329,145,0.790172260799277
4274,369.627267,369.6381,1,11088818,11089143,325,0.6653557779799973
4275,369.6393,369.668633,1,11089179,11090058,879,0.7062522154455916
4276,369.701767,369.706,1,11091053,11091180,127,0.2260614281143994
4277,369.708333,369.715967,1,11091249,11091479,230,0.6876748814407921
4278,369.718167,369.721933,1,11091545,11091657,112,0.7668675727464295
4279,369.723767,369.730933,1,11091713,11091927,214,0.6977634502511088
4280,369.7351,369.748633,1,11092053,11092458,405,0.7609943066463495
4281,369.7669,369.774,1,11093007,11093220,213,0.4810574391854462
4282,369.781433,369.784667,1,11093442,11093540,98,0.8366043676285269
4283,369.786867,369.7907,1,11093606,11093721,115,0.7960060317228922
4284,369.809767,369.8131,1,11094293,11094393,100,0.9179923620994958
4285,369.8169,369.820767,1,11094507,11094623,116,0.6795129889382994
4286,369.832667,369.839867,1,11094980,11095196,216,0.9212870789283251
4287,369.843067,369.8463,1,11095292,11095389,97,0.8134628339263695
4288,369.9387,369.941767,1,11098161,11098253,92,0.7883830529207079
4289,370.075133,370.082567,1,11102253,11102477,224,0.9424097148064551
4290,370.083633,370.0926,1,11102508,11102778,270,0.6082054645325567
4291,370.1338,370.168433,1,11104014,11105052,1038,0.32323288274543277
4292,370.195033,370.240867,1,11105850,11107226,1376,0.4436088931774183
4293,370.247467,370.375733,1,11107424,11111271,3847,0.47864233482789137
4294,370.384933,370.4588,1,11111547,11113764,2217,0.6050677757478213
4295,370.460633,370.571433,1,11113818,11117142,3324,0.5205275443378574
4296,370.573,370.7321,1,11117190,11121963,4773,0.500765013195598
4297,370.743667,370.787867,1,11122310,11123636,1326,0.61043222103952
4298,370.797867,370.808167,1,11123936,11124245,309,0.8512226364849502
4299,370.936933,370.967167,1,11128107,11129015,908,0.6391143625316207
4300,370.968333,370.996,1,11129049,11129880,831,0.8085815526640254
4301,371.0065,371.041133,1,11130195,11131233,1038,0.488983775700651
4302,371.046733,371.050667,1,11131401,11131520,119,0.946486551870374
4303,371.057633,371.315833,1,11131728,11139474,7746,0.4065325399603165
4304,371.3176,371.330833,1,11139528,11139924,396,0.8392746826524587
4305,371.3385,371.342667,1,11140155,11140280,125,0.4294315557972176
4306,371.358467,371.3693,1,11140754,11141079,325,0.4363589824334301
4307,371.370667,371.390933,1,11141120,11141727,607,0.343963349194721
4308,371.393133,371.403567,1,11141793,11142107,314,0.6739275692287525
4309,371.409367,371.416067,1,11142281,11142482,201,0.8593233018766869
4310,371.423567,371.485133,1,11142707,11144553,1846,0.629861782020419
4311,371.5452,371.549767,1,11146356,11146493,137,0.8868291818037373
4312,371.551733,371.555233,1,11146551,11146656,105,0.7782127609496893
4313,371.556267,371.559533,1,11146688,11146785,97,0.809206101927627
4314,371.5664,371.5699,1,11146992,11147097,105,0.8792724364457806
4315,371.602467,371.6075,1,11148074,11148225,151,0.5514826188355237
4316,371.612733,371.6526,1,11148381,11149578,1197,0.8301320651552513
4317,371.670633,371.674267,1,11150118,11150228,110,0.7187291807857117
4318,371.6874,371.690433,1,11150622,11150712,90,0.16002925907791882
4319,371.695633,371.7121,1,11150868,11151363,495,0.45724637695382436
4320,371.724233,371.7485,1,11151726,11152455,729,0.6480052211995727
4321,371.753,371.757267,1,11152590,11152718,128,0.7724182497158437
4322,371.7587,371.764767,1,11152761,11152943,182,0.7055676489499952
4323,371.774667,371.812333,1,11153240,11154369,1129,0.30207905470712076
4324,371.814867,371.833933,1,11154446,11155017,571,0.8311797912726007
4325,371.843433,371.882867,1,11155302,11156486,1184,0.7557456918590475
4326,371.8839,371.887133,1,11156517,11156613,96,0.8265005158454823
4327,371.888133,371.915567,1,11156643,11157467,824,0.619528757492701
4328,371.9375,371.951167,1,11158125,11158535,410,0.7758121884650268
4329,371.965167,372.145367,1,11158955,11164361,5406,0.5595152129800602
4330,372.170467,372.1759,1,11165114,11165277,163,0.6683721284625611
4331,372.1771,372.189,1,11165313,11165670,357,0.7280442918028586
4332,372.209967,372.214367,1,11166299,11166431,132,0.8227627446634209
4333,372.215633,372.224867,1,11166468,11166746,278,0.7251368721487111
4334,372.307733,372.317767,1,11169231,11169533,302,0.8741081471694252
4335,372.387067,372.3979,1,11171612,11171937,325,0.8198662916720171
4336,372.413767,372.474667,1,11172413,11174240,1827,0.4232906323501775
4337,372.483367,372.514733,1,11174501,11175441,940,0.5781353356635351
4338,372.545133,372.559767,1,11176353,11176793,440,0.8850481562081115
4339,372.580867,372.658233,1,11177426,11179746,2320,0.5540722402273568
4340,372.669133,372.681233,1,11180073,11180436,363,0.785345752857403
4341,372.8081,372.8198,1,11184243,11184594,351,0.8753733463473584
4342,372.8255,372.836233,1,11184765,11185086,321,0.7836299520861937
4343,372.8414,372.8636,1,11185242,11185908,666,0.6716332273177302
4344,372.944033,372.996133,1,11188320,11189883,1563,0.4429185976130128
4345,373.053267,373.0571,1,11191598,11191713,115,0.5246649781950118
4346,373.233233,373.260167,1,11196996,11197805,809,0.3913864384609064
4347,373.267267,373.272667,1,11198018,11198180,162,0.6812328173875789
4348,373.303867,373.307333,1,11199116,11199219,103,0.8620933363018252
4349,373.317233,373.321167,1,11199516,11199635,119,0.5712589505936789
4350,373.333333,373.353067,1,11199999,11200592,593,0.8450030706684861
4351,373.364033,373.370067,1,11200920,11201102,182,0.7334246777977217
4352,373.3712,373.3927,1,11201136,11201781,645,0.4179810839704623
4353,373.396567,373.412133,1,11201897,11202363,466,0.2526401080840804
4354,373.414933,373.468133,1,11202447,11204043,1596,0.392434525423061
4355,373.469967,373.474867,1,11204099,11204246,147,0.7252381183413537
4356,373.480033,373.512867,1,11204400,11205386,986,0.39296244540510666
4357,373.521633,373.533633,1,11205648,11206008,360,0.7838309098533616
4358,373.538667,373.554767,1,11206160,11206643,483,0.19961330791498794
4359,373.562267,373.5919,1,11206868,11207757,889,0.6111571819132797
4360,373.594,373.597067,1,11207820,11207912,92,0.589976372152438
4361,373.6047,373.6315,1,11208141,11208945,804,0.1851623404425985
4362,373.6389,373.647867,1,11209167,11209436,269,0.4195422701242941
4363,373.673233,373.7271,1,11210196,11211813,1617,0.17917993843235247
4364,373.7329,373.769433,1,11211987,11213082,1095,0.11360539599112054
4365,373.782633,373.852333,1,11213478,11215569,2091,0.40433997325034415
4366,373.860233,373.896967,1,11215806,11216909,1103,0.18637613697369296
4367,373.935,373.943867,1,11218050,11218316,266,0.48625704430051664
4368,373.9517,373.961,1,11218551,11218830,279,0.6531851379321972
4369,373.9627,373.998833,1,11218881,11219964,1083,0.6158950136625647
4370,374.001167,374.024733,1,11220035,11220741,706,0.20843678443939218
4371,374.0261,374.035567,1,11220783,11221067,284,0.3009209117971963
4372,374.141667,374.154733,1,11224250,11224641,391,0.7669109255544475
4373,374.1558,374.1668,1,11224674,11225004,330,0.6284235550960029
4374,374.291633,374.423833,1,11228748,11232714,3966,0.3109527839738058
4375,374.4386,374.4824,1,11233158,11234472,1314,0.3327559621333556
4376,374.483633,374.487167,1,11234508,11234615,107,-0.31566730567007284
4377,374.490133,374.518533,1,11234703,11235555,852,0.2000576470386673
4378,374.5196,374.533633,1,11235588,11236008,420,0.49550447262541497
4379,374.6661,374.711633,1,11239983,11241348,1365,0.33837475515507126
4380,374.713367,374.750733,1,11241401,11242521,1120,0.17188997249246546
4381,374.752533,374.770333,1,11242575,11243109,534,0.03068337500211288
4382,374.776367,374.782433,1,11243291,11243472,181,0.638399308418296
4383,374.7851,374.840933,1,11243553,11245227,1674,0.33736844515216585
4384,374.845933,374.9043,1,11245377,11247129,1752,0.010397878661366362
4385,374.9233,374.934233,1,11247699,11248026,327,0.6902985504503909
4386,374.938,374.9545,1,11248140,11248635,495,0.7361289130627212
4387,374.982267,375.000433,1,11249468,11250012,544,0.8111608859083121
4388,375.354767,375.368967,1,11260643,11261069,426,0.88042148283764
4389,375.370633,375.3747,1,11261118,11261241,123,0.8935458106044293
4390,375.472133,375.481033,1,11264163,11264430,267,0.9175103172499592
4391,375.482167,375.487033,1,11264465,11264610,145,0.8311500106780267
4392,375.531367,375.625,1,11265941,11268750,2809,0.7535780566394823
4393,375.668067,375.671333,1,11270042,11270139,97,0.725110442514776
4394,375.683667,375.702733,1,11270510,11271081,571,0.6342591487577091
4395,375.704067,375.7255,1,11271122,11271765,643,0.5584579390028204
4396,375.727333,375.730767,1,11271819,11271923,104,0.8435045527897772
4397,375.731767,375.7597,1,11271953,11272791,838,0.946725907462872
4398,375.809133,375.814667,1,11274273,11274440,167,0.732132788604346
4399,375.848667,375.854467,1,11275460,11275634,174,0.703064520244866
4400,375.886633,375.908333,1,11276598,11277249,651,0.5804515005759754
4401,375.911533,375.914967,1,11277345,11277449,104,0.895229785805877
4402,375.987533,375.991167,1,11279625,11279735,110,0.8198607262945035
4403,376.021633,376.0399,1,11280648,11281197,549,0.31807011366620946
4404,376.041833,376.055667,1,11281254,11281670,416,0.8611697283673692
4405,376.0654,376.124,1,11281962,11283720,1758,0.3306570287437519
4406,376.132467,376.169033,1,11283974,11285070,1096,0.5880459194657649
4407,376.1732,376.1826,1,11285196,11285478,282,0.5058876753691256
4408,376.1976,376.215167,1,11285928,11286455,527,0.4468186215072976
4409,376.237467,376.248733,1,11287124,11287461,337,0.926475758962623
4410,376.253133,376.2566,1,11287593,11287698,105,0.3545942361191562
4411,376.306167,376.341067,1,11289185,11290232,1047,0.7759227672378376
4412,376.375133,376.461133,1,11291253,11293833,2580,0.5780953065191266
4413,376.4663,376.4701,1,11293989,11294103,114,0.8926279689601789
4414,376.4859,376.535733,1,11294577,11296071,1494,0.4952454987333775
4415,376.5811,376.787133,1,11297433,11303613,6180,0.5681871601227872
4416,376.949667,376.9816,1,11308490,11309448,958,0.500182711998016
4417,376.982633,376.990333,1,11309478,11309709,231,0.892994158860659
4418,377.0211,377.046067,1,11310633,11311382,749,0.6495693037411298
4419,377.0471,377.051833,1,11311413,11311554,141,0.8086675126625414
4420,377.062067,377.0785,1,11311862,11312355,493,0.6123233486545696
4421,377.079533,377.085233,1,11312385,11312556,171,-0.03671153434555575
4422,377.1093,377.115867,1,11313279,11313476,197,0.5519561881257545
4423,377.126733,377.157233,1,11313801,11314716,915,0.45455031950361824
4424,377.158667,377.161867,1,11314760,11314856,96,0.8397804960884632
4425,377.163033,377.1738,1,11314890,11315214,324,0.8269228838355134
4426,377.176233,377.3251,1,11315286,11319753,4467,0.47724199717877114
4427,377.344767,377.350267,1,11320343,11320508,165,0.8481070904689505
4428,377.356,377.399833,1,11320680,11321994,1314,0.8058063334523601
4429,377.401,377.417233,1,11322030,11322516,486,0.8437606579657972
4430,377.4885,377.5269,1,11324655,11325807,1152,0.2569478615191727
4431,377.536533,377.5418,1,11326095,11326254,159,0.8491910487411176
4432,377.5432,377.657867,1,11326296,11329736,3440,0.26714214734266484
4433,377.665333,377.678,1,11329959,11330340,381,0.2523784263088775
4434,377.6794,377.716533,1,11330382,11331495,1113,0.07286908344695203
4435,377.718367,377.7394,1,11331551,11332182,631,0.50104657012425
4436,377.746833,377.7525,1,11332404,11332575,171,0.8724580856089784
4437,377.7588,377.785767,1,11332764,11333573,809,0.1546354769988026
4438,377.787033,377.806167,1,11333610,11334185,575,0.4404081574812035
4439,377.812067,377.882733,1,11334362,11336481,2119,0.36136059444306634
4440,377.886333,377.894367,1,11336589,11336831,242,0.1798252910519738
4441,378.006633,378.025,1,11340198,11340750,552,0.6555960102199347
4442,378.0857,378.095467,1,11342571,11342864,293,0.746678825364469
4443,378.0991,378.1091,1,11342973,11343273,300,0.40254968289316295
4444,378.129233,378.1588,1,11343876,11344764,888,0.45024031555933364
4445,378.457467,378.4659,1,11353724,11353977,253,0.4136403467817028
4446,378.467867,378.4711,1,11354036,11354133,97,0.26760845121271426
4447,378.476267,378.4824,1,11354288,11354472,184,0.5591418374439994
4448,378.798467,378.8052,1,11363954,11364156,202,0.4835109901739736
4449,378.9014,378.9045,1,11367042,11367135,93,0.3425791245580639
4450,378.965467,378.968767,1,11368964,11369063,99,0.7181470754610672
4451,378.973967,379.004667,1,11369219,11370140,921,0.2980271424225151
4452,379.012833,379.024267,1,11370384,11370728,344,0.8522959981159275
4453,379.025467,379.139667,1,11370764,11374190,3426,0.5896593801021325
4454,379.202567,379.212833,1,11376077,11376384,307,0.8615672293643298
4455,379.226833,379.231333,1,11376804,11376939,135,0.7518502890967395
4456,379.4835,379.4875,1,11384505,11384625,120,0.5175228906321377
4457,379.489467,379.492867,1,11384684,11384786,102,0.11693656795815668
4458,379.518933,379.577233,1,11385567,11387316,1749,0.15121748157853218
4459,379.599333,379.618433,1,11387979,11388552,573,0.15477315945537823
4460,379.632833,379.641333,1,11388984,11389239,255,0.007330081730952383
4461,379.6456,379.674933,1,11389368,11390247,879,-0.009075708894969649
4462,379.6762,379.6951,1,11390286,11390853,567,0.3373302276039338
4463,379.6963,379.705933,1,11390889,11391177,288,0.6803253170957092
4464,379.707667,379.749867,1,11391230,11392496,1266,0.09180153878369378
4465,379.752133,379.773933,1,11392563,11393217,654,0.49388181101241757
4466,379.7751,379.791167,1,11393253,11393735,482,0.9431983861994905
4467,379.793667,379.816333,1,11393810,11394489,679,0.47315715594372443
4468,379.863633,379.869,1,11395908,11396070,162,0.14412022979065423
4469,379.870167,379.877167,1,11396105,11396315,210,0.8488584732245672
4470,379.884833,379.8894,1,11396544,11396682,138,0.9618649835420482
4471,379.921967,379.935367,1,11397659,11398061,402,0.5420563693563053
4472,380.021133,380.026667,1,11400633,11400800,167,0.5903115214301008
4473,380.343067,380.352267,1,11410292,11410568,276,0.3318472004835671
4474,380.420233,380.424033,1,11412606,11412720,114,0.6311631375335847
4475,381.042833,381.046567,1,11431284,11431397,113,0.28149842929367636
4476,383.380433,383.428267,1,11501412,11502848,1436,0.14861921802648137
4477,383.4326,383.479267,1,11502978,11504378,1400,0.08050023483954041
4478,383.493167,383.536433,1,11504795,11506092,1297,0.4038441229925718
4479,383.539333,383.731667,1,11506179,11511950,5771,0.19052879482210255
4480,383.733867,383.7382,1,11512016,11512146,130,0.9223449909826827
4481,383.743833,383.751733,1,11512314,11512551,237,0.847172670606131
4482,383.7531,383.905867,1,11512593,11517176,4583,0.22022158479485257
4483,383.912767,384.009867,1,11517383,11520296,2913,0.1686206644199606
4484,384.0126,384.085133,1,11520378,11522553,2175,0.18324891050133973
4485,384.090133,384.1187,1,11522703,11523561,858,0.5785890333428749
4486,384.119767,384.131167,1,11523593,11523935,342,0.7048113824650648
4487,384.1358,384.141967,1,11524074,11524259,185,0.45082766991076373
4488,384.157133,384.1654,1,11524713,11524962,249,0.7417287415315552
4489,384.174233,384.1983,1,11525226,11525949,723,0.5886468806613766
4490,384.205267,384.210267,1,11526158,11526308,150,0.840321103579374
4491,384.275767,384.2976,1,11528273,11528928,655,0.5660085419380145
4492,384.2995,384.310967,1,11528985,11529329,344,0.825780513833007
4493,384.3203,384.347067,1,11529609,11530412,803,0.34327245023063563
4494,385.1486,385.3077,1,11554458,11559231,4773,0.7389859984072152
4495,385.310367,385.3589,1,11559311,11560767,1456,0.7134194146308428
4496,385.360967,385.367567,1,11560829,11561027,198,0.8885413402421255
4497,385.398667,385.419833,1,11561960,11562594,634,0.555353724284293
4498,385.4653,385.471367,1,11563959,11564141,182,0.804247050766576
4499,385.475333,385.5121,1,11564259,11565363,1104,0.44557371656267886
4500,385.513667,385.562033,1,11565410,11566860,1450,0.16617293025752014
4501,385.5684,385.636267,1,11567052,11569088,2036,0.1785738261762497
4502,385.648167,385.712167,1,11569445,11571365,1920,0.1016231039462074
4503,385.719167,385.777267,1,11571575,11573318,1743,0.4210633020507313
4504,385.778433,385.898733,1,11573352,11576961,3609,0.07459059262788145
4505,385.906467,385.910467,1,11577194,11577314,120,0.8599221991310194
4506,385.915033,385.9217,1,11577450,11577651,201,0.6217120869653547
4507,385.941533,385.950633,1,11578245,11578518,273,0.16284669825825168
4508,385.960733,385.9876,1,11578821,11579628,807,0.3985435122363076
4509,385.9918,386.0316,1,11579754,11580948,1194,0.22160109248525503
4510,386.036967,386.109933,1,11581109,11583297,2188,0.16382131274271963
4511,386.120833,386.158833,1,11583624,11584764,1140,0.6393431085185408
4512,386.1607,386.223567,1,11584821,11586707,1886,0.22191604001665033
4513,386.224867,386.2318,1,11586746,11586954,208,0.6289911808467279
4514,386.233133,386.320633,1,11586993,11589618,2625,0.34635249745568897
4515,386.322633,386.355133,1,11589678,11590653,975,0.5388508494296328
4516,386.357367,386.401567,1,11590721,11592047,1326,0.202969476617104
4517,386.407167,386.457367,1,11592215,11593721,1506,0.32826208637821547
4518,386.9439,386.9971,1,11608317,11609913,1596,0.18907240382453128
4519,386.998367,387.0035,1,11609951,11610105,154,0.9449479896492031
4520,387.004567,387.0096,1,11610137,11610288,151,0.703634927572766
4521,387.012133,387.037,1,11610363,11611110,747,0.4730387008469974
4522,387.040867,387.0605,1,11611226,11611815,589,0.07558770118773613
4523,387.064867,387.153467,1,11611946,11614604,2658,0.10312381948800324
4524,387.165767,387.2442,1,11614973,11617326,2353,0.30427454989939107
4525,387.246033,387.258133,1,11617380,11617743,363,0.6398849269496465
4526,387.274167,387.377967,1,11618225,11621339,3114,0.2664510199718597
4527,387.4161,387.523933,1,11622483,11625717,3234,0.3590097904972529
4528,387.526067,387.532467,1,11625782,11625974,192,0.9122669510063166
4529,387.537233,387.5504,1,11626116,11626512,396,0.7873920440433338
4530,387.551567,387.5649,1,11626547,11626947,400,0.9429418990131981
4531,387.5663,387.640867,1,11626989,11629226,2237,0.8517593899007709
4532,387.903933,387.909767,1,11637117,11637293,176,0.8789338189754609
4533,388.376667,388.395467,1,11651300,11651864,564,0.7574082223738328
4534,388.396467,388.447333,1,11651894,11653419,1525,0.6793657622257855
4535,388.448467,388.474,1,11653454,11654220,766,0.8624850277713989
4536,388.479267,388.510433,1,11654378,11655312,934,0.900405001075335
4537,388.512833,388.529567,1,11655384,11655887,503,0.7214059777354853
4538,388.550667,388.554833,1,11656520,11656644,124,0.2521615301478793
4539,388.5595,388.564467,1,11656785,11656934,149,0.680449838353229
4540,388.606467,388.608633,1,11658194,11658258,64,0.9151347712213896
4541,388.821667,388.8253,1,11664650,11664759,109,0.7503813042149653
4542,388.8411,388.874967,1,11665233,11666249,1016,0.2709480889773368
4543,388.884467,388.922733,1,11666534,11667681,1147,0.4819622825081817
4544,388.9397,389.050533,1,11668191,11671515,3324,0.5526589263362855
4545,389.082433,389.087433,1,11672472,11672622,150,0.9350908444947047
4546,389.118133,389.2871,1,11673543,11678613,5070,0.61666378712246
4547,389.2973,389.3135,1,11678919,11679405,486,0.4150528226363643
4548,389.329533,389.358533,1,11679885,11680755,870,0.8961920787277448
4549,389.368633,389.374867,1,11681058,11681246,188,0.8712804165550574
4550,389.375967,389.38,1,11681279,11681400,121,0.8640119294610497
4551,389.3814,389.395633,1,11681442,11681868,426,0.8306673175947927
4552,389.502267,389.5061,1,11685068,11685183,115,0.09946160151416547
4553,389.888667,389.9597,1,11696660,11698791,2131,0.689460537177026
4554,389.977933,390.0552,1,11699337,11701656,2319,0.8060299161019424
4555,390.089667,390.1099,1,11702690,11703297,607,0.5668937688060789
4556,390.119433,390.135,1,11703582,11704050,468,0.9136495133595174
4557,390.514567,390.520667,1,11715437,11715620,183,0.3276624226557707
4558,391.012,391.0164,1,11730360,11730492,132,0.8310578864723869
4559,391.0183,391.0321,1,11730549,11730963,414,0.5553160070363096
4560,391.041367,391.056233,1,11731241,11731686,445,0.6736074811580419
4561,391.057367,391.100267,1,11731721,11733008,1287,0.19148343661606862
4562,391.108433,391.117333,1,11733252,11733519,267,0.6195851587788748
4563,391.123367,391.1288,1,11733701,11733864,163,0.7967981143987152
4564,391.1402,391.165833,1,11734206,11734974,768,0.061762304058813465
4565,391.171167,391.186333,1,11735135,11735589,454,0.2543817489488852
4566,391.192333,391.212667,1,11735769,11736380,611,0.2505648045905316
4567,391.218133,391.243567,1,11736543,11737307,764,0.3981596071751202
4568,391.246967,391.2825,1,11737409,11738475,1066,0.5454286570097434
4569,391.289633,391.313233,1,11738688,11739396,708,0.11329352790622134
4570,391.4601,391.4728,1,11743803,11744184,381,0.2594333044156448
4571,391.482333,391.491633,1,11744469,11744748,279,0.3619158727514148
4572,391.601,391.606367,1,11748030,11748191,161,0.7961259745934498
4573,392.191433,392.2174,1,11765742,11766522,780,0.2610542844597068
4574,392.221067,392.234467,1,11766632,11767034,402,0.6004500881514164
4575,392.2437,392.250467,1,11767311,11767514,203,0.25470884129125665
4576,392.260667,392.3555,1,11767820,11770665,2845,0.3491629536861817
4577,392.3636,392.4301,1,11770908,11772903,1995,0.30288322890205605
4578,392.4331,392.4474,1,11772993,11773422,429,0.635124021825777
4579,392.450133,392.4577,1,11773503,11773731,228,0.6001209882714654
4580,392.458733,392.5321,1,11773761,11775963,2202,0.37195428862300334
4581,392.533267,392.5488,1,11775998,11776464,466,0.7632682741012354
4582,392.5502,392.6088,1,11776506,11778264,1758,0.232298459849707
4583,392.619567,392.7949,1,11778587,11783847,5260,0.5109196443234346
4584,392.796067,392.816167,1,11783882,11784485,603,0.8360434128296025
4585,392.831533,392.838867,1,11784945,11785166,221,0.36169308420523416
4586,392.869933,392.886633,1,11786097,11786598,501,0.8530091790331515
4587,392.888033,392.899767,1,11786640,11786993,353,0.6759577885799338
4588,392.954,393.192133,1,11788620,11795763,7143,0.37289003687272576
4589,393.234467,393.488767,1,11797034,11804663,7629,0.3089607429263151
4590,393.496667,393.499733,1,11804900,11804991,91,0.479460462343443
4591,393.5042,393.5857,1,11805126,11807571,2445,0.3139741128537245
4592,393.588567,393.6354,1,11807657,11809062,1405,0.30764119862460665
4593,393.6575,393.738767,1,11809725,11812163,2438,0.768931154000834
4594,393.741767,393.7475,1,11812253,11812425,172,0.8772074070970749
4595,393.751367,393.758433,1,11812541,11812752,211,0.8395964093045611
4596,393.828867,393.8366,1,11814866,11815098,232,0.921971438262635
4597,394.325967,394.357033,1,11829779,11830710,931,0.39068878381514366
4598,394.3661,394.3925,1,11830983,11831775,792,0.8144712528190756
4599,394.425,394.469367,1,11832750,11834081,1331,0.8992570838934234
4600,394.4988,394.5212,1,11834964,11835636,672,0.8119568415735459
4601,394.540133,394.573267,1,11836203,11837198,995,0.2937005506693067
4602,394.735967,394.741033,1,11842079,11842230,151,0.423263609956545
4603,394.771133,394.781533,1,11843133,11843445,312,0.6475839027117686
4604,395.0446,395.052233,1,11851338,11851566,228,0.8582522895303294
4605,395.110067,395.113633,1,11853302,11853408,106,0.6326506769765915
4606,395.610233,395.663133,1,11868306,11869893,1587,0.36402971575512216
4607,395.669767,395.754067,1,11870093,11872622,2529,0.40296305924763487
4608,395.769867,395.775967,1,11873096,11873279,183,0.7008694330396185
4609,395.7831,395.814467,1,11873493,11874434,941,0.6642251724795766
4610,395.816,395.822533,1,11874480,11874675,195,0.7868154437820467
4611,395.825967,395.8463,1,11874779,11875389,610,0.21644205648715928
4612,395.859467,395.8652,1,11875784,11875956,172,0.7538149855023811
4613,395.907333,395.911833,1,11877219,11877354,135,0.6124959021732428
4614,395.953067,395.9593,1,11878592,11878779,187,0.8992367421323145
4615,395.9603,395.981367,1,11878809,11879441,632,0.6670340295519518
4616,396.089633,396.093467,1,11882688,11882804,116,0.7252286579797032
4617,396.097933,396.104367,1,11882937,11883131,194,0.801284296772574
4618,396.120367,396.135967,1,11883611,11884079,468,0.8401093943578929
4619,396.2394,396.245867,1,11887182,11887376,194,0.5168603181040339
4620,396.256267,396.2593,1,11887688,11887779,91,0.2696049813953945
4621,396.290533,396.302133,1,11888715,11889063,348,0.7180117151794887
4622,396.308167,396.317867,1,11889245,11889536,291,0.8998473101744796
4623,396.324767,396.333667,1,11889743,11890010,267,0.7586862233867113
4624,396.466133,396.4703,1,11893983,11894109,126,0.8736863518343844
4625,396.4714,396.477533,1,11894142,11894325,183,0.7389701416583943
4626,396.498233,396.5038,1,11894946,11895114,168,0.7960916406454122
4627,396.5082,396.5308,1,11895246,11895924,678,0.27514228020658255
4628,396.533033,396.5564,1,11895990,11896692,702,0.37246064728086387
4629,396.557467,396.565233,1,11896724,11896956,232,0.5334893346674618
4630,396.5729,396.5963,1,11897187,11897889,702,0.2384666936770178
4631,396.598133,396.635433,1,11897943,11899062,1119,0.4339862270646974
4632,397.143433,397.1506,1,11914302,11914518,216,0.8598984952392457
4633,397.162633,397.1766,1,11914878,11915298,420,0.2813311564102835
4634,397.185367,397.1889,1,11915561,11915667,106,0.4516818777131799
4635,397.190667,397.247333,1,11915720,11917419,1699,0.48775936126307656
4636,397.253633,397.2612,1,11917608,11917836,228,0.8738188499278158
4637,397.337467,397.341233,1,11920124,11920236,112,0.05190846694862141
4638,397.4698,397.472967,1,11924094,11924189,95,0.7968853895684971
4639,397.529167,397.5322,1,11925875,11925966,91,0.8593132373426534
4640,397.540333,397.543533,1,11926209,11926305,96,0.8016117149965234
4641,397.594567,397.6001,1,11927837,11928003,166,0.7711700616319573
4642,397.602967,397.6101,1,11928089,11928303,214,0.6467085502365473
4643,397.6144,397.6304,1,11928432,11928912,480,0.70308380438002
4644,397.6314,397.6441,1,11928942,11929323,381,0.7184238105323775
4645,397.648033,397.6698,1,11929440,11930094,654,0.16269634096932098
4646,397.678467,397.686867,1,11930354,11930606,252,0.8393014024744291
4647,397.6956,397.698833,1,11930868,11930964,96,0.8949282620667345
4648,397.700633,397.704433,1,11931018,11931132,114,0.8784634349542677
4649,397.768633,397.7744,1,11933058,11933232,174,0.8472421379519369
4650,397.7782,397.855867,1,11933346,11935676,2330,0.3060326225426239
4651,397.9348,397.939567,1,11938044,11938187,143,0.7328196717760425
4652,397.944633,397.948,1,11938338,11938440,102,0.8251367133670594
4653,397.949367,397.9619,1,11938481,11938857,376,0.38634766961768924
4654,397.965533,397.9748,1,11938965,11939244,279,0.8749924513127483
4655,397.977067,397.981533,1,11939312,11939445,133,0.7893854602516692
4656,397.985467,398.023467,1,11939564,11940704,1140,0.3359781680883686
4657,398.103267,398.150433,1,11943098,11944512,1414,0.7008911800079957
4658,398.154667,398.1799,1,11944640,11945397,757,0.31988291148197084
4659,398.182367,398.194867,1,11945471,11945846,375,0.3584285420010502
4660,398.275433,398.278667,1,11948262,11948360,98,0.8395982556804189
4661,398.281,398.321567,1,11948430,11949647,1217,0.4209624595120292
4662,398.328467,398.366667,1,11949854,11951000,1146,0.19917756509541487
4663,398.375267,398.378367,1,11951258,11951351,93,0.7968103184907573
4664,398.409733,398.425767,1,11952291,11952773,482,0.10053142260377891
4665,398.442967,398.459867,1,11953289,11953796,507,0.3026892334063706
4666,398.461167,398.490767,1,11953835,11954723,888,0.4541370712804716
4667,398.494033,398.524733,1,11954820,11955741,921,0.1579312302904419
4668,398.596333,398.6455,1,11957889,11959365,1476,0.018400749625552982
4669,398.649967,398.726767,1,11959499,11961803,2304,0.003522501468932709
4670,398.7334,398.742167,1,11962002,11962265,263,0.40552103629655495
4671,398.767833,398.775267,1,11963034,11963258,224,0.9014177808135325
4672,398.793833,398.828567,1,11963814,11964857,1043,0.44400527329589057
4673,398.829667,398.8453,1,11964890,11965359,469,0.29218232335634103
4674,398.846367,398.857067,1,11965391,11965712,321,0.8862086963016225
4675,398.8588,398.896133,1,11965764,11966883,1119,0.0044126136465784446
4676,398.898567,398.9099,1,11966957,11967297,340,0.10699287779103368
4677,398.935333,398.939733,1,11968059,11968191,132,0.7000602786294977
4678,398.941767,398.9492,1,11968253,11968476,223,0.5247721949041296
4679,399.1359,399.1477,1,11974077,11974431,354,0.058492884492998755
4680,399.149333,399.162067,1,11974479,11974862,383,-0.18040558594716272
4681,399.246767,399.343367,1,11977403,11980301,2898,0.17478674764361143
4682,399.3475,399.407467,1,11980425,11982224,1799,0.07435666122747421
4683,399.408867,399.484833,1,11982266,11984544,2278,0.13347043133206082
4684,399.557367,399.563167,1,11986721,11986895,174,0.7075649923072186
4685,399.654133,399.6572,1,11989623,11989716,93,0.6817851879408799
4686,399.919067,399.951867,1,11997572,11998556,984,0.18433447348223297
4687,399.953533,399.9823,1,11998605,11999469,864,0.31964394021937315
4688,399.983767,400.0873,1,11999513,12002619,3106,0.22744727510443521
4689,400.0998,400.186,1,12002994,12005580,2586,0.3012194010161875
4690,400.189467,400.196667,1,12005684,12005900,216,0.4838151972790076
4691,400.198467,400.2445,1,12005954,12007335,1381,0.21221249602581527
4692,400.2456,400.2897,1,12007368,12008691,1323,0.19575644939805573
4693,400.294933,400.305967,1,12008847,12009179,332,0.2624143300808808
4694,400.3075,400.315933,1,12009225,12009477,252,0.5053365590917699
4695,400.319967,400.332567,1,12009599,12009977,378,0.45965284640396065
4696,400.333767,400.400967,1,12010013,12012029,2016,0.2668696324246311
4697,400.423633,400.427167,1,12012708,12012815,107,0.7467447762892674
4698,400.438033,400.4457,1,12013140,12013371,231,0.6867525695332943
4699,400.4526,400.470333,1,12013578,12014109,531,0.47617538134536136
4700,400.471833,400.475433,1,12014154,12014262,108,0.7315084713844316
4701,400.480267,400.484567,1,12014408,12014537,129,0.7540116598764225
4702,400.4866,400.709967,1,12014598,12021299,6701,0.3830400972691658
4703,400.749133,400.757167,1,12022473,12022715,242,0.8727965065076515
4704,401.378333,401.420167,1,12041349,12042605,1256,0.24970039648754513
4705,401.428767,401.4795,1,12042863,12044385,1522,0.31283847582148483
4706,401.493233,401.533767,1,12044796,12046013,1217,0.24018073228192813
4707,401.5351,401.582,1,12046053,12047460,1407,0.3253680039419943
4708,401.5939,401.6635,1,12047817,12049905,2088,0.45740234909933736
4709,401.6723,401.681733,1,12050169,12050451,282,0.661838010388163
4710,401.684867,401.6961,1,12050546,12050883,337,0.7037259488059053
4711,401.6973,401.7025,1,12050919,12051075,156,0.8907230676368295
4712,401.734967,401.832567,1,12052049,12054977,2928,0.6057965354655644
4713,401.8342,401.856267,1,12055026,12055688,662,0.6796827065423919
4714,401.8665,401.9623,1,12055995,12058869,2874,0.4984814092027213
4715,401.9746,401.978333,1,12059238,12059349,111,0.5867155294296528
4716,401.9993,402.004267,1,12059979,12060128,149,0.9641139001969266
4717,402.0071,402.027033,1,12060213,12060810,597,0.8904166248386278
4718,402.0345,402.046933,1,12061035,12061407,372,0.35471646167954335
4719,402.048033,402.055067,1,12061440,12061652,212,0.5263613241210409
4720,402.076767,402.081867,1,12062303,12062456,153,0.7574898782820542
4721,402.110733,402.1162,1,12063321,12063486,165,0.5408668582545401
4722,402.207967,402.211133,1,12066239,12066333,94,0.5410430953379827
4723,402.3278,402.339333,1,12069834,12070179,345,0.30231100467464866
4724,402.844033,402.847767,1,12085320,12085433,113,-0.024642145075545602
4725,402.905867,402.908867,1,12087176,12087266,90,0.842990977273213
4726,403.0651,403.071367,1,12091953,12092141,188,0.2207496716846739
4727,403.112467,403.175233,1,12093374,12095256,1882,0.11955278506588662
4728,403.177767,403.182633,1,12095333,12095478,145,0.5084311266765662
4729,403.184733,403.196,1,12095541,12095880,339,0.3916134225553692
4730,403.202933,403.224067,1,12096087,12096722,635,0.25989790459826995
4731,403.2276,403.2859,1,12096828,12098577,1749,0.29261599348212913
4732,403.292033,403.313633,1,12098760,12099408,648,0.5212317701325996
4733,403.618833,403.669533,1,12108564,12110085,1521,0.07751767516109537
4734,403.6838,403.696267,1,12110514,12110888,374,0.3205756102059128
4735,403.713533,403.8335,1,12111405,12115005,3600,0.1655061748760202
4736,403.842633,403.957033,1,12115278,12118710,3432,0.1585808070712007
4737,403.958967,404.029767,1,12118769,12120893,2124,0.18748784140393965
4738,404.032333,404.045433,1,12120969,12121362,393,0.5107906490554547
4739,404.0638,404.1203,1,12121914,12123609,1695,0.19122290013512977
4740,404.123567,404.1447,1,12123707,12124341,634,0.26808619411429363
4741,404.163067,404.169533,1,12124892,12125085,193,0.5697922963239636
4742,404.181233,404.196067,1,12125436,12125882,446,0.3811147641183809
4743,404.225967,404.238667,1,12126779,12127160,381,0.6181194253812473
4744,404.247,404.262867,1,12127410,12127886,476,0.37054324826435575
4745,404.303233,404.308633,1,12129096,12129258,162,0.8684414030153433
4746,404.3507,404.354167,1,12130521,12130625,104,0.7413687112410965
4747,404.420133,404.4246,1,12132603,12132738,135,0.836275267274349
4748,404.450567,404.456033,1,12133517,12133680,163,0.8358479484714851
4749,405.104333,405.110033,1,12153129,12153300,171,0.883836292135341
4750,405.1852,405.192767,1,12155556,12155783,227,0.9612927897892004
4751,405.2427,405.246067,1,12157281,12157382,101,0.7774545851485738
4752,405.3001,405.306267,1,12159003,12159188,185,0.3123839956654457
4753,405.370167,405.374867,1,12161105,12161246,141,0.36600019024840785
4754,405.491567,405.498367,1,12164747,12164951,204,0.3014659425042014
4755,405.534033,405.542433,1,12166020,12166272,252,0.6780011539068077
4756,405.557967,405.562467,1,12166739,12166874,135,0.31380804086491
4757,405.569033,405.574367,1,12167070,12167231,161,0.8175682663157703
4758,405.6948,405.702233,1,12170844,12171066,222,0.7662475958872509
4759,406.769233,406.7763,1,12203076,12203289,213,0.28474812356775653
4760,406.781733,406.8226,1,12203451,12204678,1227,0.19134943890571687
4761,406.8357,406.841833,1,12205071,12205254,183,0.7004933812341766
4762,406.858167,406.8826,1,12205745,12206478,733,0.04368125119801349
4763,406.898933,406.921833,1,12206967,12207654,687,0.1984546518739795
4764,406.924733,406.9354,1,12207741,12208062,321,0.31256495452055466
4765,406.9477,406.9721,1,12208431,12209163,732,0.06457085815731156
4766,406.973867,407.010633,1,12209216,12210318,1102,0.13992367225980124
4767,407.033467,407.0432,1,12211004,12211296,292,0.14161333899244413
4768,407.057567,407.087167,1,12211727,12212615,888,0.17693243022283886
4769,407.0941,407.1322,1,12212823,12213966,1143,0.12087286738593347
4770,407.1435,407.147267,1,12214305,12214418,113,0.8492106527019172
4771,407.154033,407.1667,1,12214620,12215001,381,0.24968230233521468
4772,407.167767,407.175467,1,12215033,12215264,231,0.812147605080062
4773,407.1805,407.184767,1,12215415,12215543,128,0.9343106920581734
4774,407.1932,407.201133,1,12215796,12216033,237,0.350804322132584
4775,407.2417,407.260033,1,12217251,12217800,549,0.008783060486670833
4776,407.293,407.300733,1,12218790,12219021,231,0.6781395979474875
4777,407.301733,407.318533,1,12219051,12219555,504,0.18149131245928407
4778,407.324533,407.333867,1,12219735,12220016,281,0.3174662499208484
4779,407.338333,407.3552,1,12220149,12220656,507,0.4944650330953224
4780,407.407167,407.410233,1,12222215,12222306,91,0.8820945513906879
4781,407.4114,407.464933,1,12222342,12223947,1605,0.20068886228394917
4782,407.466,407.475033,1,12223980,12224250,270,0.3027407925232448
4783,407.477433,407.482567,1,12224322,12224477,155,0.730577939175992
4784,407.483667,407.4924,1,12224510,12224772,262,0.7071115999877584
4785,407.511,407.575,1,12225330,12227250,1920,0.14771300076821436
4786,407.590667,407.5938,1,12227720,12227814,94,0.454532790500347
4787,407.595,407.598433,1,12227850,12227952,102,0.9134474484719299
4788,407.622267,407.632333,1,12228668,12228969,301,0.8562235634262231
4789,407.633533,407.636633,1,12229005,12229098,93,0.5624163635401693
4790,407.76,407.764633,1,12232800,12232938,138,0.7363914265701459
4791,407.778267,407.804233,1,12233348,12234126,778,0.5475385901553076
4792,407.816533,407.873967,1,12234495,12236219,1724,0.5989790006910335
4793,407.881633,407.911367,1,12236448,12237341,893,0.35521050041870955
4794,407.924733,407.933567,1,12237741,12238007,266,0.43764221334202114
4795,407.9404,407.954433,1,12238212,12238632,420,0.10827541316020571
4796,407.959333,407.992667,1,12238779,12239780,1001,0.3225315137066735
4797,408.000467,408.032167,1,12240014,12240965,951,0.39047924904999565
4798,408.050467,408.074833,1,12241514,12242244,730,0.22373906473465963
4799,408.077533,408.11,1,12242325,12243300,975,0.2771102757533551
4800,408.111133,408.1583,1,12243333,12244749,1416,0.30091999903271394
4801,408.163,408.174733,1,12244890,12245241,351,0.32878239115607183
4802,408.176167,408.195733,1,12245285,12245871,586,0.20193717790306925
4803,408.196733,408.2351,1,12245901,12247053,1152,0.33192166954702296
4804,408.245167,408.275533,1,12247355,12248265,910,0.4127624837003534
4805,408.2868,408.292167,1,12248604,12248765,161,0.7244818340450971
4806,408.2975,408.301633,1,12248925,12249048,123,0.8479253254060002
4807,408.306233,408.312533,1,12249186,12249375,189,0.8211942255007567
4808,408.3162,408.352567,1,12249486,12250577,1091,0.28353396662474034
4809,408.355867,408.371633,1,12250676,12251148,472,0.30415803379721706
4810,408.374333,408.379867,1,12251229,12251396,167,0.6031926221885556
4811,408.392967,408.4128,1,12251789,12252384,595,0.21601995955078093
4812,408.461933,408.4701,1,12253857,12254103,246,0.18498268580463245
4813,408.486333,408.5277,1,12254589,12255831,1242,0.5979116231763492
4814,408.536267,408.560333,1,12256088,12256809,721,0.5489956002492149
4815,408.675367,408.678767,1,12260261,12260363,102,0.8386155435568832
4816,408.759033,408.763,1,12262770,12262890,120,0.9208269794088505
4817,408.872367,408.883933,1,12266171,12266517,346,0.5846836659935758
4818,408.8867,408.893667,1,12266601,12266810,209,0.4343866911668125
4819,408.9068,408.912033,1,12267204,12267360,156,0.8624592750575779
4820,408.922133,408.937133,1,12267663,12268113,450,0.6249152879014785
4821,408.940133,408.944233,1,12268203,12268326,123,0.8941195744777624
4822,408.954133,408.9675,1,12268623,12269025,402,0.6277441448726072
4823,409.156233,409.232767,1,12274686,12276983,2297,0.1827715557975728
4824,409.236567,409.2414,1,12277097,12277242,145,-0.047754684869029076
4825,409.2453,409.255933,1,12277359,12277677,318,0.39977909601313577
4826,409.258467,409.2618,1,12277754,12277854,100,0.69828304135726
4827,409.2761,409.373033,1,12278283,12281190,2907,0.033673907310729854
4828,409.429267,409.4354,1,12282878,12283062,184,0.7310475549648965
4829,409.484667,409.4883,1,12284540,12284649,109,0.8656751698070423
4830,409.704867,409.710733,1,12291146,12291321,175,0.09413125763888504
4831,409.714333,409.774633,1,12291429,12293238,1809,0.16599160423786138
4832,409.7832,409.7922,1,12293496,12293766,270,0.5546951665165096
4833,409.7935,409.812967,1,12293805,12294389,584,0.4933382384496567
4834,409.818367,409.864433,1,12294551,12295932,1381,0.20693310814780264
4835,409.8729,409.9132,1,12296187,12297396,1209,0.20695925734029097
4836,409.920833,410.052767,1,12297624,12301583,3959,0.25186247832093667
4837,410.504467,410.586833,1,12315134,12317604,2470,0.1924669790641081
4838,410.589867,410.5934,1,12317696,12317802,106,0.6970584521323332
4839,410.595667,410.675167,1,12317870,12320255,2385,0.1961281633553487
4840,411.213267,411.235233,1,12336398,12337056,658,0.2427972633819928
4841,411.2378,411.246233,1,12337134,12337386,252,0.7622166017448903
4842,411.2624,411.2659,1,12337872,12337977,105,0.8112836017022645
4843,411.788867,411.792333,1,12353666,12353769,103,0.9017710308268967
4844,411.797667,411.803467,1,12353930,12354104,174,0.6747957805768077
4845,411.817333,411.828267,1,12354519,12354848,329,0.6787474168766238
4846,411.995667,412.058467,1,12359870,12361754,1884,0.1153324036807533
4847,412.061533,412.0805,1,12361845,12362415,570,0.2751379174560551
4848,412.0853,412.089533,1,12362559,12362685,126,0.5609433982068782
4849,412.0909,412.094433,1,12362727,12362832,105,0.7838278719422506
4850,412.096533,412.116867,1,12362895,12363506,611,0.32787478870866077
4851,412.121567,412.1368,1,12363647,12364104,457,0.011423523020254822
4852,412.1386,412.2169,1,12364158,12366507,2349,0.1567337000829671
4853,412.225633,412.2701,1,12366768,12368103,1335,0.27907070952888374
4854,412.300633,412.3038,1,12369018,12369114,96,0.719208931641608
4855,412.3052,412.342467,1,12369156,12370274,1118,0.3080263301466456
4856,412.354533,412.357867,1,12370635,12370736,101,0.9114914667520568
4857,412.360533,412.3638,1,12370815,12370914,99,0.825286060825489
4858,412.369267,412.3747,1,12371078,12371241,163,0.843543116934638
4859,412.4103,412.413433,1,12372309,12372402,93,0.6604616321285243
4860,412.4526,412.4643,1,12373578,12373929,351,0.663194605841297
4861,412.6252,412.6292,1,12378756,12378876,120,0.8257694946727243
4862,412.672833,412.854533,1,12380184,12385635,5451,0.7685447186489245
4863,412.8561,412.883467,1,12385683,12386504,821,0.6533859398204199
4864,412.887333,412.9473,1,12386619,12388419,1800,0.24086687090036651
4865,412.9496,413.064267,1,12388488,12391928,3440,0.24213282762880467
4866,413.066933,413.107933,1,12392007,12393237,1230,0.5229789026970065
4867,413.1101,413.164467,1,12393303,12394934,1631,0.20943646509665156
4868,413.177933,413.182233,1,12395337,12395466,129,0.4570912234127278
4869,413.188367,413.192233,1,12395651,12395766,115,0.8649162487519129
4870,413.198233,413.201233,1,12395946,12396036,90,-0.3092698674868691
4871,413.2067,413.2104,1,12396201,12396312,111,0.7122831797847529
4872,413.240167,413.260767,1,12397205,12397823,618,0.5255138438513176
4873,413.345,413.394867,1,12400350,12401846,1496,0.15803857352652964
4874,413.408033,413.423867,1,12402240,12402716,476,0.485710129148505
4875,413.4297,413.6217,1,12402891,12408651,5760,0.2242805083796283
4876,413.623233,413.6325,1,12408696,12408975,279,0.39756753537723566
4877,413.638167,413.692567,1,12409145,12410777,1632,0.23910393952275488
4878,413.6953,413.7115,1,12410859,12411345,486,0.15828758321997768
4879,413.717433,413.8061,1,12411522,12414183,2661,0.23110843633385975
4880,413.817533,413.8656,1,12414525,12415968,1443,0.06968929207594152
4881,413.8783,413.888167,1,12416349,12416645,296,0.7312849539798673
4882,413.907533,413.984767,1,12417225,12419543,2318,0.24590534427258678
4883,413.988567,414.0049,1,12419657,12420147,490,0.4346396150653875
4884,414.0183,414.117467,1,12420549,12423524,2975,0.2840534093895201
4885,414.1223,414.151433,1,12423669,12424542,873,0.2707400304012872
4886,414.1539,414.1585,1,12424617,12424755,138,0.843489610639658
4887,414.163033,414.1839,1,12424890,12425517,627,0.03139292313295892
4888,414.189767,414.199567,1,12425693,12425987,294,0.4519451005316589
4889,414.2887,414.2987,1,12428661,12428961,300,0.44502720931017653
4890,414.300867,414.320167,1,12429026,12429605,579,0.500665350608556
4891,414.3689,414.409533,1,12431067,12432285,1218,0.2571562133924205
4892,414.420167,414.425333,1,12432605,12432759,154,0.541482998447057
4893,414.426867,414.436267,1,12432806,12433088,282,0.17645994044480906
4894,414.439567,414.443467,1,12433187,12433304,117,0.7239647791447171
4895,414.444667,414.490167,1,12433340,12434705,1365,0.17104681494796867
4896,414.495867,414.538667,1,12434876,12436160,1284,0.3146273681009889
4897,414.553533,414.5588,1,12436605,12436764,159,0.8128786234200133
4898,414.576967,414.613067,1,12437309,12438392,1083,0.5145123295996004
4899,414.6246,414.632567,1,12438738,12438977,239,0.660441638003946
4900,414.663967,414.676033,1,12439919,12440280,361,0.5840770388114416
4901,414.6843,414.694367,1,12440529,12440831,302,0.5469828125716968
4902,414.695433,414.717967,1,12440862,12441539,677,0.467124608089581
4903,414.722133,414.735367,1,12441663,12442061,398,0.950259784521515
4904,414.750867,414.757133,1,12442526,12442713,187,0.8532214448077735
4905,414.7594,414.770033,1,12442782,12443100,318,0.7487882364410452
4906,414.777467,414.805367,1,12443324,12444161,837,0.24901179073975396
4907,414.806933,414.820033,1,12444207,12444600,393,0.8252772435846517
4908,414.881267,414.934567,1,12446438,12448037,1599,0.3646142176871069
4909,414.9406,414.951967,1,12448218,12448559,341,0.8350771090475357
4910,414.9559,414.984733,1,12448677,12449541,864,0.8281545210904944
4911,415.002233,415.0073,1,12450066,12450219,153,0.8796831067123121
4912,415.016133,415.0255,1,12450483,12450765,282,0.8526826084961301
4913,415.0297,415.042267,1,12450891,12451268,377,0.8587145423501169
4914,415.0804,415.111867,1,12452412,12453356,944,0.5624366023724405
4915,415.1152,415.2396,1,12453456,12457188,3732,0.532606724328283
4916,415.258067,415.2855,1,12457742,12458565,823,0.8446145457216383
4917,415.299067,415.401567,1,12458972,12462047,3075,0.5943788150663097
4918,415.4026,415.4183,1,12462078,12462549,471,0.9419653717661477
4919,415.429967,415.4437,1,12462899,12463311,412,0.26148396849167477
4920,415.4483,415.454667,1,12463449,12463640,191,0.8467727603404459
4921,415.456633,415.461033,1,12463698,12463830,132,0.9248462077927869
4922,415.4656,415.469633,1,12463968,12464088,120,0.48453582045608945
4923,415.4714,415.5099,1,12464142,12465297,1155,0.5189852007207874
4924,415.522733,415.528633,1,12465681,12465858,177,0.7402870340476464
4925,415.538633,415.548533,1,12466158,12466455,297,0.9304897651406467
4926,415.549633,415.5593,1,12466488,12466779,291,0.2892966259605295
4927,415.573933,415.584767,1,12467217,12467543,326,0.30539112257572026
4928,415.6022,415.6101,1,12468066,12468303,237,0.7333928747596848
4929,415.6114,415.6147,1,12468342,12468441,99,0.8177428488109247
4930,415.617733,415.6219,1,12468531,12468657,126,0.7754223349262147
4931,415.623067,415.6392,1,12468692,12469176,484,0.8199129713592026
4932,415.640433,415.673133,1,12469212,12470193,981,0.42409551515987565
4933,415.689667,415.694933,1,12470690,12470847,157,0.8574947410097009
4934,415.6975,415.7651,1,12470925,12472953,2028,0.3721220201129834
4935,415.8236,415.854133,1,12474708,12475623,915,0.28229570394338804
4936,415.869633,415.915767,1,12476088,12477473,1385,0.45526231365633685
4937,415.922833,415.945433,1,12477684,12478362,678,0.7721240697429607
4938,415.946733,415.951767,1,12478401,12478553,152,0.7633360573349653
4939,415.952933,415.964833,1,12478587,12478944,357,0.19892172404468456
4940,416.0071,416.026167,1,12480213,12480785,572,0.7846884722343632
4941,416.031,416.0464,1,12480930,12481392,462,0.6535848557337104
4942,416.089,416.099133,1,12482670,12482973,303,0.5568783368436911
4943,416.100567,416.104967,1,12483017,12483149,132,0.756222021581248
4944,416.109,416.117933,1,12483270,12483537,267,0.8281522284070204
4945,416.1208,416.134033,1,12483624,12484020,396,0.830819559932059
4946,416.137333,416.1868,1,12484119,12485604,1485,0.5442843589869754
4947,416.1938,416.1989,1,12485814,12485967,153,0.9497214300430334
4948,416.2008,416.268233,1,12486024,12488046,2022,0.47840876416058575
4949,416.303333,416.319633,1,12489099,12489588,489,0.6814749070982278
4950,416.386533,416.390867,1,12491595,12491726,131,0.8271900885916753
4951,416.406,416.409,1,12492180,12492270,90,0.8124552925968241
4952,416.421867,416.425033,1,12492656,12492750,94,0.9341890649203505
4953,416.451333,416.464467,1,12493539,12493934,395,0.7205347686993023
4954,416.467033,416.4829,1,12494010,12494487,477,0.6895027367550338
4955,416.484533,416.4958,1,12494535,12494874,339,0.5637560837383733
4956,416.51,416.5155,1,12495300,12495465,165,0.894440634901359
4957,416.517067,416.528333,1,12495512,12495849,337,0.8381061230920731
4958,416.5357,416.569433,1,12496071,12497082,1011,0.5277045669000677
4959,416.5751,416.608533,1,12497253,12498255,1002,0.4267202236073732
4960,416.6096,416.616167,1,12498288,12498485,197,0.5680433966518036
4961,416.650933,416.6673,1,12499527,12500019,492,0.7793106158826775
4962,416.686333,416.692733,1,12500589,12500781,192,0.7902930651129101
4963,416.703733,416.708667,1,12501111,12501260,149,0.7780709552615304
4964,416.716133,416.720867,1,12501483,12501626,143,0.8859523063446307
4965,416.732567,416.736667,1,12501977,12502100,123,0.6793847242140625
4966,416.739367,416.775733,1,12502181,12503271,1090,0.45402516729232967
4967,416.7824,416.7987,1,12503472,12503961,489,0.7633351294934804
4968,416.804467,416.8489,1,12504134,12505467,1333,0.4931548714104176
4969,416.859233,416.8742,1,12505776,12506226,450,-0.01718699205861946
4970,416.880233,416.885633,1,12506406,12506568,162,0.7863487520791403
4971,416.893867,416.897733,1,12506816,12506931,115,0.8788541814512872
4972,416.8991,416.933233,1,12506973,12507996,1023,0.6965099058876061
4973,416.961833,416.998467,1,12508854,12509954,1100,0.3689540335009776
4974,416.999467,417.013367,1,12509984,12510401,417,0.8040842736965839
4975,417.0144,417.018567,1,12510432,12510557,125,0.8049942943750058
4976,417.0197,417.0271,1,12510591,12510813,222,0.7393895111218249
4977,417.063233,417.067933,1,12511896,12512037,141,0.7821453692907888
4978,417.077967,417.085267,1,12512339,12512558,219,0.983571720748826
4979,417.086933,417.0953,1,12512607,12512859,252,0.9306528462937916
4980,417.1149,417.139933,1,12513447,12514197,750,0.6838057148275003
4981,417.141967,417.1478,1,12514259,12514434,175,0.9633449101000111
4982,417.1488,417.167567,1,12514464,12515027,563,0.8598593754220659
4983,417.169233,417.1754,1,12515076,12515262,186,0.9583281920602601
4984,417.203367,417.2138,1,12516101,12516414,313,0.5406466161244127
4985,417.2222,417.264433,1,12516666,12517932,1266,0.6811807276916737
4986,417.269367,417.2972,1,12518081,12518916,835,0.7184877639420149
4987,417.3014,417.317667,1,12519042,12519530,488,0.623769412815606
4988,417.327667,417.347033,1,12519830,12520410,580,0.7643430248517865
4989,417.352567,417.357,1,12520577,12520710,133,0.7106536620516424
4990,417.386967,417.3977,1,12521609,12521931,322,0.6037940368542194
4991,417.4113,417.440733,1,12522339,12523221,882,0.4670938706126498
4992,417.4514,417.4625,1,12523542,12523875,333,0.7527318203360538
4993,417.467367,417.494767,1,12524021,12524843,822,0.6993068096513365
4994,417.5025,417.508167,1,12525075,12525245,170,0.9081215567780201
4995,417.5094,417.550333,1,12525282,12526509,1227,0.6892934990806823
4996,417.551533,417.556867,1,12526545,12526706,161,0.41077234857542505
4997,417.6317,417.635467,1,12528951,12529064,113,0.472452595553567
4998,417.650367,417.6773,1,12529511,12530319,808,0.17397616029392252
4999,417.694133,417.6992,1,12530823,12530976,153,0.9068739682083627
5000,417.705933,417.711533,1,12531177,12531345,168,0.6839185785356668
5001,417.730267,417.7373,1,12531908,12532119,211,0.8708629632389923
5002,417.750667,417.7715,1,12532520,12533145,625,0.6086733617850677
5003,417.777133,417.797067,1,12533313,12533912,599,0.7768020219060373
5004,417.801967,417.811633,1,12534059,12534348,289,0.5768403439833982
5005,417.830333,417.841933,1,12534909,12535257,348,0.7650110796894348
5006,417.852567,417.864,1,12535577,12535920,343,0.8206214645500067
5007,417.869233,417.877,1,12536076,12536310,234,0.8694054175336455
5008,417.895267,417.947067,1,12536858,12538412,1554,0.7171282529015064
5009,417.948667,417.968333,1,12538460,12539049,589,0.673408787806325
5010,417.971767,418.0292,1,12539153,12540876,1723,0.6489850695025418
5011,418.030767,418.043233,1,12540923,12541296,373,0.4194637997778197
5012,418.045067,418.054,1,12541352,12541620,268,0.7588953081462798
5013,418.0659,418.0976,1,12541977,12542928,951,0.47389890265412526
5014,418.0991,418.1327,1,12542973,12543981,1008,0.31435342157445023
5015,418.134033,418.159633,1,12544020,12544788,768,0.741041390423269
5016,418.2003,418.210833,1,12546009,12546324,315,0.15666019591782698
5017,418.220233,418.224,1,12546606,12546720,114,0.790382329986368
5018,418.257167,418.265533,1,12547715,12547965,250,0.6848451051325251
5019,418.269633,418.273233,1,12548088,12548196,108,0.8534540155321227
5020,418.276267,418.321167,1,12548288,12549635,1347,0.26781245995870057
5021,418.339133,418.348933,1,12550173,12550467,294,0.4631805943940597
5022,418.377267,418.427767,1,12551318,12552833,1515,0.6331497431854315
5023,418.446367,418.450167,1,12553391,12553505,114,0.6366362198043477
5024,418.463133,418.517733,1,12553893,12555531,1638,0.4870643701653386
5025,418.527667,418.532333,1,12555830,12555969,139,0.9031529157930381
5026,418.533333,418.5503,1,12555999,12556509,510,0.6190372450247017
5027,418.581567,418.587867,1,12557447,12557636,189,0.2309704127452787
5028,418.604533,418.621233,1,12558135,12558636,501,0.4292195465752359
5029,418.6263,418.6374,1,12558789,12559122,333,0.8497061988947711
5030,418.646967,418.652633,1,12559409,12559578,169,0.8592122674044016
5031,418.653633,418.665567,1,12559608,12559967,359,0.3188385398214472
5032,418.6694,418.672733,1,12560082,12560181,99,0.6675536583121848
5033,418.678667,418.683367,1,12560360,12560501,141,0.449261796424956
5034,418.691667,418.704233,1,12560750,12561126,376,0.8206450357184722
5035,418.712433,418.737633,1,12561372,12562128,756,0.4771399864953837
5036,418.738867,418.7606,1,12562166,12562818,652,0.8140464937659734
5037,418.827933,418.857367,1,12564837,12565721,884,0.6401359850078215
5038,418.858367,418.912967,1,12565751,12567389,1638,0.3689639278921658
5039,418.9179,418.950333,1,12567537,12568509,972,0.24634765369803419
5040,418.955533,418.9671,1,12568665,12569013,348,0.43792679477453356
5041,418.9681,418.975533,1,12569043,12569265,222,0.8112008648935702
5042,418.984,419.016033,1,12569520,12570480,960,0.7475193245149339
5043,419.025267,419.046433,1,12570758,12571392,634,0.23256096630735468
5044,419.0574,419.089833,1,12571722,12572694,972,0.4985833388549335
5045,419.107367,419.1189,1,12573221,12573567,346,0.3630786244454546
5046,419.157367,419.1652,1,12574721,12574956,235,0.6472062649082744
5047,419.167767,419.1724,1,12575033,12575172,139,0.8483766094188497
5048,419.186,419.207233,1,12575580,12576216,636,0.355336596685012
5049,419.2108,419.244633,1,12576324,12577338,1014,0.7004525274666537
5050,419.2638,419.2721,1,12577914,12578163,249,0.24332563143107833
5051,419.3209,419.33,1,12579627,12579900,273,0.8016065497037602
5052,419.336133,419.358133,1,12580083,12580743,660,0.28259754597791464
5053,419.373567,419.4087,1,12581207,12582261,1054,0.5829675629565614
5054,419.4114,419.416067,1,12582342,12582482,140,0.14622171419458654
5055,419.435833,419.439333,1,12583074,12583179,105,0.9195464036878007
5056,419.46,419.4649,1,12583800,12583947,147,0.9329440231545362
5057,419.4714,419.4751,1,12584142,12584253,111,0.6676106313253233
5058,419.5171,419.534833,1,12585513,12586044,531,0.6753297222002167
5059,419.547,419.551833,1,12586410,12586554,144,0.42640052438350623
5060,419.5551,419.591333,1,12586653,12587739,1086,0.7051993347210981
5061,419.595433,419.6063,1,12587862,12588189,327,0.8787383921867867
5062,419.6118,419.6372,1,12588354,12589116,762,0.6225880571502234
5063,419.650433,419.682833,1,12589512,12590484,972,0.28111785306533893
5064,419.6937,419.6983,1,12590811,12590949,138,0.8536416774103492
5065,419.699733,419.712267,1,12590991,12591368,377,0.8883645866407384
5066,419.7795,419.785467,1,12593385,12593564,179,0.5674719220095819
5067,419.8145,419.830033,1,12594435,12594900,465,0.945161609166619
5068,419.831667,419.8419,1,12594950,12595257,307,0.8963671393269771
5069,419.848767,419.851867,1,12595463,12595556,93,0.6758310202298057
5070,419.8594,419.865133,1,12595782,12595953,171,0.7926700055920972
5071,419.871667,419.8916,1,12596150,12596748,598,0.6228937156007671
5072,419.925867,419.9357,1,12597776,12598071,295,0.8045955615331396
5073,420.1071,420.1102,1,12603213,12603306,93,0.8510129041763265
5074,420.1191,420.1233,1,12603573,12603699,126,0.9872603521597639
5075,420.2172,420.222567,1,12606516,12606677,161,0.5715623878273897
5076,420.667267,420.6736,1,12620018,12620208,190,0.9215068257672614
5077,421.358367,421.386167,1,12640751,12641585,834,0.3588052508560059
5078,421.431433,421.4437,1,12642942,12643311,369,0.5825638374311958
5079,421.448433,421.457067,1,12643452,12643712,260,0.7490722409837736
5080,421.484933,421.523233,1,12644547,12645696,1149,0.2469552898885561
5081,421.5311,421.581933,1,12645933,12647457,1524,0.24972611105357193
5082,421.5917,421.627133,1,12647751,12648813,1062,0.39833839421915296
5083,421.636767,421.648567,1,12649103,12649457,354,0.7144262004696825
5084,421.662567,421.684367,1,12649877,12650531,654,0.2579602209707636
5085,421.690333,421.696067,1,12650709,12650882,173,0.8229320958029928
5086,421.704,421.709367,1,12651120,12651281,161,0.4314298797281628
5087,421.714233,421.769133,1,12651426,12653073,1647,0.33181402039148944
5088,421.815867,421.819467,1,12654476,12654584,108,0.7174590406638188
5089,421.873733,421.885633,1,12656211,12656568,357,0.4337227948682632
5090,421.904667,421.909133,1,12657140,12657273,133,0.8526198979231423
5091,421.947233,421.951867,1,12658416,12658556,140,0.4117923668546683
5092,422.000267,422.018467,1,12660008,12660554,546,0.3839086546692525
5093,422.024233,422.0291,1,12660726,12660873,147,0.8432875556718139
5094,422.082033,422.100267,1,12662460,12663008,548,0.7381331998037157
5095,422.1018,422.1187,1,12663054,12663561,507,0.8160899568635632
5096,422.129067,422.135933,1,12663872,12664077,205,0.8344643681453928
5097,422.142633,422.152233,1,12664278,12664566,288,0.9067094907536267
5098,422.155833,422.175833,1,12664674,12665274,600,0.3802255935550092
5099,422.177267,422.1806,1,12665318,12665418,100,0.7665613188566389
5100,422.182933,422.210233,1,12665487,12666306,819,0.5885238533717385
5101,422.222833,422.236967,1,12666684,12667109,425,0.7709710882539039
5102,422.238033,422.263533,1,12667140,12667905,765,0.6053946277508733
5103,422.315433,422.3189,1,12669462,12669567,105,0.892567011479764
5104,422.4699,422.474567,1,12674097,12674237,140,0.8052978969541349
5105,422.478567,422.488567,1,12674357,12674657,300,0.6618513544730816
5106,422.494367,422.497433,1,12674831,12674922,91,0.8257549015704319
5107,422.528067,422.545167,1,12675842,12676355,513,0.6857927817326801
5108,422.574233,422.589233,1,12677226,12677676,450,0.8276879048720471
5109,422.6316,422.639733,1,12678948,12679191,243,0.5529821385835434
5110,422.678633,422.6952,1,12680358,12680856,498,0.26978872705035906
5111,422.698167,422.703267,1,12680945,12681098,153,0.7466013534841941
5112,422.708667,422.763233,1,12681260,12682896,1636,0.5436278806264921
5113,422.796433,422.867,1,12683892,12686010,2118,0.49422499208618187
5114,422.875667,422.897933,1,12686270,12686937,667,0.6636488467305729
5115,422.909,422.916467,1,12687270,12687494,224,0.7255588278533138
5116,422.9178,422.921433,1,12687534,12687642,108,0.7726756976019998
5117,422.927333,422.932867,1,12687819,12687986,167,0.6154186864095186
5118,422.9592,422.9625,1,12688776,12688875,99,0.9092847569428109
5119,422.9951,423.000133,1,12689853,12690003,150,0.6526302983323127
5120,423.0089,423.035833,1,12690267,12691074,807,0.7743822831400865
5121,423.050967,423.063933,1,12691529,12691917,388,0.5903317151086259
5122,423.065533,423.071667,1,12691965,12692150,185,0.8679555223549953
5123,423.072833,423.078067,1,12692184,12692342,158,0.7361817242898611
5124,423.079267,423.095067,1,12692378,12692852,474,0.8378697051821143
5125,423.1312,423.136633,1,12693936,12694098,162,0.798689850401224
5126,423.1378,423.146333,1,12694134,12694389,255,0.8221631629351575
5127,423.195533,423.202167,1,12695865,12696065,200,0.4662219463297247
5128,423.205033,423.235433,1,12696150,12697062,912,0.4729373722879284
5129,423.253333,423.286033,1,12697599,12698580,981,0.8262121297247735
5130,423.2872,423.318733,1,12698616,12699561,945,0.642936057893722
5131,423.326033,423.330333,1,12699780,12699909,129,0.7974071882424657
5132,423.3314,423.341267,1,12699942,12700238,296,0.7619899850638048
5133,423.3468,423.352433,1,12700404,12700572,168,0.79063350283947
5134,423.356233,423.3596,1,12700686,12700788,102,0.7929039936254668
5135,423.3679,423.371133,1,12701037,12701133,96,0.9136263502116807
5136,423.381067,423.388967,1,12701432,12701669,237,0.887974282897971
5137,423.390067,423.395433,1,12701702,12701862,160,0.8976867524872941
5138,423.406467,423.4102,1,12702194,12702306,112,0.8449872440824063
5139,423.425567,423.452633,1,12702767,12703578,811,0.6015451622045686
5140,423.4593,423.4707,1,12703779,12704121,342,0.8278203609238165
5141,423.478367,423.4878,1,12704351,12704634,283,0.5665574598853791
5142,423.512233,423.544567,1,12705366,12706337,971,0.5988188197010095
5143,423.547867,423.569467,1,12706436,12707084,648,0.34687456959010693
5144,423.570467,423.582433,1,12707114,12707472,358,0.7052476520593448
5145,423.583633,423.5874,1,12707508,12707622,114,0.8201386550399351
5146,423.6026,423.619433,1,12708078,12708582,504,0.5874669204689397
5147,423.623433,423.6273,1,12708702,12708819,117,0.840393688566539
5148,423.633367,423.648133,1,12709001,12709443,442,0.7378509982258499
5149,423.6628,423.672067,1,12709884,12710162,278,0.7677370892154247
5150,423.6746,423.6874,1,12710238,12710622,384,0.7812623292401376
5151,423.695767,423.699967,1,12710873,12710999,126,0.7765166925002506
5152,423.720733,423.775167,1,12711621,12713255,1634,0.3889129700112227
5153,423.8116,423.861767,1,12714348,12715853,1505,0.630059215823875
5154,423.864133,423.883633,1,12715923,12716508,585,0.7667108089415136
5155,423.884967,423.902433,1,12716549,12717072,523,0.875743992014025
5156,423.921,423.944633,1,12717630,12718338,708,0.29935507632192254
5157,423.957,423.967167,1,12718710,12719015,305,0.7396522050729455
5158,423.971933,423.9971,1,12719157,12719913,756,0.07087476827452883
5159,424.003533,424.0115,1,12720105,12720345,240,0.7439094463093892
5160,424.055167,424.058433,1,12721655,12721752,97,0.8423223151999902
5161,424.107267,424.1121,1,12723218,12723363,145,0.8993979638180812
5162,424.114233,424.124233,1,12723426,12723726,300,0.906557171432796
5163,424.125833,424.130933,1,12723774,12723927,153,0.9239836865060769
5164,424.1321,424.183967,1,12723963,12725519,1556,0.7238118414330534
5165,424.2082,424.216033,1,12726246,12726480,234,0.8771241727801251
5166,424.217367,424.230267,1,12726521,12726908,387,0.5313075318387062
5167,424.242333,424.2485,1,12727269,12727455,186,0.7405895012325311
5168,424.2515,424.259233,1,12727545,12727776,231,0.13039512164361267
5169,424.263167,424.275133,1,12727895,12728253,358,0.3612647482500481
5170,424.276533,424.2852,1,12728295,12728556,261,0.8949635882360222
5171,424.297633,424.3096,1,12728928,12729288,360,0.39617823774775246
5172,424.336,424.344767,1,12730080,12730343,263,0.6172803345643046
5173,424.350133,424.353833,1,12730503,12730614,111,0.6085736394020969
5174,424.388733,424.391933,1,12731661,12731757,96,0.9373576575972394
5175,424.401267,424.4047,1,12732038,12732141,103,0.899972890119324
5176,424.412333,424.416033,1,12732369,12732480,111,0.7824130480793879
5177,424.421067,424.432167,1,12732632,12732965,333,0.5998176163973888
5178,424.443533,424.448367,1,12733305,12733451,146,0.7637125890151942
5179,424.4599,424.473033,1,12733797,12734190,393,0.6320890329194266
5180,424.474467,424.481633,1,12734234,12734448,214,0.8238564208732823
5181,424.482633,424.486067,1,12734478,12734582,104,0.9344824934488525
5182,424.4933,424.5036,1,12734799,12735108,309,0.8800815295872448
5183,424.5192,424.538633,1,12735576,12736158,582,0.08672658197998907
5184,424.5547,424.5595,1,12736641,12736785,144,0.8437102731659145
5185,424.584733,424.589467,1,12737541,12737684,143,0.3427875975993835
5186,424.590633,424.596333,1,12737718,12737889,171,0.6321392281080751
5187,424.644467,424.6526,1,12739334,12739578,244,0.7541188723350548
5188,424.724967,424.7404,1,12741749,12742212,463,0.8045884814407961
5189,424.752133,424.7559,1,12742563,12742677,114,-0.23284381647726315
5190,424.765267,424.768467,1,12742958,12743054,96,0.8284180919545648
5191,424.770767,424.782767,1,12743123,12743483,360,0.767073266354036
5192,424.783767,424.788267,1,12743513,12743648,135,0.9272486504189107
5193,424.790733,424.7997,1,12743721,12743991,270,0.6705299404989885
5194,424.811633,424.8289,1,12744348,12744867,519,0.4939669659503645
5195,424.842,424.8483,1,12745260,12745449,189,0.6531444685321218
5196,424.8497,424.861133,1,12745491,12745833,342,0.7442092523273299
5197,424.8769,424.8992,1,12746307,12746976,669,0.6547405335990302
5198,424.902333,424.906133,1,12747069,12747183,114,0.7587386852683284
5199,424.915267,424.937733,1,12747458,12748131,673,0.793670011823951
5200,424.949733,424.9541,1,12748491,12748623,132,0.7417711226471786
5201,424.956367,424.9694,1,12748691,12749082,391,0.653240779959306
5202,425.008467,425.028,1,12750254,12750840,586,0.05097776519700021
5203,425.0361,425.054467,1,12751083,12751634,551,0.2551149562304998
5204,425.0638,425.068733,1,12751914,12752061,147,0.9405550472624099
5205,425.071033,425.0822,1,12752130,12752466,336,0.3025259976412115
5206,425.092233,425.147,1,12752766,12754410,1644,0.3175316361495203
5207,425.2211,425.239967,1,12756633,12757199,566,0.5917641636501035
5208,425.2485,425.2693,1,12757455,12758079,624,0.7465943620952189
5209,425.274567,425.314967,1,12758237,12759449,1212,0.15117366248815955
5210,425.319067,425.324267,1,12759572,12759728,156,0.5695704886249918
5211,425.3256,425.328633,1,12759768,12759858,90,0.5733084723319276
5212,425.347967,425.353533,1,12760439,12760605,166,0.48202926394562823
5213,425.378133,425.387067,1,12761343,12761612,269,0.6588637163862774
5214,425.403567,425.436433,1,12762107,12763092,985,0.027166702337903213
5215,425.4433,425.4502,1,12763299,12763506,207,0.8003931531530579
5216,425.498433,425.503333,1,12764952,12765099,147,0.46598620052017664
5217,425.5405,425.543967,1,12766215,12766319,104,0.94019549162987
5218,425.5635,425.573967,1,12766905,12767219,314,0.6099885151892339
5219,425.5903,425.5989,1,12767709,12767967,258,0.3549360760037467
5220,425.6054,425.6335,1,12768162,12769005,843,0.46571765386707387
5221,425.674433,425.6845,1,12770232,12770535,303,0.8611347640661013
5222,425.7041,425.738033,1,12771123,12772140,1017,0.27915700066333454
5223,425.7702,425.8009,1,12773106,12774027,921,0.831776202072151
5224,425.803233,425.8145,1,12774096,12774435,339,0.6901532269020899
5225,425.815933,425.884067,1,12774477,12776522,2045,0.3904334803828435
5226,425.923967,425.930767,1,12777719,12777923,204,0.809122022207289
5227,425.952067,425.9607,1,12778562,12778821,259,0.7607133172585904
5228,425.980133,425.9905,1,12779403,12779715,312,0.7338996590720261
5229,426.010467,426.0254,1,12780314,12780762,448,0.5568874592727502
5230,426.046867,426.059033,1,12781406,12781770,364,0.7179288651253625
5231,426.070067,426.075967,1,12782102,12782279,177,0.8294229857934078
5232,426.087,426.1152,1,12782610,12783456,846,0.7613495223672351
5233,426.116833,426.132533,1,12783504,12783975,471,0.7252342098067986
5234,426.139733,426.152933,1,12784191,12784587,396,0.7348539290204483
5235,426.1711,426.174433,1,12785133,12785232,99,0.43469450100261803
5236,426.177967,426.1884,1,12785339,12785652,313,0.8308822790310911
5237,426.200967,426.204633,1,12786029,12786138,109,0.8782661687693383
5238,426.263933,426.311433,1,12787917,12789342,1425,0.7168660275954561
5239,426.3127,426.321733,1,12789381,12789651,270,0.9163024746438686
5240,426.327567,426.335567,1,12789827,12790067,240,0.552201104099437
5241,426.3435,426.3586,1,12790305,12790758,453,0.7577888033213178
5242,426.421767,426.432767,1,12792653,12792983,330,0.6905180319421079
5243,426.459433,426.467533,1,12793782,12794025,243,0.8115385026863832
5244,426.470933,426.4951,1,12794127,12794853,726,0.7400070295954695
5245,426.497733,426.5121,1,12794931,12795363,432,0.7883364027823176
5246,426.5132,426.5207,1,12795396,12795621,225,0.5196826546279268
5247,426.522,426.5251,1,12795660,12795753,93,0.8262103439397063
5248,426.5289,426.541633,1,12795867,12796248,381,0.7464641711649673
5249,426.545933,426.5518,1,12796377,12796554,177,0.8585889503172034
5250,426.622667,426.639167,1,12798680,12799175,495,0.8797806266559938
5251,426.6509,426.661867,1,12799527,12799856,329,0.6857967659909334
5252,426.6694,426.6734,1,12800082,12800202,120,0.86746912390175
5253,426.678567,426.688833,1,12800357,12800664,307,0.7193333491233063
5254,426.7081,426.713867,1,12801243,12801416,173,0.6139465355599609
5255,426.715567,426.72,1,12801467,12801600,133,0.9266868462566639
5256,426.733833,426.750133,1,12802014,12802503,489,0.672008640329676
5257,426.772933,426.780133,1,12803187,12803403,216,0.6222367507256351
5258,426.810733,426.8147,1,12804321,12804441,120,0.43873300200582444
5259,426.870267,426.874,1,12806108,12806220,112,0.7788711656621252
5260,426.893,426.9039,1,12806790,12807117,327,0.8320324476889028
5261,426.940933,426.947767,1,12808227,12808433,206,0.7596595327778479
5262,426.9982,427.001467,1,12809946,12810044,98,0.8163998721459998
5263,427.0742,427.0821,1,12812226,12812463,237,0.6461682396440797
5264,427.0831,427.0871,1,12812493,12812613,120,0.889365942302288
5265,427.0881,427.113967,1,12812643,12813419,776,0.4197693983062949
5266,427.121433,427.137467,1,12813642,12814124,482,0.1896195646232095
5267,427.1453,427.151433,1,12814359,12814542,183,0.8521134958366754
5268,427.189133,427.1924,1,12815673,12815772,99,0.8499528749347556
5269,427.203867,427.227867,1,12816116,12816836,720,0.8013407385212828
5270,427.2524,427.255867,1,12817572,12817676,104,0.883643719368852
5271,427.257833,427.2616,1,12817734,12817848,114,0.29238111347598933
5272,427.333367,427.347567,1,12820001,12820427,426,0.8252340386455986
5273,427.355233,427.364933,1,12820656,12820947,291,0.8452151086562574
5274,427.388067,427.3918,1,12821642,12821754,112,0.8810696957959951
5275,427.401633,427.414033,1,12822048,12822420,372,0.7034938996460686
5276,427.424567,427.430667,1,12822737,12822920,183,0.6922796871694387
5277,427.438033,427.442733,1,12823140,12823281,141,0.832667014563939
5278,427.504067,427.5131,1,12825122,12825393,271,0.7859417899032667
5279,427.566633,427.571333,1,12826998,12827139,141,0.7320129492652087
5280,427.590667,427.595233,1,12827720,12827856,136,0.3122853102430018
5281,427.6166,427.627067,1,12828498,12828812,314,0.7979704478919284
5282,427.6422,427.6457,1,12829266,12829371,105,0.8546713986087514
5283,427.657067,427.665133,1,12829712,12829953,241,0.8002388708075212
5284,427.689867,427.6974,1,12830696,12830922,226,0.5529649290597746
5285,427.833467,427.844233,1,12835004,12835326,322,0.6682194401096239
5286,427.847533,427.8581,1,12835425,12835743,318,0.7615933981172563
5287,427.860767,427.897833,1,12835823,12836934,1111,0.35820667358011127
5288,427.899167,427.902967,1,12836975,12837089,114,0.8865926944394554
5289,427.910233,427.928267,1,12837306,12837848,542,0.5736842291719872
5290,427.929567,427.941633,1,12837887,12838248,361,0.7695843889546644
5291,427.9443,427.950767,1,12838329,12838523,194,0.7678572619852309
5292,427.971267,427.974767,1,12839138,12839243,105,0.6432741823354298
5293,428.027033,428.041867,1,12840810,12841256,446,0.8629340428081218
5294,428.0584,428.061833,1,12841752,12841854,102,0.9366529259772
5295,428.076433,428.0808,1,12842292,12842424,132,0.6588934355440631
5296,428.129733,428.134433,1,12843891,12844032,141,0.7948498601403946
5297,428.227167,428.2312,1,12846815,12846936,121,0.7541663713932315
5298,428.287833,428.292667,1,12848634,12848780,146,0.6829120108190688
5299,428.297867,428.3034,1,12848936,12849102,166,0.8537160537052935
5300,428.3191,428.324,1,12849573,12849720,147,0.903951071752368
5301,428.329,428.343933,1,12849870,12850317,447,0.7504315182726404
5302,428.4408,428.443867,1,12853224,12853316,92,0.6542861921726353
5303,428.532133,428.546867,1,12855963,12856406,443,0.5849772854085906
5304,428.555167,428.565767,1,12856655,12856973,318,0.728487667027315
5305,428.630067,428.6331,1,12858902,12858993,91,0.8965555577603636
5306,428.6392,428.648133,1,12859176,12859443,267,0.8707681855137985
5307,428.657367,428.6765,1,12859721,12860295,574,0.5560624255365828
5308,428.684333,428.687933,1,12860529,12860637,108,0.9286240279729182
5309,428.8335,428.837433,1,12865005,12865122,117,0.8704182843612687
5310,428.864767,428.8813,1,12865943,12866439,496,0.6797724063956846
5311,428.8835,428.894933,1,12866505,12866847,342,0.6573755131463599
5312,428.933533,428.947667,1,12868005,12868430,425,0.7701645615232585
5313,429.281967,429.2862,1,12878459,12878586,127,0.7413403384123398
5314,429.288067,429.2966,1,12878642,12878898,256,0.5607094389475936
5315,429.3025,429.3067,1,12879075,12879201,126,0.8439691053079916
5316,429.438333,429.4444,1,12883149,12883332,183,0.2617394911119256
5317,429.577967,429.582233,1,12887339,12887466,127,0.3486784686156105
5318,429.6242,429.628967,1,12888726,12888869,143,0.4181416927799534
5319,429.671667,429.674833,1,12890150,12890244,94,0.833684279391871
5320,429.700467,429.706033,1,12891014,12891180,166,0.7757147241237813
5321,429.7622,429.767333,1,12892866,12893019,153,0.461663108261677
5322,429.793267,429.806433,1,12893798,12894192,394,0.3108985751655762
5323,429.898567,429.901667,1,12896957,12897050,93,0.8227721460766513
5324,429.9102,429.9157,1,12897306,12897471,165,0.9138647175791134
5325,430.112267,430.115667,1,12903368,12903470,102,0.20440008196822548
5326,430.491267,430.511267,1,12914738,12915338,600,0.33647549840617136
5327,430.517733,430.530067,1,12915531,12915902,371,0.6819138560154964
5328,430.6833,430.686333,1,12920499,12920589,90,0.7897799060625411
5329,430.711867,430.723067,1,12921356,12921692,336,0.5136204450905016
5330,430.732167,430.848967,1,12921965,12925469,3504,0.27028345808965104
5331,430.853733,430.859033,1,12925611,12925770,159,0.8382639005026485
5332,430.889167,430.922833,1,12926675,12927684,1009,0.21816826802920408
5333,430.925067,430.996667,1,12927752,12929900,2148,0.24235970302514892
5334,431.031367,431.0883,1,12930941,12932649,1708,0.19379627134732408
5335,431.091467,431.168367,1,12932744,12935051,2307,0.15729106732081322
5336,431.179433,431.205333,1,12935382,12936159,777,0.6079768036333263
5337,431.239267,431.242367,1,12937178,12937271,93,0.64849131161228
5338,431.2785,431.283133,1,12938355,12938493,138,0.46823088856422107
5339,431.2884,431.2965,1,12938652,12938895,243,0.8794358363180999
5340,431.298033,431.313233,1,12938940,12939396,456,0.5167176029192595
5341,431.321533,431.333367,1,12939645,12940001,356,0.9450231024312469
5342,431.3345,431.340467,1,12940035,12940214,179,0.8070187666502089
5343,431.341533,431.354767,1,12940245,12940643,398,0.9322312904870647
5344,431.358833,431.4023,1,12940764,12942069,1305,0.742394981811717
5345,431.403367,431.4077,1,12942101,12942231,130,0.7517915281825757
5346,431.469967,431.501033,1,12944099,12945030,931,0.2894738697584918
5347,431.5187,431.544567,1,12945561,12946337,776,0.8690435429282048
5348,431.573533,431.601367,1,12947205,12948041,836,0.7839876423955162
5349,431.602567,431.607167,1,12948077,12948215,138,0.8877832432750247
5350,431.660933,431.6657,1,12949827,12949971,144,0.8776586716461425
5351,431.6755,431.680867,1,12950265,12950426,161,0.764024637626362
5352,431.684633,431.6882,1,12950538,12950646,108,0.6707212239562687
5353,431.699467,431.708967,1,12950984,12951269,285,0.8290525999877134
5354,431.718767,431.724567,1,12951563,12951737,174,0.5550235357321438
5355,431.7287,431.744567,1,12951861,12952337,476,0.7507754172561353
5356,431.7461,431.754467,1,12952383,12952634,251,0.8892173649463121
5357,431.7569,431.7927,1,12952707,12953781,1074,0.34825495650391197
5358,431.800433,431.805767,1,12954012,12954173,161,0.7238551868276462
5359,431.808,431.812833,1,12954240,12954384,144,0.8590179050028587
5360,431.815733,431.821267,1,12954471,12954638,167,0.856850269815064
5361,431.8224,431.826267,1,12954672,12954788,116,0.8573067236998839
5362,431.830567,431.833833,1,12954917,12955014,97,0.8603960935417596
5363,431.840867,431.846767,1,12955226,12955403,177,0.8789334059170971
5364,431.851667,431.861733,1,12955550,12955851,301,0.6824498262350139
5365,431.878667,431.8865,1,12956360,12956595,235,0.8892169178894818
5366,431.8875,431.9113,1,12956625,12957339,714,0.8362558088052389
5367,431.914067,431.917767,1,12957422,12957533,111,0.7195108926283638
5368,431.941933,431.951167,1,12958257,12958535,278,0.8531543626355964
5369,431.952533,431.957967,1,12958575,12958739,164,0.9009680688591176
5370,431.959333,431.964033,1,12958779,12958920,141,0.9331827076925764
5371,431.965967,431.9754,1,12958979,12959262,283,0.8984255379639313
5372,431.979267,431.997,1,12959378,12959910,532,0.6927946939931289
5373,432.1648,432.2273,1,12964944,12966819,1875,0.6588722832704274
5374,432.2296,432.257333,1,12966888,12967719,831,0.7547821351914108
5375,432.2842,432.2891,1,12968526,12968673,147,0.42092739346296415
5376,432.290233,432.313367,1,12968706,12969401,695,0.786803629815132
5377,432.325133,432.343133,1,12969753,12970293,540,0.9213071078870121
5378,432.344633,432.347767,1,12970338,12970433,95,0.8159046287131865
5379,432.3737,432.3771,1,12971211,12971313,102,0.9474320004243181
5380,432.378767,432.3859,1,12971363,12971577,214,0.8356554785560529
5381,432.387033,432.3979,1,12971610,12971937,327,0.7586576740735372
5382,432.400233,432.4108,1,12972006,12972324,318,0.873804683553452
5383,432.417067,432.421767,1,12972512,12972653,141,0.3954931415881882
5384,432.454433,432.459233,1,12973632,12973776,144,0.9066151126481725
5385,432.478167,432.486967,1,12974345,12974609,264,0.877435487635649
5386,432.5323,432.539533,1,12975969,12976185,216,0.7292919983128765
5387,432.540833,432.543933,1,12976224,12976317,93,0.8682333957762618
5388,432.623133,432.649667,1,12978693,12979490,797,0.7412967645447618
5389,432.734433,432.745067,1,12982032,12982352,320,0.19026028446511997
5390,432.785933,432.811967,1,12983577,12984359,782,0.2562907769613621
5391,432.813333,432.8194,1,12984399,12984582,183,0.8838214412912594
5392,432.873367,432.905633,1,12986201,12987168,967,0.7361760974900745
5393,432.920667,432.926133,1,12987620,12987783,163,0.7783836647808824
5394,432.948233,432.985867,1,12988446,12989576,1130,0.6056715740603201
5395,432.993767,432.997033,1,12989813,12989910,97,0.8478713216131443
5396,433.030733,433.034567,1,12990921,12991037,116,0.7735974258153906
5397,433.053233,433.0579,1,12991596,12991737,141,0.5309891873349113
5398,433.072367,433.0764,1,12992171,12992292,121,0.9104030273444411
5399,433.170767,433.1855,1,12995123,12995565,442,0.8245635609939657
5400,433.224333,433.231933,1,12996729,12996957,228,0.709403350843786
5401,433.254033,433.258067,1,12997620,12997742,122,0.6750693620379393
5402,433.2599,433.275733,1,12997797,12998271,474,0.8438891137633902
5403,433.276967,433.296633,1,12998309,12998898,589,0.8702697671633338
5404,433.311333,433.332967,1,12999339,12999989,650,0.43676814709107603
5405,433.3475,433.353167,1,13000425,13000595,170,0.8192676294926997
5406,433.380267,433.383467,1,13001408,13001504,96,0.9716650333250205
5407,433.4162,433.4313,1,13002486,13002939,453,0.7553380182545649
5408,433.437267,433.4414,1,13003118,13003242,124,0.8066774134491617
5409,433.4591,433.4626,1,13003773,13003878,105,0.8528343597804053
5410,433.464067,433.4703,1,13003922,13004109,187,0.6802530174734572
5411,433.5129,433.522233,1,13005387,13005666,279,0.6204870129134823
5412,433.531233,433.5506,1,13005936,13006518,582,0.6278277362086907
5413,433.556367,433.561233,1,13006691,13006836,145,0.7557895270868008
5414,433.566333,433.5786,1,13006989,13007358,369,0.5758097728027813
5415,433.582833,433.605767,1,13007484,13008173,689,0.5650336389000125
5416,433.625933,433.6415,1,13008777,13009245,468,0.8555968761830587
5417,433.643067,433.6505,1,13009292,13009515,223,0.8528768152644788
5418,433.651567,433.6599,1,13009547,13009797,250,0.8928035600028923
5419,433.6849,433.696067,1,13010547,13010882,335,0.5668612617488611
5420,433.7132,433.717667,1,13011396,13011530,134,0.538139107151428
5421,433.7953,433.803533,1,13013859,13014105,246,0.9317491530001638
5422,433.8235,433.8371,1,13014705,13015113,408,0.7039460143224301
5423,433.839033,433.886767,1,13015170,13016603,1433,0.6752593459370485
5424,433.902733,433.913133,1,13017081,13017393,312,0.12771374737332472
5425,433.915867,433.9311,1,13017476,13017933,457,0.6841563948418595
5426,433.936233,433.9861,1,13018086,13019583,1497,0.4874189071456672
5427,434.0347,434.0474,1,13021041,13021422,381,0.2113835165912393
5428,434.0667,434.155433,1,13022001,13024662,2661,0.5900392968521215
5429,434.165,434.169133,1,13024950,13025073,123,0.7282841543219107
5430,434.192733,434.197667,1,13025781,13025930,149,0.8572688443173061
5431,434.2277,434.232733,1,13026831,13026981,150,0.3843072455666225
5432,434.256667,434.259733,1,13027700,13027791,91,0.6052529719041706
5433,434.280867,434.283867,1,13028426,13028516,90,0.8145085724400115
5434,434.290333,434.296133,1,13028709,13028883,174,0.9308447270282512
5435,434.2973,434.3387,1,13028919,13030161,1242,0.6726768658778576
5436,434.350433,434.354,1,13030512,13030620,108,0.8432464254958232
5437,434.3786,434.402167,1,13031358,13032065,707,0.793300865123484
5438,434.404967,434.4163,1,13032149,13032489,340,0.7098119830191207
5439,434.418367,434.4214,1,13032551,13032642,91,0.9630553762276272
5440,434.426467,434.432167,1,13032794,13032965,171,0.8498868066796567
5441,434.4334,434.438933,1,13033002,13033167,165,0.6892745048823363
5442,434.4466,434.450567,1,13033398,13033517,119,0.8772765434671552
5443,434.451933,434.4569,1,13033557,13033707,150,0.6813162646905577
5444,434.4657,434.4759,1,13033971,13034277,306,0.9298637953025979
5445,434.4812,434.4869,1,13034436,13034607,171,0.8047759117187484
5446,434.4918,434.5133,1,13034754,13035399,645,0.8714964305371303
5447,434.529667,434.537533,1,13035890,13036125,235,0.83025314188808
5448,434.547167,434.5516,1,13036415,13036548,133,0.9575772120799759
5449,434.561,434.584533,1,13036830,13037535,705,0.8390091781369076
5450,434.588633,434.595833,1,13037658,13037874,216,0.8092757661709216
5451,434.5987,434.605867,1,13037961,13038176,215,0.4340788348314958
5452,434.6725,434.718967,1,13040175,13041569,1394,0.8616249769153773
5453,434.725267,434.7351,1,13041758,13042053,295,0.7549341165081452
5454,434.736267,434.745233,1,13042088,13042356,268,0.8514479495811119
5455,434.749367,434.754567,1,13042481,13042637,156,0.8727300188364124
5456,434.803633,434.808333,1,13044108,13044249,141,0.7371646252593379
5457,434.8126,434.830767,1,13044378,13044923,545,0.8174167850238125
5458,434.839333,434.853233,1,13045179,13045596,417,0.8514949627642582
5459,434.861,434.8679,1,13045830,13046037,207,0.8198619405965147
5460,434.871667,434.884067,1,13046150,13046522,372,0.6660884572179636
5461,434.885567,434.8889,1,13046567,13046667,100,0.6920472586414008
5462,434.919467,434.9322,1,13047584,13047966,382,0.8016480443773145
5463,435.0325,435.0448,1,13050975,13051344,369,0.7013052981104896
5464,435.069367,435.078233,1,13052081,13052346,265,0.6097935990351838
5465,435.0842,435.097167,1,13052526,13052915,389,0.818483129064279
5466,435.0983,435.105567,1,13052949,13053167,218,0.8496395371108368
5467,435.106933,435.125867,1,13053207,13053776,569,0.7957591916609024
5468,435.1818,435.197067,1,13055454,13055912,458,0.9192463935222174
5469,435.1998,435.2032,1,13055994,13056096,102,0.19779395506093145
5470,435.2147,435.224,1,13056441,13056720,279,0.8206612448814031
5471,435.228233,435.2414,1,13056846,13057242,396,0.5310488799988278
5472,435.242667,435.270233,1,13057280,13058106,826,0.8003837249510867
5473,435.276433,435.282133,1,13058292,13058463,171,0.610800947324991
5474,435.2882,435.310333,1,13058646,13059309,663,0.8106970462010451
5475,435.316967,435.327633,1,13059509,13059828,319,0.8744870035675371
5476,435.341867,435.347033,1,13060256,13060410,154,0.6364404191702443
5477,435.363833,435.376933,1,13060914,13061307,393,0.8005329916476865
5478,435.4314,435.434467,1,13062942,13063034,92,0.3618577735951298
5479,435.439467,435.448733,1,13063184,13063461,277,0.8873748862634727
5480,435.4782,435.483067,1,13064346,13064492,146,0.4408731283133925
5481,435.507133,435.534267,1,13065213,13066028,815,0.6510060421677273
5482,435.5373,435.5522,1,13066119,13066566,447,0.774469066254235
5483,435.8424,435.8617,1,13075272,13075851,579,0.2967683049905876
5484,435.900233,435.904933,1,13077006,13077147,141,0.6230235730791265
5485,435.9162,435.919533,1,13077486,13077585,99,0.7108368418361943
5486,436.1952,436.1982,1,13085856,13085946,90,0.8029516968734525
5487,436.216,436.222667,1,13086480,13086680,200,0.40477885433286565
5488,436.2259,436.2322,1,13086777,13086966,189,0.4796320687793542
5489,436.324633,436.3323,1,13089738,13089969,231,0.7752109614085722
5490,436.334333,436.337833,1,13090029,13090134,105,0.3160515288429563
5491,436.409667,436.413267,1,13092290,13092398,108,0.21460881466038406
5492,436.444767,436.4486,1,13093343,13093458,115,0.42354092785234027
5493,436.530367,436.534633,1,13095911,13096038,127,0.8672029174833257
5494,436.6674,436.670633,1,13100022,13100118,96,0.692493618528318
5495,436.948933,436.952067,1,13108467,13108562,95,0.7747677185820929
5496,437.0918,437.106967,1,13112754,13113209,455,0.29072439542652173
5497,437.663433,437.666967,1,13129902,13130009,107,0.841226385308784
5498,437.7224,437.7304,1,13131672,13131912,240,0.23930821884562248
5499,437.738833,437.7424,1,13132164,13132272,108,0.7497765879082418
5500,437.882067,437.885567,1,13136462,13136567,105,0.7861808406671629
5501,437.9917,437.995633,1,13139751,13139868,117,0.8807402536102651
5502,438.050467,438.058333,1,13141514,13141749,235,0.45805291059703607
5503,438.063033,438.067033,1,13141890,13142010,120,0.20757139092043675
5504,438.385867,438.3903,1,13151576,13151709,133,0.23950095909598434
5505,438.7738,438.801067,1,13163214,13164032,818,0.7588905249634563
5506,438.828,438.831367,1,13164840,13164941,101,-0.4268122770300619
5507,438.8731,438.900367,1,13166193,13167011,818,0.7091911724824017
5508,438.9202,438.923833,1,13167606,13167714,108,0.823413601800081
5509,438.951833,438.958867,1,13168554,13168766,212,0.695543952604496
5510,438.985733,438.990767,1,13169571,13169723,152,0.7326393295801646
5511,438.9919,439.013933,1,13169757,13170417,660,0.6774137893206383
5512,439.063467,439.067467,1,13171904,13172024,120,0.8981383748434602
5513,439.073033,439.077133,1,13172190,13172313,123,0.4764714125811192
5514,439.082833,439.089933,1,13172484,13172697,213,0.8064699691885652
5515,439.092133,439.099933,1,13172763,13172997,234,0.3947791004061402
5516,439.111033,439.143267,1,13173330,13174298,968,0.653941572493437
5517,439.202767,439.2086,1,13176083,13176258,175,0.45367261216084065
5518,439.2941,439.297367,1,13178823,13178921,98,0.6699569925842727
5519,439.298767,439.303033,1,13178963,13179090,127,0.9038261099392647
5520,439.913733,439.9178,1,13197411,13197534,123,0.834053409985855
5521,439.923767,439.927833,1,13197713,13197834,121,0.4494486203417262
5522,439.9317,439.935467,1,13197951,13198064,113,0.6746791249910343
5523,441.337667,441.348067,1,13240130,13240442,312,0.8449208314340061
5524,441.363967,441.369733,1,13240919,13241091,172,0.49974619431561684
5525,441.370767,441.3738,1,13241123,13241214,91,0.6090699657006784
5526,441.4086,441.412633,1,13242258,13242378,120,0.7632073316059191
5527,441.4233,441.427,1,13242699,13242810,111,0.7455260260205735
5528,442.5686,442.588967,1,13277058,13277669,611,0.12538135071298318
5529,442.6011,442.605267,1,13278033,13278158,125,0.9667924379883557
5530,442.7266,442.732567,1,13281798,13281977,179,0.44524550781155453
5531,442.7477,442.756,1,13282431,13282680,249,0.455448069295352
5532,443.089067,443.094233,1,13292672,13292826,154,0.07107232140992911
5533,443.0958,443.111433,1,13292874,13293342,468,0.5604814972970713
5534,443.112867,443.1172,1,13293386,13293516,130,0.939468636582474
5535,443.204967,443.2114,1,13296149,13296342,193,0.2599050918149206
5536,447.0923,447.096267,1,13412769,13412888,119,0.3330322217558881
5537,447.7224,447.736633,1,13431672,13432098,426,0.1753970410681457
5538,448.163767,448.168667,1,13444913,13445060,147,0.5691025415758896
5539,448.3933,448.399133,1,13451799,13451973,174,0.2515626275926026
5540,448.420333,448.426167,1,13452609,13452785,176,0.1856137109187503
5541,452.659,452.684833,1,13579770,13580544,774,0.2630787497796955
5542,452.958367,452.963867,1,13588751,13588916,165,0.9588138115821047
5543,453.798367,453.804267,1,13613951,13614128,177,0.5028179627275409
5544,454.0013,454.009167,1,13620039,13620275,236,0.6423623000821791
5545,454.0354,454.1215,1,13621062,13623645,2583,0.1910752539442773
5546,454.139567,454.143367,1,13624187,13624301,114,0.5664883753584211
5547,454.176933,454.210833,1,13625307,13626324,1017,0.2779675342077834
5548,454.218533,454.2649,1,13626555,13627947,1392,0.264920056492561
5549,454.293667,454.3009,1,13628810,13629027,217,0.5567137397877556
5550,454.3413,454.375567,1,13630239,13631267,1028,0.12780856992590148
5551,454.3812,454.446,1,13631436,13633380,1944,0.13713507112821924
5552,454.4944,454.529667,1,13634832,13635890,1058,0.5176784059144368
5553,454.539,454.5799,1,13636170,13637397,1227,0.3336286769526638
5554,454.6315,454.634867,1,13638945,13639046,101,0.25074043222474346
5555,454.658833,454.7007,1,13639764,13641021,1257,0.25830493842713437
5556,454.703733,454.719867,1,13641111,13641596,485,0.6337997285024264
5557,454.722067,454.826567,1,13641662,13644797,3135,0.4763126064767796
5558,454.842033,454.902833,1,13645260,13647084,1824,0.1477376839643961
5559,454.907967,454.927933,1,13647239,13647837,598,0.22061028956743695
5560,454.9389,454.998333,1,13648167,13649949,1782,0.31004460833786723
5561,455.002567,455.006567,1,13650077,13650197,120,0.7437540725167926
5562,455.021633,455.028867,1,13650648,13650866,218,0.7752134662052639
5563,455.307167,455.325933,1,13659215,13659777,562,0.38919549233930156
5564,455.326933,455.349633,1,13659807,13660488,681,0.7884035427008179
5565,455.366467,455.376333,1,13660994,13661289,295,0.7250354596809356
5566,457.292167,457.296833,1,13718765,13718904,139,0.015626095204541796
5567,457.3393,457.352633,1,13720179,13720578,399,0.21457928474829827
5568,458.631033,458.641767,1,13758930,13759253,323,0.20789575503970925
5569,459.4413,459.4861,1,13783239,13784583,1344,0.08748995531431457
5570,459.491367,459.518933,1,13784741,13785567,826,-0.011340718783141841
5571,459.538133,459.5677,1,13786143,13787031,888,0.24599898187775757
5572,459.579767,459.6059,1,13787393,13788177,784,0.3169976309578246
5573,459.6257,459.700033,1,13788771,13791000,2229,0.23818968890759476
5574,464.5797,464.589933,1,13937391,13937697,306,0.6428052825217082
5575,464.607567,464.611233,1,13938227,13938336,109,0.8865845891683555
5576,464.6201,464.657367,1,13938603,13939721,1118,0.4362383232200728
5577,464.697333,464.700733,1,13940919,13941021,102,0.7066925161757349
5578,464.7049,464.7128,1,13941147,13941384,237,0.7664376294397182
5579,464.715767,464.7193,1,13941473,13941579,106,0.8469873597571117
5580,464.735967,464.7725,1,13942079,13943175,1096,0.8257690869916101
5581,464.811933,464.8159,1,13944357,13944477,120,0.9131013070626264
5582,464.8246,464.847,1,13944738,13945410,672,0.8164532723405252
5583,464.848467,464.894333,1,13945454,13946829,1375,0.7816279994528901
5584,464.902733,464.908233,1,13947081,13947246,165,0.4261358281279334
5585,464.911433,464.914567,1,13947342,13947437,95,0.8449859301328492
5586,464.9159,464.923167,1,13947477,13947695,218,0.6172357486773826
5587,464.9247,464.9294,1,13947741,13947882,141,0.9026753571039838
5588,464.941667,464.9461,1,13948250,13948383,133,0.8035241386918903
5589,464.970267,464.975067,1,13949108,13949252,144,0.9009853183640804
5590,465.0008,465.023867,1,13950024,13950716,692,0.61796861050025
5591,465.025033,465.029333,1,13950750,13950879,129,0.8771867033392247
5592,465.222267,465.2266,1,13956668,13956798,130,0.6348070950626836
5593,466.028667,466.0317,1,13980860,13980951,91,0.7225685342003125
5594,466.033767,466.038733,1,13981013,13981161,148,0.6496655603254754
5595,468.379367,468.385333,1,14051381,14051559,178,0.09668386273853065
5596,468.418667,468.427367,1,14052560,14052821,261,-0.023201639877034455
5597,468.460167,468.491367,1,14053805,14054741,936,0.19430806612088372
5598,468.497067,468.507,1,14054912,14055210,298,0.32478319170675124
5599,468.5082,468.5143,1,14055246,14055429,183,0.8607307392109879
5600,468.529867,468.588067,1,14055896,14057642,1746,0.11704333956244967
5601,472.1165,472.126367,1,14163495,14163791,296,0.35061666971077454
5602,472.6756,472.696467,1,14180268,14180894,626,0.2799742274000036
5603,472.6979,472.706133,1,14180937,14181183,246,0.7938448277703108
5604,472.712567,472.715567,1,14181377,14181467,90,0.9258709677790019
5605,472.7169,472.797633,1,14181507,14183928,2421,0.5495653027796155
5606,472.798833,472.805533,1,14183964,14184165,201,0.8323295935255788
5607,472.813433,472.9574,1,14184402,14188722,4320,0.4893211804454546
5608,472.985,473.054667,1,14189550,14191640,2090,0.566384587281334
5609,473.056133,473.059967,1,14191683,14191799,116,0.7772217379890691
5610,473.216067,473.2203,1,14196482,14196609,127,0.6860690189391563
5611,473.725233,473.7307,1,14211756,14211921,165,0.8279825188630016
5612,474.015367,474.043967,1,14220461,14221319,858,0.6016091925804373
5613,474.066367,474.074933,1,14221991,14222247,256,0.6225810451606439
5614,474.0767,474.089533,1,14222301,14222685,384,0.37958758091038236
5615,474.288333,474.2954,1,14228649,14228862,213,0.8100874961575673
5616,474.299833,474.3079,1,14228994,14229237,243,0.6986301825110685
5617,474.308933,474.314467,1,14229267,14229434,167,0.6705204866090015
5618,474.330967,474.4095,1,14229929,14232285,2356,0.22470426010823083
5619,474.4616,474.5392,1,14233848,14236176,2328,0.14751230659293144
5620,474.545533,474.556933,1,14236365,14236707,342,0.2423373839719263
5621,474.6017,474.630567,1,14238051,14238917,866,0.5184871019424049
5622,474.640067,474.675167,1,14239202,14240255,1053,0.19231757231161634
5623,474.676233,474.6857,1,14240286,14240571,285,-0.04157040037010021
5624,474.737733,474.750267,1,14242131,14242508,377,0.4712147066171927
5625,474.751967,474.776167,1,14242559,14243285,726,0.6119834451368509
5626,474.789167,474.8149,1,14243675,14244447,772,0.32908704073523837
5627,474.818067,474.8286,1,14244542,14244858,316,0.27828004286566616
5628,474.909,474.934467,1,14247270,14248034,764,0.49960766900092346
5629,474.960867,474.975233,1,14248826,14249256,430,0.03243613449951692
5630,475.1501,475.183733,1,14254503,14255511,1008,0.5092152774879886
5631,475.199467,475.216333,1,14255984,14256489,505,0.09515850920560033
5632,475.231233,475.235567,1,14256936,14257067,131,0.07189079055684318
5633,475.2496,475.260733,1,14257488,14257821,333,-0.1296700160989828
5634,475.309767,475.347267,1,14259293,14260418,1125,0.3239712274854517
5635,475.3585,475.394,1,14260755,14261820,1065,0.2798979190669377
5636,475.757067,475.760967,1,14272712,14272829,117,0.7796367159324677
5637,475.763067,475.782767,1,14272892,14273483,591,0.8026705439320269
5638,475.807267,475.8138,1,14274218,14274414,196,0.7854159255777275
5639,475.958667,475.9951,1,14278760,14279853,1093,0.6688937921714403
5640,476.021267,476.028633,1,14280638,14280858,220,0.8132658645016525
5641,476.054433,476.068267,1,14281632,14282048,416,0.7939497378719834
5642,476.0695,476.090967,1,14282085,14282729,644,0.5434126904994454
5643,476.259033,476.274733,1,14287770,14288241,471,0.8233462165050409
5644,476.275867,476.280233,1,14288276,14288406,130,0.8857608033083487
5645,476.314833,476.328767,1,14289444,14289863,419,0.9183992661576313
5646,476.344733,476.348267,1,14290341,14290448,107,0.8339564633307888
5647,476.415067,476.421333,1,14292452,14292639,187,0.82401264847884
5648,476.510967,476.532433,1,14295329,14295972,643,0.3364145595283953
5649,476.6617,476.665,1,14299851,14299950,99,0.8461548906835598
5650,476.861167,476.8656,1,14305835,14305968,133,0.13807810927311606
5651,476.899033,476.908633,1,14306970,14307258,288,0.5825205408427833
5652,479.4682,479.531267,1,14384046,14385938,1892,-0.01321076524860692
5653,479.5341,479.564933,1,14386023,14386947,924,0.030091722190349328
5654,480.019967,480.0276,1,14400599,14400828,229,0.3093048952840431
5655,480.0385,480.1146,1,14401155,14403438,2283,0.18763860507591748
5656,480.133833,480.154333,1,14404014,14404629,615,0.2818786262892673
5657,480.176267,480.2066,1,14405288,14406198,910,0.4661589346451921
5658,480.294833,480.2993,1,14408844,14408979,135,0.9124918017899561
5659,480.325,480.390533,1,14409750,14411715,1965,0.6932912532309761
5660,480.525067,480.5294,1,14415752,14415882,130,0.30232499733814877
5661,480.612733,480.627533,1,14418381,14418825,444,0.7424306701316162
5662,480.647267,480.662633,1,14419418,14419878,460,0.6424467090881795
5663,480.7793,480.783933,1,14423379,14423517,138,0.903975279233912
5664,480.785167,480.7883,1,14423555,14423649,94,0.5561234736455467
5665,480.8184,480.8216,1,14424552,14424648,96,0.5791204338483291
5666,481.033867,481.037033,1,14431016,14431110,94,0.7599281094314846
5667,481.321833,481.324867,1,14439654,14439746,92,0.15791096968511278
5668,481.7152,481.737533,1,14451456,14452125,669,0.7426893256106454
5669,481.7564,481.8141,1,14452692,14454423,1731,0.3762037638063842
5670,481.886967,481.890933,1,14456609,14456727,118,0.9126230658330079
5671,484.581367,484.608667,1,14537441,14538260,819,0.8373611830622442
5672,484.676367,484.682367,1,14540291,14540471,180,0.7872269639408633
5673,484.6849,484.688267,1,14540547,14540648,101,0.6223487041244927
5674,485.097733,485.1008,1,14552931,14553024,93,0.6605585127922449
5675,485.227833,485.241333,1,14556834,14557239,405,0.1957888929987612
5676,485.3432,485.346867,1,14560296,14560406,110,0.9287977103268253
5677,485.348133,485.362033,1,14560443,14560860,417,0.8353885179425548
5678,485.372933,485.436233,1,14561187,14563086,1899,0.5447854877622235
5679,485.4919,485.495033,1,14564757,14564850,93,0.8841766391741401
5680,485.496067,485.6078,1,14564882,14568234,3352,0.45472880234401847
5681,485.6125,485.628533,1,14568375,14568855,480,0.7484564308518704
5682,485.931733,485.934967,1,14577951,14578049,98,0.7406710804256595
5683,487.0456,487.0487,1,14611368,14611461,93,0.1820862848650636
5684,487.638133,487.645633,1,14629143,14629368,225,0.7431493240684959
5685,487.647033,487.678,1,14629410,14630340,930,0.3880160766730257
5686,487.6847,487.728067,1,14630541,14631842,1301,0.48742773882264406
5687,487.7294,487.7941,1,14631882,14633823,1941,0.36216622978434126
5688,487.8201,487.823367,1,14634603,14634701,98,0.9162518771389816
5689,488.431367,488.4359,1,14652941,14653077,136,0.8110318681467937
5690,489.0197,489.0231,1,14670591,14670693,102,0.710813646632009
5691,489.064667,489.070667,1,14671940,14672120,180,0.213053053972642
5692,489.150167,489.1641,1,14674505,14674923,418,0.0013988502517489673
5693,489.793067,489.802467,1,14693792,14694074,282,0.232499359876566
5694,489.8154,489.825033,1,14694462,14694750,288,0.46270548943336604
5695,489.855,489.859667,1,14695650,14695790,140,0.06706413480673205
5696,489.877433,489.880533,1,14696322,14696415,93,0.8715170949798868
5697,490.275133,490.291767,1,14708253,14708753,500,0.5943191035134486
5698,490.915067,490.9182,1,14727452,14727546,94,0.57349986314038
5699,490.922667,490.9321,1,14727680,14727963,283,0.5543325387345842
5700,490.9439,490.950333,1,14728317,14728509,192,0.9309910569757758
5701,491.237833,491.269567,1,14737134,14738087,953,0.4894482705567438
5702,491.287667,491.485833,1,14738630,14744574,5944,0.5005768240010169
5703,491.487233,491.495867,1,14744616,14744876,260,0.8203271151776624
5704,491.497133,491.508033,1,14744913,14745240,327,0.6628690455900429
5705,491.5151,491.518467,1,14745453,14745554,101,0.8257898051860135
5706,491.526333,491.5298,1,14745789,14745894,105,0.830915602226792
5707,491.585,491.589933,1,14747550,14747697,147,0.49735655587257876
5708,492.291767,492.298767,1,14768753,14768963,210,0.6161476077288371
5709,492.304033,492.307667,1,14769120,14769230,110,-0.16476003377713427
5710,492.527367,492.530733,1,14775821,14775921,100,0.8533694660126352
5711,492.550433,492.556633,1,14776512,14776698,186,0.9097748222546289
5712,492.604133,492.618267,1,14778123,14778548,425,0.06361869579250053
5713,492.657433,492.661333,1,14779722,14779839,117,0.3667970808918135
5714,492.745133,492.753367,1,14782353,14782601,248,0.9317926289916963
5715,492.758133,492.762033,1,14782743,14782860,117,0.6641913973983669
5716,492.775367,492.781733,1,14783261,14783451,190,0.8764598025359694
5717,492.7835,492.7883,1,14783505,14783649,144,0.29383631334931937
5718,492.8187,492.825433,1,14784561,14784762,201,0.8771788356577639
5719,492.8523,492.8558,1,14785569,14785674,105,0.7444986204265307
5720,492.863567,492.868567,1,14785907,14786057,150,0.8000527112046885
5721,492.873967,492.881333,1,14786219,14786439,220,0.9409891619412569
5722,492.882667,492.886867,1,14786480,14786606,126,0.9635239582806263
5723,492.891267,492.906533,1,14786738,14787195,457,0.8721719636047061
5724,492.916067,492.9763,1,14787482,14789289,1807,0.38370471144815566
5725,493.0029,493.006167,1,14790087,14790185,98,0.9408171214937106
5726,493.063767,493.066967,1,14791913,14792009,96,0.8379166792182502
5727,493.068067,493.078467,1,14792042,14792354,312,0.1857332216838254
5728,493.0804,493.0906,1,14792412,14792718,306,0.7215054898349104
5729,493.0926,493.0964,1,14792778,14792892,114,0.8225476245336706
5730,493.1282,493.2495,1,14793846,14797485,3639,0.32113927245574936
5731,498.114433,498.120367,1,14943432,14943611,179,0.07043411685504133
5732,498.353367,498.388333,1,14950601,14951649,1048,0.40892293137577557
5733,498.408233,498.4206,1,14952246,14952618,372,0.871045283722582
5734,498.4311,498.434933,1,14952933,14953047,114,0.760061526138618
5735,498.4695,498.473033,1,14954085,14954190,105,0.8664203478056135
5736,499.150433,499.168933,1,14974512,14975067,555,0.13149666462390275
5737,499.3303,499.353567,1,14979909,14980607,698,0.38690117795018897
5738,499.369467,499.372667,1,14981084,14981180,96,0.8242599125349293
5739,499.491467,499.563233,1,14984744,14986896,2152,0.3097789062395053
5740,499.564667,499.575633,1,14986940,14987268,328,0.6112578982749575
5741,499.579633,499.675033,1,14987388,14990250,2862,0.253818526232459
5742,499.685767,499.6905,1,14990573,14990715,142,0.8030200663437534
5743,499.692933,499.6986,1,14990787,14990958,171,0.44394128645722325
5744,499.705833,499.753933,1,14991174,14992617,1443,0.17922500413006867
5745,499.757667,499.7672,1,14992730,14993016,286,0.6480770707428175
5746,499.7699,499.8131,1,14993097,14994393,1296,0.5188505907985573
5747,499.816067,499.8314,1,14994482,14994942,460,0.7016870549246031
5748,499.8513,499.928633,1,14995539,14997858,2319,0.3275417415742149
5749,499.938267,499.9975,1,14998148,14999925,1777,0.2040504303881167
5750,499.998667,500.024267,1,14999960,15000728,768,0.21184100432324818
5751,500.0574,500.0705,1,15001722,15002115,393,0.1370772089515939
5752,500.088967,500.109167,1,15002669,15003275,606,0.722300802649996
5753,500.1248,500.174267,1,15003744,15005228,1484,0.23921025474836385
5754,500.176133,500.1892,1,15005283,15005676,393,0.2746199446738774
5755,500.191167,500.197467,1,15005735,15005924,189,0.3367735811189895
5756,500.207267,500.215233,1,15006218,15006456,238,0.16703671113233626
5757,500.220267,500.227333,1,15006608,15006819,211,0.2433596735538339
5758,500.2475,500.370633,1,15007425,15011118,3693,0.34281748961596054
5759,500.3717,500.3751,1,15011151,15011253,102,0.9378956951040198
5760,503.1419,503.149833,1,15094257,15094494,237,0.011693008583957745
5761,503.181667,503.187,1,15095450,15095610,160,0.5022703489042758
5762,504.1684,504.171967,1,15125052,15125159,107,0.5647470742230695
5763,504.390433,504.4079,1,15131712,15132237,525,0.6446863737674958
5764,504.522067,504.5431,1,15135662,15136293,631,0.8440186572037051
5765,504.5763,504.620233,1,15137289,15138606,1317,0.4287632424589095
5766,504.621533,504.624733,1,15138645,15138741,96,0.9514050984381902
5767,504.626133,504.6737,1,15138783,15140211,1428,0.8028204948476416
5768,504.675167,504.704067,1,15140255,15141122,867,0.8381901843886197
5769,504.705567,504.7511,1,15141167,15142533,1366,0.6617300118075338
5770,504.760933,504.769167,1,15142827,15143075,248,0.5043477664079294
5771,505.179133,505.182533,1,15155373,15155475,102,0.9070459469553445
5772,505.185367,505.208967,1,15155561,15156269,708,0.7252895056176664
5773,505.217,505.2342,1,15156510,15157026,516,0.8351693100779388
5774,505.498233,505.5356,1,15164946,15166068,1122,0.6890224754074954
5775,505.536667,505.568867,1,15166100,15167066,966,0.27109101665939417
5776,505.645533,505.7112,1,15169365,15171336,1971,0.18012571998320737
5777,505.712833,505.796867,1,15171384,15173906,2522,0.2532487818560234
5778,505.7981,505.801467,1,15173943,15174044,101,0.9768722644798351
5779,505.803133,505.953533,1,15174093,15178605,4512,0.08447628956433867
5780,505.9547,505.961733,1,15178641,15178851,210,0.8817529145579001
5781,505.995233,506.034533,1,15179856,15181035,1179,0.5241126708031023
5782,506.038867,506.0899,1,15181166,15182697,1531,0.17501818108815867
5783,506.123967,506.137067,1,15183719,15184112,393,0.6757195230949404
5784,506.158067,506.192833,1,15184742,15185784,1042,0.7322492342421977
5785,506.208233,506.230967,1,15186246,15186929,683,0.15130353368848798
5786,506.282267,506.295633,1,15188468,15188868,400,0.017672487947332043
5787,506.329533,506.369133,1,15189885,15191073,1188,0.6069918654719011
5788,506.3739,506.406233,1,15191217,15192186,969,0.20807776374176798
5789,506.4191,506.428967,1,15192573,15192869,296,0.21552171681074994
5790,506.5007,506.542,1,15195021,15196260,1239,0.6267852339673825
5791,506.551,506.572867,1,15196530,15197186,656,0.5074406715696183
5792,506.5812,506.590967,1,15197436,15197729,293,0.06042939446341413
5793,506.713633,506.719033,1,15201408,15201570,162,0.6697943198210252
5794,506.7204,506.7248,1,15201612,15201744,132,0.8546956769971544
5795,506.7284,506.7391,1,15201852,15202173,321,0.776079881572727
5796,506.7433,506.747633,1,15202299,15202428,129,0.6981465094826711
5797,508.799233,508.802633,1,15263976,15264078,102,-0.024173916540690305
5798,508.810367,508.875267,1,15264311,15266258,1947,0.166855400129889
5799,508.877867,508.8971,1,15266336,15266913,577,0.04927550102868453
5800,508.899333,508.911933,1,15266979,15267357,378,0.534246026548847
5801,508.920133,508.933867,1,15267603,15268016,413,0.20670791067501063
5802,508.9409,508.976867,1,15268227,15269306,1079,0.32127541777617774
5803,508.986067,509.016,1,15269582,15270480,898,0.16315581701635226
5804,509.0222,509.026433,1,15270666,15270792,126,0.9167079311678398
5805,509.027567,509.050167,1,15270827,15271505,678,0.16298849703089424
5806,509.060067,509.103,1,15271802,15273090,1288,0.07705139946303154
5807,509.1096,509.210633,1,15273288,15276318,3030,0.2901964306723941
5808,509.219367,509.246467,1,15276581,15277394,813,0.4247932640765968
5809,509.2479,509.269733,1,15277437,15278091,654,0.5650787851746605
5810,509.289033,509.293233,1,15278670,15278796,126,0.8628334020512386
5811,509.356967,509.469733,1,15280709,15284091,3382,0.36754880194188316
5812,509.478167,509.4884,1,15284345,15284652,307,0.8303874960022685
5813,509.5038,509.507733,1,15285114,15285231,117,0.7729246660360081
5814,509.8936,509.935433,1,15296808,15298062,1254,0.37601674561128334
5815,509.9554,509.9627,1,15298662,15298881,219,0.8808380952469799
5816,510.2433,510.349467,1,15307299,15310484,3185,0.41855653060730025
5817,510.350533,510.526267,1,15310515,15315788,5273,0.4924283256791638
5818,510.527367,510.533833,1,15315821,15316014,193,0.9137735058701977
5819,510.561767,510.6101,1,15316853,15318303,1450,0.8128024712965403
5820,510.611267,510.892067,1,15318338,15326762,8424,0.5966174956141393
5821,510.8932,511.171233,1,15326796,15335136,8340,0.41094673628312006
5822,511.1724,511.175633,1,15335172,15335268,96,0.8101502027003857
5823,511.218133,511.303467,1,15336543,15339104,2561,0.7822793314864207
5824,511.304833,511.3562,1,15339144,15340686,1542,0.8533105213373142
5825,511.375533,511.379933,1,15341265,15341397,132,0.6986230711178735
5826,511.410733,511.414167,1,15342321,15342425,104,0.21670064547027038
5827,511.4154,511.4205,1,15342462,15342615,153,0.41384187853297405
5828,511.421633,511.4256,1,15342648,15342768,120,0.6649403507176734
5829,511.4269,511.4309,1,15342807,15342927,120,0.8445537526868623
5830,511.442833,511.476533,1,15343284,15344295,1011,0.7954332040736021
5831,511.478133,511.4919,1,15344343,15344757,414,0.8102868433945288
5832,511.498533,511.5173,1,15344955,15345519,564,0.8207199871431659
5833,511.538333,511.542633,1,15346149,15346278,129,0.7696547532432743
5834,511.544,511.5516,1,15346320,15346548,228,0.7549421258790504
5835,511.555167,511.5602,1,15346655,15346806,151,0.794097478695614
5836,511.577967,511.585833,1,15347339,15347574,235,0.8918839260840459
5837,511.5893,511.594567,1,15347679,15347837,158,0.8818394378328236
5838,511.597933,511.6012,1,15347937,15348036,99,0.9459414505304548
5839,511.602367,511.611833,1,15348071,15348354,283,0.8735126574475868
5840,511.643967,511.675,1,15349319,15350250,931,0.4509807959091686
5841,511.6836,511.7273,1,15350508,15351819,1311,0.8039625651207832
5842,511.788533,511.799533,1,15353655,15353985,330,0.8843573809066123
5843,512.2598,512.2741,1,15367794,15368223,429,0.5700522999936055
5844,512.277267,512.2943,1,15368318,15368829,511,0.7370428557901938
5845,512.4745,512.535833,1,15374235,15376074,1839,0.34375012390161547
5846,512.543667,512.554667,1,15376310,15376640,330,0.8696770662683319
5847,512.623933,512.950733,1,15378717,15388521,9804,0.4265170561524044
5848,512.9656,512.970767,1,15388968,15389123,155,0.8002698782562764
5849,513.048,513.054167,1,15391440,15391625,185,0.3251234886973872
5850,513.3055,513.3172,1,15399165,15399515,350,-0.002017762186873204
5851,513.8337,513.8507,1,15415011,15415520,509,0.5315207882475299
5852,514.594667,514.598133,1,15437840,15437943,103,0.8507490098614877
5853,515.900833,515.911467,1,15477024,15477344,320,0.8405792568403531
5854,515.9146,515.923633,1,15477437,15477708,271,0.9233234723995072
5855,515.935333,515.940333,1,15478059,15478209,150,0.8024828828810895
5856,515.961067,515.965733,1,15478832,15478971,139,0.9108003716245028
5857,516.254567,516.2579,1,15487637,15487736,99,0.8920550383287416
5858,516.260133,516.317233,1,15487803,15489516,1713,0.599582833721905
5859,516.339367,516.345133,1,15490181,15490353,172,0.8431173520536432
5860,516.774767,516.797133,1,15503243,15503913,670,0.6793706829992181
5861,516.810367,516.820567,1,15504311,15504617,306,0.7932141010681051
5862,516.857233,516.874133,1,15505716,15506223,507,0.5717877755886375
5863,516.8763,516.897633,1,15506289,15506928,639,0.7769905413053597
5864,516.908633,516.933567,1,15507258,15508007,749,0.6755400152001554
5865,516.947767,517.0164,1,15508433,15510492,2059,0.7534103654393557
5866,517.063533,517.102,1,15511905,15513060,1155,0.3289494905569346
5867,517.103,517.1498,1,15513089,15514494,1405,0.6036453376272376
5868,517.174967,517.179,1,15515249,15515370,121,0.3049503098972877
5869,517.189267,517.388367,1,15515678,15521651,5973,0.48875239559071737
5870,517.3901,517.396867,1,15521702,15521906,204,0.7316028900229676
5871,517.4072,517.419967,1,15522216,15522599,383,0.7027971149947094
5872,517.439,517.443067,1,15523169,15523292,123,0.8689851764445371
5873,517.471033,517.475,1,15524130,15524250,120,0.9435962151850472
5874,517.476733,517.482933,1,15524301,15524487,186,0.860566355983623
5875,517.486133,517.6802,1,15524583,15530406,5823,0.4033029938703245
5876,517.682867,517.6871,1,15530486,15530613,127,0.6637679143853024
5877,517.7008,517.707767,1,15531023,15531233,210,0.5582094077507485
5878,517.7178,517.749433,1,15531534,15532482,948,0.39442337253439386
5879,517.753333,517.7684,1,15532599,15533052,453,0.6942955487822304
5880,517.772933,517.7896,1,15533187,15533687,500,0.33078407527736114
5881,517.798067,517.821333,1,15533942,15534639,697,0.4176832162769795
5882,517.876633,517.890933,1,15536298,15536727,429,0.5652584160713154
5883,517.8968,517.939267,1,15536904,15538178,1274,0.5558816022856736
5884,517.942833,518.047333,1,15538284,15541419,3135,0.4061035302855325
5885,518.054967,518.131833,1,15541649,15543954,2305,0.6341120179841636
5886,518.478467,518.485833,1,15554354,15554574,220,0.6765900195541595
5887,518.488267,518.4948,1,15554648,15554844,196,0.7758765836426388
5888,518.8569,518.864267,1,15565707,15565928,221,0.6370660625113164
5889,518.868767,518.872767,1,15566063,15566183,120,0.8772924791669393
5890,518.882767,518.8858,1,15566483,15566574,91,0.9220594834712456
5891,519.1135,519.2162,1,15573405,15576485,3080,0.40971215858267795
5892,519.217267,519.227,1,15576518,15576810,292,0.9441346366695397
5893,519.468667,519.487033,1,15584060,15584610,550,0.9013220848666729
5894,519.673867,519.7023,1,15590216,15591069,853,0.8773110272502336
5895,519.705333,519.762567,1,15591159,15592877,1718,0.44711048855654106
5896,519.766433,519.796533,1,15592992,15593895,903,0.5706749628300741
5897,519.7981,519.8559,1,15593943,15595677,1734,0.269323814074336
5898,519.873933,519.884333,1,15596217,15596529,312,0.599313737287156
5899,519.893767,519.926433,1,15596813,15597792,979,0.4199738869067243
5900,519.938667,519.972133,1,15598160,15599163,1003,0.4174819712127084
5901,520.0117,520.0148,1,15600351,15600444,93,0.037370253871447975
5902,520.0366,520.043333,1,15601098,15601299,201,0.5863334154205245
5903,520.044967,520.0686,1,15601349,15602057,708,0.7650940306304388
5904,520.077633,520.112533,1,15602328,15603375,1047,0.08879304436875977
5905,520.1153,520.119433,1,15603459,15603582,123,0.920108262254318
5906,520.186733,520.193633,1,15605601,15605808,207,0.8705158612723208
5907,520.195067,520.221967,1,15605852,15606659,807,0.2777903196517639
5908,520.2303,520.268433,1,15606909,15608052,1143,0.18646583066005312
5909,520.351033,520.355433,1,15610530,15610662,132,0.6522644152240656
5910,520.363433,520.371933,1,15610902,15611157,255,0.879430019360862
5911,520.380333,520.3868,1,15611409,15611604,195,0.9185445791992386
5912,520.405433,520.430467,1,15612162,15612914,752,0.13076846166197031
5913,520.507033,520.540767,1,15615210,15616223,1013,0.25579327615000325
5914,520.545533,520.5809,1,15616365,15617427,1062,0.28736099625040085
5915,520.657367,520.697,1,15619721,15620910,1189,0.4752393661625292
5916,520.702833,520.7075,1,15621084,15621225,141,0.5135286718256189
5917,520.714033,520.7192,1,15621420,15621576,156,0.050698442719935136
5918,520.720333,520.7245,1,15621609,15621735,126,0.9133997960014293
5919,520.726167,520.729367,1,15621785,15621881,96,0.75252496686457
5920,520.737,520.764467,1,15622109,15622934,825,0.9199073377070394
5921,520.7656,520.770733,1,15622967,15623121,154,0.9482840972531109
5922,520.772133,520.792333,1,15623163,15623769,606,0.8285853718896808
5923,520.7935,520.799167,1,15623805,15623975,170,0.8787884815749013
5924,520.805167,520.810367,1,15624155,15624311,156,0.9377597450413334
5925,521.285633,521.3083,1,15638568,15639249,681,0.48913166544704667
5926,521.509133,521.516567,1,15645273,15645497,224,0.8810972126494033
5927,521.5313,521.546767,1,15645939,15646403,464,0.2682706860638906
5928,521.559767,521.572333,1,15646793,15647169,376,0.545426333069221
5929,521.573333,521.576367,1,15647199,15647291,92,0.9267446109523849
5930,521.586533,521.590367,1,15647595,15647711,116,0.7674011336182943
5931,521.7444,521.749367,1,15652332,15652481,149,0.22465870368909618
5932,521.8074,521.811867,1,15654222,15654356,134,0.9089080578190798
5933,521.834167,521.839067,1,15655025,15655172,147,0.8006675314365128
5934,521.8574,521.8614,1,15655722,15655842,120,0.8535430049273015
5935,521.8801,521.886733,1,15656403,15656601,198,-0.15535789702044578
5936,521.9747,521.984633,1,15659241,15659538,297,0.6316822492021944
5937,522.031767,522.0477,1,15660953,15661430,477,0.8320091994644012
5938,522.054967,522.059533,1,15661649,15661785,136,0.8601205021609406
5939,522.0616,522.1078,1,15661848,15663234,1386,0.2816559373491977
5940,522.117333,522.1725,1,15663519,15665175,1656,0.7936390684352643
5941,522.190133,522.205233,1,15665703,15666156,453,0.607993203969807
5942,522.216033,522.2387,1,15666480,15667161,681,0.6225689280203616
5943,522.240133,522.2475,1,15667203,15667424,221,0.7649937776101196
5944,522.2491,522.2878,1,15667473,15668633,1160,0.5630459355043581
5945,522.292367,522.2956,1,15668771,15668868,97,0.976817409151762
5946,522.304233,522.607,1,15669126,15678210,9084,0.3863333317732905
5947,522.610367,522.614167,1,15678311,15678425,114,0.8761488783124458
5948,522.615667,522.620833,1,15678470,15678624,154,0.8759589409090844
5949,522.630433,522.6496,1,15678912,15679487,575,0.8450025760474876
5950,522.7507,522.7538,1,15682521,15682613,92,0.8792872830451345
5951,522.779033,522.7879,1,15683370,15683637,267,0.8200612697636749
5952,522.9556,522.962367,1,15688668,15688871,203,0.8087666456834071
5953,523.001033,523.005967,1,15690030,15690179,149,0.23046481380984665
5954,523.165467,523.170133,1,15694964,15695103,139,-0.0973793798886689
5955,523.245867,523.250133,1,15697376,15697503,127,0.25622073699264053
5956,523.260267,523.266167,1,15697808,15697985,177,0.43878226491822314
5957,524.573367,524.598767,1,15737201,15737963,762,0.13727232536539963
5958,524.987733,525.249333,1,15749631,15757479,7848,0.292743760202908
5959,525.2531,525.2918,1,15757593,15758753,1160,0.8166246390509659
5960,525.295467,525.3049,1,15758864,15759147,283,0.7418787243069549
5961,525.317633,525.3211,1,15759528,15759633,105,0.8099671807610562
5962,525.3337,525.347467,1,15760011,15760424,413,0.8479397340629314
5963,525.352033,525.355533,1,15760560,15760665,105,0.8848889191995714
5964,525.3567,525.3618,1,15760701,15760854,153,0.7895167839167297
5965,525.370867,525.385333,1,15761126,15761559,433,0.5361975524168902
5966,525.4194,525.424533,1,15762582,15762735,153,0.6189122307730058
5967,525.4438,525.486467,1,15763314,15764594,1280,0.6701488857539808
5968,525.4959,525.545633,1,15764877,15766368,1491,0.6821807799786689
5969,525.5579,525.602867,1,15766737,15768086,1349,0.7367157634416698
5970,525.6042,525.616767,1,15768126,15768503,377,0.8080520992506057
5971,525.634367,525.642267,1,15769031,15769268,237,0.8903742643654294
5972,525.643267,525.648933,1,15769298,15769467,169,0.723172470886095
5973,525.6501,525.751533,1,15769502,15772545,3043,0.549443971186795
5974,525.755933,525.762367,1,15772677,15772871,194,0.9195829116486075
5975,525.763467,525.7666,1,15772904,15772998,94,0.6792692834940779
5976,525.767967,525.830567,1,15773039,15774917,1878,0.7072445399324192
5977,525.8351,525.8609,1,15775053,15775827,774,0.8683062407898835
5978,525.862167,525.872633,1,15775865,15776178,313,0.8378713516964286
5979,525.907067,525.9151,1,15777212,15777453,241,0.7740252524493061
5980,525.9208,525.9239,1,15777624,15777717,93,0.6934187260396676
5981,526.0297,526.0398,1,15780891,15781194,303,0.8208738797367484
5982,526.046333,526.049333,1,15781389,15781479,90,0.8293983623081409
5983,526.050467,526.0539,1,15781514,15781617,103,0.8310158374836139
5984,526.0706,526.075733,1,15782118,15782271,153,0.8366385173089564
5985,526.1192,526.1257,1,15783576,15783771,195,0.7193075260320557
5986,526.133933,526.1509,1,15784017,15784527,510,0.8438505352680052
5987,526.1619,526.178633,1,15784856,15785358,502,0.8662671315213418
5988,526.2,526.203133,1,15786000,15786093,93,0.964542100270691
5989,526.205867,526.209467,1,15786176,15786284,108,0.9509663009673688
5990,526.211067,526.215267,1,15786332,15786458,126,0.9419399366864141
5991,526.332033,526.3359,1,15789960,15790077,117,0.25971789534436257
5992,526.3677,526.371933,1,15791031,15791157,126,-0.07028796939287975
5993,526.373,526.377433,1,15791190,15791322,132,0.19392959083930472
5994,526.3855,526.391133,1,15791565,15791733,168,0.14511121272719066
5995,526.392233,526.399967,1,15791766,15791999,233,0.4584923792734565
5996,526.4356,526.583467,1,15793068,15797504,4436,0.7071026629036642
5997,526.584833,526.6033,1,15797544,15798099,555,0.5565697755530458
5998,526.604533,526.610233,1,15798135,15798306,171,0.9020837666584375
5999,526.6116,526.615967,1,15798347,15798479,132,0.9651376169872147
6000,526.6212,526.624933,1,15798636,15798747,111,0.9082046478520485
6001,526.643867,526.657233,1,15799316,15799716,400,0.9245278091157423
6002,526.674667,526.769667,1,15800240,15803090,2850,0.5662159217688416
6003,526.8081,526.8598,1,15804242,15805793,1551,0.6100596165049563
6004,526.8785,526.8844,1,15806355,15806532,177,0.7911537330876763
6005,526.906233,526.909467,1,15807186,15807284,98,0.8584651760868945
6006,526.910767,526.9205,1,15807323,15807614,291,0.8003554483116917
6007,526.926833,526.944967,1,15807804,15808349,545,0.8749481282774448
6008,526.946133,526.9503,1,15808383,15808509,126,0.8689873605863745
6009,526.969933,526.9738,1,15809097,15809214,117,0.9597929790102716
6010,527.0159,527.0217,1,15810477,15810651,174,0.8897250483096076
6011,527.092333,527.114233,1,15812769,15813426,657,0.8335252989043325
6012,527.206667,527.238867,1,15816200,15817166,966,0.8652087620794079
6013,527.239933,527.424,1,15817197,15822720,5523,0.5101878805118003
6014,527.451033,527.456133,1,15823530,15823683,153,0.17065731850829097
6015,527.462633,527.509733,1,15823878,15825291,1413,0.585829637972044
6016,527.519833,527.524,1,15825594,15825720,126,0.7311366306212337
6017,527.5403,527.549433,1,15826209,15826482,273,0.5348313335187979
6018,527.564733,527.836933,1,15826941,15835107,8166,0.2392152989618218
6019,527.846933,527.8576,1,15835407,15835728,321,0.612640380502454
6020,527.871667,527.880633,1,15836150,15836418,268,0.8591667762953883
6021,527.8918,527.9072,1,15836754,15837216,462,0.6853673519279199
6022,527.917767,528.098233,1,15837533,15842946,5413,0.421605926847257
6023,529.122067,529.131167,1,15873662,15873935,273,0.5868712604319025
6024,529.486333,529.4931,1,15884589,15884793,204,0.9140622751116219
6025,529.536233,529.566867,1,15886086,15887006,920,0.42780067312106773
6026,529.5691,529.578933,1,15887073,15887367,294,0.7030151724846416
6027,529.580067,529.5965,1,15887402,15887895,493,0.7024467025371895
6028,529.6024,529.6088,1,15888072,15888264,192,0.8806581563862415
6029,529.610733,529.6195,1,15888321,15888585,264,0.9548958989427512
6030,529.629567,529.734467,1,15888887,15892034,3147,0.40110650788499086
6031,530.1299,530.133033,1,15903897,15903990,93,0.7557498451257507
6032,530.3285,530.3483,1,15909854,15910449,595,0.22018781070641538
6033,530.360233,530.382333,1,15910806,15911469,663,0.29352585349552385
6034,530.401433,530.437967,1,15912042,15913139,1097,0.45202898472637354
6035,530.4646,530.471267,1,15913938,15914138,200,0.700717415676435
6036,530.721067,530.7263,1,15921632,15921789,157,0.6773143472594352
6037,530.7276,530.762533,1,15921828,15922875,1047,0.7730162291020409
6038,530.780967,530.786267,1,15923429,15923588,159,0.5550513809778548
6039,530.7873,530.798833,1,15923618,15923964,346,0.47454625777491705
6040,530.8136,530.841667,1,15924407,15925250,843,0.7652273448427656
6041,530.842767,530.848467,1,15925283,15925454,171,0.9245556205328801
6042,530.853267,530.8949,1,15925598,15926847,1249,0.6752636435312696
6043,530.8971,530.9546,1,15926913,15928638,1725,0.5214705931995747
6044,530.9761,530.979233,1,15929283,15929376,93,0.7772402136497807
6045,531.202233,531.3577,1,15936066,15940731,4665,0.3573909583359059
6046,531.3607,531.449633,1,15940820,15943488,2668,0.6748890457921479
6047,531.472,531.6809,1,15944160,15950426,6266,0.4605982549320974
6048,531.682333,531.716067,1,15950469,15951482,1013,0.5923433420118884
6049,531.717867,531.721267,1,15951536,15951638,102,0.7239194776451955
6050,531.722933,531.727767,1,15951687,15951833,146,0.6526571233212872
6051,531.844133,531.8518,1,15955323,15955554,231,0.5791178402921935
6052,531.856733,531.862433,1,15955701,15955872,171,0.7645071863500065
6053,531.8674,531.875867,1,15956022,15956276,254,0.647470341417882
6054,531.881367,531.889233,1,15956441,15956676,235,0.78577552683066
6055,531.898733,531.924433,1,15956961,15957732,771,0.7773819916269663
6056,531.925733,531.9344,1,15957771,15958032,261,0.5674472981610863
6057,531.935433,531.949433,1,15958062,15958482,420,0.7635488391088153
6058,532.3907,532.397833,1,15971721,15971934,213,0.6255381329445178
6059,532.399333,532.409567,1,15971979,15972287,308,0.6390566142464207
6060,532.412233,532.424867,1,15972366,15972746,380,0.7190630081837395
6061,532.426233,532.604333,1,15972786,15978129,5343,0.6317744788076328
6062,532.6131,532.628333,1,15978393,15978849,456,0.5880350732314178
6063,532.6296,532.637733,1,15978888,15979131,243,0.775559646585821
6064,532.8074,532.8224,1,15984222,15984672,450,0.702002920136443
6065,532.851533,532.855633,1,15985545,15985668,123,0.8367621170981578
6066,532.9029,532.913467,1,15987087,15987404,317,0.8606938136352853
6067,532.914533,532.926267,1,15987435,15987788,353,0.6067394998866367
6068,532.927767,532.969633,1,15987833,15989088,1255,0.7296563570501386
6069,532.971167,532.976733,1,15989135,15989301,166,0.7988857655505186
6070,532.9831,532.990833,1,15989493,15989724,231,0.6174111873897096
6071,532.9927,533.008467,1,15989781,15990254,473,0.7506172246721817
6072,533.0096,533.015067,1,15990288,15990452,164,0.8000145785326276
6073,533.0167,533.021367,1,15990501,15990641,140,0.8689508532998321
6074,533.022633,533.029067,1,15990678,15990872,194,0.9312025235825201
6075,533.639433,533.643933,1,16009182,16009317,135,-0.1937504711435022
6076,533.917867,533.921233,1,16017536,16017636,100,0.20532473065692797
6077,535.750033,535.754867,1,16072500,16072646,146,0.7470642921356364
6078,535.768,535.7729,1,16073040,16073187,147,0.5790034626787229
6079,536.0237,536.026933,1,16080710,16080807,97,0.6167219244298229
6080,536.119233,536.122267,1,16083576,16083668,92,0.7546061580747101
6081,536.155733,536.181933,1,16084671,16085457,786,0.7373220551730045
6082,536.198733,536.2094,1,16085961,16086281,320,0.7386180260222187
6083,536.2108,536.216367,1,16086323,16086491,168,0.8290569401784619
6084,536.284567,536.287867,1,16088537,16088636,99,0.2966075996121567
6085,536.333233,536.336367,1,16089996,16090091,95,0.6387015635458739
6086,536.360033,536.3721,1,16090800,16091163,363,0.05701513752621106
6087,536.3732,536.3767,1,16091196,16091301,105,0.9521687935544665
6088,536.613233,536.620967,1,16098396,16098629,233,0.8393099908083657
6089,536.622333,536.6336,1,16098669,16099008,339,0.7206138110512131
6090,536.779133,536.783067,1,16103373,16103492,119,-0.16200230668508822
6091,536.9241,536.9273,1,16107722,16107818,96,0.5328141497047519
6092,536.9798,536.982833,1,16109393,16109484,91,0.770712950143217
6093,537.015,537.020467,1,16110450,16110614,164,0.7432285455500639
6094,537.266167,537.2723,1,16117985,16118169,184,0.02314535225077316
6095,537.309333,537.325467,1,16119279,16119764,485,0.553773573365172
6096,537.538433,537.5458,1,16126152,16126374,222,0.8365945433148602
6097,537.630933,537.6625,1,16128927,16129875,948,0.40309617054186625
6098,537.6645,537.693833,1,16129935,16130814,879,0.7384857828247204
6099,537.695133,537.726433,1,16130853,16131792,939,0.5212886188974538
6100,537.812167,537.8317,1,16134365,16134950,585,0.4417729443642517
6101,537.8332,537.915167,1,16134996,16137455,2459,0.2225682477671045
6102,537.982667,538.0529,1,16139480,16141587,2107,0.5850901511804856
6103,538.6096,538.638367,1,16158288,16159151,863,0.46527395564613294
6104,538.733,538.7756,1,16161989,16163268,1279,0.6092301723039617
6105,538.835633,538.8422,1,16165068,16165266,198,0.2356181847477005
6106,538.859933,538.863233,1,16165797,16165896,99,0.3756505159984302
6107,538.869967,538.873367,1,16166099,16166201,102,0.48975891722325354
6108,538.889133,538.924667,1,16166673,16167740,1067,0.11309170388816886
6109,538.930267,538.9705,1,16167908,16169115,1207,0.14027775372470058
6110,538.995,539.0075,1,16169850,16170225,375,-0.032238789329565615
6111,539.032667,539.0432,1,16170980,16171295,315,0.5426393731778324
6112,539.045167,539.067167,1,16171355,16172015,660,0.784860174820626
6113,539.0875,539.111733,1,16172625,16173351,726,0.36116609845064573
6114,539.143233,539.150167,1,16174296,16174505,209,0.21921487406110743
6115,539.1555,539.165767,1,16174664,16174973,309,0.09282672471647989
6116,539.1856,539.189967,1,16175568,16175699,131,0.40520984313769226
6117,539.1954,539.218567,1,16175861,16176557,696,0.4198000894807697
6118,539.495967,539.503,1,16184879,16185090,211,0.5961637766203034
6119,539.527567,539.559,1,16185827,16186770,943,0.6448754486567426
6120,539.594233,539.598167,1,16187826,16187945,119,0.8631788146471732
6121,539.600167,539.6036,1,16188005,16188108,103,0.8137313641034302
6122,539.626767,539.6591,1,16188803,16189772,969,0.5499030261239521
6123,539.7312,539.734833,1,16191935,16192044,109,0.4951320329624314
6124,539.740433,539.7466,1,16192212,16192397,185,0.6828883392061457
6125,539.752733,539.914467,1,16192581,16197434,4853,0.273514325887436
6126,539.918667,540.0825,1,16197560,16202475,4915,0.5715327693223241
6127,540.0871,540.090333,1,16202612,16202709,97,0.6963321082511279
6128,540.1567,540.187433,1,16204701,16205622,921,0.7020846754263375
6129,540.194867,540.198133,1,16205846,16205943,97,0.8746848933649495
6130,540.1995,540.233233,1,16205984,16206996,1012,0.7018168763952842
6131,540.2343,540.2475,1,16207028,16207424,396,0.7681631753218147
6132,540.252333,540.2568,1,16207569,16207704,135,0.89513430948994
6133,540.263,540.271933,1,16207890,16208157,267,0.8455890487326023
6134,540.279933,540.299333,1,16208397,16208979,582,0.9147544053624335
6135,540.3077,540.311567,1,16209230,16209347,117,0.6387098943463275
6136,540.312667,540.329033,1,16209380,16209870,490,0.85071842059586
6137,540.3303,540.335033,1,16209908,16210050,142,0.6436185603530236
6138,540.3362,540.4886,1,16210085,16214658,4573,0.4606552076910024
6139,540.4961,540.4998,1,16214882,16214994,112,-0.3601026262462144
6140,540.537467,540.5443,1,16216124,16216329,205,0.7647055804900609
6141,540.5667,540.675533,1,16217000,16220265,3265,0.6169978333676449
6142,540.6834,540.687867,1,16220502,16220636,134,0.8946658794606821
6143,540.7464,540.750267,1,16222392,16222508,116,0.7434293869871594
6144,540.792533,540.797633,1,16223775,16223928,153,0.6099236782606476
6145,540.815467,540.8309,1,16224464,16224927,463,0.592141489172435
6146,540.8747,540.888067,1,16226240,16226642,402,0.8896816458868874
6147,540.9168,540.9373,1,16227503,16228119,616,0.7617462361192754
6148,540.939233,540.9473,1,16228176,16228419,243,0.7755575987492528
6149,540.953967,541.129567,1,16228619,16233887,5268,0.5271766171962247
6150,541.170167,541.1887,1,16235105,16235661,556,0.6310763319849813
6151,541.209733,541.222567,1,16236291,16236677,386,0.5783919852428421
6152,541.224033,541.245433,1,16236720,16237362,642,0.6720896417227126
6153,541.246567,541.2501,1,16237397,16237503,106,0.7349506983647903
6154,541.3763,541.380333,1,16241289,16241409,120,0.9392319290078126
6155,541.381633,541.390567,1,16241448,16241717,269,0.6774343221822687
6156,541.397733,541.405633,1,16241931,16242168,237,0.8672911049455582
6157,541.406933,541.423933,1,16242207,16242717,510,0.8329983438234763
6158,541.427267,541.4322,1,16242818,16242965,147,0.756111832621176
6159,541.436067,541.444633,1,16243082,16243338,256,0.816423341338404
6160,541.448633,541.456367,1,16243458,16243691,233,0.6606507792940636
6161,541.457433,541.5046,1,16243722,16245138,1416,0.5100999586261156
6162,541.514967,541.5316,1,16245449,16245948,499,0.7837825750393679
6163,541.569933,541.573433,1,16247097,16247202,105,
6164,541.589667,541.594433,1,16247690,16247832,142,0.7594614527314085
6165,541.595533,541.601667,1,16247865,16248050,185,0.6394876592399358
6166,541.6027,541.803167,1,16248081,16254095,6014,0.7551636345883496
6167,541.8045,541.8094,1,16254134,16254282,148,0.9055658643272018
6168,541.8105,541.8182,1,16254315,16254546,231,0.7165899142572161
6169,541.835367,541.8387,1,16255061,16255161,100,0.8347156425732764
6170,541.843467,541.885567,1,16255304,16256567,1263,0.8499057812271321
6171,541.888533,541.8978,1,16256655,16256933,278,0.9079180909094974
6172,541.8989,541.940267,1,16256967,16258208,1241,0.5991240767973166
6173,541.945567,541.952733,1,16258367,16258581,214,0.8048367977300068
6174,542.0004,542.0061,1,16260012,16260182,170,0.5542581446416887
6175,542.014,542.026533,1,16260420,16260795,375,0.8583084579564394
6176,542.028267,542.033467,1,16260848,16261004,156,0.6397395600846736
6177,542.037467,542.044033,1,16261124,16261320,196,0.8372497829404296
6178,542.0467,542.054833,1,16261401,16261644,243,0.6541334743146521
6179,542.061133,542.0749,1,16261833,16262246,413,0.7957042883423953
6180,542.0761,542.096533,1,16262283,16262895,612,0.8150110633269027
6181,542.115667,542.1192,1,16263470,16263576,106,0.5563759152352549
6182,542.2353,542.2393,1,16267059,16267178,119,0.95336170024793
6183,542.2852,542.3004,1,16268556,16269011,455,0.7670586322187926
6184,542.301733,542.3062,1,16269051,16269186,135,0.9197410643389392
6185,542.311,542.314667,1,16269330,16269440,110,0.872024290839117
6186,542.317167,542.3222,1,16269515,16269665,150,0.6771990761022444
6187,542.3363,542.340933,1,16270089,16270227,138,0.8953727171812813
6188,542.3425,542.345767,1,16270275,16270373,98,0.8099700525512001
6189,542.4212,542.432267,1,16272636,16272968,332,0.6767804897214136
6190,542.470933,542.507633,1,16274127,16275228,1101,0.852003122813201
6191,542.550367,542.5538,1,16276511,16276614,103,0.8667799667860433
6192,542.5554,542.5725,1,16276661,16277175,514,0.8330524387055046
6193,542.5736,542.579333,1,16277208,16277379,171,0.8450096790763597
6194,542.5808,542.5863,1,16277423,16277589,166,0.6520862192968342
6195,542.588267,542.6466,1,16277648,16279398,1750,0.7466183939548513
6196,542.687867,542.742233,1,16280636,16282266,1630,0.6417335514262089
6197,542.7453,542.7676,1,16282359,16283028,669,0.7427288906894244
6198,542.769233,542.839233,1,16283076,16285176,2100,0.7407755229742711
6199,542.840467,542.860833,1,16285214,16285824,610,0.5968446006992092
6200,542.8636,542.872567,1,16285908,16286177,269,0.8622869953408986
6201,542.8743,542.8976,1,16286228,16286928,700,0.8572384104902154
6202,542.902867,542.910067,1,16287086,16287302,216,0.8823068341230175
6203,542.927267,542.936967,1,16287818,16288109,291,0.9214093340150112
6204,543.543833,543.547433,1,16306314,16306422,108,0.6811514563292623
6205,543.597833,543.607633,1,16307934,16308228,294,0.7355305234340322
6206,543.625067,543.656833,1,16308752,16309704,952,0.5012703722752773
6207,543.711267,543.743767,1,16311338,16312313,975,0.559706186614621
6208,543.767867,543.772433,1,16313036,16313172,136,0.8774248760135827
6209,543.8387,543.842567,1,16315161,16315277,116,0.730753729435635
6210,543.8506,543.8558,1,16315518,16315674,156,0.8507591483791718
6211,543.859433,543.862567,1,16315782,16315877,95,0.4929251366832543
6212,543.873633,543.8794,1,16316208,16316382,174,0.806468306882003
6213,543.894867,543.898967,1,16316846,16316969,123,0.678108813907464
6214,543.9856,543.991167,1,16319568,16319735,167,0.29267149944448634
6215,544.109733,544.113233,1,16323291,16323396,105,0.5802988790469171
6216,544.118167,544.131933,1,16323545,16323957,412,0.1561867692208335
6217,544.2933,544.298167,1,16328799,16328945,146,0.4277262937145382
6218,545.641233,545.673567,1,16369236,16370207,971,0.6509022190296538
6219,545.674867,545.750367,1,16370246,16372511,2265,0.705445249124871
6220,545.753867,545.758133,1,16372616,16372743,127,0.12009552150225648
6221,545.7626,545.780667,1,16372878,16373420,542,0.6748312912213325
6222,545.795167,545.7984,1,16373855,16373952,97,0.8324616769239354
6223,545.937633,545.943667,1,16378128,16378310,182,0.8118478584903348
6224,545.944767,545.947933,1,16378343,16378437,94,0.9039427377230498
6225,546.620767,546.624467,1,16398623,16398734,111,0.7501328916521063
6226,546.663967,546.6674,1,16399919,16400022,103,0.8823253405634081
6227,546.676833,546.6903,1,16400304,16400709,405,0.8153410567282668
6228,546.691767,546.702467,1,16400753,16401074,321,0.8282848877088477
6229,546.703567,546.7103,1,16401107,16401308,201,0.8322523794536296
6230,546.711333,546.799033,1,16401339,16403970,2631,0.42213051282292274
6231,546.800067,546.920833,1,16404002,16407624,3622,0.6393134715190573
6232,547.086333,547.110667,1,16412589,16413320,731,0.8838722932628699
6233,547.169533,547.240767,1,16415085,16417223,2138,0.6322421128443568
6234,547.242133,547.251,1,16417263,16417530,267,0.8295912034886737
6235,547.252033,547.2598,1,16417560,16417794,234,0.893654175444062
6236,547.261333,547.271633,1,16417839,16418148,309,0.8554862655031694
6237,547.272967,547.2802,1,16418189,16418406,217,0.8509009946984455
6238,547.285133,547.291767,1,16418553,16418753,200,0.8207600306158559
6239,547.307467,547.311067,1,16419224,16419332,108,0.825075674324334
6240,547.312233,547.315233,1,16419366,16419456,90,0.9151146597747511
6241,547.322067,547.327567,1,16419662,16419827,165,0.9538561178404478
6242,547.348467,547.352567,1,16420454,16420577,123,0.9320105525664016
6243,547.356533,547.359967,1,16420695,16420799,104,0.5066797609682369
6244,547.361567,547.364667,1,16420847,16420940,93,0.8571182312055367
6245,547.366333,547.370467,1,16420989,16421114,125,0.7611867594168763
6246,547.3728,547.387967,1,16421184,16421639,455,0.5163252317582275
6247,547.4059,547.5716,1,16422177,16427148,4971,0.3236403658262133
6248,547.5907,547.78,1,16427721,16433400,5679,0.5236548955055762
6249,547.786767,547.789833,1,16433603,16433694,91,0.865755911108785
6250,547.790867,547.883833,1,16433726,16436514,2788,0.5320406407100818
6251,547.9263,548.197533,1,16437789,16445925,8136,0.41492017404712683
6252,548.2365,548.3906,1,16447095,16451717,4622,0.19666217854450646
6253,548.462833,548.474133,1,16453884,16454223,339,0.33943400888605196
6254,548.477467,548.487167,1,16454324,16454615,291,0.7154173043359148
6255,549.7698,549.986733,1,16493094,16499601,6507,0.37307469697688733
6256,549.988067,550.007167,1,16499642,16500215,573,0.8671902854757599
6257,550.029667,550.0533,1,16500890,16501599,709,0.6927715550093723
6258,550.066567,550.073167,1,16501997,16502195,198,0.8730861511364293
6259,550.101267,550.118867,1,16503038,16503566,528,0.8428211167616539
6260,550.135567,550.146333,1,16504067,16504389,322,0.7393097583595153
6261,550.229,550.2463,1,16506870,16507389,519,0.8252045032458858
6262,550.268033,550.271567,1,16508040,16508147,107,0.8412637875950937
6263,550.603467,550.607367,1,16518104,16518221,117,0.8256591262485202
6264,550.611667,550.615133,1,16518350,16518453,103,0.9133802225278126
6265,550.646667,550.652167,1,16519400,16519565,165,0.8733713495670001
6266,550.751533,550.7552,1,16522545,16522655,110,-0.012864584129281932
6267,550.991233,551.0033,1,16529736,16530098,362,0.9445872095825221
6268,551.004733,551.009233,1,16530141,16530276,135,0.853607864725556
6269,551.179267,551.185,1,16535378,16535549,171,0.7083369637048057
6270,551.201133,551.212567,1,16536033,16536377,344,0.9040602562689133
6271,551.2395,551.243167,1,16537185,16537295,110,0.7357582333788635
6272,551.244367,551.251767,1,16537331,16537553,222,0.6565028513098169
6273,551.253433,551.367167,1,16537602,16541015,3413,0.681061534943962
6274,551.3683,551.382767,1,16541049,16541483,434,0.8088565289149698
6275,551.383833,551.3973,1,16541514,16541919,405,0.8374193113393287
6276,551.400067,551.4038,1,16542002,16542114,112,0.7616436959369427
6277,551.405,551.430833,1,16542150,16542924,774,0.3239233761892941
6278,551.4999,551.503867,1,16544997,16545116,119,0.16145170079371754
6279,551.504933,551.5087,1,16545147,16545261,114,0.9058024472819293
6280,551.524833,551.528367,1,16545744,16545851,107,0.9424823912301473
6281,551.5392,551.5489,1,16546176,16546467,291,0.2957486705913135
6282,551.550933,551.554667,1,16546527,16546640,113,0.6374604019915932
6283,551.555833,551.559067,1,16546674,16546772,98,0.7188270512533759
6284,551.582167,551.5857,1,16547465,16547571,106,0.9103295830146746
6285,551.593767,551.5991,1,16547813,16547973,160,0.2321615153845061
6286,551.604033,551.608233,1,16548120,16548246,126,0.7637015786254868
6287,551.939,551.9579,1,16558169,16558737,568,0.771573917417934
6288,551.9589,551.9664,1,16558767,16558992,225,0.8772901478755628
6289,552.011033,552.014267,1,16560330,16560428,98,0.8731353496877979
6290,552.169533,552.173233,1,16565085,16565196,111,0.44733930865526966
6291,552.478733,552.482933,1,16574361,16574487,126,0.6839588678035162
6292,552.485033,552.488433,1,16574550,16574652,102,0.837267611681199
6293,552.49,552.4989,1,16574700,16574967,267,0.7818580500941341
6294,552.557033,552.563167,1,16576710,16576895,185,0.8488231057534804
6295,552.644067,552.6471,1,16579322,16579413,91,0.7118168167900419
6296,552.726,552.731033,1,16581780,16581930,150,0.06903505950636998
6297,552.732933,552.736933,1,16581987,16582107,120,0.7431793352308992
6298,552.808633,552.812233,1,16584258,16584366,108,0.817543411606789
6299,552.814233,552.823,1,16584426,16584690,264,0.3964016029680201
6300,552.8464,552.8506,1,16585392,16585518,126,0.31380012203413304
6301,552.871033,552.88,1,16586130,16586400,270,0.277375613838945
6302,552.954333,552.969933,1,16588629,16589097,468,0.709153772778614
6303,552.974533,552.980067,1,16589235,16589402,167,0.9357048970890952
6304,552.989467,552.996033,1,16589684,16589880,196,0.6954875998413114
6305,553.000333,553.0343,1,16590009,16591029,1020,0.16791254525729696
6306,553.054367,553.089767,1,16591631,16592693,1062,0.4754906668377626
6307,553.114367,553.133633,1,16593431,16594008,577,0.4742641324125723
6308,553.141533,553.147,1,16594245,16594410,165,0.8301059775449632
6309,553.151567,553.410767,1,16594547,16602323,7776,0.4853572167933522
6310,553.492267,553.497533,1,16604768,16604925,157,0.7849919690001672
6311,553.529233,553.537733,1,16605876,16606131,255,0.618075352173684
6312,553.569067,553.618,1,16607072,16608540,1468,0.8177521301020194
6313,553.6442,553.651833,1,16609325,16609554,229,0.8139965266727696
6314,553.6533,553.656567,1,16609598,16609697,99,0.8928823088742516
6315,553.692833,553.710233,1,16610784,16611306,522,0.8375318361438089
6316,553.711333,553.783367,1,16611339,16613501,2162,0.879502596406911
6317,553.7844,553.792267,1,16613532,16613768,236,0.8771108856254952
6318,553.793367,553.931933,1,16613801,16617957,4156,0.7792793350435847
6319,553.9336,553.943367,1,16618007,16618301,294,0.7650671319903269
6320,553.945067,554.009567,1,16618352,16620287,1935,0.5699921007646681
6321,554.0316,554.050767,1,16620948,16621523,575,0.6539635113067971
6322,554.053667,554.077,1,16621610,16622310,700,0.6678791527082846
6323,554.080167,554.113533,1,16622405,16623405,1000,0.6816188224036285
6324,555.350533,555.355433,1,16660515,16660662,147,0.6565006694078025
6325,555.7734,555.8801,1,16673202,16676403,3201,0.4957607495896353
6326,555.884067,555.961533,1,16676522,16678845,2323,0.6576792670195502
6327,555.969967,555.974567,1,16679099,16679237,138,0.8217000889567956
6328,555.9762,555.983367,1,16679285,16679501,216,0.8388229833743844
6329,555.984567,555.991333,1,16679537,16679739,202,0.7538642455267786
6330,555.993367,556.017167,1,16679801,16680515,714,0.8579825912930603
6331,556.0939,556.098567,1,16682816,16682957,141,0.8423682887785678
6332,556.184367,556.192633,1,16685531,16685778,247,0.7080599122278097
6333,556.401967,556.4065,1,16692059,16692195,136,0.8515312218391556
6334,556.4627,556.5102,1,16693881,16695306,1425,0.544331956149695
6335,556.617033,556.6215,1,16698510,16698645,135,0.009493574528410466
6336,556.6298,556.6429,1,16698894,16699287,393,0.8981810109966806
6337,556.707667,556.813233,1,16701230,16704396,3166,0.18942754534639694
6338,556.839833,556.8466,1,16705194,16705397,203,0.8807276338434681
6339,556.850833,556.859,1,16705524,16705770,246,0.551593791752137
6340,556.861067,556.968967,1,16705832,16709069,3237,0.4861897883660943
6341,556.982533,556.986333,1,16709475,16709589,114,0.49855474536739913
6342,556.987633,557.029767,1,16709628,16710893,1265,0.7026786099271012
6343,557.031267,557.040233,1,16710938,16711206,268,0.7013301541775013
6344,557.041267,557.1285,1,16711238,16713855,2617,0.3675497838646966
6345,557.179867,557.1843,1,16715396,16715529,133,0.770378046435646
6346,557.185967,557.1903,1,16715579,16715709,130,0.8779610957762479
6347,557.201833,557.218033,1,16716054,16716540,486,0.7439854512586935
6348,557.221933,557.2362,1,16716657,16717086,429,0.8312816613992101
6349,557.2408,557.252667,1,16717224,16717580,356,0.519211707297154
6350,557.254033,557.285567,1,16717620,16718567,947,0.3594063427703642
6351,557.298667,557.3049,1,16718960,16719147,187,0.6766315434944814
6352,557.349667,557.353233,1,16720490,16720596,106,0.08119044289621521
6353,557.378867,557.3987,1,16721366,16721960,594,0.5912173186047148
6354,557.4254,557.432533,1,16722761,16722975,214,0.6163934002597239
6355,557.509367,557.5142,1,16725281,16725425,144,0.8261217215397485
6356,558.006,558.0107,1,16740180,16740321,141,0.20615584616442875
6357,564.330533,564.348033,1,16929915,16930440,525,0.7723884091961082
6358,564.3499,564.360033,1,16930497,16930800,303,0.42816290762797954
6359,564.377,564.3863,1,16931310,16931589,279,0.6631436345646965
6360,564.464767,564.529967,1,16933943,16935899,1956,0.2322820373756803
6361,564.5495,564.561467,1,16936485,16936844,359,0.42124265402649613
6362,564.564967,564.576567,1,16936949,16937297,348,0.3461486449561087
6363,564.579133,564.650567,1,16937373,16939517,2144,0.2565127820986098
6364,564.671333,564.675767,1,16940139,16940273,134,0.9078408048812805
6365,564.731433,564.785567,1,16941942,16943567,1625,0.5883592117352875
6366,564.791967,565.253233,1,16943759,16957596,13837,0.6339022324483465
6367,565.2546,565.2645,1,16957638,16957935,297,0.8357495818409411
6368,565.265533,565.2751,1,16957965,16958253,288,0.8530921098426525
6369,565.276167,565.284267,1,16958285,16958528,243,0.938642718521769
6370,565.2856,565.2902,1,16958568,16958706,138,0.7745166133169115
6371,565.2914,565.304233,1,16958742,16959126,384,0.7216739180156948
6372,565.305633,565.3146,1,16959168,16959438,270,0.7732033225282364
6373,565.319133,565.325967,1,16959573,16959779,206,0.7824465646848732
6374,565.331733,565.345967,1,16959951,16960379,428,0.7385088398549166
6375,565.387133,565.3988,1,16961613,16961964,351,0.8836833444066358
6376,565.476667,565.487033,1,16964300,16964610,310,0.762140154041614
6377,565.488533,565.5044,1,16964655,16965132,477,0.8392534391598294
6378,565.579033,565.5835,1,16967370,16967505,135,0.7621955462272243
6379,565.5929,565.6074,1,16967787,16968222,435,0.7303746645938376
6380,565.608633,565.625,1,16968258,16968750,492,0.8439697056400495
6381,565.626633,565.826433,1,16968798,16974792,5994,0.327732898385601
6382,565.841933,565.849033,1,16975257,16975470,213,0.9365205490956453
6383,565.856533,565.9138,1,16975695,16977414,1719,0.7969642845871492
6384,565.915133,566.177533,1,16977453,16985325,7872,0.7368524282816016
6385,566.483033,566.490733,1,16994490,16994721,231,0.9230362312958547
6386,566.6923,566.730933,1,17000769,17001927,1158,0.3962083182631701
6387,566.734367,566.819267,1,17002031,17004578,2547,0.6398006198370696
6388,566.8267,566.863133,1,17004801,17005893,1092,0.3183715550571193
6389,566.873233,566.8818,1,17006196,17006454,258,0.7239718607645785
6390,566.893867,566.908733,1,17006816,17007261,445,0.3978680159258224
6391,566.913867,566.9486,1,17007416,17008458,1042,0.49032371429125604
6392,566.976267,567.0025,1,17009288,17010075,787,0.5710537174944355
6393,567.006167,567.097033,1,17010185,17012910,2725,0.5347331819850685
6394,567.4958,567.506733,1,17024874,17025201,327,0.6830799824009435
6395,567.615567,567.636833,1,17028467,17029104,637,0.7930948173598039
6396,567.639667,567.656633,1,17029190,17029698,508,0.9294896363261906
6397,567.877333,568.0115,1,17036319,17040345,4026,0.3979456064395507
6398,568.0127,568.057767,1,17040381,17041733,1352,0.834221029061012
6399,568.061933,568.069633,1,17041857,17042088,231,0.8516917583930201
6400,568.070933,568.082,1,17042127,17042460,333,0.9056776229274311
6401,568.0861,568.110967,1,17042583,17043329,746,0.904863731136563
6402,568.139267,568.1506,1,17044178,17044518,340,0.8286194667726796
6403,568.1529,568.168667,1,17044587,17045060,473,0.8913176060940626
6404,568.170367,568.175533,1,17045111,17045265,154,0.896202980397105
6405,568.257733,568.275933,1,17047731,17048277,546,0.3925259233234574
6406,568.282533,568.432533,1,17048475,17052975,4500,0.4784331769512312
6407,568.4804,568.4898,1,17054412,17054694,282,0.7302341102428115
6408,568.491133,568.503067,1,17054733,17055092,359,0.7947641512007784
6409,568.5079,568.511667,1,17055237,17055350,113,0.909004857411189
6410,568.515367,568.521733,1,17055461,17055651,190,0.8450118247828651
6411,568.522833,568.5276,1,17055684,17055828,144,0.8817032214462635
6412,568.529,568.583767,1,17055870,17057513,1643,0.46622990467355796
6413,568.588333,568.631367,1,17057649,17058941,1292,0.46187758105836507
6414,568.6325,568.653767,1,17058975,17059613,638,0.7511848581024156
6415,568.6559,568.688167,1,17059677,17060645,968,0.9004746299280781
6416,568.689233,568.693233,1,17060676,17060796,120,0.9671253743510317
6417,568.694433,568.733467,1,17060832,17062004,1172,0.23460498885271366
6418,568.7347,568.766067,1,17062041,17062982,941,0.34017006338933653
6419,568.7675,568.853533,1,17063025,17065605,2580,0.5514392743096935
6420,568.873367,568.879,1,17066201,17066370,169,0.6331302187401893
6421,568.959133,568.9639,1,17068773,17068917,144,0.818391308412404
6422,568.978733,568.9832,1,17069361,17069496,135,0.8341546165809679
6423,568.994533,569.244333,1,17069835,17077329,7494,0.4452965581200175
6424,569.2489,569.293433,1,17077467,17078802,1335,0.4371643587713079
6425,569.294867,569.320967,1,17078846,17079629,783,0.4471988529189142
6426,569.345333,569.3534,1,17080359,17080602,243,0.742159830846645
6427,569.363167,569.367867,1,17080895,17081036,141,0.889061429690789
6428,569.377633,569.381833,1,17081328,17081454,126,0.8320574396597148
6429,569.398267,569.404567,1,17081948,17082137,189,0.5450781723393073
6430,569.430367,569.438733,1,17082911,17083161,250,0.3943380368622773
6431,569.444033,569.4933,1,17083320,17084799,1479,0.26338971228976693
6432,569.494533,569.638133,1,17084835,17089143,4308,0.3021136990728002
6433,569.6433,569.6525,1,17089299,17089575,276,0.5288464872850982
6434,569.657367,569.6607,1,17089721,17089821,100,0.5474464181427372
6435,569.711067,569.761267,1,17091332,17092838,1506,0.35951260909596283
6436,569.766033,569.802133,1,17092980,17094063,1083,0.49021143418180557
6437,569.814067,569.8308,1,17094422,17094924,502,0.6818938360934746
6438,570.329167,570.334667,1,17109875,17110040,165,0.38991018151987084
6439,570.738,570.747567,1,17122140,17122427,287,0.5930312502916418
6440,570.9612,571.019633,1,17128836,17130588,1752,0.2910794616428511
6441,571.134533,571.1607,1,17134035,17134821,786,0.3251774100041464
6442,571.1875,571.191433,1,17135625,17135742,117,0.03424110215814007
6443,571.322567,571.3545,1,17139677,17140635,958,0.6286895994855692
6444,571.363933,571.4023,1,17140917,17142069,1152,0.21396146509606392
6445,571.412867,571.415933,1,17142386,17142477,91,-0.4349462994125689
6446,571.4201,571.430167,1,17142603,17142905,302,0.8272762222063703
6447,571.4417,571.446067,1,17143251,17143382,131,0.7000144955755785
6448,571.4473,571.455367,1,17143419,17143661,242,0.7060662596142339
6449,571.481567,571.516,1,17144447,17145480,1033,0.386453638833586
6450,571.520833,571.557,1,17145624,17146710,1086,0.19835033313219777
6451,571.648633,571.6865,1,17149458,17150595,1137,0.5351922268090232
6452,571.6952,571.738,1,17150856,17152140,1284,0.40894082562101625
6453,572.027133,572.0563,1,17160813,17161689,876,0.4751240417083795
6454,572.078667,572.086733,1,17162360,17162601,241,0.46119028576201127
6455,572.528733,572.533433,1,17175861,17176002,141,0.18228579770166692
6456,572.535233,572.5492,1,17176056,17176476,420,0.010983015531313872
6457,573.3736,573.4228,1,17201208,17202684,1476,0.03369589068803996
6458,573.4276,573.480067,1,17202828,17204402,1574,0.106436218698127
6459,573.484867,573.4938,1,17204546,17204814,268,0.43441145674105225
6460,573.498533,573.503667,1,17204955,17205110,155,0.785111229156023
6461,573.512367,573.5252,1,17205371,17205756,385,0.8165418529095263
6462,573.5284,573.5336,1,17205852,17206008,156,0.8466019420090928
6463,573.536967,573.5555,1,17206109,17206665,556,0.5168805432868379
6464,573.586933,573.592,1,17207607,17207760,153,0.9095038986535431
6465,573.5953,573.599433,1,17207859,17207982,123,0.5922399227348112
6466,573.727133,573.735733,1,17211813,17212071,258,0.4638982937633599
6467,573.736967,573.7418,1,17212109,17212254,145,0.8182970729666023
6468,573.7428,573.754767,1,17212284,17212643,359,0.7780513096785384
6469,573.758,573.765867,1,17212740,17212976,236,0.8697497126375408
6470,573.7875,573.794567,1,17213625,17213837,212,0.9647016769450498
6471,573.796867,573.803333,1,17213906,17214099,193,0.9695519485177708
6472,573.804667,573.812867,1,17214140,17214386,246,0.8744799050827521
6473,573.8178,573.840567,1,17214534,17215217,683,0.7164919130491373
6474,573.8977,573.902867,1,17216931,17217086,155,0.4533906009696129
6475,573.909333,573.912867,1,17217279,17217386,107,0.9298014780519988
6476,574.369333,574.3724,1,17231079,17231172,93,0.9158643124257749
6477,574.3865,574.389667,1,17231595,17231690,95,0.9510052761750801
6478,574.396767,574.432933,1,17231903,17232987,1084,0.727207500143331
6479,574.443433,574.483733,1,17233302,17234511,1209,0.7761329940053314
6480,574.484733,574.489333,1,17234541,17234679,138,0.8546775107445745
6481,574.4914,574.503767,1,17234742,17235113,371,0.6565246965321787
6482,574.505367,574.592933,1,17235161,17237787,2626,0.6984315633670294
6483,574.594233,574.598233,1,17237826,17237946,120,0.8440852709988971
6484,574.6019,574.607367,1,17238057,17238221,164,0.8911721596099741
6485,574.6092,574.6126,1,17238276,17238378,102,0.9490061266298676
6486,574.6136,574.6214,1,17238408,17238642,234,0.9013841161079119
6487,574.6259,574.630933,1,17238777,17238927,150,0.6621098167050108
6488,574.632033,574.714167,1,17238960,17241425,2465,0.7084555238899989
6489,574.7152,574.734867,1,17241456,17242046,590,0.7938736661065237
6490,574.736,574.757233,1,17242080,17242716,636,0.8623752493042475
6491,574.7589,574.773233,1,17242767,17243196,429,0.7108572470297772
6492,574.7745,574.801167,1,17243235,17244035,800,0.8166016496600712
6493,574.802167,574.807233,1,17244065,17244216,151,0.8395543603674489
6494,574.812267,574.8179,1,17244368,17244537,169,0.5440709800717757
6495,574.869667,574.873267,1,17246090,17246198,108,0.5150893442086438
6496,575.3582,575.4115,1,17260746,17262345,1599,0.23994311090527404
6497,575.473533,575.528867,1,17264205,17265866,1661,0.6636839998435713
6498,575.554,575.559267,1,17266620,17266778,158,0.8843575730311143
6499,575.5628,575.626167,1,17266884,17268785,1901,0.49713741458896027
6500,575.627367,575.637533,1,17268821,17269125,304,0.8363354486688461
6501,575.6392,575.648433,1,17269176,17269452,276,0.7954281138842453
6502,575.650333,575.658333,1,17269509,17269749,240,0.8611669781002701
6503,575.660867,575.6654,1,17269826,17269962,136,0.7542223824076296
6504,575.672867,575.711333,1,17270186,17271339,1153,0.6283879399178871
6505,575.712367,575.7188,1,17271371,17271564,193,0.7685315705043844
6506,575.7383,575.742433,1,17272149,17272272,123,0.7181329415624796
6507,575.7488,575.757433,1,17272464,17272722,258,0.7516940980743514
6508,575.762933,575.775533,1,17272887,17273265,378,0.6562002117448149
6509,575.776567,575.783833,1,17273297,17273514,217,0.9220606265388489
6510,575.784867,575.795367,1,17273546,17273861,315,0.6685496387832998
6511,575.797,575.802833,1,17273910,17274084,174,0.8566820027385831
6512,575.811633,575.817967,1,17274348,17274539,191,0.841302073705067
6513,575.8515,575.857233,1,17275545,17275716,171,0.8551270972963315
6514,575.861367,575.864433,1,17275841,17275932,91,0.9421683807913679
6515,576.197267,576.226967,1,17285918,17286809,891,0.7226946230715153
6516,576.229767,576.240633,1,17286893,17287218,325,0.8907893647048725
6517,576.2608,576.2671,1,17287824,17288013,189,0.7836326917683636
6518,576.2846,576.3074,1,17288538,17289222,684,0.31722371113946457
6519,576.531933,576.538867,1,17295957,17296166,209,0.7096507705544014
6520,576.5914,576.597233,1,17297742,17297916,174,0.5191458581131675
6521,579.208967,579.2613,1,17376269,17377839,1570,0.1017918165380394
6522,579.264633,579.272,1,17377938,17378160,222,0.8322368602654351
6523,579.3182,579.3271,1,17379546,17379813,267,0.7528715820940077
6524,579.328167,579.333033,1,17379845,17379990,145,0.29321395354565305
6525,579.562433,579.574533,1,17386872,17387235,363,0.5233801692656415
6526,579.5903,579.594,1,17387709,17387820,111,0.8131572068217701
6527,579.5959,579.599867,1,17387877,17387996,119,0.6792198788752871
6528,579.629367,579.6513,1,17388881,17389539,658,0.47744768602918114
6529,579.666967,579.671433,1,17390009,17390142,133,0.6877834685929871
6530,579.6763,579.722333,1,17390289,17391669,1380,0.3477567817840384
6531,579.728967,579.7834,1,17391869,17393502,1633,0.3755804506726933
6532,579.797533,579.806233,1,17393925,17394186,261,0.6337241265146195
6533,579.8171,579.820333,1,17394513,17394609,96,0.9471536594317443
6534,579.8328,579.843367,1,17394984,17395301,317,0.794762976622903
6535,579.845,579.858533,1,17395350,17395755,405,0.6311134392829097
6536,579.8737,579.883633,1,17396211,17396508,297,0.511966170741353
6537,579.951733,579.9585,1,17398551,17398755,204,0.6747654043788125
6538,581.0919,581.097967,1,17432757,17432939,182,0.6031360589477419
6539,581.694533,581.7008,1,17450835,17451024,189,-0.11411431242040601
6540,582.508167,582.512033,1,17475245,17475360,115,0.4112120402588216
6541,582.796733,582.8077,1,17483901,17484231,330,0.6117834576836094
6542,582.825267,582.8336,1,17484758,17485008,250,0.9121051470744965
6543,582.8511,582.861367,1,17485533,17485841,308,0.7621609913343864
6544,582.866233,582.961767,1,17485986,17488853,2867,0.7306196690218427
6545,582.962833,582.973467,1,17488884,17489204,320,0.886377161992748
6546,583.0515,583.055567,1,17491545,17491667,122,0.8312797743196877
6547,583.0792,583.085567,1,17492376,17492567,191,0.821745487120555
6548,583.087467,583.103133,1,17492624,17493093,469,0.7489904463271204
6549,583.109933,583.117467,1,17493297,17493524,227,0.8288349456763076
6550,583.1204,583.1248,1,17493612,17493744,132,0.8077501300615892
6551,583.1261,583.1633,1,17493783,17494899,1116,0.797614052609776
6552,583.189433,583.219933,1,17495682,17496597,915,0.5153435822641962
6553,583.220933,583.327167,1,17496627,17499815,3188,0.5064990907386472
6554,583.338967,583.353733,1,17500169,17500611,442,0.6202000155977846
6555,583.3656,583.4069,1,17500968,17502207,1239,0.771337778087583
6556,583.4137,583.417267,1,17502411,17502518,107,0.6948692026282705
6557,583.449,583.552233,1,17503470,17506566,3096,0.6173984107656011
6558,583.5547,583.557867,1,17506641,17506736,95,0.6819314041443876
6559,583.599633,583.6105,1,17507988,17508315,327,0.7878526281977407
6560,583.611733,583.640467,1,17508351,17509214,863,0.8040883675117485
6561,583.642267,583.645267,1,17509268,17509358,90,0.8983700021267281
6562,583.726867,583.7302,1,17511806,17511906,100,0.9401776852755478
6563,583.801467,583.8075,1,17514044,17514225,181,0.8890841190119562
6564,583.8156,583.843467,1,17514468,17515304,836,0.8887138771410992
6565,583.8559,583.863867,1,17515677,17515916,239,0.6193646058903751
6566,583.865067,583.891167,1,17515952,17516735,783,0.7121184232687671
6567,583.892267,583.964133,1,17516768,17518923,2155,0.7781822114682265
6568,584.086967,584.1008,1,17522609,17523024,415,0.8176237141824909
6569,584.111767,584.115833,1,17523353,17523474,121,0.9496290716804436
6570,584.1301,584.158733,1,17523903,17524761,858,0.8192113563883808
6571,584.1665,584.190533,1,17524995,17525715,720,0.6501698858957956
6572,584.1922,584.217967,1,17525766,17526539,773,0.6888253230813012
6573,584.2191,584.223067,1,17526573,17526692,119,0.6145458466586486
6574,584.234233,584.2423,1,17527026,17527269,243,0.830057365307199
6575,584.245933,584.257333,1,17527377,17527719,342,0.7924076239288266
6576,584.2584,584.263433,1,17527752,17527902,150,0.934652171631602
6577,584.265933,584.3076,1,17527977,17529228,1251,0.4817604828623548
6578,584.308933,584.3219,1,17529267,17529657,390,0.8192319974439923
6579,584.343733,584.454833,1,17530311,17533644,3333,0.553398425742288
6580,584.512933,584.621133,1,17535387,17538633,3246,0.5837692332695588
6581,584.8268,584.8327,1,17544804,17544981,177,0.4327897674300874
6582,584.838167,584.843967,1,17545145,17545319,174,0.6780808800421583
6583,584.873867,584.895067,1,17546216,17546852,636,0.7546626697364855
6584,584.8988,584.9345,1,17546964,17548035,1071,0.6502430329556701
6585,585.0116,585.032567,1,17550348,17550977,629,0.8960558122582603
6586,585.05,585.136067,1,17551500,17554082,2582,0.598211381842195
6587,585.142667,585.1504,1,17554280,17554512,232,0.6910229169840251
6588,585.151467,585.157467,1,17554544,17554724,180,0.7098918009971107
6589,585.169333,585.176567,1,17555079,17555297,218,0.8111205293850312
6590,585.1893,585.203467,1,17555679,17556104,425,0.7765772434517785
6591,585.2047,585.2294,1,17556141,17556882,741,0.7040921725219405
6592,585.2304,585.354233,1,17556912,17560626,3714,0.5787805319915522
6593,585.3558,585.382867,1,17560674,17561486,812,0.7103079017538104
6594,585.450033,585.4536,1,17563500,17563608,108,0.8856641085591851
6595,585.4824,585.4854,1,17564472,17564562,90,0.9222478905710154
6596,585.496167,585.505467,1,17564885,17565164,279,0.413467408617326
6597,585.509333,585.518233,1,17565279,17565546,267,0.788837226428169
6598,585.5195,585.524467,1,17565585,17565734,149,0.4918231297764655
6599,585.579067,585.584033,1,17567372,17567520,148,0.7903205487708722
6600,585.588633,585.592467,1,17567658,17567774,116,0.7595341669372815
6601,586.055633,586.088967,1,17581668,17582669,1001,0.42029054630617585
6602,586.09,586.099033,1,17582700,17582970,270,0.826051863993555
6603,586.1008,586.1109,1,17583024,17583327,303,0.8139456581643049
6604,586.1119,586.118667,1,17583357,17583560,203,0.594547653179655
6605,586.1521,586.155567,1,17584563,17584667,104,0.6398000850789093
6606,587.026433,587.0313,1,17610792,17610939,147,0.5564768555401406
6607,587.0323,587.0666,1,17610969,17611998,1029,0.014566239436173342
6608,587.186167,587.197367,1,17615585,17615921,336,0.18050271417807037
6609,587.1984,587.269,1,17615952,17618070,2118,0.19785244034582639
6610,587.272733,587.331033,1,17618181,17619930,1749,0.1750165276262365
6611,587.335333,587.387533,1,17620059,17621625,1566,0.1010511647533174
6612,587.413433,587.450133,1,17622402,17623503,1101,0.1876919420260324
6613,587.4513,587.4751,1,17623539,17624253,714,0.5622488720876289
6614,587.527833,587.539,1,17625834,17626170,336,0.6048014092283683
6615,587.545933,587.551333,1,17626377,17626539,162,0.884847083339076
6616,587.589967,587.617633,1,17627699,17628528,829,0.47492600778813887
6617,587.7923,587.801467,1,17633769,17634044,275,0.6855994623871322
6618,587.809867,587.821133,1,17634296,17634633,337,0.8170214771710139
6619,587.824233,587.827533,1,17634726,17634825,99,0.6827007640599329
6620,587.9358,587.941467,1,17638074,17638244,170,0.3598290233532394
6621,587.965167,587.970267,1,17638955,17639108,153,0.8226730972068784
6622,587.9918,588.025733,1,17639754,17640771,1017,0.44357046369323744
6623,588.064033,588.069633,1,17641920,17642088,168,0.9060749342719614
6624,588.088,588.092233,1,17642640,17642766,126,0.8499013465850855
6625,588.109533,588.1152,1,17643285,17643456,171,0.7981518498345005
6626,588.1211,588.128033,1,17643633,17643840,207,0.8901123089032064
6627,588.142167,588.146367,1,17644265,17644391,126,0.6806311034312711
6628,588.190967,588.198233,1,17645729,17645946,217,0.8026137500455841
6629,588.211533,588.229667,1,17646345,17646890,545,0.7826301957015954
6630,588.284033,588.287167,1,17648520,17648615,95,0.8306655365450054
6631,588.311633,588.3148,1,17649348,17649444,96,0.5128105290013409
6632,588.490133,588.493133,1,17654703,17654793,90,0.7602496690397427
6633,588.497133,588.501667,1,17654913,17655050,137,0.738100631184841
6634,588.505,588.525367,1,17655150,17655761,611,0.12748827036420748
6635,588.5339,588.537767,1,17656017,17656133,116,0.8836196343235687
6636,588.5389,588.6136,1,17656167,17658408,2241,0.1729504188542564
6637,588.6186,588.622467,1,17658558,17658674,116,0.6282273692716371
6638,588.6528,588.661867,1,17659584,17659856,272,0.5668147925485459
6639,588.663267,588.705233,1,17659898,17661156,1258,0.44686298528494306
6640,588.7079,588.733833,1,17661237,17662014,777,0.46877004441996706
6641,588.734967,588.7768,1,17662049,17663304,1255,0.21507146142990227
6642,588.8678,588.887967,1,17666034,17666639,605,0.3378632683076286
6643,588.900533,588.9056,1,17667015,17667168,153,0.6007444217088324
6644,588.9282,588.949133,1,17667846,17668473,627,0.2490232216564806
6645,588.9511,588.956333,1,17668533,17668689,156,0.8121392771668778
6646,588.968933,588.9732,1,17669067,17669196,129,0.9609258753367509
6647,588.9786,588.981733,1,17669358,17669451,93,0.8099703964455708
6648,588.988367,588.991933,1,17669651,17669757,106,0.52409502966166
6649,589.014867,589.019367,1,17670446,17670581,135,0.6644463632361342
6650,590.011333,590.015567,1,17700339,17700467,128,0.20000234259512878
6651,590.0191,590.024367,1,17700573,17700731,158,0.8452277411297782
6652,590.094667,590.103433,1,17702840,17703102,262,0.3511594139708652
6653,590.120467,590.135867,1,17703614,17704076,462,0.6077911514406537
6654,590.1704,590.185467,1,17705112,17705564,452,0.22677780288162147
6655,590.1936,590.2038,1,17705808,17706114,306,0.917307783100499
6656,590.211167,590.220633,1,17706335,17706618,283,0.6994318940436219
6657,590.2603,590.274967,1,17707809,17708249,440,0.21742038781979567
6658,590.287367,590.322167,1,17708621,17709665,1044,0.47504533915056507
6659,590.3445,590.352,1,17710335,17710560,225,0.6018549541541711
6660,590.3542,590.372033,1,17710626,17711160,534,0.42789783947440596
6661,590.3828,590.392067,1,17711484,17711762,278,0.11406781870332913
6662,590.3956,590.422733,1,17711868,17712681,813,0.4023789797598756
6663,590.455033,590.470133,1,17713650,17714103,453,0.29296000704763825
6664,590.473833,590.493,1,17714214,17714790,576,0.04398170470602416
6665,590.496067,590.537033,1,17714882,17716110,1228,0.45658103507477
6666,590.560467,590.5902,1,17716814,17717706,892,0.48131974010436174
6667,590.593033,590.606,1,17717790,17718180,390,0.07280187858007352
6668,590.6104,590.616633,1,17718312,17718498,186,0.007694237084446156
6669,590.618867,590.6226,1,17718566,17718678,112,0.8696537315324311
6670,590.623733,590.654867,1,17718711,17719646,935,0.6858923136336218
6671,590.680567,590.690167,1,17720417,17720705,288,0.07676132558354887
6672,590.692167,590.7016,1,17720765,17721048,283,0.06876552315126984
6673,590.7192,590.742033,1,17721576,17722260,684,0.08192124980500273
6674,590.7449,590.753533,1,17722347,17722605,258,0.32479440228799294
6675,590.754667,590.7889,1,17722640,17723667,1027,0.23749480462729575
6676,590.810433,590.835867,1,17724312,17725076,764,-0.10735603971843255
6677,590.8528,590.871233,1,17725584,17726136,552,0.08907193632968369
6678,590.8764,590.881733,1,17726292,17726451,159,0.0886437455677315
6679,590.887233,590.902867,1,17726616,17727086,470,0.7831907790606073
6680,590.904367,590.927667,1,17727131,17727830,699,0.6250511552576813
6681,590.9407,590.9731,1,17728221,17729193,972,0.20135841107787436
6682,591.022033,591.026167,1,17730660,17730785,125,0.08719940464279266
6683,591.045133,591.0832,1,17731353,17732496,1143,0.4326520644026481
6684,591.090833,591.127933,1,17732724,17733837,1113,0.33821421409126284
6685,591.145,591.1493,1,17734350,17734479,129,0.4083875690885727
6686,591.161533,591.164733,1,17734845,17734941,96,0.3467051384305981
6687,591.167367,591.215967,1,17735021,17736479,1458,0.21324186840637022
6688,591.233867,591.259867,1,17737016,17737796,780,0.3855055322296907
6689,591.267933,591.291133,1,17738037,17738733,696,0.6950110623425995
6690,591.459733,591.463467,1,17743791,17743904,113,0.4421470246889147
6691,591.467467,591.473533,1,17744024,17744205,181,0.798702629129134
6692,591.4759,591.479033,1,17744277,17744370,93,0.6343542797674051
6693,591.5684,591.575033,1,17747052,17747250,198,-0.0114410628941936
6694,591.884733,591.894567,1,17756541,17756837,296,0.7254104560708567
6695,591.941467,591.951833,1,17758244,17758554,310,0.05602465316406635
6696,592.228067,592.235833,1,17766842,17767074,232,0.7302220994450934
6697,592.2459,592.249567,1,17767377,17767487,110,0.7450390814078559
6698,593.451767,593.457067,1,17803553,17803712,159,0.18544529371712948
6699,593.497033,593.505567,1,17804910,17805167,257,0.42671897500636047
6700,593.869533,593.8787,1,17816085,17816361,276,0.3427435124301482
6701,593.9481,593.955633,1,17818443,17818668,225,0.643084521880069
6702,594.0706,594.0745,1,17822118,17822235,117,0.4490675584842901
6703,594.131167,594.136533,1,17823935,17824095,160,0.841834373903215
6704,594.141933,594.165733,1,17824257,17824971,714,0.4921582430255376
6705,594.183133,594.189333,1,17825493,17825679,186,0.0791739336636171
6706,594.207433,594.3222,1,17826222,17829666,3444,0.5089341099361225
6707,594.348367,594.357833,1,17830451,17830734,283,0.7692959581789146
6708,595.2204,595.244667,1,17856612,17857340,728,0.6464536721120069
6709,595.246667,595.258667,1,17857400,17857760,360,0.6840954937269514
6710,595.2599,595.2667,1,17857797,17858001,204,0.63867833046873
6711,595.269733,595.288033,1,17858091,17858640,549,0.37340631842012256
6712,595.297433,595.3008,1,17858922,17859024,102,0.7423988714052274
6713,595.3074,595.3149,1,17859222,17859447,225,0.8061090187365839
6714,595.475367,595.558567,1,17864261,17866757,2496,0.2737761725590898
6715,595.666533,595.703733,1,17869995,17871111,1116,0.32261707751568897
6716,595.712133,595.7188,1,17871363,17871564,201,0.5720010267733726
6717,595.72,595.727733,1,17871600,17871831,231,0.21048872087342194
6718,596.083233,596.120333,1,17882496,17883609,1113,0.4037182049779405
6719,596.1302,596.157133,1,17883906,17884713,807,0.17974982464893546
6720,596.210733,596.2186,1,17886321,17886558,237,-0.0023825603391161294
6721,596.220067,596.2232,1,17886602,17886696,94,0.9034721950958807
6722,596.251833,596.314033,1,17887554,17889420,1866,0.16092910310273975
6723,596.315133,596.397067,1,17889453,17891912,2459,0.20800333024655543
6724,596.412333,596.420167,1,17892369,17892605,236,0.9244917242350197
6725,596.4474,596.495,1,17893422,17894850,1428,0.09670686421469786
6726,596.4991,596.578067,1,17894973,17897342,2369,0.14518032902687975
6727,596.580267,596.592267,1,17897408,17897768,360,0.47160304075281134
6728,596.6886,596.6925,1,17900658,17900775,117,0.7552140683571051
6729,596.849833,596.854533,1,17905494,17905635,141,-0.39360751965792273
6730,596.868733,596.878233,1,17906061,17906346,285,0.1864673341223668
6731,596.914767,596.9546,1,17907443,17908638,1195,-0.007149887474453822
6732,597.197467,597.224867,1,17915924,17916746,822,0.24292357712255291
6733,597.8862,597.897867,1,17936586,17936936,350,0.4087444557257978
6734,597.9008,597.9063,1,17937024,17937189,165,0.713283790755869
6735,597.928233,597.9474,1,17937846,17938422,576,0.7685040409702393
6736,597.954733,597.964367,1,17938641,17938931,290,0.8040964125481621
6737,598.4771,598.481533,1,17954313,17954445,132,0.6613097984499586
6738,598.4843,598.493033,1,17954529,17954790,261,0.8040109584359629
6739,598.496933,598.505333,1,17954907,17955159,252,0.7596253037172468
6740,598.506433,598.5803,1,17955192,17957409,2217,0.7809462159433219
6741,598.582533,598.588,1,17957475,17957640,165,0.570574764060488
6742,599.543067,599.561133,1,17986292,17986833,541,0.816727715312633
6743,599.569267,599.577233,1,17987078,17987316,238,0.9017891594401571
6744,599.5898,599.5938,1,17987694,17987814,120,0.6227958905378608
6745,599.608067,599.6121,1,17988242,17988363,121,0.9421370793452731
6746,600.1042,600.131233,1,18003126,18003936,810,0.4522867513850048
6747,600.133633,600.1369,1,18004008,18004107,99,0.6981536833966071
6748,600.138367,600.160467,1,18004151,18004814,663,0.6941993752999011
6749,600.1615,600.164633,1,18004845,18004938,93,0.8217826774137945
6750,600.899733,600.917433,1,18026991,18027522,531,0.6756178434492853
6751,600.9221,600.929033,1,18027663,18027870,207,0.8493181181413281
6752,600.959233,600.9654,1,18028776,18028962,186,0.774448979722788
6753,600.9672,600.980533,1,18029016,18029415,399,0.6816377154069434
6754,600.992767,601.014533,1,18029783,18030435,652,0.5385639548552229
6755,601.038633,601.0438,1,18031158,18031314,156,0.8220708273848086
6756,601.431867,601.459467,1,18042956,18043784,828,0.2525112605386943
6757,601.4741,601.481367,1,18044223,18044441,218,0.6070707137005533
6758,601.4829,601.501,1,18044487,18045030,543,0.16435903136459631
6759,601.718833,601.723767,1,18051564,18051713,149,0.44983161904651303
6760,601.948267,601.9841,1,18058448,18059523,1075,0.4755642944018166
6761,602.2353,602.239133,1,18067059,18067173,114,0.29064439142136994
6762,602.2469,602.257333,1,18067407,18067719,312,0.026153828675095532
6763,602.259733,602.264333,1,18067791,18067929,138,0.5036052138635122
6764,602.331033,602.344833,1,18069930,18070344,414,0.2455776990654648
6765,602.3503,602.396167,1,18070509,18071885,1376,-0.17556426866905875
6766,602.405667,602.494533,1,18072170,18074835,2665,-0.1251472632054765
6767,602.509667,602.6275,1,18075290,18078825,3535,0.19138698438621438
6768,602.632833,602.647233,1,18078984,18079416,432,-0.09415931948397244
6769,602.666467,602.718967,1,18079994,18081569,1575,0.19436524119652518
6770,602.8464,602.853633,1,18085392,18085608,216,0.2304435626910938
6771,602.945933,602.9716,1,18088377,18089148,771,0.686494917582423
6772,602.978233,603.023733,1,18089346,18090711,1365,0.8044051880948262
6773,603.194067,603.198567,1,18095822,18095957,135,0.2369252360831679
6774,603.2334,603.2368,1,18097002,18097104,102,0.5163164028508337
6775,604.8132,604.900033,1,18144396,18147000,2604,0.09947755494113172
6776,604.908367,604.992767,1,18147251,18149783,2532,0.2620422139197412
6777,605.535667,605.539067,1,18166070,18166172,102,0.5217558045153773
6778,605.543933,605.546933,1,18166317,18166407,90,0.1952889182430043
6779,605.556133,605.560967,1,18166683,18166829,146,0.37816790727619015
6780,605.5698,605.7961,1,18167094,18173883,6789,0.07697400416182593
6781,605.801567,605.866633,1,18174047,18175998,1951,0.15853472982697647
6782,605.9042,605.913167,1,18177126,18177395,269,0.851046846529826
6783,605.9166,605.941167,1,18177498,18178235,737,0.35151090915083283
6784,605.9486,605.964967,1,18178458,18178949,491,0.5753350899505182
6785,606.063333,606.081633,1,18181899,18182448,549,0.4406194751890285
6786,606.208733,606.2164,1,18186261,18186492,231,0.9024519417604152
6787,606.2334,606.269733,1,18187002,18188091,1089,0.7231692597457583
6788,606.271033,606.283867,1,18188130,18188516,386,0.611878336623238
6789,606.285,606.298,1,18188550,18188940,390,0.6632647347486603
6790,606.3635,606.399333,1,18190905,18191979,1074,0.7510804300836876
6791,606.400433,606.404267,1,18192012,18192128,116,0.8939638047185066
6792,606.448333,606.4664,1,18193449,18193992,543,0.4175000945314354
6793,606.4676,606.483267,1,18194028,18194498,470,0.8619741725535807
6794,606.494133,606.498667,1,18194823,18194960,137,-0.3499624682135555
6795,606.506567,606.510633,1,18195197,18195318,121,0.6833803773235642
6796,606.512033,606.5166,1,18195360,18195498,138,0.7723193012336605
6797,606.521267,606.5258,1,18195638,18195774,136,0.042899443068009566
6798,606.527767,606.5312,1,18195833,18195936,103,0.43318208855499973
6799,606.534133,606.5378,1,18196023,18196134,111,0.5514482639642867
6800,606.547033,606.5587,1,18196410,18196761,351,0.6032174204186782
6801,606.5949,606.598367,1,18197847,18197951,104,0.5435908789067073
6802,606.6467,606.655767,1,18199401,18199673,272,0.68233630377227
6803,606.681167,606.6912,1,18200435,18200736,301,0.7503589710498655
6804,606.692267,606.699533,1,18200768,18200985,217,0.2508563387873914
6805,606.936333,606.950567,1,18208089,18208517,428,0.5795990396184342
6806,607.049267,607.059967,1,18211478,18211799,321,0.7456655113407846
6807,607.061567,607.065533,1,18211847,18211965,118,0.8655621339672082
6808,607.069767,607.075267,1,18212093,18212258,165,0.7372320775098871
6809,607.124367,607.1301,1,18213731,18213903,172,0.624766551016366
6810,607.1522,607.184167,1,18214566,18215525,959,0.536070853758259
6811,607.192433,607.218033,1,18215772,18216540,768,0.5002215478116593
6812,607.2193,607.242633,1,18216579,18217278,699,0.6716912647708294
6813,607.251467,607.255733,1,18217544,18217671,127,0.8957306645467384
6814,607.2608,607.268067,1,18217824,18218042,218,0.8493112494341467
6815,607.2722,607.284533,1,18218166,18218535,369,0.3586112383947175
6816,607.2856,607.3227,1,18218568,18219681,1113,0.6181247427342198
6817,607.3308,607.352933,1,18219924,18220587,663,0.4971787795239331
6818,607.354467,607.380467,1,18220634,18221414,780,0.27274107539826475
6819,607.3824,607.4013,1,18221472,18222039,567,0.727983963029636
6820,607.444767,607.449833,1,18223343,18223494,151,0.9393324821939271
6821,607.5366,607.576467,1,18226098,18227294,1196,0.35450111718904176
6822,607.6169,607.637533,1,18228507,18229125,618,0.3931565265283688
6823,607.8137,607.833933,1,18234411,18235017,606,0.38086697741761527
6824,608.1481,608.1991,1,18244443,18245973,1530,0.2394670451770781
6825,608.204467,608.2657,1,18246134,18247971,1837,0.7408684269561756
6826,608.294133,608.2972,1,18248823,18248916,93,0.8437153741192678
6827,608.298367,608.3016,1,18248951,18249048,97,0.65361463822359
6828,608.3226,608.328767,1,18249678,18249863,185,0.6258827423120243
6829,608.387533,608.399633,1,18251625,18251988,363,0.6495775578867163
6830,608.4027,608.809133,1,18252081,18264273,12192,0.5422698471439725
6831,608.8134,608.819633,1,18264402,18264588,186,0.8428665791068394
6832,608.870867,608.874967,1,18266126,18266249,123,0.7716629515477493
6833,609.055933,609.060267,1,18271677,18271808,131,0.5835694651832296
6834,609.168767,609.191333,1,18275063,18275739,676,0.61308442438312
6835,609.205133,609.2091,1,18276153,18276273,120,0.9130443475068126
6836,609.2886,609.3794,1,18278658,18281382,2724,0.6682826826178346
6837,609.4027,609.4222,1,18282081,18282666,585,0.7862202902933889
6838,609.425467,609.4311,1,18282764,18282933,169,0.7640683025150412
6839,609.433067,609.439033,1,18282992,18283170,178,0.7350228722342302
6840,609.443267,609.4615,1,18283298,18283845,547,0.9068377859521661
6841,609.5512,609.5815,1,18286536,18287445,909,0.599622090309727
6842,609.624333,609.632067,1,18288729,18288962,233,0.7397797633802222
6843,609.657067,609.666633,1,18289712,18289998,286,0.8716748592462814
6844,609.6679,609.680333,1,18290037,18290409,372,0.765797759036601
6845,609.691633,609.694667,1,18290748,18290840,92,0.7822741784190435
6846,609.730567,609.738833,1,18291917,18292164,247,0.3325012434838075
6847,609.891333,609.898633,1,18296739,18296958,219,0.6068075348305864
6848,609.96,609.9978,1,18298800,18299934,1134,0.5956416195056902
6849,610.006533,610.0122,1,18300195,18300366,171,0.8248330159642332
6850,610.016633,610.0439,1,18300498,18301317,819,0.6359129251197375
6851,610.058433,610.0694,1,18301752,18302082,330,0.7245701377462679
6852,610.243433,610.246533,1,18307302,18307395,93,0.12043620726050053
6853,610.316333,610.495333,1,18309489,18314859,5370,0.6343939175366803
6854,610.496467,610.5065,1,18314894,18315195,301,0.8244858333563554
6855,610.507667,610.5186,1,18315230,18315558,328,0.864741930365198
6856,610.532233,610.5473,1,18315966,18316419,453,0.7146484768936405
6857,610.5865,610.591333,1,18317595,18317739,144,0.7087475731504138
6858,610.594233,610.638133,1,18317826,18319143,1317,0.5783748079306984
6859,610.641067,610.65,1,18319232,18319500,268,0.901061205524889
6860,610.6523,610.662333,1,18319569,18319869,300,0.789701286566238
6861,610.6643,610.679733,1,18319929,18320391,462,0.8582000535339601
6862,610.685933,610.708367,1,18320577,18321251,674,0.40281453069311707
6863,610.711967,610.716567,1,18321359,18321497,138,0.6318431735458645
6864,610.804533,610.811467,1,18324135,18324344,209,0.8595640026305188
6865,610.812533,610.8351,1,18324375,18325053,678,0.6811190375537141
6866,610.8366,610.8408,1,18325098,18325224,126,0.9048202520073
6867,611.034233,611.405567,1,18331026,18342167,11141,0.3794487763562959
6868,611.407167,611.410233,1,18342215,18342306,91,0.8838135860164985
6869,611.4163,611.4269,1,18342489,18342807,318,0.6736881032989268
6870,611.4284,611.4685,1,18342852,18344055,1203,0.7999534427168665
6871,611.469933,611.483867,1,18344097,18344516,419,0.9223344897099915
6872,611.484933,611.4934,1,18344547,18344802,255,0.9005349035219602
6873,611.529333,611.536067,1,18345879,18346082,203,0.6747169125963156
6874,611.5379,611.550833,1,18346137,18346524,387,0.21786662296149814
6875,611.554833,611.571633,1,18346644,18347148,504,0.37983888845245906
6876,611.5803,611.643367,1,18347409,18349301,1892,0.5603571407453296
6877,611.644367,611.655267,1,18349331,18349658,327,0.8996432919638282
6878,611.6593,611.662967,1,18349779,18349889,110,0.817743822633595
6879,611.6684,611.671933,1,18350052,18350157,105,0.8008942021149349
6880,611.672933,611.676767,1,18350187,18350303,116,0.9105123221225057
6881,611.739967,611.743533,1,18352199,18352305,106,0.8610193946232184
6882,611.7919,611.7955,1,18353757,18353865,108,0.8517188088514304
6883,611.7966,611.8124,1,18353898,18354372,474,0.7085688231041507
6884,611.813767,611.817133,1,18354413,18354513,100,0.8902587353530589
6885,611.885733,611.889867,1,18356571,18356696,125,0.933970751433874
6886,611.897,611.9,1,18356910,18357000,90,0.909447538622744
6887,611.9077,611.933867,1,18357231,18358016,785,0.8222143016663066
6888,611.937067,611.943533,1,18358112,18358305,193,0.9228828325311056
6889,611.947267,611.958267,1,18358418,18358748,330,0.7485266004820228
6890,611.967967,611.980633,1,18359039,18359418,379,0.9119525915062927
6891,611.987367,612.049567,1,18359621,18361487,1866,0.444755397726826
6892,612.055467,612.063067,1,18361664,18361892,228,0.3673353172655121
6893,612.064233,612.076833,1,18361926,18362304,378,0.7164000899345799
6894,612.083233,612.1227,1,18362496,18363681,1185,0.8148659854002269
6895,612.125767,612.130367,1,18363773,18363911,138,0.9138194801615648
6896,612.1511,612.1546,1,18364533,18364638,105,0.491760050041943
6897,612.1768,612.180933,1,18365304,18365427,123,0.4499750196959546
6898,612.187567,612.190733,1,18365627,18365721,94,0.8924119453902449
6899,612.2557,612.258967,1,18367671,18367769,98,0.9510687143776682
6900,612.2614,612.273233,1,18367842,18368196,354,0.9063786241061581
6901,612.281133,612.291433,1,18368433,18368742,309,0.8029145045692975
6902,612.3583,612.365633,1,18370749,18370968,219,0.8911326581933251
6903,612.366733,612.376033,1,18371001,18371280,279,0.8908447773141038
6904,612.3863,612.389433,1,18371589,18371682,93,0.9690335147871151
6905,612.433767,612.446367,1,18373013,18373391,378,0.9318969418460309
6906,612.5114,612.520867,1,18375342,18375626,284,0.7846453938215527
6907,612.522667,612.529533,1,18375680,18375885,205,0.9704398610443182
6908,612.5315,612.562367,1,18375945,18376871,926,0.8014694658725205
6909,612.563867,612.592233,1,18376916,18377766,850,0.78825803183018
6910,612.597,612.6062,1,18377910,18378186,276,0.7825305007412899
6911,612.851233,612.855667,1,18385536,18385670,134,0.8830265992078514
6912,613.025167,613.0322,1,18390755,18390966,211,0.6493146687657793
6913,613.110467,613.1359,1,18393314,18394077,763,0.881048528863518
6914,613.1373,613.1465,1,18394119,18394395,276,0.6802778080354003
6915,613.225567,613.245633,1,18396767,18397368,601,0.30875625667341244
6916,613.256333,613.2596,1,18397689,18397788,99,0.815527059651012
6917,613.443267,613.4669,1,18403298,18404007,709,0.8016693684700097
6918,613.4857,613.553233,1,18404571,18406596,2025,0.6217140830827534
6919,613.5543,613.5585,1,18406629,18406755,126,0.786025735471673
6920,613.666733,613.669767,1,18410001,18410093,92,0.8623912277397364
6921,613.686533,613.6935,1,18410595,18410805,210,0.7138506475689086
6922,613.743167,613.7676,1,18412295,18413028,733,0.7924818331576762
6923,613.769333,613.781367,1,18413079,18413441,362,0.4026563897719182
6924,613.782533,613.786533,1,18413475,18413595,120,0.1713599375491514
6925,613.811267,613.814767,1,18414338,18414443,105,0.6754718790543688
6926,613.8234,613.844633,1,18414702,18415338,636,0.7564272968223427
6927,613.854567,613.858167,1,18415637,18415745,108,0.7827000017230621
6928,613.859767,613.870067,1,18415793,18416102,309,0.670473662159401
6929,613.871133,613.88,1,18416133,18416400,267,0.07898191035048917
6930,613.8834,613.886467,1,18416502,18416594,92,0.7261410063718334
6931,613.910467,613.920733,1,18417314,18417621,307,0.8243922929074802
6932,613.9293,613.9349,1,18417879,18418047,168,-0.3260188817687161
6933,613.943,613.947,1,18418290,18418410,120,0.7250463407834169
6934,613.976533,613.993767,1,18419295,18419813,518,0.6080689761808002
6935,613.994967,614.013167,1,18419849,18420395,546,0.2937980697286428
6936,614.015633,614.018967,1,18420468,18420569,101,0.5714822253605508
6937,614.023167,614.0276,1,18420695,18420828,133,0.6520345962505871
6938,614.040333,614.051267,1,18421209,18421538,329,0.7002850865110944
6939,614.079967,614.084567,1,18422399,18422537,138,0.6557814811634355
6940,614.210033,614.215,1,18426300,18426450,150,0.3157140101208597
6941,614.217,614.2257,1,18426510,18426771,261,-0.05187060262222426
6942,614.231,614.241467,1,18426930,18427244,314,0.8431438287482453
6943,614.4743,614.4777,1,18434229,18434331,102,0.9088773268792014
6944,614.490767,614.495133,1,18434723,18434853,130,0.43172398270760903
6945,614.509633,614.5156,1,18435288,18435468,180,0.9441408224392154
6946,614.532867,614.5363,1,18435986,18436089,103,0.9519358432799859
6947,614.7364,614.74,1,18442092,18442200,108,0.40987270581545016
6948,614.7427,614.755433,1,18442281,18442662,381,0.31519105958791843
6949,614.771033,614.7756,1,18443130,18443268,138,0.1255313392697251
6950,614.821033,614.825267,1,18444630,18444758,128,0.3252341239680263
6951,614.864933,614.878267,1,18445947,18446348,401,0.781596098293969
6952,614.8806,614.888267,1,18446418,18446648,230,0.8052568498492356
6953,614.895,614.9117,1,18446850,18447351,501,0.39532868876810956
6954,614.998533,615.001667,1,18449955,18450050,95,0.8378559308053786
6955,615.020267,615.027033,1,18450608,18450810,202,0.8423089145448331
6956,615.4889,615.5173,1,18464667,18465519,852,0.26834758689922317
6957,615.518633,615.547367,1,18465558,18466421,863,0.5637845090088408
6958,615.562767,615.5833,1,18466883,18467499,616,0.579850536547351
6959,615.607167,615.6127,1,18468215,18468381,166,-0.04732747999914013
6960,615.623467,615.627767,1,18468704,18468833,129,0.7595897131631694
6961,615.639933,615.643733,1,18469197,18469311,114,0.6080732252456748
6962,615.647767,615.651033,1,18469433,18469530,97,0.8360592914167602
6963,615.683133,615.686867,1,18470493,18470606,113,0.9182576790943642
6964,615.689867,615.693467,1,18470696,18470804,108,0.9668292367288633
6965,615.699333,615.706,1,18470979,18471180,201,0.8503945659011437
6966,615.7105,615.717533,1,18471315,18471525,210,0.8013123880780096
6967,615.754533,615.766033,1,18472635,18472980,345,0.4780105262913251
6968,615.807733,615.811467,1,18474231,18474344,113,0.695466751964799
6969,615.829467,615.845333,1,18474884,18475359,475,0.7834027851646614
6970,615.846333,615.8526,1,18475389,18475578,189,0.2927117574432559
6971,615.853967,615.860467,1,18475619,18475814,195,0.5799389534922967
6972,615.8642,615.867533,1,18475926,18476025,99,0.8823687181125448
6973,615.915267,615.920667,1,18477458,18477620,162,0.35091141025385797
6974,615.989133,615.993333,1,18479673,18479799,126,0.7651417914077097
6975,615.997367,616.001733,1,18479921,18480051,130,0.8365074465294895
6976,616.0039,616.012467,1,18480117,18480374,257,0.28880644176966774
6977,616.0135,616.019533,1,18480405,18480585,180,0.43406316361778424
6978,616.025667,616.0356,1,18480770,18481068,298,0.4171254484313079
6979,616.036867,616.043033,1,18481106,18481290,184,0.8078578726569686
6980,616.0466,616.050933,1,18481398,18481527,129,0.14658039703098497
6981,616.053767,616.066533,1,18481613,18481995,382,0.5067394450364565
6982,616.1356,616.1445,1,18484068,18484335,267,0.7753631513132996
6983,616.168333,616.183033,1,18485049,18485490,441,0.5433261371110667
6984,616.243333,616.246667,1,18487299,18487400,101,0.2007016727218585
6985,616.421867,616.442433,1,18492656,18493272,616,0.17525182365412476
6986,616.4831,616.503633,1,18494493,18495108,615,0.416622401635193
6987,616.653867,616.663533,1,18499616,18499905,289,0.8854631539467722
6988,616.666933,616.676067,1,18500007,18500282,275,0.6798017354608112
6989,616.6776,616.681867,1,18500328,18500456,128,0.6523698349381796
6990,616.695633,616.7254,1,18500868,18501762,894,0.7366834877758783
6991,616.734433,616.740867,1,18502032,18502226,194,0.7318956635915402
6992,616.742667,616.7525,1,18502280,18502575,295,0.7984784602212843
6993,617.0662,617.087933,1,18511986,18512637,651,0.5268366320575341
6994,617.112867,617.124833,1,18513386,18513744,358,0.29198817724486487
6995,617.126133,617.131533,1,18513783,18513945,162,0.8217717250702785
6996,617.144,617.1613,1,18514320,18514839,519,0.5184057328827377
6997,617.165333,617.1687,1,18514959,18515061,102,0.38832481741952196
6998,617.175367,617.230733,1,18515261,18516921,1660,0.39475084005563055
6999,617.235967,617.2666,1,18517079,18517998,919,0.43126763933429074
7000,617.2785,617.290433,1,18518355,18518712,357,0.4859438637598991
7001,617.292167,617.2953,1,18518765,18518859,94,0.7331557921196656
7002,617.3447,617.507533,1,18520341,18525225,4884,0.2850162463249659
7003,617.5153,617.5219,1,18525459,18525657,198,0.534174472667748
7004,617.530867,617.548033,1,18525926,18526440,514,0.7414508493059064
7005,617.5526,617.603167,1,18526578,18528095,1517,0.23572045040502937
7006,617.6047,617.6149,1,18528141,18528447,306,0.25991722691701297
7007,617.6678,617.671033,1,18530034,18530130,96,0.8351919408747283
7008,617.673567,617.677133,1,18530207,18530313,106,0.9188121066991641
7009,617.6805,617.6866,1,18530415,18530598,183,0.695795556684821
7010,617.691267,617.7101,1,18530738,18531303,565,0.5639319421650689
7011,617.7113,617.714867,1,18531339,18531446,107,0.8131820515413167
7012,617.737567,617.770767,1,18532127,18533123,996,0.35135766158867976
7013,617.771767,617.775733,1,18533153,18533271,118,0.4242332037078198
7014,618.4699,618.543167,1,18554097,18556295,2198,0.10891932717964202
7015,618.5442,618.5733,1,18556326,18557199,873,0.08028173021438241
7016,618.577433,618.656767,1,18557322,18559703,2381,0.10566808826579165
7017,618.832467,618.9121,1,18564974,18567363,2389,0.09697005801037094
7018,618.9134,618.946433,1,18567402,18568392,990,0.3137608437428776
7019,618.9515,618.974433,1,18568545,18569232,687,0.057985751115996145
7020,618.9757,618.981033,1,18569271,18569430,159,0.5580425357121718
7021,618.986767,619.048367,1,18569603,18571451,1848,0.1683605223749311
7022,619.0552,619.115533,1,18571656,18573465,1809,0.1757403679376258
7023,619.1222,619.155467,1,18573666,18574664,998,0.2438042900169439
7024,619.159333,619.190633,1,18574779,18575718,939,0.1816327859500812
7025,619.1931,619.2692,1,18575793,18578076,2283,-0.0066097283509387265
7026,619.273767,619.2768,1,18578213,18578304,91,0.3656935927534196
7027,619.318733,619.3297,1,18579561,18579891,330,-0.04787074327070701
7028,619.351567,619.3551,1,18580547,18580653,106,0.6323698055863497
7029,619.3583,619.370767,1,18580749,18581123,374,0.6248126554767838
7030,619.384633,619.390967,1,18581538,18581729,191,0.7705763695456062
7031,619.3948,619.399267,1,18581844,18581978,134,0.7677939548928293
7032,619.426467,619.430633,1,18582794,18582918,124,0.8281429163542072
7033,619.442367,619.445833,1,18583271,18583374,103,0.9133701564005998
7034,619.451967,619.464833,1,18583559,18583944,385,0.3432175156278819
7035,619.4666,619.492733,1,18583998,18584781,783,0.05253195891357237
7036,619.509267,619.5123,1,18585278,18585369,91,0.6587318397574341
7037,619.5815,619.593267,1,18587445,18587798,353,-0.020368123230432057
7038,619.6691,619.6739,1,18590073,18590217,144,0.4541079750166901
7039,619.7559,619.771233,1,18592677,18593136,459,0.5193380907856807
7040,619.780933,619.786867,1,18593427,18593606,179,0.4954753901863364
7041,619.892067,619.896033,1,18596762,18596880,118,0.44115351734759667
7042,619.931533,619.939133,1,18597945,18598173,228,-0.17694337668807275
7043,619.9437,619.9937,1,18598311,18599811,1500,0.5278294897546628
7044,619.9997,620.014633,1,18599991,18600438,447,0.26731360397806714
7045,620.020967,620.026333,1,18600629,18600789,160,0.5616568082086941
7046,620.062533,620.088133,1,18601875,18602643,768,0.10524172004849565
7047,620.089867,620.1302,1,18602696,18603906,1210,0.19464076827006843
7048,620.1329,620.154667,1,18603987,18604640,653,0.3609626260009032
7049,620.1699,620.173367,1,18605097,18605201,104,0.9446495981440256
7050,620.3672,620.379967,1,18611016,18611399,383,0.26135660565764707
7051,620.400267,620.4042,1,18612008,18612126,118,0.7467516578762776
7052,620.422833,620.471267,1,18612684,18614138,1454,0.1629058305325033
7053,620.4723,620.6664,1,18614169,18619992,5823,0.16534958450028023
7054,620.6715,620.749833,1,18620145,18622494,2349,0.2499481366612596
7055,620.7539,620.7604,1,18622617,18622812,195,0.6026463978338462
7056,620.7641,620.785367,1,18622923,18623561,638,0.5912065016366884
7057,620.786833,620.810433,1,18623604,18624312,708,0.4383298093235894
7058,620.840433,620.843433,1,18625212,18625302,90,0.8328123611223638
7059,620.8572,620.875867,1,18625716,18626276,560,0.45202776766142455
7060,620.894767,620.901233,1,18626843,18627036,193,0.5702732727542407
7061,620.911067,620.915833,1,18627332,18627474,142,0.5460628959286433
7062,620.9178,620.928467,1,18627534,18627854,320,0.270119462628747
7063,620.9319,620.944467,1,18627957,18628334,377,0.4213103910842691
7064,620.954633,620.970367,1,18628638,18629111,473,0.8053448194960587
7065,620.986333,620.995,1,18629589,18629850,261,0.7982656788893336
7066,620.997967,621.0035,1,18629939,18630105,166,0.5789478107247732
7067,622.3763,622.380667,1,18671289,18671420,131,-0.1206000040531894
7068,623.033567,623.053733,1,18691007,18691611,604,0.5292670228835364
7069,623.158467,623.184667,1,18694754,18695540,786,0.734332799723177
7070,623.2484,623.253067,1,18697452,18697592,140,0.83702513393656
7071,623.254733,623.293133,1,18697641,18698793,1152,0.38985834783914325
7072,623.5912,623.5942,1,18707736,18707826,90,0.6546816172382945
7073,623.759367,623.776467,1,18712781,18713294,513,0.4506908224156415
7074,623.805833,623.811433,1,18714174,18714342,168,0.7485444552310436
7075,623.813167,623.817133,1,18714395,18714513,118,0.9043927859808085
7076,623.8183,623.8276,1,18714549,18714828,279,0.18525007865884202
7077,623.866967,623.872167,1,18716009,18716165,156,0.28639875170953455
7078,623.9491,623.952167,1,18718473,18718565,92,0.5307379963598787
7079,624.148667,624.153,1,18724460,18724590,130,0.5181640164547445
7080,624.5678,624.601433,1,18737034,18738042,1008,0.24299843316689043
7081,624.602733,624.718433,1,18738081,18741552,3471,0.18071466012082688
7082,624.722467,624.726867,1,18741674,18741806,132,0.5850288566312053
7083,624.729967,624.754667,1,18741899,18742640,741,0.4819165687948899
7084,624.763533,624.815733,1,18742905,18744471,1566,0.03974531894810499
7085,624.819133,624.849667,1,18744573,18745490,917,0.1250678207263676
7086,624.858433,624.885433,1,18745752,18746562,810,0.18699503021444697
7087,624.898167,624.937033,1,18746945,18748110,1165,0.2785154091387637
7088,627.282533,627.2978,1,18818475,18818934,459,0.5111341798880057
7089,627.6206,627.626267,1,18828618,18828788,170,0.5040849642578022
7090,627.6315,627.6357,1,18828945,18829071,126,0.6744624021637244
7091,627.643767,627.658033,1,18829313,18829740,427,0.7636991128071131
7092,627.6625,627.682467,1,18829875,18830474,599,0.61577773782043
7093,627.687467,627.6912,1,18830624,18830736,112,0.8232538975876191
7094,627.7003,627.703967,1,18831009,18831119,110,0.5065206077554998
7095,627.705133,627.719267,1,18831153,18831578,425,0.755309656734982
7096,627.720467,627.728533,1,18831614,18831855,241,0.771431908109525
7097,627.729733,627.734533,1,18831891,18832035,144,0.28229100352905645
7098,627.7404,627.748233,1,18832212,18832446,234,0.6243665427188428
7099,627.758433,627.7794,1,18832752,18833382,630,0.33587266334729365
7100,627.9869,628.1328,1,18839607,18843984,4377,0.054909038517381735
7101,628.7613,628.834867,1,18862839,18865046,2207,0.0514761962924683
7102,628.839667,628.9463,1,18865190,18868389,3199,0.11765634355231515
7103,628.955833,629.0252,1,18868674,18870756,2082,0.2512811788346872
7104,629.0269,629.0302,1,18870807,18870906,99,0.9286729875162868
7105,629.031433,629.040867,1,18870942,18871226,284,0.3705671907964048
7106,629.041867,629.060167,1,18871256,18871805,549,0.5455142663459653
7107,629.062967,629.103,1,18871889,18873090,1201,0.49885013915977605
7108,629.1109,629.169867,1,18873327,18875096,1769,0.24539114423193434
7109,629.171167,629.196433,1,18875135,18875892,757,0.5585598891174225
7110,629.205933,629.246367,1,18876177,18877391,1214,0.1288011005613328
7111,629.249333,629.3931,1,18877479,18881793,4314,0.10055125733506205
7112,629.395533,629.428867,1,18881865,18882866,1001,-0.009277834575541252
7113,629.432767,629.463133,1,18882983,18883893,910,-0.1388194446737201
7114,629.464433,629.484533,1,18883932,18884535,603,-0.1738521560703672
7115,629.4875,629.492233,1,18884625,18884766,141,0.541318696230759
7116,629.5332,629.568533,1,18885996,18887055,1059,0.31188348283647926
7117,629.576233,629.6452,1,18887286,18889356,2070,0.3884515984911033
7118,629.6476,629.653833,1,18889428,18889614,186,0.8459155963657654
7119,629.655433,629.658933,1,18889662,18889767,105,0.9322757741493748
7120,629.6649,629.675467,1,18889947,18890264,317,0.7375041748087179
7121,629.7051,629.7135,1,18891153,18891405,252,0.7537903053675101
7122,629.8077,629.811133,1,18894231,18894333,102,0.6955713267073158
7123,629.833433,629.836967,1,18895002,18895109,107,0.8960640068037294
7124,629.8466,629.853333,1,18895398,18895599,201,0.91839410577529
7125,629.898267,629.944367,1,18896948,18898331,1383,0.6197619488031041
7126,629.955433,629.977667,1,18898662,18899330,668,0.5744300435212621
7127,630.134367,630.137367,1,18904031,18904121,90,0.7633218957831001
7128,630.1384,630.1513,1,18904152,18904539,387,0.7593056866113156
7129,630.157233,630.162833,1,18904716,18904884,168,0.7744906600897176
7130,630.164933,630.168133,1,18904947,18905043,96,0.845088955352532
7131,630.1798,630.2184,1,18905394,18906552,1158,0.15650123567694996
7132,630.2204,630.227033,1,18906612,18906810,198,0.49271489150886816
7133,630.240167,630.251233,1,18907205,18907536,331,-0.02960096109884717
7134,630.256867,630.283867,1,18907706,18908516,810,0.2901529374374222
7135,630.2899,630.320067,1,18908697,18909602,905,0.1743208732202716
7136,630.323467,630.3328,1,18909704,18909984,280,0.7888169995680528
7137,630.3338,630.351167,1,18910014,18910535,521,0.9182870441619537
7138,631.123367,631.131867,1,18933701,18933956,255,0.268568467551751
7139,631.182,631.185233,1,18935460,18935556,96,0.8111599356787432
7140,631.218533,631.222567,1,18936555,18936677,122,0.8869605684251408
7141,631.7432,631.798167,1,18952296,18953945,1649,0.23941668958205367
7142,631.805333,631.809933,1,18954159,18954297,138,0.6338353769143263
7143,631.9504,631.9542,1,18958512,18958626,114,0.7712117115230295
7144,632.041333,632.1157,1,18961239,18963471,2232,0.16023994398554622
7145,632.116767,632.201167,1,18963503,18966035,2532,0.22354402210016033
7146,632.202333,632.2075,1,18966069,18966225,156,0.42502110694013817
7147,632.208667,632.319933,1,18966260,18969597,3337,0.31492096655960833
7148,632.353833,632.493433,1,18970614,18974802,4188,0.40101883061661986
7149,632.4947,632.5137,1,18974841,18975411,570,0.3119117437890082
7150,632.515267,632.5206,1,18975458,18975618,160,0.59939676412683
7151,632.537933,632.723267,1,18976137,18981698,5561,0.08711695878720989
7152,632.766667,632.864367,1,18983000,18985931,2931,0.5684591913137954
7153,632.9126,632.9239,1,18987378,18987717,339,0.45685210785214375
7154,632.925567,633.0089,1,18987767,18990267,2500,0.07495918379893166
7155,633.013633,633.042867,1,18990408,18991286,878,0.06749166636018263
7156,633.0514,633.071467,1,18991542,18992144,602,0.10247163827227224
7157,633.082233,633.198533,1,18992466,18995955,3489,0.1525102386863707
7158,633.224367,633.2444,1,18996731,18997332,601,0.1752034306277237
7159,633.2521,633.272,1,18997563,18998160,597,0.15015381696557617
7160,633.301,633.328567,1,18999030,18999857,827,0.06765781689029012
7161,633.336167,633.3495,1,19000085,19000485,400,0.5483759106315131
7162,633.357867,633.3861,1,19000736,19001583,847,0.464542578161099
7163,633.3897,633.393867,1,19001691,19001816,125,0.8481281775901428
7164,633.394967,633.429833,1,19001849,19002894,1045,0.4497600444068827
7165,633.431233,633.489933,1,19002936,19004697,1761,0.05414382460383816
7166,633.499333,633.5176,1,19004979,19005528,549,0.31274752549498425
7167,633.519367,633.5334,1,19005581,19006002,421,0.3935279778165375
7168,633.537933,633.5851,1,19006137,19007553,1416,0.1843931682706386
7169,633.594133,633.675833,1,19007823,19010274,2451,0.14313197348449505
7170,633.696533,633.706633,1,19010895,19011198,303,0.819353815511437
7171,633.715033,633.720033,1,19011450,19011600,150,0.6144990736734153
7172,633.7249,633.729967,1,19011747,19011899,152,0.9064255664732455
7173,633.8057,633.8113,1,19014171,19014339,168,0.5742699101009239
7174,634.2838,634.289167,1,19028514,19028675,161,0.5145941268558806
7175,634.2958,634.353733,1,19028874,19030611,1737,0.14185954176294088
7176,634.359367,634.420367,1,19030781,19032611,1830,0.33344940092947944
7177,634.425433,634.4577,1,19032762,19033731,969,0.48491438310859136
7178,634.459167,634.463967,1,19033775,19033919,144,0.785967452871488
7179,634.472733,634.579,1,19034181,19037370,3189,0.15173973442039984
7180,634.585567,634.5897,1,19037567,19037691,124,0.6564805661826977
7181,634.593567,634.597033,1,19037807,19037910,103,0.4169623522087358
7182,634.602867,634.611367,1,19038086,19038341,255,0.5882956207822863
7183,634.619067,634.623333,1,19038572,19038699,127,0.6548089889726297
7184,634.631567,634.652533,1,19038947,19039575,628,0.2897155616954916
7185,634.673567,634.6743,1,19040207,19040229,22,0.9788896231326463
7186,635.066833,635.074433,1,19052004,19052232,228,0.7032391581600651
7187,635.090167,635.0938,1,19052705,19052814,109,0.7338175909063505
7188,635.0959,635.108267,1,19052877,19053248,371,0.5934887571408314
7189,635.516867,635.536267,1,19065506,19066088,582,0.08121470086715947
7190,635.539967,635.550867,1,19066199,19066526,327,0.27749399003475655
7191,636.036167,636.191767,1,19081085,19085753,4668,0.13640237215284723
7192,636.1953,636.198467,1,19085859,19085954,95,0.8718124099556606
7193,636.1999,636.2702,1,19085997,19088106,2109,0.02165608176527182
7194,636.396333,636.4029,1,19091889,19092087,198,0.2667626719046696
7195,636.484933,636.5044,1,19094547,19095132,585,0.4069891634310711
7196,636.506967,636.556367,1,19095209,19096691,1482,0.11907340990355031
7197,636.5675,636.588,1,19097025,19097640,615,0.46133924972587254
7198,636.6158,636.711667,1,19098474,19101350,2876,0.14640180600893885
7199,636.7129,636.728967,1,19101387,19101869,482,0.19290933735238103
7200,636.742033,636.7492,1,19102260,19102476,216,0.3058424663278337
7201,636.761133,636.765067,1,19102833,19102952,119,0.7784880849157709
7202,636.770733,636.782967,1,19103121,19103489,368,0.5604921872982968
7203,636.815633,636.841067,1,19104468,19105232,764,0.24115695979718763
7204,636.966533,637.025167,1,19108995,19110755,1760,0.12389013802640642
7205,637.057567,637.221567,1,19111727,19116647,4920,0.08642206502956354
7206,637.2378,637.287767,1,19117134,19118633,1499,0.24929811325930576
7207,637.2907,637.3145,1,19118721,19119435,714,0.12148312005474277
7208,637.329367,637.4002,1,19119881,19122006,2125,0.1760544084282595
7209,637.4061,637.4092,1,19122183,19122276,93,0.7524460246141425
7210,637.4103,637.414367,1,19122309,19122431,122,0.892090009935639
7211,637.4533,637.459233,1,19123599,19123776,177,0.8993780797920855
7212,637.4757,637.4803,1,19124271,19124409,138,0.6851523590791679
7213,637.494667,637.505733,1,19124840,19125171,331,0.24479854915669685
7214,637.508933,637.512433,1,19125267,19125372,105,0.2955361828322127
7215,637.516667,637.520567,1,19125500,19125617,117,0.369387440932581
7216,637.618867,637.6245,1,19128566,19128735,169,-0.13952099378111354
7217,637.627967,637.6311,1,19128839,19128933,94,-0.5916056880689654
7218,637.6513,637.753067,1,19129539,19132592,3053,0.013782459490655706
7219,637.7543,637.778733,1,19132629,19133361,732,0.6678537938151403
7220,637.7888,637.7964,1,19133664,19133892,228,0.5915875681713375
7221,637.797667,637.823833,1,19133930,19134714,784,0.359906241982667
7222,637.825267,637.905867,1,19134758,19137176,2418,0.42711448610314623
7223,637.907467,637.9138,1,19137224,19137414,190,0.0836766934125128
7224,637.919333,637.923767,1,19137579,19137713,134,0.7972693737383592
7225,638.114333,638.1651,1,19143429,19144953,1524,0.42126608069861504
7226,638.220667,638.225967,1,19146620,19146779,159,0.8541842338529766
7227,638.226967,638.235833,1,19146809,19147074,265,0.8352599592826442
7228,638.237,638.240167,1,19147110,19147205,95,0.925475238675315
7229,638.3144,638.320533,1,19149432,19149615,183,0.9271199834616796
7230,638.340267,638.351933,1,19150208,19150557,349,0.6313336403865207
7231,638.3533,638.359133,1,19150599,19150773,174,0.603931377103162
7232,638.3677,638.375533,1,19151031,19151265,234,0.2755277919883154
7233,638.489867,638.497767,1,19154696,19154933,237,0.20213867879430436
7234,638.5072,638.5129,1,19155216,19155387,171,0.5892906039838843
7235,638.515767,638.599067,1,19155473,19157972,2499,0.19435480605564723
7236,638.604133,638.6109,1,19158123,19158327,204,0.7335453234182157
7237,638.617833,638.6469,1,19158534,19159407,873,0.13355139866440371
7238,638.652667,638.670433,1,19159580,19160112,532,0.28140904682889006
7239,638.679667,638.692833,1,19160390,19160784,394,0.401282982337876
7240,638.695,638.7502,1,19160850,19162506,1656,0.2633133028146427
7241,638.752567,638.756,1,19162577,19162680,103,0.9261784405663519
7242,638.834667,638.8378,1,19165040,19165134,94,0.8688391747401658
7243,639.010967,639.0169,1,19170329,19170507,178,0.518514994072236
7244,639.133233,639.139933,1,19173996,19174197,201,0.36645707363600116
7245,639.1789,639.186633,1,19175367,19175598,231,0.2844436990800532
7246,639.1887,639.1924,1,19175661,19175772,111,0.8233555006426856
7247,639.193733,639.199433,1,19175811,19175982,171,0.35458807600968145
7248,639.2008,639.2965,1,19176024,19178895,2871,0.12614110225300915
7249,639.3052,639.326367,1,19179156,19179791,635,0.035258630293143176
7250,639.336733,639.3556,1,19180101,19180668,567,0.13843392348697076
7251,639.3624,639.410733,1,19180872,19182321,1449,0.03602255427277106
7252,639.411833,639.430433,1,19182354,19182912,558,0.2096759429957204
7253,639.4357,639.4407,1,19183071,19183221,150,0.5308717216119572
7254,639.448033,639.508867,1,19183440,19185266,1826,0.1339056200524075
7255,639.5134,639.603467,1,19185402,19188104,2702,0.5469282440337184
7256,639.604467,639.610967,1,19188134,19188329,195,0.900036723371265
7257,639.612033,639.6355,1,19188360,19189065,705,0.717672206744709
7258,639.686533,639.695733,1,19190595,19190871,276,0.8303801978750589
7259,640.0239,640.027667,1,19200717,19200830,113,0.2159939586859473
7260,640.1088,640.114033,1,19203264,19203420,156,-0.021038680241648955
7261,640.120367,640.129867,1,19203611,19203896,285,-0.04818849986331447
7262,640.208533,640.343033,1,19206255,19210290,4035,0.34647023728285403
7263,640.352433,640.435633,1,19210572,19213068,2496,0.2041299848993521
7264,640.441267,640.448033,1,19213238,19213440,202,0.7397805383396394
7265,640.452733,640.460667,1,19213581,19213820,239,0.744048898848027
7266,640.462367,640.4658,1,19213871,19213974,103,0.7542503448112954
7267,640.4718,640.4761,1,19214154,19214283,129,0.9276666305381229
7268,640.515567,640.524233,1,19215467,19215726,259,0.8434179425627074
7269,640.569333,640.575667,1,19217079,19217270,191,0.7237763896558147
7270,640.5823,640.633033,1,19217469,19218990,1521,0.28669330057576004
7271,640.637267,640.645433,1,19219118,19219362,244,0.11600990725261909
7272,640.647667,640.684967,1,19219430,19220549,1119,0.30379908388363247
7273,640.686533,640.697333,1,19220595,19220919,324,0.6318297515180961
7274,641.228167,641.231967,1,19236845,19236959,114,0.39360577947377995
7275,641.242367,641.2649,1,19237271,19237947,676,0.168260224335946
7276,641.288167,641.360967,1,19238645,19240829,2184,0.1782400728546469
7277,641.369367,641.378,1,19241081,19241340,259,0.13847190790143943
7278,641.379,641.384867,1,19241370,19241546,176,-0.1518039519859669
7279,641.386833,641.3924,1,19241604,19241772,168,0.34709091448078006
7280,641.400033,641.421833,1,19242000,19242654,654,-0.037678891604986046
7281,641.4251,641.527833,1,19242753,19245834,3081,0.21299132999649642
7282,644.053267,644.056333,1,19321598,19321689,91,0.8981277004422109
7283,644.213667,644.327233,1,19326410,19329816,3406,0.15941602679296887
7284,644.351333,644.377,1,19330539,19331310,771,0.13258427522364558
7285,644.3783,644.4532,1,19331349,19333596,2247,0.23265181344348917
7286,644.852433,644.875767,1,19345572,19346273,701,0.1755618140923942
7287,644.877133,644.921067,1,19346313,19347632,1319,0.11212389400801732
7288,644.9241,644.9507,1,19347723,19348521,798,0.3482747305452207
7289,644.956533,644.960533,1,19348695,19348815,120,0.8165338028143474
7290,644.9727,644.9858,1,19349181,19349574,393,0.3584302182995537
7291,644.9957,645.016533,1,19349871,19350495,624,0.1414886982479288
7292,645.029533,645.039667,1,19350885,19351190,305,0.3461505326653584
7293,645.044733,645.192533,1,19351341,19355775,4434,0.09955550647126374
7294,645.2274,645.242833,1,19356822,19357284,462,0.11512840320103773
7295,645.254267,645.262333,1,19357628,19357869,241,0.3381918969197032
7296,645.263567,645.270767,1,19357907,19358123,216,0.29343608892617223
7297,645.2718,645.2766,1,19358154,19358298,144,0.3309990399000336
7298,645.280467,645.2857,1,19358414,19358571,157,0.14091459102428205
7299,645.403367,645.465033,1,19362101,19363950,1849,0.14795234761531084
7300,645.4808,645.4848,1,19364424,19364544,120,0.4391525159177707
7301,645.497267,645.666267,1,19364918,19369988,5070,0.1454125102701974
7302,645.667433,645.671067,1,19370022,19370132,110,0.5039929775855911
7303,645.675033,645.713333,1,19370250,19371399,1149,0.20564112071271817
7304,645.721033,645.728167,1,19371630,19371845,215,0.31234510498182677
7305,645.732433,645.736567,1,19371972,19372097,125,0.6706305010807856
7306,645.759133,645.8016,1,19372773,19374048,1275,0.4773084990567733
7307,645.805533,645.856233,1,19374165,19375686,1521,0.21817050921697304
7308,645.8588,645.8618,1,19375764,19375854,90,-0.3414525579615405
7309,645.865767,645.871,1,19375973,19376130,157,0.35548435737326317
7310,645.872933,645.881567,1,19376187,19376447,260,0.46372476176355015
7311,645.907467,646.018467,1,19377224,19380554,3330,0.2515881408308008
7312,646.0212,646.032733,1,19380636,19380981,345,0.4497347401582073
7313,646.058733,646.061933,1,19381761,19381857,96,0.6801799817287787
7314,646.067067,646.092567,1,19382012,19382777,765,0.5111360739290501
7315,646.0961,646.113667,1,19382883,19383410,527,0.6573411263241297
7316,646.119067,646.158067,1,19383572,19384742,1170,0.22452946127363407
7317,646.188233,646.197267,1,19385646,19385918,272,0.34664927849751537
7318,646.260367,646.263933,1,19387811,19387917,106,0.8329323597231204
7319,646.266467,646.270467,1,19387994,19388114,120,0.720895695645216
7320,646.5752,646.579133,1,19397256,19397373,117,0.7303417414484699
7321,646.584833,646.588267,1,19397544,19397648,104,0.8156166811009186
7322,646.591167,646.677467,1,19397735,19400324,2589,0.12987579253368067
7323,646.702533,646.826833,1,19401075,19404804,3729,0.13966535524317092
7324,646.8327,646.840333,1,19404981,19405209,228,0.2939362260001774
7325,647.4716,647.482067,1,19424148,19424462,314,0.11703661012968898
7326,647.487433,647.5655,1,19424622,19426965,2343,0.09928634908868968
7327,647.573,647.5967,1,19427190,19427901,711,0.10931736174962131
7328,647.6008,647.6073,1,19428024,19428219,195,0.017597293761974133
7329,647.6083,647.624767,1,19428249,19428743,494,-0.01787837944044741
7330,647.6352,647.651867,1,19429056,19429556,500,0.0677094915162163
7331,647.6833,647.787067,1,19430499,19433612,3113,0.12404992871571772
7332,647.790633,647.850833,1,19433718,19435524,1806,-0.2286253050255258
7333,647.860933,647.887733,1,19435827,19436631,804,0.11689503009969394
7334,647.8889,647.892467,1,19436667,19436774,107,0.9066559342746588
7335,647.899833,647.9308,1,19436994,19437924,930,0.2257495196299577
7336,647.940333,648.003233,1,19438209,19440096,1887,0.19462357635355995
7337,648.004767,648.0159,1,19440143,19440477,334,0.40450323813054984
7338,648.1349,648.149233,1,19444047,19444476,429,0.3156743681743
7339,648.16,648.163467,1,19444800,19444904,104,0.7384495660214772
7340,648.1703,648.1767,1,19445109,19445301,192,0.008626576222190478
7341,648.187167,648.2502,1,19445615,19447506,1891,0.15158565881567151
7342,648.278267,648.305333,1,19448348,19449159,811,0.23536629744633975
7343,648.410267,648.415433,1,19452308,19452462,154,0.6915551299327161
7344,648.421733,648.428867,1,19452651,19452866,215,0.39897500576243355
7345,648.430567,648.460067,1,19452917,19453802,885,0.2592293578820928
7346,648.462167,648.4843,1,19453865,19454529,664,0.20254253165015396
7347,648.5244,648.5382,1,19455732,19456146,414,0.1319762425326438
7348,648.5397,648.5617,1,19456191,19456851,660,0.14476443389226426
7349,648.5631,648.5681,1,19456893,19457043,150,0.7142573699182685
7350,648.5761,648.5795,1,19457283,19457385,102,0.613398660510004
7351,648.581733,648.588433,1,19457451,19457652,201,0.8247189256468694
7352,648.633533,648.675633,1,19459005,19460268,1263,0.3117725976429844
7353,648.701467,648.769067,1,19461044,19463072,2028,0.18711301191547625
7354,648.7738,648.8067,1,19463214,19464201,987,0.03385250440123164
7355,648.8238,648.838267,1,19464714,19465148,434,0.05448709412678606
7356,648.839433,648.878667,1,19465182,19466360,1178,0.1638012468130829
7357,648.886167,648.8913,1,19466585,19466739,154,0.8391787103256123
7358,648.9647,648.978433,1,19468941,19469352,411,0.5069167532785019
7359,648.979533,649.037833,1,19469385,19471134,1749,0.3265319404480845
7360,649.043733,649.0528,1,19471311,19471584,273,0.2338151900225724
7361,649.064167,649.068833,1,19471925,19472064,139,0.6322818291412003
7362,649.079933,649.110167,1,19472397,19473305,908,0.16825002736887737
7363,649.116467,649.1404,1,19473494,19474212,718,0.4511066754002485
7364,649.147567,649.1539,1,19474427,19474617,190,0.7443485957420783
7365,649.160733,649.194233,1,19474821,19475826,1005,0.23721547495449272
7366,649.232967,649.237133,1,19476989,19477113,124,0.8768954160546845
7367,649.243233,649.255967,1,19477296,19477679,383,0.09943060788792735
7368,649.284467,649.316067,1,19478534,19479482,948,0.5969164421930075
7369,649.4508,649.518133,1,19483524,19485543,2019,0.08781405722733487
7370,649.5305,649.5368,1,19485915,19486104,189,0.9099167399452728
7371,649.5378,649.637533,1,19486134,19489125,2991,-0.038262995288641306
7372,649.6391,649.662233,1,19489173,19489866,693,0.12032767358756363
7373,650.079767,650.084167,1,19502393,19502525,132,0.47212742160722654
7374,651.3072,651.318433,1,19539216,19539552,336,0.18461854805270045
7375,651.319433,651.394433,1,19539582,19541832,2250,0.23412120501513672
7376,651.397033,651.415667,1,19541910,19542470,560,0.4834726933220935
7377,651.4187,651.430067,1,19542561,19542902,341,0.1312317626987625
7378,651.434433,651.443933,1,19543032,19543317,285,0.5843240479011642
7379,651.444933,651.4546,1,19543347,19543638,291,0.40659136687131076
7380,651.4591,651.473567,1,19543773,19544207,434,0.18020023989770986
7381,651.477133,651.493967,1,19544313,19544819,506,0.46891146187857374
7382,651.496767,651.557867,1,19544903,19546736,1833,0.2646163124586132
7383,651.5598,651.573067,1,19546794,19547192,398,0.7318079230161736
7384,651.586833,651.593167,1,19547604,19547795,191,-0.23401909677564048
7385,651.604067,651.616067,1,19548122,19548482,360,0.5205988400149686
7386,651.679733,651.689933,1,19550391,19550697,306,0.03598179698395431
7387,651.7702,651.773867,1,19553106,19553216,110,0.02234721868277879
7388,651.806367,651.8134,1,19554191,19554402,211,0.22914779942630512
7389,651.8962,651.899967,1,19556886,19556999,113,0.3123912073544972
7390,652.007567,652.089733,1,19560227,19562691,2464,0.20113815396202436
7391,652.108867,652.121033,1,19563266,19563630,364,0.6565041165601689
7392,652.125433,652.163267,1,19563762,19564898,1136,0.29806945208357016
7393,652.164367,652.1786,1,19564931,19565358,427,0.09841624229093791
7394,652.1803,652.280867,1,19565409,19568426,3017,0.13545512378688304
7395,652.332967,652.3539,1,19569989,19570617,628,0.5375495325626519
7396,652.3785,652.404333,1,19571355,19572129,774,0.5103885186170616
7397,652.4446,652.453967,1,19573338,19573619,281,0.22954383740888035
7398,652.455033,652.459,1,19573650,19573770,120,-0.3892941092377792
7399,652.477933,652.4876,1,19574337,19574628,291,0.33752713912362875
7400,652.491,652.495833,1,19574730,19574874,144,0.3332857917691412
7401,652.7855,652.8868,1,19583565,19586604,3039,0.20242343802113655
7402,652.888,652.8962,1,19586640,19586886,246,0.5815573760100767
7403,652.898767,652.927333,1,19586963,19587819,856,0.428607019359253
7404,652.931333,652.953933,1,19587939,19588617,678,0.28190803796768893
7405,652.958,652.981933,1,19588740,19589457,717,0.10913906287686222
7406,652.985367,653.0508,1,19589561,19591524,1963,0.18861314201880786
7407,653.052167,653.057533,1,19591565,19591725,160,0.4202223668683075
7408,653.387733,653.489367,1,19601631,19604681,3050,0.14236070073101992
7409,653.4935,653.5028,1,19604805,19605084,279,0.6601492419549445
7410,653.5044,653.5287,1,19605132,19605861,729,0.033404039626512255
7411,653.538367,653.560433,1,19606151,19606812,661,0.24969417313360226
7412,653.565367,653.6655,1,19606961,19609965,3004,0.09055791298340385
7413,653.675,653.682933,1,19610250,19610487,237,0.6711403156269813
7414,653.691067,653.760533,1,19610732,19612815,2083,0.1456282044025203
7415,653.812,653.821333,1,19614360,19614639,279,0.7343348805825768
7416,653.833267,653.863,1,19614998,19615890,892,-0.17844058703683358
7417,653.880833,653.904633,1,19616424,19617138,714,-0.042479974883002446
7418,653.911367,653.9175,1,19617341,19617525,184,0.8173938852521657
7419,653.964833,653.968033,1,19618944,19619040,96,0.7746048983414011
7420,653.9741,653.9794,1,19619223,19619382,159,0.8059685679039119
7421,653.9805,653.994967,1,19619415,19619849,434,0.29876010856579854
7422,654.002667,654.008633,1,19620080,19620258,178,0.8997876854285846
7423,654.0358,654.040567,1,19621074,19621217,143,0.655206249168954
7424,654.0417,654.047167,1,19621251,19621415,164,0.7875006470615684
7425,654.0522,654.066533,1,19621566,19621995,429,0.6655675254166977
7426,654.3559,654.432467,1,19630677,19632974,2297,0.09371315203830535
7427,654.4348,654.4442,1,19633044,19633326,282,0.34347501166738476
7428,654.451667,654.455033,1,19633550,19633650,100,0.9006771346046655
7429,654.4646,654.482333,1,19633938,19634469,531,0.3470253987364456
7430,654.484067,654.487067,1,19634522,19634612,90,0.8691573669505164
7431,654.488867,654.5178,1,19634666,19635534,868,0.1344135581479001
7432,654.521633,654.598033,1,19635648,19637940,2292,0.16948930402754694
7433,654.6002,654.604667,1,19638006,19638140,134,0.7644799091921655
7434,654.637967,654.671133,1,19639139,19640133,994,0.5252504578195163
7435,654.6723,654.6813,1,19640169,19640439,270,0.7424304343320561
7436,654.686167,654.719533,1,19640585,19641585,1000,0.18578972162405213
7437,654.749233,654.784467,1,19642476,19643534,1058,0.48537776696267115
7438,654.785933,654.841067,1,19643577,19645232,1655,0.31170848929623973
7439,654.842867,654.8591,1,19645286,19645773,487,0.3165112789519664
7440,654.863767,654.870433,1,19645913,19646112,199,-0.12817246038402014
7441,654.8733,654.881633,1,19646199,19646448,249,0.3865963854326087
7442,654.885067,654.902167,1,19646552,19647065,513,0.2077708543015853
7443,654.9064,654.9368,1,19647192,19648104,912,0.25432981493524126
7444,654.948533,654.9863,1,19648455,19649589,1134,0.12060664721693248
7445,655.003667,655.016567,1,19650110,19650497,387,0.36181277910102466
7446,655.025933,655.0479,1,19650777,19651437,660,0.05362073225226886
7447,655.0499,655.086033,1,19651497,19652580,1083,0.16013654292928337
7448,655.089133,655.092433,1,19652673,19652772,99,0.6807541308630717
7449,655.099367,655.13,1,19652981,19653900,919,0.38197760105464224
7450,655.1321,655.135867,1,19653963,19654076,113,0.891855854408171
7451,655.219033,655.222433,1,19656570,19656672,102,0.7850996493303013
7452,655.2521,655.257033,1,19657563,19657710,147,0.8362319778256113
7453,655.411867,655.415533,1,19662356,19662465,109,0.7028495906588641
7454,655.4197,655.424567,1,19662591,19662737,146,0.8531942738800768
7455,655.425833,655.440333,1,19662774,19663209,435,0.31167583402558285
7456,655.441367,655.447033,1,19663241,19663410,169,0.7813566798438338
7457,655.4521,655.4589,1,19663563,19663767,204,0.7537374679980303
7458,655.489833,655.492833,1,19664694,19664784,90,-0.026681081356055944
7459,655.645233,655.662733,1,19669356,19669881,525,0.27795238393180105
7460,655.6984,655.701833,1,19670952,19671054,102,0.8159498043473701
7461,655.7144,655.720967,1,19671432,19671629,197,0.31259067413788244
7462,655.727733,655.7592,1,19671831,19672776,945,0.7604301013156968
7463,655.760367,655.7647,1,19672811,19672941,130,0.6893073930351075
7464,655.781433,655.7877,1,19673442,19673631,189,0.7384460858042278
7465,655.8378,655.846967,1,19675134,19675409,275,0.7883153255572499
7466,655.864233,655.867367,1,19675926,19676021,95,0.8430380037922705
7467,655.881,655.891833,1,19676430,19676754,324,0.4184651835867238
7468,655.9119,655.9157,1,19677357,19677471,114,0.15561549699928373
7469,655.917,655.939733,1,19677510,19678191,681,0.06657995145571743
7470,655.941,655.946167,1,19678230,19678385,155,0.4207273148564488
7471,655.954633,656.435633,1,19678638,19693068,14430,0.15161183310881005
7472,656.436633,656.440133,1,19693098,19693203,105,0.7475628683452874
7473,656.455267,656.487467,1,19693658,19694624,966,0.11673606877071413
7474,656.4887,656.571833,1,19694661,19697154,2493,0.31523631406255426
7475,656.578833,656.6102,1,19697364,19698306,942,0.2895889304438751
7476,656.621667,656.651033,1,19698650,19699530,880,0.1855962734868022
7477,656.6567,656.686933,1,19699701,19700607,906,0.17619288355538848
7478,656.699467,656.7718,1,19700984,19703154,2170,0.5868149176849736
7479,656.782,656.8138,1,19703460,19704414,954,0.6765070246802788
7480,656.815467,656.819533,1,19704464,19704585,121,0.8673463810984902
7481,656.827267,656.866333,1,19704818,19705989,1171,0.4627792786850713
7482,656.871767,656.903433,1,19706153,19707102,949,0.48724452379706323
7483,656.913633,656.953567,1,19707408,19708607,1199,0.3137370301779357
7484,656.957933,656.993267,1,19708737,19709798,1061,0.555200128459385
7485,657.000667,657.0321,1,19710020,19710963,943,0.2758343352921191
7486,657.042133,657.0798,1,19711263,19712394,1131,0.24696423400250908
7487,657.086767,657.1183,1,19712603,19713549,946,0.2898554981083417
7488,657.1208,657.1635,1,19713624,19714905,1281,0.432715558073292
7489,657.168,657.200333,1,19715040,19716009,969,0.38433960711540893
7490,657.216967,657.2404,1,19716509,19717212,703,0.732972958095107
7491,657.253967,657.2877,1,19717619,19718631,1012,0.761504612721133
7492,657.304233,657.3319,1,19719126,19719957,831,0.7506743011111876
7493,657.3341,657.344033,1,19720023,19720320,297,0.7965045696671385
7494,657.350733,657.3738,1,19720521,19721214,693,0.5046131631426249
7495,657.377167,657.384067,1,19721315,19721522,207,0.4159337884893161
7496,657.391267,657.428733,1,19721738,19722861,1123,0.42459395069188544
7497,657.4336,657.462633,1,19723008,19723878,870,0.5491081592114908
7498,657.487833,657.504833,1,19724634,19725144,510,0.6683661669287984
7499,657.5277,657.557733,1,19725831,19726731,900,0.47062744371732335
7500,657.567667,657.5942,1,19727030,19727826,796,0.4871458472314222
7501,657.614733,657.645633,1,19728441,19729368,927,0.5921338918936514
7502,657.6611,657.6952,1,19729833,19730856,1023,0.5976567461814214
7503,657.707267,657.730867,1,19731218,19731926,708,0.6558989063306877
7504,657.749,657.774633,1,19732470,19733238,768,0.6927953141607623
7505,657.793933,657.821767,1,19733817,19734653,836,0.3856715842436165
7506,657.839733,657.8495,1,19735191,19735485,294,0.5617600185397486
7507,657.850967,657.872767,1,19735529,19736183,654,0.6343726947901133
7508,657.885867,657.892767,1,19736576,19736783,207,0.795867067557273
7509,657.894833,657.906967,1,19736844,19737209,365,0.5304309372812819
7510,657.932267,657.957967,1,19737968,19738739,771,0.7561978176521289
7511,657.976833,658.0043,1,19739304,19740129,825,0.6569496764798121
7512,658.027667,658.052233,1,19740830,19741566,736,0.5300182465744917
7513,658.075833,658.101033,1,19742274,19743030,756,0.5236897074601243
7514,658.388767,658.391833,1,19751663,19751754,91,0.7170172223361743
7515,659.361767,659.367967,1,19780853,19781039,186,0.7631055078138983
7516,659.463333,659.4775,1,19783899,19784325,426,0.31473934835646455
7517,659.494233,659.5211,1,19784826,19785633,807,0.27587674791269434
7518,659.532267,659.5368,1,19785968,19786104,136,0.7381860264832582
7519,659.556567,659.570567,1,19786697,19787117,420,0.20484884132703254
7520,659.578533,659.5913,1,19787355,19787739,384,0.5010808077459393
7521,659.739767,659.744933,1,19792193,19792347,154,0.491846560333845
7522,659.7848,659.797867,1,19793544,19793936,392,0.3239491243365836
7523,659.803533,659.8263,1,19794105,19794789,684,0.2517988156049715
7524,659.828933,659.920267,1,19794867,19797608,2741,0.4068037407233363
7525,659.922167,659.9709,1,19797665,19799127,1462,0.4074301314291846
7526,659.974267,659.991933,1,19799228,19799757,529,0.4870606788965855
7527,660.030567,660.035467,1,19800917,19801064,147,0.7098397857948748
7528,660.0548,660.064967,1,19801644,19801949,305,0.691651564691562
7529,660.157067,660.162067,1,19804712,19804862,150,0.9122517086820189
7530,660.574333,660.578933,1,19817229,19817367,138,0.7697404312539631
7531,660.627,660.6391,1,19818810,19819173,363,0.7125979488990063
7532,660.640567,660.6473,1,19819217,19819419,202,0.2236236544876353
7533,660.651833,660.659167,1,19819554,19819775,221,0.6880837223606173
7534,660.662,660.665033,1,19819860,19819950,90,0.7466331802586669
7535,660.691633,660.699467,1,19820748,19820984,236,0.4620700848709965
7536,660.700667,660.708867,1,19821020,19821266,246,0.21041857461877922
7537,660.947933,660.970933,1,19828437,19829127,690,0.4490696458068163
7538,660.985467,661.007533,1,19829564,19830225,661,0.28463296968431734
7539,661.011333,661.027033,1,19830339,19830810,471,0.48101313459217293
7540,661.065833,661.070267,1,19831974,19832108,134,0.7648720144797226
7541,661.081467,661.085133,1,19832444,19832553,109,0.857557822122843
7542,661.090333,661.108267,1,19832709,19833248,539,0.3547002640582056
7543,661.2509,661.259533,1,19837527,19837785,258,0.6807493944899984
7544,661.261933,661.2694,1,19837857,19838082,225,0.3902114688046032
7545,661.2718,661.2916,1,19838154,19838748,594,0.42948671782228726
7546,661.292633,661.304333,1,19838778,19839129,351,0.6093447789893243
7547,661.310933,661.3342,1,19839327,19840026,699,0.06151685750519764
7548,661.3875,661.3952,1,19841625,19841856,231,0.6963344259355136
7549,661.3991,661.453333,1,19841973,19843599,1626,0.31943829908059546
7550,661.465233,661.496233,1,19843956,19844886,930,-0.11057656480457471
7551,661.500433,661.512933,1,19845012,19845387,375,0.0547184760162808
7552,661.5539,661.561033,1,19846617,19846830,213,0.7637793408462138
7553,661.567033,661.575133,1,19847010,19847253,243,0.5116772014992381
7554,661.579167,661.5862,1,19847375,19847586,211,0.6174315040086771
7555,661.612933,661.638,1,19848387,19849140,753,0.27725272722824407
7556,661.7543,661.763267,1,19852629,19852898,269,0.49796138309835475
7557,661.776767,661.789,1,19853303,19853670,367,0.8014452883880687
7558,662.113433,662.1194,1,19863402,19863582,180,0.9223903494812099
7559,662.1205,662.1301,1,19863615,19863903,288,0.38405488881657435
7560,662.143767,662.148033,1,19864313,19864440,127,0.5744944257677468
7561,662.158133,662.165233,1,19864743,19864956,213,0.8011019421364256
7562,662.173733,662.180733,1,19865211,19865421,210,0.655659594856449
7563,662.205833,662.208833,1,19866174,19866264,90,0.9516177695056104
7564,662.2123,662.218367,1,19866369,19866551,182,0.8567494417804755
7565,664.466067,664.47,1,19933982,19934100,118,0.6387696635402763
7566,664.577333,664.580933,1,19937319,19937427,108,0.8810567739346139
7567,664.588367,664.593,1,19937651,19937790,139,0.7207082392170975
7568,664.675867,664.7017,1,19940276,19941051,775,0.8975230492023272
7569,664.7229,664.726433,1,19941687,19941792,105,0.9166645794507912
7570,664.909633,664.933533,1,19947288,19948005,717,0.2869362290152055
7571,664.939167,664.9548,1,19948175,19948644,469,0.8104431907995375
7572,664.959367,664.983833,1,19948781,19949514,733,0.66647591971324
7573,664.991567,665.314967,1,19949747,19959449,9702,0.351868994450577
7574,665.3241,665.3334,1,19959723,19960002,279,0.7886980102169223
7575,665.360833,665.430633,1,19960824,19962918,2094,0.37724210566345745
7576,665.4403,665.455067,1,19963209,19963652,443,0.7281081344570006
7577,665.465033,665.497733,1,19963950,19964931,981,0.6063962619239778
7578,665.499067,665.528233,1,19964972,19965846,874,0.5351933961057361
7579,665.529333,665.5385,1,19965879,19966155,276,0.8600619325330666
7580,665.548067,665.571933,1,19966442,19967157,715,0.7781764782576546
7581,665.5743,665.593733,1,19967229,19967811,582,0.2742732267149961
7582,665.595733,665.598933,1,19967871,19967967,96,0.5911109416758726
7583,665.6,665.6144,1,19968000,19968432,432,0.3489707951547994
7584,665.6353,665.660067,1,19969059,19969802,743,0.48768638694276384
7585,665.6614,665.686267,1,19969842,19970588,746,0.7152728375093
7586,665.695633,665.714433,1,19970868,19971432,564,0.2031732267951337
7587,665.777433,665.781467,1,19973322,19973444,122,0.6496880619324729
7588,665.785833,665.790567,1,19973574,19973717,143,0.8991672300370996
7589,665.791733,665.800967,1,19973751,19974029,278,0.7099078533746095
7590,665.802533,665.816433,1,19974075,19974492,417,0.7691963214097832
7591,665.817633,665.825467,1,19974528,19974764,236,0.6789471677708824
7592,665.834633,665.855467,1,19975038,19975664,626,0.3856979533215186
7593,665.869,665.8726,1,19976070,19976178,108,0.31951471650113744
7594,665.930633,665.9384,1,19977918,19978152,234,0.8401726732095451
7595,665.9438,665.9473,1,19978314,19978419,105,0.8520346399216812
7596,665.9609,665.964067,1,19978827,19978922,95,0.9171519467087114
7597,665.966633,665.9737,1,19978998,19979211,213,0.9746372109117248
7598,666.256,666.2684,1,19987680,19988052,372,0.3902607377942928
7599,666.3909,666.3943,1,19991727,19991829,102,0.8927794925890781
7600,666.5546,666.561933,1,19996638,19996857,219,0.7928604298656434
7601,666.567467,666.5715,1,19997024,19997145,121,0.7193793695783762
7602,666.572667,666.5765,1,19997180,19997295,115,0.8040466996722087
7603,666.579733,666.588167,1,19997391,19997645,254,0.7908567928075024
7604,666.603433,666.614067,1,19998102,19998422,320,0.6680984385890819
7605,666.6198,666.628867,1,19998594,19998866,272,0.09540002540873875
7606,666.668933,666.6791,1,20000067,20000373,306,-0.03196398744989449
7607,666.680867,666.691333,1,20000426,20000739,313,0.410865323055205
7608,666.7151,666.719067,1,20001453,20001572,119,0.6107083236494294
7609,667.727967,667.751767,1,20031839,20032553,714,0.2063348237624978
7610,667.755767,667.786467,1,20032673,20033594,921,0.2122942603788476
7611,667.787967,667.803133,1,20033639,20034093,454,0.2926402647059483
7612,667.810467,667.8154,1,20034314,20034462,148,0.5961243478310099
7613,667.830333,667.910867,1,20034909,20037326,2417,0.2804147736385048
7614,667.9125,667.964267,1,20037375,20038928,1553,0.13725953691179033
7615,667.9737,667.986067,1,20039211,20039582,371,0.8151426795598125
7616,667.993767,668.068933,1,20039813,20042067,2254,0.21640460655438662
7617,668.072833,668.0783,1,20042184,20042349,165,0.8404093215981632
7618,668.0809,668.085433,1,20042427,20042562,135,0.4568892814520359
7619,668.114767,668.140367,1,20043443,20044211,768,0.5131850238198579
7620,668.1415,668.161333,1,20044245,20044839,594,0.40524239863531686
7621,668.174433,668.1824,1,20045232,20045472,240,0.6806239465794333
7622,668.1887,668.2162,1,20045661,20046486,825,0.22435017672582636
7623,668.220533,668.230067,1,20046615,20046902,287,0.7511861794378464
7624,668.236833,668.244433,1,20047104,20047332,228,-0.18808661434794335
7625,668.3452,668.3487,1,20050356,20050461,105,0.7040988616423418
7626,668.350167,668.3533,1,20050505,20050599,94,-0.14672018859227515
7627,668.783,669.210133,1,20063490,20076303,12813,0.10621094290226187
7628,669.223333,669.2493,1,20076699,20077479,780,0.265501764935354
7629,669.2794,669.300633,1,20078382,20079018,636,0.4347901697419713
7630,669.301767,669.3069,1,20079053,20079207,154,0.854073954357557
7631,669.3238,669.3273,1,20079714,20079819,105,0.918777641652579
7632,669.333667,669.337567,1,20080010,20080127,117,0.7730314886818751
7633,669.3446,669.3491,1,20080338,20080473,135,0.43398702745760215
7634,669.824967,669.832333,1,20094749,20094969,220,0.2534742982266623
7635,669.840133,669.934033,1,20095203,20098020,2817,0.19286890839370618
7636,669.944667,669.9706,1,20098340,20099118,778,0.6310975207263019
7637,669.972533,669.992067,1,20099175,20099762,587,0.4216958606392854
7638,669.993267,669.997833,1,20099798,20099934,136,0.7596134908807143
7639,670.0012,670.0979,1,20100036,20102937,2901,0.22380146190464725
7640,671.013967,671.017433,1,20130419,20130522,103,0.38916688671949856
7641,671.024933,671.095033,1,20130747,20132850,2103,0.15545429523548673
7642,671.0964,671.1021,1,20132892,20133063,171,0.9298276532362315
7643,671.113833,671.123633,1,20133414,20133708,294,0.7121385850967473
7644,671.129833,671.1837,1,20133894,20135511,1617,0.18101312698404828
7645,671.184867,671.254867,1,20135546,20137646,2100,0.14235043492992575
7646,671.259167,671.2689,1,20137775,20138067,292,0.34844901255025507
7647,671.287533,671.329933,1,20138625,20139897,1272,0.4174774303042405
7648,671.337933,671.380767,1,20140137,20141423,1286,0.16078507015856425
7649,671.3835,671.3885,1,20141505,20141655,150,0.6179296663224961
7650,671.396533,671.405833,1,20141895,20142174,279,0.5339636736409912
7651,671.424433,671.430967,1,20142732,20142929,197,0.7469036539629335
7652,671.4326,671.4828,1,20142978,20144484,1506,0.2374008393830159
7653,671.504633,671.583567,1,20145138,20147507,2369,0.20245191204921006
7654,671.5847,671.633233,1,20147541,20148996,1455,0.12461492480448247
7655,671.6519,671.655333,1,20149557,20149659,102,0.6476002279839643
7656,671.6621,671.668267,1,20149863,20150048,185,0.662456941403308
7657,671.676,671.682733,1,20150280,20150481,201,0.13883113155377488
7658,671.685433,671.6985,1,20150562,20150955,393,0.18155152398568122
7659,671.705367,671.7485,1,20151161,20152455,1294,0.14406137571559788
7660,671.751467,671.757467,1,20152544,20152724,180,0.7961133699429322
7661,671.759467,671.784967,1,20152784,20153549,765,0.13722233811947693
7662,671.7911,671.840367,1,20153733,20155211,1478,0.34373491528600836
7663,671.8414,671.890467,1,20155242,20156714,1472,0.43131224168831855
7664,671.892033,671.929833,1,20156760,20157894,1134,0.347658033489705
7665,671.9311,671.9346,1,20157933,20158038,105,0.7641565106409561
7666,671.941667,671.949933,1,20158250,20158497,247,0.4663204346858024
7667,671.9532,671.957333,1,20158596,20158719,123,0.8099531562128478
7668,671.9588,672.013467,1,20158764,20160404,1640,0.47626573552582224
7669,672.020567,672.048467,1,20160617,20161454,837,0.24259555523054016
7670,672.058233,672.063333,1,20161746,20161899,153,0.13996221109333362
7671,672.080667,672.088367,1,20162420,20162651,231,0.10823585697111825
7672,672.092567,672.189567,1,20162777,20165687,2910,0.47710592088105874
7673,672.526567,672.607133,1,20175797,20178213,2416,0.30459074430405375
7674,672.6102,672.6273,1,20178306,20178819,513,0.21245752473774412
7675,672.635267,672.6508,1,20179058,20179524,466,0.17619732585689538
7676,672.6581,672.679567,1,20179743,20180387,644,0.18916655091483564
7677,672.692,672.768033,1,20180760,20183040,2280,0.1326938024903273
7678,672.790333,672.8173,1,20183709,20184519,810,0.1197833556280437
7679,672.840467,672.861467,1,20185214,20185844,630,0.14434435103304677
7680,672.879733,672.899267,1,20186391,20186978,587,0.11532308585006239
7681,672.9006,672.909,1,20187018,20187270,252,0.35801199639953085
7682,672.9214,672.9273,1,20187642,20187819,177,0.6580145638914295
7683,672.934733,672.947533,1,20188041,20188425,384,0.19333920880339872
7684,672.974667,673.012167,1,20189240,20190365,1125,0.4915421116895259
7685,673.019667,673.060933,1,20190590,20191827,1237,0.16146292804564122
7686,673.0937,673.110867,1,20192811,20193326,515,0.18436535164402343
7687,673.114767,673.1186,1,20193443,20193558,115,0.8164367635577747
7688,673.1217,673.139067,1,20193651,20194172,521,0.5375555463903665
7689,673.1432,673.2176,1,20194296,20196528,2232,0.11478708478029107
7690,673.2187,673.238967,1,20196561,20197169,608,0.4258191609439374
7691,673.274,673.303533,1,20198220,20199105,885,0.3032223106186707
7692,673.315633,673.327933,1,20199468,20199837,369,0.6124724161416052
7693,673.3547,673.362733,1,20200641,20200881,240,0.8599656344686505
7694,673.380533,673.383633,1,20201415,20201508,93,0.3908703642247565
7695,673.387833,673.399433,1,20201634,20201982,348,0.7959612210477635
7696,675.083167,675.096133,1,20252495,20252883,388,0.8360756968951698
7697,675.3142,675.318767,1,20259426,20259563,137,0.7990939245326573
7698,676.1097,676.200633,1,20283291,20286018,2727,0.25021323744312246
7699,676.201633,676.208867,1,20286048,20286266,218,0.8823155980522456
7700,676.2133,676.2426,1,20286399,20287278,879,0.19335095262063273
7701,676.247333,676.262467,1,20287419,20287874,455,0.5686250630775296
7702,676.264067,676.270767,1,20287922,20288123,201,0.8666502806210065
7703,676.278333,676.2853,1,20288349,20288559,210,0.7588732651012781
7704,676.2987,676.304,1,20288961,20289120,159,0.7796731000043108
7705,676.3051,676.3101,1,20289153,20289303,150,0.8134562565190107
7706,676.3113,676.350367,1,20289339,20290511,1172,0.5370010694652051
7707,676.354967,676.495133,1,20290649,20294853,4204,0.40075829715231187
7708,676.499733,676.599233,1,20294991,20297976,2985,0.5352762303110217
7709,676.604333,676.842333,1,20298129,20305269,7140,0.5242359098941588
7710,676.848,676.851933,1,20305440,20305557,117,0.7726363491646803
7711,676.864467,676.898667,1,20305934,20306960,1026,0.4526458503152589
7712,676.9157,676.922867,1,20307471,20307686,215,0.6782244158862257
7713,676.924433,677.095167,1,20307732,20312855,5123,0.3870182446284748
7714,677.1041,677.107767,1,20313123,20313233,110,0.8588855254621897
7715,677.1091,677.2882,1,20313273,20318646,5373,0.3186560565602566
7716,677.289267,677.2929,1,20318678,20318787,109,0.6482096191206683
7717,677.315533,677.324967,1,20319465,20319749,284,0.8119072829332094
7718,677.439,677.456667,1,20323170,20323700,530,0.7321600355482737
7719,677.4745,677.4859,1,20324235,20324577,342,0.8553877469370774
7720,677.487033,677.520033,1,20324610,20325600,990,0.84553716842593
7721,677.728767,677.733333,1,20331863,20331999,136,0.8763568269577767
7722,677.740867,677.7456,1,20332226,20332368,142,0.8277623278837197
7723,677.748133,677.752333,1,20332443,20332569,126,0.9452602822866785
7724,677.762833,677.791767,1,20332884,20333753,869,0.9008283160771737
7725,677.819633,677.826733,1,20334588,20334801,213,0.9528005589602412
7726,677.829567,677.834667,1,20334887,20335040,153,0.8503414276575814
7727,677.847333,677.852367,1,20335419,20335571,152,0.7439085342077737
7728,677.8617,677.870067,1,20335851,20336102,251,0.8294061505395806
7729,677.871333,677.884067,1,20336139,20336522,383,0.6280633046123142
7730,677.887667,677.891233,1,20336630,20336736,106,0.9444127450407163
7731,677.895833,677.899733,1,20336874,20336991,117,0.8814520465281686
7732,678.267133,678.294867,1,20348013,20348846,833,0.834738470704567
7733,678.330033,678.3933,1,20349900,20351799,1899,0.6559142829394404
7734,678.404167,678.425,1,20352125,20352750,625,0.5092266936052432
7735,678.432167,678.472267,1,20352965,20354168,1203,0.3372963843801349
7736,678.473967,678.494633,1,20354219,20354838,619,0.7120446350609332
7737,678.514133,678.538267,1,20355423,20356148,725,0.42689032991677717
7738,678.5452,678.5825,1,20356356,20357475,1119,0.08843993866153778
7739,678.584367,678.624067,1,20357531,20358722,1191,0.7492279696038189
7740,678.804633,678.808167,1,20364138,20364245,107,0.8907448226016094
7741,678.958367,678.9614,1,20368751,20368842,91,0.861690900613314
7742,678.967733,678.979267,1,20369031,20369378,347,0.7069620934015066
7743,680.603533,680.6202,1,20418105,20418606,501,0.08803586653079294
7744,680.6559,680.659067,1,20419677,20419772,95,0.8343015300375191
7745,680.662533,680.6727,1,20419875,20420181,306,0.5436066452600515
7746,680.6952,680.6983,1,20420856,20420949,93,0.4635826224259273
7747,680.859233,680.867033,1,20425776,20426010,234,0.5845515844961543
7748,680.976233,680.981233,1,20429286,20429436,150,0.8376522174476375
7749,680.989567,680.992867,1,20429687,20429786,99,0.7340299284776255
7750,681.000933,681.005033,1,20430027,20430150,123,0.8007734313034703
7751,681.1973,681.2013,1,20435919,20436039,120,0.7762797485971474
7752,681.216133,681.2198,1,20436483,20436594,111,0.9335838865252126
7753,681.294333,681.308067,1,20438829,20439242,413,0.6612309629602817
7754,681.782067,681.785633,1,20453462,20453568,106,0.461360056612851
7755,681.812633,681.833533,1,20454378,20455005,627,0.17189378548904877
7756,682.138067,682.150967,1,20464142,20464529,387,0.07353398301410351
7757,682.195967,682.2068,1,20465879,20466204,325,0.42914462198170733
7758,682.214767,682.2282,1,20466443,20466846,403,0.7132807883283794
7759,682.2301,682.233133,1,20466903,20466993,90,0.8690966009956461
7760,682.291067,682.310867,1,20468732,20469326,594,0.5926659347784227
7761,682.690733,682.707367,1,20480721,20481221,500,0.07582357417969833
7762,682.870533,682.8832,1,20486115,20486496,381,0.38133349590637156
7763,682.954533,682.9606,1,20488635,20488818,183,0.3770153902152799
7764,683.0457,683.048933,1,20491371,20491467,96,0.8928084308561307
7765,683.2697,683.276233,1,20498091,20498286,195,0.9291739706034409
7766,683.2797,683.283033,1,20498391,20498490,99,0.8046531072205851
7767,683.350067,683.353867,1,20500502,20500616,114,0.8778492102538923
7768,683.476167,683.499033,1,20504285,20504970,685,0.24246422167386542
7769,683.523167,683.5387,1,20505695,20506161,466,0.6696541644466686
7770,683.551167,683.5604,1,20506535,20506812,277,0.4069280702631066
7771,683.665567,683.679033,1,20509967,20510370,403,0.20529628298041297
7772,683.694567,683.698833,1,20510837,20510964,127,0.8185610068917999
7773,683.700333,683.713333,1,20511009,20511399,390,0.46802353620413784
7774,683.762833,683.766833,1,20512884,20513004,120,0.3616425786653684
7775,683.957667,683.967367,1,20518730,20519021,291,0.7457504523178802
7776,684.744867,684.750933,1,20542346,20542527,181,0.4223105016742199
7777,686.304033,686.311933,1,20589120,20589357,237,0.3616827010504754
7778,687.706733,687.728833,1,20631201,20631864,663,0.4295150185210014
7779,687.757867,687.768667,1,20632736,20633060,324,0.7091586589785112
7780,687.804833,687.809433,1,20634144,20634282,138,0.6445723098811244
7781,692.186567,692.190167,1,20765597,20765705,108,0.7543907335208049
7782,692.192167,692.1954,1,20765765,20765862,97,-0.07587856030003719
7783,692.198,692.202533,1,20765940,20766075,135,-0.04313134498236314
7784,692.2095,692.212767,1,20766285,20766383,98,0.4984841145232074
7785,692.214267,692.225533,1,20766428,20766765,337,0.1671596869588495
7786,692.228933,692.2419,1,20766867,20767257,390,0.24480475273583147
7787,692.243133,692.248633,1,20767293,20767458,165,-0.09129207702784466
7788,692.2499,692.2538,1,20767497,20767614,117,0.7755929848865442
7789,692.261967,692.266167,1,20767859,20767985,126,0.5838201956049199
7790,692.289133,692.293333,1,20768673,20768799,126,0.7745004051983274
7791,692.322133,692.327867,1,20769663,20769836,173,0.9129546563517142
7792,692.331467,692.335233,1,20769944,20770056,112,0.8138048553126137
7793,692.404067,692.408967,1,20772122,20772269,147,0.7679551590825665
7794,693.703067,693.7122,1,20811092,20811366,274,0.8982270524292509
7795,693.7141,693.718767,1,20811423,20811563,140,0.8777634958888121
7796,693.724367,693.730767,1,20811731,20811923,192,0.7702726965560295
7797,694.115433,694.1196,1,20823462,20823588,126,0.7275440487929977
7798,694.332733,694.336033,1,20829981,20830080,99,0.6192410692691991
7799,694.412733,694.420567,1,20832381,20832617,236,0.2457780895831813
7800,694.527433,694.5315,1,20835822,20835945,123,0.8088498830107596
7801,695.796133,695.804667,1,20873883,20874140,257,0.4616611478081399
7802,700.047633,700.050633,1,21001428,21001518,90,0.7391450875841887
7803,700.061833,700.064967,1,21001854,21001949,95,-0.32394491105718193
7804,705.107967,705.127067,1,21153239,21153812,573,0.09413019232381363
7805,705.137167,705.155567,1,21154115,21154667,552,0.9319828305247869
7806,705.157267,705.161967,1,21154718,21154859,141,0.8948400571482694
7807,705.5684,705.577833,1,21167052,21167334,282,0.6829466328116306
7808,706.2512,706.258733,1,21187536,21187761,225,0.7380919188484489
7809,709.0878,709.091633,1,21272634,21272748,114,0.7891359368809221
7810,709.146267,709.1495,1,21274388,21274485,97,0.7463502248663867
7811,711.3007,711.3089,1,21339021,21339267,246,0.05591189512832925
7812,711.554467,711.5692,1,21346634,21347076,442,0.5377625360522043
7813,711.623767,711.627533,1,21348713,21348825,112,0.8879875077027547
7814,711.633767,711.6372,1,21349013,21349116,103,0.7986422284022285
7815,711.747033,711.750733,1,21352410,21352521,111,0.7457409259165823
7816,712.685633,712.6934,1,21380568,21380802,234,0.8909068923413264
7817,712.706267,712.712133,1,21381188,21381363,175,0.7383708769977514
7818,712.929267,712.9383,1,21387878,21388149,271,0.3939837296058656
7819,712.960533,712.964533,1,21388815,21388935,120,0.5469284525133784
7820,713.408467,713.417733,1,21402254,21402531,277,0.6870490936979263
7821,717.0143,717.017667,1,21510429,21510530,101,0.3142000709609667
7822,717.096867,717.1233,1,21512906,21513699,793,0.07247318988743649
7823,717.1252,717.128733,1,21513756,21513861,105,-0.37741546790178093
7824,717.1426,717.167567,1,21514278,21515027,749,0.3822359595468552
7825,717.206833,717.2177,1,21516204,21516531,327,0.5974958359946553
7826,717.525067,717.591333,1,21525752,21527739,1987,0.2417339811404777
7827,717.6128,717.6173,1,21528384,21528519,135,0.6384503336599376
7828,717.6467,717.684533,1,21529401,21530535,1134,0.32756633442883415
7829,717.685767,717.7175,1,21530573,21531525,952,0.3406671555935235
7830,717.732667,717.7363,1,21531980,21532089,109,0.3469676488532727
7831,717.758567,717.762533,1,21532757,21532875,118,0.7596775633885855
7832,717.767567,717.802967,1,21533027,21534089,1062,0.4901635556704417
7833,717.8084,717.836967,1,21534252,21535109,857,0.30867366430808457
7834,717.839067,717.8545,1,21535172,21535635,463,0.47889557467972976
7835,717.899933,717.943167,1,21536997,21538295,1298,0.45600915459645325
7836,717.945333,717.971967,1,21538359,21539159,800,0.38161951450333614
7837,717.973133,717.987467,1,21539193,21539624,431,0.3483905027498763
7838,717.991667,717.9985,1,21539750,21539955,205,0.13306154433512749
7839,718.026567,718.082633,1,21540797,21542478,1681,0.13974410726785885
7840,718.0904,718.1088,1,21542712,21543264,552,0.45295667859717137
7841,718.111567,718.1301,1,21543347,21543903,556,0.6895073024995005
7842,718.168167,718.172867,1,21545045,21545186,141,0.5926158635662295
7843,718.4855,718.4887,1,21554565,21554661,96,0.8917027309926524
7844,718.605633,718.6155,1,21558168,21558465,297,0.49578079609273024
7845,718.6181,718.623667,1,21558543,21558710,167,0.8496470731292881
7846,718.635133,718.647167,1,21559053,21559415,362,0.7610973405096977
7847,718.674767,718.677833,1,21560243,21560334,91,0.023699083747081746
7848,732.533233,732.5363,1,21975996,21976089,93,0.6293534927829666
7849,745.072967,745.260633,1,22352189,22357818,5629,0.7896264616243333
7850,745.4275,745.434067,1,22362825,22363022,197,0.7107246324411381
7851,745.4377,745.4408,1,22363131,22363224,93,0.5219109312703238
7852,745.523967,745.587233,1,22365719,22367616,1897,0.21402143870416016
7853,745.613333,745.619333,1,22368399,22368579,180,0.10534184104018668
7854,745.634033,745.6444,1,22369020,22369332,312,-0.020086380257335286
7855,745.645633,745.6856,1,22369368,22370568,1200,0.5749618150561089
7856,745.6936,745.712933,1,22370808,22371387,579,0.3077571761641043
7857,745.7685,745.777667,1,22373055,22373330,275,0.16852260979330969
7858,745.7868,745.8245,1,22373604,22374735,1131,0.689104364624315
7859,745.8374,745.857533,1,22375122,22375725,603,0.13552303992891346
7860,745.901567,745.9152,1,22377047,22377456,409,0.10521701931845565
7861,745.925033,745.969133,1,22377750,22379073,1323,0.07188402314082179
7862,745.970633,746.0062,1,22379118,22380186,1068,0.17476677283923372
7863,746.040633,746.0493,1,22381218,22381479,261,0.22347044018252574
7864,746.055833,746.067567,1,22381674,22382027,353,0.6187024960284301
7865,746.0733,746.1082,1,22382199,22383246,1047,0.5349717339842892
7866,746.1255,746.146933,1,22383765,22384407,642,0.38258890142963065
7867,746.201133,746.2105,1,22386033,22386315,282,0.13382427721370127
7868,746.2293,746.236467,1,22386879,22387094,215,0.620116680611353
7869,746.238333,746.266933,1,22387149,22388007,858,0.3757121370889671
7870,746.2785,746.301967,1,22388355,22389059,704,0.22058556523351844
7871,746.392567,746.4325,1,22391777,22392975,1198,0.36599718902472483
7872,746.440067,746.4721,1,22393202,22394163,961,0.22017054833668367
7873,746.4877,746.491067,1,22394631,22394732,101,0.08085338919917841
7874,746.5627,746.605133,1,22396881,22398153,1272,0.37570420597217297
7875,746.606833,746.6417,1,22398204,22399251,1047,0.17997490719832202
7876,746.645,746.662067,1,22399350,22399862,512,-0.021452763453858947
7877,746.663567,746.702667,1,22399907,22401080,1173,0.049747914934265024
7878,746.766633,746.814633,1,22402998,22404438,1440,0.46331320460356706
7879,746.844467,746.8492,1,22405334,22405476,142,0.772010596315258
7880,748.243533,748.252567,1,22447305,22447577,272,0.0429440802233462
7881,748.266367,748.276433,1,22447991,22448292,301,-0.038029514658288674
7882,748.340967,748.386633,1,22450229,22451598,1369,0.10012845657391237
7883,748.423233,748.482467,1,22452696,22454474,1778,0.15872399395329706
7884,751.040133,751.069467,1,22531203,22532084,881,0.04017728701719019
7885,751.0747,751.079967,1,22532241,22532399,158,0.15723615872076113
7886,751.768233,751.7833,1,22553046,22553499,453,0.49757875975908117
7887,751.796767,752.0083,1,22553903,22560249,6346,0.7683482135114931
7888,752.622467,752.6352,1,22578674,22579056,382,-0.027214798581770262
7889,752.6384,752.6452,1,22579152,22579356,204,-0.11678590009741541
7890,752.6472,752.654033,1,22579416,22579620,204,0.3359571607079195
7891,752.655633,752.681233,1,22579668,22580436,768,0.5560553220619991
7892,752.730433,752.744067,1,22581912,22582322,410,0.8015878267122841
7893,752.745067,752.786433,1,22582352,22583592,1240,0.33223965300913616
7894,752.798967,752.810133,1,22583969,22584303,334,0.05207065377616858
7895,753.534433,753.5455,1,22606032,22606365,333,0.02896985824351167
7896,753.5471,753.570333,1,22606413,22607109,696,0.1457511296914334
7897,753.606433,753.611933,1,22608192,22608357,165,0.8427935913366634
7898,754.2848,754.291333,1,22628544,22628739,195,0.2975648033772003
7899,754.325367,754.340233,1,22629761,22630206,445,0.08383027716270001
7900,754.341533,754.362533,1,22630245,22630875,630,0.29654415343378276
7901,754.402467,754.5384,1,22632074,22636152,4078,0.2052704269381364
7902,754.550933,754.563967,1,22636527,22636919,392,0.6056989181524841
7903,754.566433,754.591233,1,22636992,22637736,744,0.14599018936778274
7904,754.603,754.678967,1,22638090,22640369,2279,0.22980621676885035
7905,754.6988,754.7084,1,22640964,22641252,288,0.7985441955465022
7906,755.054733,755.0605,1,22651641,22651815,174,0.11242237262923394
7907,756.454,756.458167,1,22693620,22693745,125,0.567204386590454
7908,756.464833,756.481267,1,22693944,22694438,494,0.7242769973536528
7909,756.4823,756.5052,1,22694469,22695156,687,0.29493904649999814
7910,756.513333,756.5371,1,22695399,22696113,714,0.5605153049880984
7911,756.538767,756.546833,1,22696163,22696404,241,0.7627825379438545
7912,756.549667,756.556467,1,22696490,22696694,204,0.8941606890613966
7913,756.558667,756.584433,1,22696760,22697532,772,0.34304423948958346
7914,756.596267,756.600133,1,22697888,22698003,115,0.5554743433807015
7915,756.601633,756.6049,1,22698048,22698147,99,0.6538899337797922
7916,756.609667,756.617533,1,22698290,22698525,235,0.7492670453522656
7917,756.741033,756.7442,1,22702230,22702326,96,0.8326708809928246
7918,757.9281,757.9338,1,22737843,22738014,171,0.05440423464941135
7919,757.937367,757.943233,1,22738121,22738296,175,0.5896880883688123
7920,757.9468,757.961267,1,22738404,22738838,434,0.5418925106714721
7921,758.202433,758.2156,1,22746072,22746468,396,0.45129946908776136
7922,758.245933,758.254333,1,22747377,22747629,252,0.83325354128207
7923,758.317533,758.3434,1,22749525,22750302,777,0.4502891586302373
7924,758.443967,758.448667,1,22753319,22753460,141,0.13626119363560268
7925,758.497467,758.508233,1,22754924,22755246,322,0.6947162081730501
7926,758.5472,758.559233,1,22756416,22756776,360,0.5513581354508628
7927,758.587033,758.6151,1,22757610,22758453,843,0.6485315562447014
7928,758.621133,758.6612,1,22758633,22759836,1203,0.34630967480108177
7929,758.666967,758.671867,1,22760009,22760156,147,0.1978615332266314
7930,758.678233,758.687567,1,22760346,22760627,281,0.39060442490150943
7931,758.688933,758.717233,1,22760667,22761516,849,0.6359767505988737
7932,758.727867,758.779533,1,22761836,22763385,1549,0.2522184311643915
7933,758.784933,758.801567,1,22763547,22764047,500,0.3105935212000497
7934,758.802667,758.810367,1,22764080,22764311,231,0.7444216427344051
7935,758.8117,758.833233,1,22764351,22764996,645,0.580279609173227
7936,758.845267,758.902533,1,22765358,22767075,1717,0.18398024811331082
7937,758.911267,758.917533,1,22767338,22767525,187,0.014532237248941943
7938,758.919333,758.934367,1,22767579,22768031,452,0.6758102485400715
7939,758.9389,758.9505,1,22768167,22768515,348,0.6611290603538638
7940,758.951733,758.956833,1,22768551,22768704,153,0.8783583107775416
7941,758.9696,759.0116,1,22769088,22770348,1260,0.2871731741810287
7942,759.0287,759.038567,1,22770861,22771157,296,0.11316535872542431
7943,759.0473,759.095733,1,22771419,22772871,1452,0.5397080971545685
7944,759.110033,759.131533,1,22773300,22773945,645,0.10192876916997516
7945,759.139133,759.1499,1,22774173,22774497,324,0.6060118537265938
7946,759.151033,759.159433,1,22774530,22774782,252,0.12533704803133652
7947,759.1742,759.1955,1,22775226,22775865,639,0.19151745049455582
7948,759.204633,759.217133,1,22776138,22776513,375,0.769318202973206
7949,759.245933,759.3021,1,22777377,22779063,1686,0.38050115566909704
7950,759.3858,759.400667,1,22781574,22782020,446,0.8438184994237955
7951,759.4055,759.411733,1,22782165,22782351,186,0.7414957670070917
7952,759.431367,759.449833,1,22782941,22783494,553,0.4627768348527671
7953,759.451333,759.462367,1,22783539,22783871,332,0.6629161192937097
7954,759.812167,759.8356,1,22794365,22795068,703,0.749219278550751
7955,759.836767,759.849233,1,22795103,22795476,373,0.43322950291595647
7956,759.875333,759.893267,1,22796259,22796798,539,0.21517541105149954
7957,759.900167,759.905867,1,22797005,22797176,171,0.02221384245295513
7958,759.948067,759.982167,1,22798442,22799465,1023,0.30125236031413477
7959,759.990867,759.9964,1,22799726,22799892,166,0.6767722846563402
7960,760.004333,760.0081,1,22800129,22800243,114,0.5534209691251748
7961,761.133633,761.1408,1,22834008,22834224,216,0.2715564296174839
7962,761.1419,761.161433,1,22834257,22834842,585,0.34205872820379263
7963,762.134133,762.142667,1,22864023,22864280,257,0.06972158280184478
7964,762.228433,762.2336,1,22866852,22867008,156,0.4410036195390617
7965,762.254533,762.2738,1,22867635,22868214,579,0.5376422256208989
7966,762.275567,762.3617,1,22868267,22870851,2584,0.3017212279807614
7967,762.4246,762.429833,1,22872738,22872894,156,0.5587109107883516
7968,762.5194,762.5662,1,22875582,22876986,1404,0.08619675293934775
7969,762.735733,762.7465,1,22882071,22882395,324,0.24937873906771696
7970,762.7529,762.849867,1,22882587,22885496,2909,0.16561611641977783
7971,762.8659,762.8925,1,22885977,22886775,798,0.29003581976007814
7972,762.894333,762.901333,1,22886829,22887039,210,0.12960613808150842
7973,762.903933,762.9083,1,22887117,22887249,132,0.570778230598205
7974,762.909433,762.993133,1,22887282,22889793,2511,0.09676149230399811
7975,762.9954,762.9999,1,22889862,22889997,135,0.8267567792874941
7976,763.010467,763.0168,1,22890314,22890504,190,0.7335771465796096
7977,764.391567,764.399733,1,22931747,22931991,244,0.1710528515000547
7978,764.439867,764.535533,1,22933196,22936065,2869,0.0597945570865469
7979,764.536867,764.5411,1,22936106,22936233,127,0.9527790233291443
7980,764.546767,764.663967,1,22936403,22939919,3516,0.1853275824373556
7981,764.673433,764.793833,1,22940202,22943814,3612,0.16340437251776654
7982,764.9942,765.003867,1,22949826,22950116,290,0.3462545808345881
7983,765.005867,765.0668,1,22950176,22952004,1828,0.07176483111079562
7984,765.076267,765.117467,1,22952288,22953524,1236,0.3470966267262389
7985,765.1333,765.152867,1,22953999,22954586,587,0.22106093572914853
7986,765.154233,765.1744,1,22954626,22955232,606,0.41588571062033286
7987,765.178733,765.286867,1,22955361,22958606,3245,0.15468429990638555
7988,765.287933,765.295167,1,22958637,22958855,218,0.5444656439178743
7989,765.299167,765.303933,1,22958975,22959117,142,0.8326555063877692
7990,765.3449,765.354067,1,22960347,22960622,275,0.8781800440730727
7991,765.406433,765.417367,1,22962192,22962521,329,0.1845688843266193
7992,765.5834,765.658833,1,22967502,22969764,2262,0.11467955027752197
7993,765.6632,765.674333,1,22969896,22970229,333,0.27484880616385843
7994,765.676133,765.6973,1,22970283,22970919,636,0.3371277265411812
7995,765.7183,765.802233,1,22971549,22974066,2517,0.16365560510963686
7996,765.8035,765.8236,1,22974105,22974708,603,0.10054005194436513
7997,765.826567,765.851267,1,22974797,22975538,741,0.2866583055517282
7998,765.879633,765.908367,1,22976388,22977251,863,0.1273179579175715
7999,765.9278,765.935333,1,22977834,22978059,225,0.5524474734012603
8000,765.936467,765.949633,1,22978094,22978488,394,0.9130987226597335
8001,765.9509,765.963233,1,22978527,22978896,369,0.9462114992942868
8002,765.9684,765.983233,1,22979052,22979496,444,0.5784541059181727
8003,766.0042,766.018867,1,22980126,22980566,440,0.257068555228685
8004,766.028633,766.0319,1,22980858,22980957,99,0.166806958705585
8005,766.961033,766.967033,1,23008830,23009010,180,0.8941108742430468
8006,766.9687,766.976267,1,23009061,23009288,227,0.5673205732214059
8007,766.9774,766.9897,1,23009322,23009691,369,0.7334383610459183
8008,769.490667,769.496933,1,23084720,23084907,187,0.2828512747228325
8009,769.536967,769.5472,1,23086109,23086416,307,0.1596448017524947
8010,769.549533,769.575767,1,23086485,23087273,788,0.6516178173990625
8011,769.587233,769.594133,1,23087616,23087823,207,0.7715629234879702
8012,769.6064,769.610133,1,23088192,23088303,111,0.825633471786909
8013,769.735567,769.7437,1,23092067,23092311,244,0.7132767272603252
8014,770.661267,770.7703,1,23119838,23123109,3271,0.14168993245159262
8015,770.772333,770.806067,1,23123169,23124182,1013,0.31222885446053256
8016,770.8134,770.830167,1,23124402,23124905,503,0.2866283902730985
8017,770.837633,770.841367,1,23125128,23125241,113,0.9088172319439691
8018,770.848,770.949867,1,23125440,23128496,3056,0.24770399241454732
8019,771.300533,771.308167,1,23139015,23139245,230,0.7639321922618756
8020,771.346467,771.356133,1,23140394,23140683,289,0.13622600622425826
8021,771.422067,771.4344,1,23142662,23143032,370,0.5682631513332183
8022,771.440867,771.473033,1,23143226,23144190,964,0.2259751908600432
8023,771.6378,771.646967,1,23149134,23149409,275,0.8360845242316763
8024,772.271433,772.350867,1,23168142,23170526,2384,0.28624812066211763
8025,772.372033,772.406267,1,23171160,23172188,1028,0.2635845007349981
8026,772.420033,772.4542,1,23172600,23173626,1026,0.22042416963977102
8027,772.460833,772.4893,1,23173824,23174679,855,0.14349843598726927
8028,772.490667,772.562933,1,23174720,23176887,2167,0.1943731735415659
8029,773.266767,773.2718,1,23198003,23198154,151,0.8437096419960942
8030,773.277167,773.349033,1,23198315,23200470,2155,0.2399854298655489
8031,773.351433,773.359633,1,23200542,23200788,246,0.4564043605178726
8032,773.367267,773.382,1,23201018,23201460,442,0.7776011136486392
8033,773.429067,773.435633,1,23202872,23203068,196,0.6999760919705679
8034,773.437533,773.454867,1,23203125,23203646,521,0.5752845721628087
8035,773.7816,773.785033,1,23213448,23213550,102,0.7988235284185792
8036,773.786733,773.855733,1,23213601,23215671,2070,0.05336935447573745
8037,773.862767,773.8846,1,23215883,23216538,655,0.4063029723740041
8038,773.8858,773.9866,1,23216574,23219598,3024,0.13541048967611824
8039,773.999167,774.008267,1,23219975,23220248,273,0.5808108876443691
8040,774.0138,774.0397,1,23220414,23221191,777,0.3541660654281241
8041,774.040767,774.081533,1,23221223,23222445,1222,0.13477690904696343
8042,774.085967,774.0956,1,23222579,23222868,289,0.041372882299590456
8043,774.160867,774.176233,1,23224826,23225286,460,0.753619457883986
8044,774.1804,774.1852,1,23225412,23225556,144,0.6949675628680939
8045,774.224667,774.2411,1,23226740,23227233,493,0.5919831497090481
8046,774.8061,774.8762,1,23244183,23246286,2103,0.1371855577031969
8047,774.879967,775.063367,1,23246399,23251901,5502,0.16001632592774928
8048,775.070367,775.077867,1,23252111,23252336,225,0.8753562305019066
8049,775.087767,775.100733,1,23252633,23253021,388,0.3055020346341432
8050,775.1191,775.147533,1,23253573,23254425,852,0.35940999424382625
8051,775.151933,775.1622,1,23254557,23254866,309,0.49813525109837764
8052,775.169667,775.189667,1,23255090,23255690,600,0.08827177475852441
8053,775.192933,775.198267,1,23255787,23255948,161,0.3108554953797391
8054,775.199267,775.233467,1,23255978,23257004,1026,0.7782166542007429
8055,775.2416,775.282967,1,23257248,23258489,1241,0.32524459332737354
8056,775.2986,775.318633,1,23258958,23259558,600,0.12612288912064887
8057,775.321633,775.3273,1,23259648,23259819,171,0.7077330051128643
8058,775.330133,775.3667,1,23259903,23261001,1098,0.2311565291287873
8059,775.369567,775.4058,1,23261087,23262174,1087,0.287624676846036
8060,775.412567,775.420733,1,23262377,23262621,244,0.30471509348138565
8061,775.421767,775.4277,1,23262653,23262831,178,0.797199101949008
8062,775.4432,775.462533,1,23263296,23263875,579,0.005020064436024087
8063,775.4661,775.507567,1,23263983,23265227,1244,0.2616273502671956
8064,775.5121,775.542267,1,23265363,23266268,905,0.3167837700902603
8065,775.549,775.5601,1,23266470,23266803,333,0.13539362558855692
8066,775.593467,775.614433,1,23267804,23268432,628,0.023485065392476075
8067,775.618233,775.646667,1,23268546,23269400,854,0.3407329376117197
8068,775.648767,775.658667,1,23269463,23269760,297,0.6676134031451103
8069,775.671,775.687667,1,23270130,23270630,500,0.5328901395430798
8070,775.6891,775.697567,1,23270673,23270927,254,0.3398596701059461
8071,776.054467,776.063267,1,23281634,23281898,264,-0.11783826308832465
8072,776.072667,776.100267,1,23282180,23283008,828,0.2283670207417286
8073,776.210333,776.2232,1,23286309,23286696,387,0.2564414803736077
8074,776.239333,776.245367,1,23287179,23287361,182,0.5113977830463227
8075,776.2485,776.276233,1,23287455,23288286,831,0.16597167519403536
8076,776.279367,776.293067,1,23288381,23288792,411,0.31040135445158484
8077,776.295567,776.3137,1,23288867,23289411,544,0.15196523278941645
8078,776.339633,776.361433,1,23290188,23290842,654,0.3196873333071552
8079,776.364,776.373633,1,23290920,23291208,288,0.44853380053213054
8080,776.379567,776.3845,1,23291387,23291535,148,0.2444377566933663
8081,776.396567,776.4125,1,23291897,23292375,478,0.2828863342838325
8082,779.3391,779.35,1,23380173,23380500,327,0.5413755742105033
8083,781.2609,781.2853,1,23437827,23438559,732,0.07608194940342067
8084,781.3115,781.3347,1,23439345,23440041,696,0.863132712586857
8085,783.177767,783.205833,1,23495333,23496174,841,0.19415825688517194
8086,783.213633,783.273867,1,23496408,23498216,1808,0.19590591138838628
8087,783.296433,783.3566,1,23498892,23500698,1806,0.3017202955342528
8088,783.358267,783.382633,1,23500748,23501478,730,0.22477677084087797
8089,783.383933,783.4735,1,23501517,23504205,2688,0.14815272977741784
8090,783.740267,783.7484,1,23512208,23512452,244,0.6962653261429318
8091,783.857167,783.864867,1,23515715,23515946,231,0.4902561195941009
8092,783.866933,783.950033,1,23516007,23518500,2493,0.1701907833628532
8093,783.955633,783.9595,1,23518668,23518785,117,0.8838032515523704
8094,783.963433,784.021,1,23518902,23520630,1728,0.20581968212249885
8095,784.0233,784.052833,1,23520699,23521584,885,0.014425198600445084
8096,784.058367,784.077,1,23521751,23522310,559,0.14926315390342884
8097,784.0806,784.1002,1,23522418,23523006,588,0.36479131207596127
8098,784.1111,784.1378,1,23523333,23524134,801,0.18458317528491083
8099,784.141733,784.2306,1,23524251,23526918,2667,0.052234836378295346
8100,784.241567,784.2512,1,23527247,23527536,289,0.10465328414442622
8101,784.282733,784.308333,1,23528481,23529249,768,0.0720363176603782
8102,784.323467,784.338067,1,23529704,23530142,438,0.18778730372240263
8103,784.368767,784.404733,1,23531063,23532141,1078,0.1747575892299721
8104,784.4429,784.464,1,23533287,23533920,633,0.28192051655593486
8105,784.471233,784.475667,1,23534136,23534270,134,0.9422684795026894
8106,784.479667,784.493767,1,23534390,23534813,423,0.617428987494578
8107,784.5183,784.521367,1,23535549,23535641,92,0.7698825446344115
8108,784.6558,784.661333,1,23539674,23539839,165,0.3402239018250047
8109,784.719033,784.7424,1,23541570,23542272,702,0.289709467548482
8110,784.831333,784.845533,1,23544939,23545365,426,0.26296950582931644
8111,785.381933,785.385667,1,23561457,23561570,113,0.732712842112473
8112,785.386867,785.4023,1,23561606,23562069,463,0.5144184125672706
8113,785.491233,785.496233,1,23564736,23564886,150,0.37044883105618487
8114,785.499633,785.557267,1,23564988,23566718,1730,0.0826556639795924
8115,785.559167,785.567567,1,23566775,23567027,252,0.5177786938479214
8116,785.593567,785.741333,1,23567807,23572239,4432,0.14835092341219774
8117,785.742467,785.749867,1,23572274,23572496,222,0.5834920765460975
8118,785.752367,785.782767,1,23572571,23573483,912,0.042195344643341265
8119,785.7923,785.8053,1,23573769,23574159,390,-0.035904771500227986
8120,785.8165,785.830567,1,23574495,23574917,422,0.03210965135515951
8121,785.832033,785.8352,1,23574960,23575056,96,0.9312364636005318
8122,785.836367,785.865367,1,23575091,23575961,870,0.6691440876282807
8123,785.870067,785.873367,1,23576102,23576201,99,0.7601590023473919
8124,785.891833,785.9095,1,23576754,23577285,531,0.6456988538828831
8125,785.962467,785.97,1,23578874,23579100,226,0.2552540056569445
8126,785.979967,785.9841,1,23579399,23579523,124,0.9124662295157041
8127,785.985967,786.026367,1,23579579,23580791,1212,0.49247032473844143
8128,786.040633,786.064467,1,23581218,23581934,716,0.3336282298979235
8129,786.122867,786.1304,1,23583686,23583912,226,0.0016176576694886305
8130,786.1435,786.184667,1,23584305,23585540,1235,0.563847845259668
8131,786.186533,786.194267,1,23585595,23585828,233,0.6172567186362002
8132,786.2096,786.225567,1,23586288,23586767,479,0.41538129634554916
8133,786.262867,786.270967,1,23587886,23588129,243,0.15470081681758302
8134,786.2994,786.3196,1,23588982,23589588,606,-0.0012877325910963034
8135,786.4901,786.498,1,23594703,23594940,237,0.2946385404847684
8136,786.506933,786.515233,1,23595207,23595456,249,0.1689842041226401
8137,788.102233,788.114833,1,23643066,23643444,378,-0.03331082306136368
8138,790.780967,790.875867,1,23723429,23726276,2847,0.16096585151680332
8139,790.883533,790.9269,1,23726505,23727807,1302,0.28963696725014487
8140,790.934933,791.000433,1,23728047,23730012,1965,0.2123456860774208
8141,791.001567,791.016667,1,23730047,23730500,453,0.9311059712532198
8142,792.889533,792.895867,1,23786685,23786876,191,0.5195862065994516
8143,792.934033,792.937133,1,23788020,23788113,93,0.6966953056207663
8144,793.314667,793.32,1,23799440,23799600,160,0.8222220812390605
8145,795.472067,795.5766,1,23864162,23867298,3136,0.16391273091895447
8146,795.5847,795.628367,1,23867541,23868851,1310,0.08133031326291565
8147,795.630533,795.6616,1,23868915,23869848,933,0.24918095861716755
8148,795.664033,795.6678,1,23869920,23870034,114,0.8053183320973445
8149,795.6766,795.7829,1,23870298,23873487,3189,0.3505216722620749
8150,795.804233,795.808533,1,23874126,23874255,129,0.890111274528484
8151,795.8272,795.8336,1,23874816,23875008,192,0.783950338656594
8152,795.842367,795.8516,1,23875271,23875548,277,0.8112638743209597
8153,795.870067,795.894867,1,23876102,23876846,744,0.38181982471631504
8154,795.898667,795.912433,1,23876960,23877372,412,0.2797375441246729
8155,796.291233,796.2985,1,23888736,23888955,219,0.7047838181141184
8156,796.359733,796.384867,1,23890791,23891546,755,0.0629597593072226
8157,796.4412,796.4443,1,23893236,23893329,93,0.7941013278009359
8158,796.446867,796.450367,1,23893406,23893511,105,0.6884247270088002
8159,796.516433,796.521767,1,23895492,23895653,161,0.715684082175862
8160,797.156933,797.173967,1,23914707,23915219,512,0.08545153782982626
8161,797.1751,797.245867,1,23915253,23917376,2123,0.1521854763951575
8162,797.250967,797.311533,1,23917529,23919345,1816,0.13595376642378357
8163,797.313867,797.3183,1,23919416,23919549,133,0.9674271995597555
8164,797.357,797.380933,1,23920710,23921427,717,0.39488693811946424
8165,797.4018,797.409567,1,23922054,23922287,233,0.3226355186435631
8166,797.4122,797.416033,1,23922366,23922480,114,0.8754584003480528
8167,797.420767,797.4314,1,23922623,23922942,319,0.5587058738101277
8168,797.434167,797.444267,1,23923025,23923328,303,0.47361930408340114
8169,797.465667,797.4723,1,23923970,23924169,199,0.7894658246945436
8170,797.479833,797.482967,1,23924394,23924489,95,0.7772822584362837
8171,797.4882,797.493333,1,23924646,23924799,153,0.7803716382428232
8172,797.495167,797.520067,1,23924855,23925602,747,0.6725254410284088
8173,797.529767,797.5359,1,23925893,23926077,184,0.7783203623256453
8174,797.539167,797.561167,1,23926175,23926835,660,0.49694770100521324
8175,797.5671,797.612633,1,23927013,23928378,1365,0.48863510144306777
8176,797.622967,797.658667,1,23928689,23929760,1071,0.18790367571739916
8177,797.671933,797.714967,1,23930157,23931449,1292,0.30256912455147517
8178,797.7282,797.772067,1,23931846,23933162,1316,0.28834950310629665
8179,797.7854,797.8312,1,23933562,23934936,1374,0.25959223439203244
8180,797.835967,797.839867,1,23935079,23935196,117,0.9346911143534455
8181,797.852933,797.8623,1,23935587,23935869,282,0.5000825134552627
8182,797.867967,797.880333,1,23936039,23936409,370,0.3439846611526583
8183,797.884167,798.052467,1,23936525,23941574,5049,0.28686406184234964
8184,798.0587,798.078533,1,23941761,23942355,594,0.7932434351717388
8185,798.0801,798.1119,1,23942403,23943357,954,0.20860210777788415
8186,798.113033,798.143,1,23943390,23944290,900,0.5490177602227246
8187,798.147533,798.157467,1,23944425,23944724,299,0.7843117644537012
8188,798.1987,798.2123,1,23945961,23946369,408,0.7222474463282454
8189,798.2256,798.229033,1,23946768,23946870,102,-0.037768808845753135
8190,798.244,798.2574,1,23947320,23947722,402,0.39182398381241534
8191,798.2594,798.286333,1,23947782,23948589,807,0.7716081394895493
8192,798.2963,798.307467,1,23948889,23949224,335,0.568983145840762
8193,798.3223,798.348033,1,23949669,23950440,771,0.30986043563429017
8194,798.349467,798.3532,1,23950484,23950596,112,0.8328140330627098
8195,798.498867,798.502867,1,23954966,23955086,120,0.2942421034683834
8196,798.506333,798.563667,1,23955189,23956910,1721,0.1883314143996005
8197,798.5708,798.583567,1,23957124,23957507,383,0.39339176295525
8198,798.5902,798.604067,1,23957706,23958122,416,0.4340634380172178
8199,798.605667,798.624533,1,23958170,23958735,565,0.09530720542147968
8200,798.626433,798.6455,1,23958792,23959365,573,0.4060188401230338
8201,798.647467,798.737633,1,23959424,23962128,2704,0.21390398961056756
8202,798.743567,798.7502,1,23962307,23962506,199,0.9126863247271109
8203,798.7513,798.7768,1,23962539,23963304,765,0.5780217732554328
8204,798.788333,798.822033,1,23963649,23964660,1011,0.26816988921169804
8205,798.825767,798.8359,1,23964773,23965077,304,0.3263672765519118
8206,798.848167,798.851433,1,23965445,23965542,97,0.8584837021339651
8207,798.8534,798.882867,1,23965602,23966486,884,0.15289024633807488
8208,798.8971,798.904133,1,23966913,23967123,210,0.41387802540896945
8209,798.914333,798.9335,1,23967429,23968005,576,0.0730021633195988
8210,798.948033,798.9831,1,23968440,23969493,1053,0.18823757781919281
8211,799.039433,799.048533,1,23971182,23971455,273,0.3114654368486984
8212,799.379633,799.421067,1,23981388,23982632,1244,0.13232502138153707
8213,799.4248,799.504633,1,23982744,23985138,2394,0.17577800550753236
8214,799.518133,799.525567,1,23985543,23985767,224,0.5033753213265596
8215,799.526867,799.545,1,23985806,23986350,544,0.548424599318058
8216,799.546133,799.558667,1,23986383,23986760,377,0.4901535844543821
8217,799.569533,799.5926,1,23987085,23987778,693,0.3622443742251472
8218,799.594,799.598767,1,23987820,23987963,143,0.6614579296599505
8219,799.607667,799.632333,1,23988230,23988969,739,0.3132870496890415
8220,799.633533,799.651467,1,23989005,23989544,539,0.6890783120480979
8221,799.656533,799.696233,1,23989695,23990886,1191,0.5116211127975531
8222,799.697267,799.701267,1,23990918,23991038,120,0.715741462338551
8223,799.702333,799.7057,1,23991069,23991171,102,0.9241822390672984
8224,799.712067,799.7539,1,23991362,23992617,1255,0.41760787373461505
8225,799.7646,799.806967,1,23992938,23994209,1271,0.39709074441570885
8226,799.809067,799.8156,1,23994272,23994468,196,0.7669444700140516
8227,799.821567,799.829067,1,23994647,23994872,225,0.8335541350541239
8228,799.8736,799.8882,1,23996208,23996646,438,0.2874109923626057
8229,799.896267,799.913933,1,23996888,23997417,529,0.573693150789936
8230,799.948533,799.9517,1,23998455,23998551,96,0.9328111718309741
8231,799.958967,799.962733,1,23998769,23998881,112,0.9372089252692111
8232,799.9755,799.979967,1,23999265,23999399,134,0.7780108603356004
8233,800.014267,800.03,1,24000428,24000900,472,0.7302105400127917
8234,801.1757,801.183733,1,24035271,24035511,240,0.5452684711065839
8235,801.199333,801.206833,1,24035979,24036204,225,0.483479688126729
8236,801.2145,801.225467,1,24036435,24036764,329,0.24724290325551893
8237,801.234167,801.392367,1,24037025,24041771,4746,0.0027543915755749273
8238,801.3964,801.490967,1,24041892,24044729,2837,0.2078738345763945
8239,801.4979,801.517133,1,24044937,24045513,576,0.42128257583618034
8240,801.525067,801.5652,1,24045752,24046956,1204,0.13336959318255784
8241,801.571567,801.5768,1,24047147,24047304,157,0.9139236832313419
8242,801.578533,801.592133,1,24047355,24047763,408,0.07813807236747532
8243,801.603233,801.636133,1,24048096,24049083,987,0.010840348474971402
8244,801.756933,801.761633,1,24052707,24052848,141,0.6392441153473204
8245,801.768033,801.797867,1,24053040,24053936,896,0.1458551029995783
8246,801.801733,801.8054,1,24054051,24054162,111,0.9572174274526677
8247,801.809667,801.813167,1,24054290,24054395,105,0.9565774917466154
8248,801.8145,801.885367,1,24054435,24056561,2126,0.4106423583596539
8249,801.916133,802.011867,1,24057483,24060356,2873,0.31472693395841056
8250,802.0132,802.016633,1,24060396,24060498,102,0.7902320179645121
8251,802.018233,802.023833,1,24060546,24060714,168,0.8312140966998195
8252,802.038233,802.047967,1,24061146,24061439,293,0.5429155940203412
8253,802.049133,802.055667,1,24061473,24061670,197,0.5125614722314348
8254,802.0569,802.061267,1,24061707,24061838,131,0.7330175614188047
8255,802.062633,802.0677,1,24061878,24062031,153,0.6942083688629828
8256,802.071333,802.0859,1,24062139,24062577,438,0.7692167546286715
8257,802.0997,802.1401,1,24062991,24064203,1212,0.3824551626584335
8258,802.1533,802.158233,1,24064599,24064746,147,0.7502494141023911
8259,802.1601,802.165667,1,24064803,24064970,167,0.8127656408576844
8260,802.335267,802.3434,1,24070058,24070302,244,0.45932997182701557
8261,802.6782,802.692,1,24080346,24080760,414,0.16563945316975132
8262,803.4358,803.439767,1,24103074,24103193,119,0.7489155258776177
8263,803.854733,803.858133,1,24115641,24115743,102,0.9257802375632753
8264,803.882,803.885167,1,24116460,24116555,95,0.7664052064722028
8265,804.029933,804.1255,1,24120897,24123765,2868,0.04068696306327612
8266,804.129533,804.1328,1,24123885,24123984,99,0.8523697285634766
8267,804.139367,804.1619,1,24124181,24124857,676,0.0891054871994965
8268,804.164833,804.193333,1,24124944,24125799,855,0.19036027906832934
8269,804.200467,804.279933,1,24126014,24128397,2383,0.1534742654959504
8270,804.316833,804.325367,1,24129504,24129761,257,0.5831117403451448
8271,804.333033,804.3414,1,24129990,24130242,252,0.8185685594611393
8272,804.345867,804.349033,1,24130376,24130470,94,0.9812657610636878
8273,804.351233,804.354867,1,24130536,24130646,110,0.8836113894871743
8274,804.367467,804.3706,1,24131024,24131118,94,0.8367833695964497
8275,804.376167,804.4032,1,24131285,24132096,811,0.4232147829403948
8276,805.378833,805.487633,1,24161364,24164628,3264,0.23234977975969415
8277,805.4934,805.514267,1,24164802,24165428,626,0.08933443738823992
8278,805.540067,805.735867,1,24166202,24172076,5874,0.3543159845119765
8279,805.967667,805.973767,1,24179030,24179213,183,0.919717964269459
8280,805.975167,806.0083,1,24179255,24180249,994,0.7318024081126852
8281,806.409333,806.490733,1,24192279,24194721,2442,0.21181447411090332
8282,806.496767,806.5141,1,24194903,24195423,520,0.292668677904252
8283,806.538033,806.553033,1,24196140,24196590,450,0.16858096971159864
8284,806.557267,806.5619,1,24196718,24196857,139,0.8786404775952261
8285,806.5802,806.586933,1,24197406,24197607,201,0.7118021164536265
8286,806.5913,806.625933,1,24197739,24198777,1038,0.4760597490115576
8287,806.632633,806.6365,1,24198978,24199095,117,0.7824134744210856
8288,806.6438,806.667167,1,24199314,24200015,701,0.4848691045036511
8289,806.668733,806.7464,1,24200061,24202392,2331,0.13496874652377908
8290,806.7695,806.778067,1,24203085,24203342,257,0.6068624541850208
8291,806.784267,806.788867,1,24203528,24203666,138,0.8627295735060356
8292,806.8041,806.807333,1,24204123,24204219,96,0.6269661964527214
8293,806.8408,806.847267,1,24205224,24205418,194,0.9486367974862755
8294,806.850233,806.855333,1,24205506,24205659,153,0.8589662248416102
8295,806.860967,806.866667,1,24205829,24206000,171,0.9103057558151079
8296,807.116233,807.1195,1,24213486,24213585,99,0.7945511270796558
8297,807.172667,807.187933,1,24215180,24215637,457,0.14238801064962642
8298,807.1936,807.3356,1,24215808,24220068,4260,0.21946458465472243
8299,807.3429,807.392967,1,24220287,24221789,1502,0.19376139878437001
8300,807.396833,807.513,1,24221904,24225390,3486,0.2743004829470517
8301,810.4285,810.453933,1,24312855,24313617,762,0.7924393791720482
8302,810.4551,810.465533,1,24313653,24313965,312,0.7285659726101238
8303,810.466567,810.4798,1,24313997,24314394,397,0.7180500187664011
8304,810.483167,810.500767,1,24314495,24315023,528,0.8036672170253839
8305,810.512667,810.517433,1,24315380,24315522,142,0.7475927753312253
8306,810.5204,810.5245,1,24315612,24315735,123,0.8656429362835585
8307,810.5257,810.630933,1,24315771,24318927,3156,0.7883953509266891
8308,810.632,810.642733,1,24318960,24319281,321,0.6869211499775115
8309,810.646133,810.649967,1,24319383,24319499,116,0.7365761999059283
8310,810.651033,810.678367,1,24319530,24320351,821,0.7458393729064355
8311,810.6794,810.685133,1,24320382,24320553,171,0.7667145725673852
8312,810.686367,810.789767,1,24320591,24323693,3102,0.7721785673255533
8313,810.790767,810.796533,1,24323723,24323895,172,0.6803736410503924
8314,810.7977,810.812933,1,24323931,24324387,456,0.8118006301876775
8315,810.816733,810.8247,1,24324501,24324741,240,0.7456586586018442
8316,810.830433,810.8343,1,24324912,24325029,117,0.6198929744904093
8317,810.837633,810.850833,1,24325128,24325524,396,0.7446313282460842
8318,810.8519,810.867167,1,24325557,24326015,458,0.7128734847067507
8319,810.868167,810.929333,1,24326045,24327879,1834,0.8065594659169322
8320,810.9304,810.945633,1,24327912,24328368,456,0.7096103711149179
8321,810.949067,810.964433,1,24328472,24328932,460,0.8119371097614217
8322,810.965467,810.971733,1,24328964,24329151,187,0.7883576746320358
8323,810.975067,810.978633,1,24329252,24329358,106,0.6233752426423069
8324,810.982067,810.985933,1,24329462,24329577,115,0.6217998747776695
8325,810.986967,810.9999,1,24329609,24329997,388,0.3421698832488539
8326,811.001133,811.0091,1,24330033,24330273,240,0.6330059592836228
8327,811.0101,811.113767,1,24330303,24333413,3110,0.7086112838614007
8328,811.1148,811.1324,1,24333444,24333972,528,0.725230334657916
8329,811.135867,811.139533,1,24334076,24334185,109,0.7372720299354952
8330,811.140767,811.156133,1,24334223,24334683,460,0.8014507374791217
8331,811.157133,811.160733,1,24334713,24334821,108,0.6417083132303896
8332,811.1641,811.167967,1,24334923,24335039,116,0.8248124600033627
8333,811.169033,811.251233,1,24335070,24337536,2466,0.7601050098571511
8334,811.252233,811.330833,1,24337566,24339924,2358,0.7218231520093871
8335,811.334367,811.347467,1,24340031,24340424,393,0.6985193868801686
8336,811.3485,811.449667,1,24340455,24343490,3035,0.7404619892244512
8337,811.450667,811.465967,1,24343520,24343979,459,0.725424749630504
8338,811.467067,811.4825,1,24344012,24344475,463,0.8212706258437031
8339,811.4835,811.610233,1,24344505,24348306,3801,0.7436587867229086
8340,811.611267,811.626533,1,24348338,24348795,457,0.738690294420598
8341,811.627533,811.780467,1,24348825,24353414,4589,0.6635785054101285
8342,811.7815,811.803533,1,24353445,24354105,660,0.7115745423087841
8343,811.845967,811.915433,1,24355379,24357462,2083,0.8022301372038718
8344,811.916833,811.920067,1,24357504,24357602,98,0.9302915354676946
8345,811.928333,811.941667,1,24357849,24358250,401,0.44818467657314265
8346,811.943767,812.0646,1,24358313,24361938,3625,0.7736590142015333
8347,812.0658,812.115567,1,24361974,24363467,1493,0.5748713677421454
8348,812.154433,812.159833,1,24364632,24364794,162,0.2982557728142408
8349,812.208233,812.257433,1,24366246,24367722,1476,0.10145096899727318
8350,812.2619,812.279533,1,24367857,24368385,528,0.11660061930498576
8351,812.2989,812.311233,1,24368967,24369336,369,0.23193302301154675
8352,812.3251,812.374933,1,24369753,24371247,1494,0.1373608277175987
8353,812.423333,812.426867,1,24372699,24372806,107,0.9597929435474322
8354,812.434267,812.4454,1,24373028,24373362,334,0.8755049502346575
8355,812.457667,812.462267,1,24373730,24373868,138,0.631749047365642
8356,812.466167,812.482967,1,24373985,24374489,504,0.5208567866990954
8357,812.4855,812.489567,1,24374565,24374687,122,0.7842190911509848
8358,812.494533,812.499667,1,24374835,24374990,155,0.4413794467805735
8359,812.5087,812.5277,1,24375261,24375831,570,0.1907087948442143
8360,812.5346,812.5446,1,24376038,24376338,300,0.11366295946973823
8361,812.550933,812.558133,1,24376527,24376743,216,0.8153148200951958
8362,812.5629,812.5661,1,24376887,24376983,96,0.5273493699172179
8363,812.5827,812.591667,1,24377481,24377750,269,0.8177785895877733
8364,812.594833,812.6008,1,24377844,24378024,180,0.5822562259348323
8365,812.619167,812.637133,1,24378575,24379113,538,0.013554990698249787
8366,812.655667,812.695467,1,24379670,24380864,1194,0.20654794227222628
8367,812.7,812.7035,1,24381000,24381105,105,0.9198463115307949
8368,812.7258,812.772433,1,24381774,24383172,1398,0.4552803540055448
8369,812.774333,812.806267,1,24383229,24384188,959,0.2479723846699453
8370,812.812433,812.823533,1,24384372,24384705,333,0.540045633186067
8371,812.8442,812.8979,1,24385326,24386937,1611,0.37597484264788744
8372,812.904467,812.931233,1,24387134,24387936,802,0.4279708175189207
8373,814.262833,814.267833,1,24427884,24428034,150,0.22641956416169137
8374,814.271233,814.371733,1,24428136,24431151,3015,0.04008020732165547
8375,814.375867,814.4006,1,24431276,24432018,742,0.2932142009550416
8376,814.421233,814.4368,1,24432636,24433104,468,0.1190038314089857
8377,814.443467,814.4477,1,24433304,24433431,127,0.6223903247054235
8378,814.462433,814.5611,1,24433872,24436833,2961,0.20670790288639013
8379,815.364033,815.370633,1,24460920,24461118,198,0.21823978906953548
8380,815.383833,815.523333,1,24461514,24465699,4185,0.19617297698152716
8381,815.5498,815.655567,1,24466494,24469667,3173,0.14001826085187286
8382,815.661267,815.6863,1,24469838,24470589,751,0.18698390363203657
8383,815.706767,815.710367,1,24471203,24471311,108,0.7760407235199303
8384,815.727533,815.7418,1,24471825,24472254,429,0.09182236637514847
8385,815.759533,815.7902,1,24472785,24473706,921,0.26848980728252825
8386,815.8113,815.814533,1,24474339,24474435,96,0.5875866240012165
8387,815.817267,815.8316,1,24474518,24474948,430,0.18920748860749667
8388,815.833133,815.864267,1,24474993,24475928,935,0.13587130601929615
8389,815.865733,815.8703,1,24475971,24476109,138,0.7815773947544322
8390,815.873633,815.915933,1,24476208,24477477,1269,0.24355228300041665
8391,815.934367,815.957133,1,24478031,24478713,682,0.08214712200934517
8392,815.960467,815.980167,1,24478814,24479405,591,0.2601897790683612
8393,815.981633,815.988633,1,24479448,24479658,210,0.812701576852505
8394,815.992067,816.018233,1,24479762,24480546,784,0.10044165447910629
8395,816.025767,816.028967,1,24480773,24480869,96,0.9023369287417894
8396,816.094667,816.103133,1,24482840,24483093,253,0.37293103997982074
8397,816.274433,816.282467,1,24488232,24488474,242,0.3216571253931644
8398,816.294633,816.322367,1,24488838,24489671,833,0.18944766755748535
8399,816.326233,816.399867,1,24489786,24491996,2210,0.2636055233638892
8400,816.425967,816.434767,1,24492779,24493043,264,0.7810910513441969
8401,816.436167,816.469733,1,24493085,24494091,1006,0.44897151553246256
8402,816.475067,816.481,1,24494252,24494430,178,0.4484084765265035
8403,816.493433,816.541333,1,24494802,24496239,1437,0.4072946378822588
8404,816.710433,816.7208,1,24501312,24501624,312,0.42374924584529866
8405,816.726267,816.807033,1,24501788,24504210,2422,0.24490360796295912
8406,816.816667,816.820333,1,24504500,24504609,109,0.7286877099491289
8407,816.825233,816.9268,1,24504756,24507804,3048,0.2478862878589359
8408,816.9446,816.951367,1,24508338,24508541,203,0.13304122437405128
8409,816.9566,816.960233,1,24508698,24508806,108,0.11513717875691347
8410,817.092067,817.256533,1,24512762,24517695,4933,0.7483530064643407
8411,817.257967,817.2823,1,24517739,24518469,730,0.737724491828498
8412,817.447133,817.455767,1,24523413,24523673,260,0.6523353575072905
8413,817.468767,817.472167,1,24524063,24524165,102,0.756638639918033
8414,817.498167,817.505467,1,24524945,24525164,219,0.6915967726332358
8415,817.651133,817.713333,1,24529533,24531399,1866,0.16346799363222034
8416,817.720433,817.728167,1,24531612,24531845,233,0.8157823845470284
8417,817.7379,817.755267,1,24532137,24532658,521,0.23573065493393786
8418,817.756467,817.786833,1,24532694,24533604,910,0.07727150439502835
8419,817.799,817.885333,1,24533970,24536559,2589,0.1699246070740042
8420,817.902367,817.9075,1,24537071,24537225,154,0.6046954631980143
8421,817.911233,817.935,1,24537336,24538050,714,0.1259798748125219
8422,817.9467,817.9847,1,24538401,24539541,1140,0.24480481184717412
8423,818.1176,818.123733,1,24543528,24543711,183,0.6143170334372426
8424,819.3201,819.325367,1,24579603,24579761,158,0.5038679668674544
8425,819.3281,819.410267,1,24579843,24582308,2465,0.11506848260205134
8426,819.412067,819.4861,1,24582362,24584583,2221,0.2504206957875171
8427,819.509567,819.598433,1,24585287,24587952,2665,0.09670248873676013
8428,819.613933,819.636867,1,24588417,24589106,689,0.127560629511338
8429,819.646667,819.691133,1,24589400,24590733,1333,0.20224707292323468
8430,819.710267,819.721867,1,24591308,24591656,348,0.6649699782276012
8431,819.7761,819.781967,1,24593283,24593459,176,0.19296532892614987
8432,819.796467,819.812,1,24593894,24594360,466,0.4590213593684186
8433,819.8207,819.8244,1,24594621,24594732,111,0.8180294709337447
8434,820.328833,820.394533,1,24609864,24611835,1971,0.19673762857245847
8435,820.395767,820.4109,1,24611873,24612327,454,0.24489313913268093
8436,820.429367,820.438167,1,24612881,24613145,264,0.6613437571399221
8437,820.441933,820.5217,1,24613257,24615651,2394,0.1449849293515815
8438,820.524,820.676833,1,24615720,24620304,4584,0.12392879057668507
8439,820.757233,820.7633,1,24622716,24622899,183,0.7932656514659495
8440,820.769933,820.955033,1,24623097,24628650,5553,0.7203956879122995
8441,820.956233,820.9796,1,24628686,24629388,702,0.7210725810979439
8442,820.998933,821.005033,1,24629967,24630150,183,0.34019411477603106
8443,821.1306,821.1375,1,24633918,24634125,207,0.7643141070757306
8444,821.143767,821.148367,1,24634313,24634451,138,0.8130754456220114
8445,821.1546,821.202833,1,24634638,24636084,1446,0.19383857951644146
8446,821.2081,821.218067,1,24636243,24636542,299,0.7177508576750694
8447,821.227667,821.3162,1,24636830,24639486,2656,0.14464009802773994
8448,821.3172,821.379633,1,24639516,24641388,1872,0.2127111102477045
8449,821.382667,821.4296,1,24641480,24642888,1408,0.16848475058291368
8450,821.434833,821.443733,1,24643044,24643311,267,0.3558395313758869
8451,821.520467,821.559333,1,24645614,24646779,1165,0.04693260566865684
8452,821.600367,821.6076,1,24648011,24648228,217,0.3449554808799424
8453,823.0731,823.183667,1,24692193,24695510,3317,0.06541746680164227
8454,823.188933,823.229,1,24695667,24696870,1203,0.2524263270415549
8455,823.230167,823.239467,1,24696905,24697184,279,0.3207343743682593
8456,823.241267,823.2605,1,24697238,24697815,577,0.25891168087200384
8457,823.264667,823.2914,1,24697940,24698742,802,0.36801798022196325
8458,823.312633,823.315833,1,24699378,24699474,96,0.7706459859499682
8459,823.3172,823.430067,1,24699516,24702902,3386,0.16625904376244321
8460,823.431133,823.4728,1,24702933,24704184,1251,0.3715906085656144
8461,823.474433,823.526067,1,24704232,24705782,1550,0.12119159266521526
8462,823.5272,823.538067,1,24705816,24706142,326,0.3801963612794386
8463,823.553267,823.602767,1,24706598,24708083,1485,0.16519204717332664
8464,823.605367,823.610733,1,24708161,24708321,160,0.6008992009576468
8465,823.612033,823.627,1,24708360,24708810,450,0.4938402255183379
8466,823.633067,823.756133,1,24708992,24712683,3691,0.20039304083748663
8467,823.7697,823.848233,1,24713091,24715446,2355,0.2816185259562469
8468,823.8516,823.862967,1,24715548,24715889,341,0.5532595879755918
8469,823.865533,823.904067,1,24715965,24717122,1157,0.3997669204917093
8470,823.905233,823.9085,1,24717156,24717255,99,0.6607892004339755
8471,823.9095,823.914267,1,24717285,24717428,143,0.6862657391368882
8472,823.918667,823.963333,1,24717560,24718899,1339,0.2245984846145658
8473,824.023933,824.0297,1,24720717,24720891,174,-0.04426538851771334
8474,824.036,824.074133,1,24721080,24722223,1143,0.675513036748698
8475,824.075633,824.109467,1,24722268,24723284,1016,0.2972460547162126
8476,824.113233,824.122367,1,24723396,24723671,275,0.061123144958361166
8477,824.134633,824.157967,1,24724038,24724739,701,0.1897010935969938
8478,824.2014,824.208667,1,24726042,24726260,218,0.6258648225851471
8479,824.236,824.282167,1,24727080,24728465,1385,0.15232339449332347
8480,824.283767,824.2868,1,24728513,24728604,91,0.9668879400802662
8481,824.293567,824.304367,1,24728807,24729131,324,0.4849302818796109
8482,824.309133,824.316933,1,24729273,24729507,234,0.4659662150988246
8483,824.405367,824.409,1,24732161,24732270,109,0.6338805148195875
8484,824.414033,824.4351,1,24732420,24733053,633,0.25562119627689106
8485,824.446467,824.4502,1,24733394,24733506,112,0.9088995390123051
8486,824.464267,824.475533,1,24733928,24734265,337,0.680516915867501
8487,824.4977,824.5104,1,24734931,24735312,381,0.8157357250182051
8488,824.5148,824.522233,1,24735444,24735666,222,0.8989469591569265
8489,824.571467,824.653233,1,24737144,24739596,2452,0.1767942805320868
8490,824.655833,824.666333,1,24739674,24739989,315,0.40242502056959234
8491,824.675767,824.7312,1,24740273,24741936,1663,0.18126679429133155
8492,824.732933,824.751833,1,24741987,24742554,567,0.23345142436226332
8493,824.753067,824.763433,1,24742592,24742902,310,0.6017133667083693
8494,824.767733,824.847233,1,24743031,24745416,2385,0.13733492886946647
8495,825.931767,825.938,1,24777953,24778140,187,0.2857505509607731
8496,825.947667,826.126633,1,24778430,24783798,5368,0.16607488221100036
8497,826.142333,826.157433,1,24784269,24784722,453,0.18405402655333175
8498,826.1695,826.193633,1,24785085,24785808,723,0.16338209708101334
8499,826.194633,826.200667,1,24785838,24786020,182,0.6163656073364998
8500,826.201867,826.282167,1,24786056,24788465,2409,0.06396000288320304
8501,826.308467,826.3901,1,24789254,24791703,2449,0.07328393923254399
8502,826.412467,826.436833,1,24792374,24793104,730,0.7753858413475674
8503,826.493567,826.499133,1,24794807,24794973,166,0.44145981520183125
8504,826.713,826.7492,1,24801390,24802476,1086,0.4424718962013774
8505,826.828733,827.0447,1,24804861,24811341,6480,0.14731164714477663
8506,827.046633,827.052833,1,24811398,24811584,186,0.7843573758506583
8507,827.055167,827.140433,1,24811655,24814212,2557,0.0966892667641478
8508,827.143333,827.1794,1,24814299,24815382,1083,0.25093737840328245
8509,827.180433,827.190067,1,24815412,24815702,290,0.7794877305218361
8510,827.210667,827.215733,1,24816320,24816471,151,0.2611348520805112
8511,827.227133,827.232667,1,24816813,24816980,167,0.6600022916122137
8512,827.326433,827.4949,1,24819792,24824847,5055,0.7751903242556853
8513,827.497633,827.516667,1,24824928,24825500,572,0.7504697815126142
8514,827.5265,827.535033,1,24825795,24826050,255,0.5879219881944338
8515,827.918333,827.9915,1,24837549,24839745,2196,0.1516749875598754
8516,827.9951,828.017633,1,24839853,24840528,675,0.3024540443812272
8517,828.018633,828.084067,1,24840558,24842522,1964,0.04038049757754249
8518,828.093433,828.2327,1,24842802,24846981,4179,0.18549212140218127
8519,828.245633,828.268533,1,24847368,24848055,687,0.19817585694876289
8520,828.282433,828.3017,1,24848472,24849051,579,0.07415830278221928
8521,828.308933,828.3498,1,24849267,24850494,1227,0.24993039727763788
8522,828.392033,828.414867,1,24851760,24852446,686,0.5943018510818563
8523,828.435933,828.449767,1,24853077,24853493,416,0.7410275522239876
8524,829.171167,829.1891,1,24875135,24875673,538,0.5529937119016863
8525,829.190267,829.281767,1,24875708,24878453,2745,0.20235848481445773
8526,829.2831,829.3078,1,24878493,24879234,741,-0.02498875531942144
8527,829.3166,829.467033,1,24879498,24884010,4512,0.125038973799195
8528,829.475767,829.4941,1,24884273,24884823,550,0.25727771088314483
8529,829.510567,829.535967,1,24885317,24886079,762,0.15405903867239473
8530,829.537367,829.541333,1,24886121,24886239,118,0.6275526012892383
8531,829.574,829.619367,1,24887220,24888581,1361,0.1966979747660794
8532,829.643433,829.649933,1,24889302,24889497,195,0.5331134263833608
8533,829.691033,829.696,1,24890730,24890880,150,0.7960975295853483
8534,829.715267,829.720167,1,24891458,24891605,147,0.801260832060317
8535,829.727867,829.734633,1,24891836,24892038,202,0.3438847065875955
8536,829.972167,829.9783,1,24899165,24899349,184,0.8242222158388574
8537,829.980967,830.0149,1,24899429,24900447,1018,0.21271472452823864
8538,830.0196,830.067767,1,24900588,24902033,1445,0.26506653373541184
8539,830.075267,830.088667,1,24902258,24902660,402,0.6724802391634662
8540,830.959033,831.080433,1,24928770,24932412,3642,0.2243168573999966
8541,831.086467,831.1042,1,24932594,24933126,532,0.19757471293424492
8542,831.105733,831.1105,1,24933171,24933315,144,0.5624201863853608
8543,831.129333,831.203933,1,24933879,24936117,2238,0.20120165905477708
8544,832.0178,832.025033,1,24960534,24960750,216,0.5381722330389236
8545,832.035267,832.039567,1,24961058,24961187,129,0.5787456571571088
8546,832.664033,832.7505,1,24979920,24982515,2595,0.18055317926630735
8547,832.752067,832.799167,1,24982562,24983975,1413,0.10271585379061603
8548,832.800533,832.811667,1,24984015,24984350,335,0.5297053029187595
8549,832.813733,832.8376,1,24984411,24985128,717,0.20497213386790078
8550,832.8469,832.890233,1,24985407,24986706,1299,0.18962032187198055
8551,832.892833,832.921167,1,24986784,24987635,851,0.7681765274792883
8552,832.930833,832.9528,1,24987924,24988584,660,0.5138644421259593
8553,832.957367,832.968933,1,24988721,24989067,346,0.3644988793665415
8554,832.975033,832.9815,1,24989250,24989445,195,0.8772386530040038
8555,832.990033,833.016267,1,24989700,24990488,788,0.29038782621461817
8556,833.033433,833.039033,1,24991002,24991170,168,0.6240642555200785
8557,833.0418,833.059533,1,24991254,24991785,531,0.44004558339201094
8558,833.060733,833.0773,1,24991821,24992319,498,0.5840206409622557
8559,833.083233,833.104467,1,24992496,24993134,638,0.12411632754351153
8560,833.109333,833.122467,1,24993279,24993674,395,0.4058264407043971
8561,833.1359,833.141433,1,24994077,24994242,165,0.7292584251697674
8562,833.1468,833.155,1,24994404,24994650,246,0.6690677098262027
8563,833.156167,833.175767,1,24994685,24995273,588,0.7142133202304474
8564,833.180533,833.1858,1,24995415,24995574,159,0.7411074139352531
8565,833.194633,833.206867,1,24995838,24996206,368,0.3419552832388885
8566,833.209833,833.219867,1,24996294,24996596,302,0.2892403336873219
8567,833.327633,833.3425,1,24999828,25000275,447,0.6146351902381442
8568,833.3469,833.352767,1,25000407,25000583,176,0.31969360761920057
8569,833.361267,833.3849,1,25000838,25001547,709,0.36507276716102194
8570,833.488267,833.491767,1,25004648,25004753,105,0.6120688091970045
8571,833.842333,833.863633,1,25015269,25015908,639,0.13437737853030796
8572,833.865533,834.0613,1,25015965,25021839,5874,0.12360770591856005
8573,834.0634,834.152533,1,25021902,25024575,2673,0.1990334481808987
8574,834.161433,834.175533,1,25024842,25025265,423,0.2786577114834706
8575,834.176833,834.1807,1,25025304,25025421,117,0.8618273828376615
8576,834.185167,834.213133,1,25025555,25026393,838,0.8373348833458324
8577,834.216167,834.2481,1,25026485,25027443,958,0.2082703692491259
8578,834.287933,834.344833,1,25028637,25030344,1707,0.5400529855378897
8579,834.3463,834.3728,1,25030389,25031184,795,0.3063907874828411
8580,834.380067,834.3846,1,25031402,25031538,136,0.6116883104119393
8581,834.388467,834.406167,1,25031654,25032185,531,0.47991146580759697
8582,834.4546,834.455167,1,25033638,25033655,17,0.9980953901514135
8583,834.474267,834.477633,1,25034228,25034328,100,0.8850484333319183
8584,834.479233,834.486033,1,25034376,25034580,204,0.4960468955471074
8585,834.515933,834.523767,1,25035477,25035713,236,0.8722821314475295
8586,834.6032,834.627733,1,25038096,25038831,735,0.2801868925178379
8587,834.630567,834.662533,1,25038917,25039875,958,0.20153488306980036
8588,834.6742,834.807,1,25040226,25044210,3984,0.08472974369397679
8589,834.812567,834.823533,1,25044377,25044705,328,0.30327170388365926
8590,834.824667,834.9109,1,25044740,25047327,2587,0.25360446053925123
8591,834.9122,834.9259,1,25047366,25047777,411,0.9241950038168394
8592,834.927767,834.933567,1,25047833,25048007,174,0.799251677489182
8593,834.946133,834.9792,1,25048383,25049376,993,0.8211298377972372
8594,834.980433,835.0045,1,25049412,25050135,723,0.7691682527192414
8595,835.019233,835.023533,1,25050576,25050705,129,0.9132922190443603
8596,835.0854,835.1093,1,25052562,25053279,717,0.7874002108065237
8597,835.112433,835.1206,1,25053372,25053618,246,0.8619711708573318
8598,835.1219,835.1265,1,25053657,25053795,138,0.6333870707974247
8599,835.1276,835.1369,1,25053828,25054107,279,0.7473872743577272
8600,835.140067,835.1456,1,25054202,25054368,166,0.6512982074007162
8601,835.148433,835.164667,1,25054452,25054940,488,0.9261069951511464
8602,835.1673,835.177833,1,25055019,25055334,315,0.8236760353634917
8603,835.215,835.220067,1,25056450,25056602,152,0.8324116638991887
8604,835.226767,835.231933,1,25056803,25056957,154,0.8646879091139343
8605,835.242433,835.245433,1,25057272,25057362,90,0.6066232770024961
8606,835.2466,835.257733,1,25057398,25057731,333,0.7556321402645451
8607,835.263033,835.269033,1,25057890,25058070,180,0.8212616767025672
8608,835.274833,835.277967,1,25058244,25058339,95,0.9143265618868458
8609,835.2793,835.286133,1,25058379,25058583,204,0.738058665606818
8610,835.287433,835.291633,1,25058622,25058748,126,0.8538958624104572
8611,835.298567,835.303333,1,25058957,25059099,142,0.9185609263458788
8612,835.3083,835.312067,1,25059249,25059362,113,0.5929458600574454
8613,835.326133,835.3302,1,25059783,25059906,123,0.8461699077189545
8614,835.339167,835.348333,1,25060175,25060449,274,0.8681318536932314
8615,835.349633,835.353,1,25060488,25060590,102,0.7463083093795091
8616,835.356167,835.362433,1,25060685,25060872,187,0.6600153435237853
8617,835.371267,835.374967,1,25061138,25061249,111,0.8891035179536143
8618,835.533867,835.5375,1,25066016,25066125,109,0.863436887538515
8619,835.543967,835.552167,1,25066319,25066565,246,0.8118473758780694
8620,835.5568,835.5636,1,25066704,25066908,204,0.7749755947580431
8621,835.5808,835.586867,1,25067424,25067606,182,0.7838056946558463
8622,835.5934,835.6113,1,25067802,25068339,537,0.44904622951078316
8623,835.750933,835.7646,1,25072527,25072938,411,0.43162495041618454
8624,836.3834,836.387533,1,25091502,25091625,123,0.3757740002044031
8625,837.473667,837.476933,1,25124210,25124307,97,0.8164609612284194
8626,837.479833,837.4834,1,25124394,25124502,108,0.885030684107285
8627,837.5562,837.5593,1,25126686,25126779,93,0.7902013647761541
8628,837.571467,837.574833,1,25127144,25127244,100,0.7565302495427645
8629,837.591033,837.594733,1,25127730,25127841,111,0.81918451615451
8630,837.630033,837.664267,1,25128900,25129928,1028,0.37399794218021637
8631,837.677067,837.680267,1,25130312,25130408,96,0.812549204243931
8632,837.682433,837.7164,1,25130472,25131492,1020,0.48550475780370533
8633,837.722667,837.793233,1,25131680,25133796,2116,0.3849678653238178
8634,838.0145,838.018833,1,25140435,25140564,129,0.7734634923702384
8635,838.029667,838.033933,1,25140890,25141017,127,0.5371405210039107
8636,838.751367,838.757533,1,25162541,25162725,184,0.8138190611707514
8637,838.762133,838.7661,1,25162863,25162983,120,0.9011553029818901
8638,843.651933,843.655733,1,25309557,25309671,114,0.8208020056262534
8639,843.683833,843.728833,1,25310514,25311864,1350,0.27724754748494423
8640,843.730467,843.7399,1,25311914,25312197,283,0.3744576051845198
8641,843.745133,843.7566,1,25312353,25312698,345,0.6008260546060856
8642,843.764133,843.781033,1,25312923,25313430,507,-0.10179973001471486
8643,843.8001,843.8353,1,25314003,25315059,1056,0.04106178511490053
8644,843.851233,843.854567,1,25315536,25315637,101,0.8913278284873688
8645,843.8795,843.8901,1,25316385,25316703,318,-0.014806486708376844
8646,843.891133,843.8958,1,25316733,25316874,141,0.8680051261644995
8647,843.9026,843.932167,1,25317078,25317965,887,0.6480988764684515
8648,843.9402,843.9554,1,25318206,25318662,456,0.4721153819584887
8649,843.9597,843.9676,1,25318791,25319028,237,0.5286684842470338
8650,843.990167,843.9976,1,25319705,25319928,223,0.4867749305987291
8651,843.9992,844.008467,1,25319976,25320254,278,0.5914588350030654
8652,844.011167,844.026233,1,25320335,25320786,451,0.5812606796965488
8653,844.028167,844.035533,1,25320845,25321065,220,0.8036923718663699
8654,844.052267,844.069133,1,25321568,25322073,505,0.8546282550634523
8655,844.071333,844.0778,1,25322139,25322334,195,0.7988569520909511
8656,844.094067,844.097467,1,25322822,25322924,102,0.9422785692658351
8657,844.142367,844.156,1,25324271,25324680,409,0.9019665035230443
8658,844.224367,844.227667,1,25326731,25326830,99,0.9556877663040939
8659,844.233333,844.2678,1,25326999,25328034,1035,0.3896798259680285
8660,844.269133,844.276933,1,25328073,25328307,234,0.7188475947461348
8661,844.2791,844.283633,1,25328373,25328508,135,0.7042471053335327
8662,844.293533,844.306033,1,25328805,25329180,375,0.4011503354309898
8663,844.308467,844.3333,1,25329254,25329999,745,0.21948285421432165
8664,844.339233,844.4052,1,25330176,25332156,1980,0.2713273491132902
8665,844.413733,844.417167,1,25332411,25332515,104,0.8525737271969591
8666,844.420567,844.424367,1,25332617,25332731,114,0.7034714802762247
8667,844.425867,844.4383,1,25332776,25333149,373,0.6995142559427094
8668,844.440333,844.449567,1,25333209,25333487,278,0.6468348068258921
8669,844.4613,844.480867,1,25333839,25334426,587,0.5363261782771106
8670,844.488267,844.498633,1,25334648,25334958,310,0.7230245698897423
8671,844.515233,844.5384,1,25335456,25336152,696,0.02525733336907938
8672,844.544267,844.561367,1,25336328,25336841,513,0.6571414304042307
8673,844.5819,844.602067,1,25337457,25338062,605,0.13627307414492773
8674,844.630433,844.6389,1,25338912,25339167,255,0.34232736329067365
8675,844.6426,844.6538,1,25339278,25339614,336,0.3294291277824147
8676,844.6551,844.681033,1,25339653,25340430,777,0.6645549805011847
8677,844.6852,844.697733,1,25340556,25340931,375,0.7666685325624039
8678,844.7004,844.7054,1,25341012,25341162,150,0.8156169457383012
8679,844.711667,844.742067,1,25341350,25342262,912,0.3706851212426546
8680,844.748333,844.756,1,25342449,25342680,231,0.6233092661791523
8681,844.7768,844.789533,1,25343304,25343685,381,0.295242313670995
8682,844.791533,844.8393,1,25343745,25345179,1434,0.5903359194297794
8683,844.845733,844.875233,1,25345371,25346256,885,0.20388274340853085
8684,844.902833,844.911567,1,25347084,25347347,263,0.18639423775981812
8685,844.9201,844.938833,1,25347603,25348164,561,0.027839318634133314
8686,844.9401,844.979467,1,25348203,25349384,1181,0.20974480065755594
8687,844.987,845.014133,1,25349610,25350423,813,0.39868934615941015
8688,845.0736,845.081267,1,25352208,25352438,230,0.17879205274054208
8689,845.094933,845.109933,1,25352847,25353297,450,0.7683123190431285
8690,845.113133,845.135267,1,25353393,25354058,665,0.5807589199379896
8691,845.1368,845.142967,1,25354104,25354289,185,0.6222616102413014
8692,845.1512,845.191167,1,25354536,25355735,1199,0.14903462694946842
8693,845.252467,845.259333,1,25357574,25357779,205,0.2152024078852267
8694,845.267867,845.2724,1,25358036,25358172,136,0.7964494732916878
8695,845.281767,845.289,1,25358453,25358670,217,0.6047152438399359
8696,845.292767,845.296667,1,25358783,25358900,117,0.26030217470928535
8697,845.876033,845.879067,1,25376280,25376372,92,0.622360306748671
8698,847.363133,847.509433,1,25420893,25425282,4389,0.15704067875033514
8699,847.512933,847.524167,1,25425387,25425725,338,0.38791410227482603
8700,847.534467,847.5907,1,25426034,25427721,1687,0.25870145171550224
8701,847.617233,847.716567,1,25428516,25431497,2981,0.18721212920764974
8702,848.3255,848.3399,1,25449765,25450197,432,0.07869414359878169
8703,848.380467,848.393167,1,25451414,25451795,381,0.15513754567112034
8704,848.395567,848.5841,1,25451867,25457523,5656,0.07561063916626296
8705,848.619267,848.7793,1,25458578,25463379,4801,0.15661834549167625
8706,848.791567,848.811333,1,25463747,25464339,592,0.14323309877247975
8707,848.816667,848.8199,1,25464500,25464597,97,0.5387185424337019
8708,848.8515,848.898167,1,25465545,25466945,1400,0.16642179607118632
8709,848.909933,848.937867,1,25467297,25468136,839,0.4857676239958652
8710,848.9608,849.000433,1,25468824,25470012,1188,0.1257110501599939
8711,849.024367,849.0452,1,25470731,25471356,625,0.2239991894942127
8712,849.046267,849.057633,1,25471388,25471728,340,0.841424712118648
8713,849.063033,849.067633,1,25471890,25472028,138,0.7075510717934009
8714,849.077167,849.0894,1,25472315,25472682,367,0.1400301455169263
8715,849.2596,849.270733,1,25477788,25478121,333,0.6282792700611307
8716,849.290367,849.299533,1,25478711,25478985,274,0.44469275512577744
8717,849.309033,849.3401,1,25479270,25480203,933,0.12824027406260308
8718,849.3496,849.3607,1,25480488,25480821,333,0.5272704096253761
8719,849.362,849.380567,1,25480860,25481417,557,0.21185380569348955
8720,849.483033,849.491,1,25484490,25484730,240,0.6800870616822345
8721,849.937267,849.941167,1,25498118,25498235,117,-0.027333000378429752
8722,850.648967,850.732067,1,25519469,25521962,2493,0.11340100037547513
8723,850.741633,850.793767,1,25522248,25523813,1565,0.47871626519003985
8724,850.8101,850.8475,1,25524303,25525425,1122,0.11399307371578625
8725,850.848767,850.852233,1,25525463,25525566,103,0.9476326698446177
8726,850.874333,850.892,1,25526229,25526760,531,0.2935897460712282
8727,850.8957,850.899333,1,25526871,25526979,108,0.7859292794207221
8728,850.9049,850.950867,1,25527147,25528526,1379,0.28413093495606107
8729,851.144667,851.149633,1,25534340,25534488,148,0.8769472008819698
8730,851.156167,851.163433,1,25534685,25534902,217,0.7157368529042087
8731,851.167667,851.173467,1,25535030,25535204,174,0.6822876657644992
8732,851.1758,851.181967,1,25535274,25535459,185,0.4964761717705334
8733,851.186967,851.198833,1,25535609,25535964,355,0.22685452788574753
8734,851.2032,851.212,1,25536096,25536360,264,0.577120688236443
8735,851.215567,851.2193,1,25536467,25536579,112,0.7378103225996827
8736,851.220367,851.230833,1,25536611,25536924,313,0.5207732355388147
8737,851.734067,851.814333,1,25552022,25554429,2407,0.1546759044282996
8738,851.815367,851.850333,1,25554461,25555509,1048,0.2995921279018876
8739,851.854067,851.8784,1,25555622,25556352,730,0.427124082322449
8740,851.8845,851.9002,1,25556535,25557006,471,0.1727051506884943
8741,851.908333,851.995167,1,25557249,25559855,2606,0.19916490127019162
8742,852.370967,852.447633,1,25571129,25573428,2299,0.13259303613886614
8743,852.448733,852.527,1,25573461,25575810,2349,0.25791494571105283
8744,852.534,852.670767,1,25576020,25580123,4103,0.19766450051822143
8745,853.1268,853.140267,1,25593804,25594208,404,0.18991417953998332
8746,853.148,853.165,1,25594440,25594950,510,0.0955693199490845
8747,853.1669,853.228267,1,25595007,25596848,1841,0.2811177552870217
8748,853.235967,853.2542,1,25597079,25597626,547,0.2767112074918471
8749,853.258133,853.266667,1,25597743,25598000,257,0.37575940606303626
8750,853.427167,853.475567,1,25602815,25604267,1452,0.6082084505103568
8751,854.659933,854.764233,1,25639797,25642926,3129,0.0033685484881738666
8752,854.7701,854.899667,1,25643103,25646990,3887,0.12216188898406045
8753,854.9358,854.963333,1,25648074,25648899,825,0.05987756308520965
8754,854.964867,854.977667,1,25648946,25649330,384,0.34178165743029604
8755,855.008233,855.0573,1,25650246,25651719,1473,0.1295234162971082
8756,855.246167,855.249333,1,25657385,25657479,94,0.5735199616442817
8757,856.360633,856.370933,1,25690818,25691127,309,0.21597888609071259
8758,856.374533,856.5654,1,25691235,25696962,5727,0.06414627832098176
8759,856.578567,856.5817,1,25697357,25697451,94,0.9609120598426274
8760,856.584533,856.605733,1,25697535,25698171,636,0.2040469836569278
8761,856.628833,856.735233,1,25698864,25702056,3192,0.08235644134532052
8762,856.7363,856.7428,1,25702089,25702284,195,0.20427723647876447
8763,856.755567,856.759967,1,25702667,25702799,132,0.461750032725554
8764,857.6999,857.745,1,25730997,25732350,1353,0.05116700677942972
8765,857.7486,857.821233,1,25732458,25734636,2178,0.16498746601564482
8766,857.823267,857.826667,1,25734698,25734800,102,0.7983056432645299
8767,857.858367,857.892567,1,25735751,25736777,1026,0.0731223530316177
8768,857.899633,857.935533,1,25736988,25738065,1077,0.19461117680786175
8769,857.963,858.0087,1,25738890,25740261,1371,0.16377689912820892
8770,858.1242,858.147433,1,25743726,25744422,696,0.36221906431046674
8771,858.1635,858.190967,1,25744905,25745729,824,0.25850687644917614
8772,858.192867,858.2252,1,25745786,25746756,970,0.31863521324055916
8773,858.241833,858.268333,1,25747254,25748049,795,0.49295732639584033
8774,858.2755,858.291233,1,25748265,25748736,471,0.3730434187410161
8775,858.3139,858.3466,1,25749417,25750398,981,0.40944705934609665
8776,858.3476,858.365433,1,25750428,25750962,534,0.47068056190250335
8777,858.370033,858.375333,1,25751100,25751259,159,0.7215250960524476
8778,858.3814,858.3865,1,25751442,25751595,153,0.8328088750903296
8779,858.392133,858.399633,1,25751763,25751988,225,0.8167407240763522
8780,858.428767,858.451567,1,25752863,25753547,684,0.6562217362252323
8781,858.457067,858.4611,1,25753712,25753833,121,0.7769707135038476
8782,858.6854,858.7435,1,25760562,25762305,1743,0.1344308196955244
8783,858.752667,858.761633,1,25762580,25762848,268,0.21681974696873138
8784,858.769167,858.947,1,25763075,25768410,5335,0.127647878205992
8785,858.948367,858.9753,1,25768451,25769259,808,0.17931806876964151
8786,858.9849,859.039367,1,25769547,25771181,1634,0.23145821684520476
8787,859.0471,859.075167,1,25771413,25772255,842,0.7842901850666181
8788,859.0938,859.098067,1,25772814,25772942,128,0.7988635327258996
8789,859.107233,859.1491,1,25773216,25774473,1257,0.3375765815825988
8790,859.150167,859.155167,1,25774505,25774655,150,0.8521588271666546
8791,859.1624,859.188433,1,25774872,25775652,780,0.0721337333860162
8792,859.1903,859.200367,1,25775709,25776011,302,0.12732456563501046
8793,859.236267,859.279067,1,25777088,25778372,1284,0.5275619415138966
8794,859.291833,859.2974,1,25778754,25778922,168,0.7988014891023628
8795,859.299,859.321167,1,25778970,25779635,665,0.5399769136097307
8796,859.628933,859.676067,1,25788867,25790282,1415,0.17201835368591023
8797,859.684967,859.690567,1,25790549,25790717,168,0.6181745963894805
8798,859.692267,859.6971,1,25790768,25790913,145,0.4189779203441256
8799,859.698833,859.720833,1,25790964,25791624,660,0.2094357364227752
8800,859.722067,859.743167,1,25791662,25792295,633,0.07420102463940263
8801,859.749833,859.818,1,25792494,25794540,2046,0.119312014204005
8802,859.838933,859.843967,1,25795167,25795319,152,0.6978048728581286
8803,859.8473,859.923833,1,25795419,25797714,2295,0.30307352077191296
8804,859.929333,859.938867,1,25797879,25798166,287,0.0003210561821903172
8805,859.9493,859.9527,1,25798479,25798581,102,0.008985263514261743
8806,859.969933,859.977033,1,25799097,25799310,213,0.4892491815095201
8807,859.9822,859.9876,1,25799466,25799628,162,0.8701001062687023
8808,859.9886,860.015267,1,25799658,25800458,800,0.5388292251625724
8809,860.029267,860.063567,1,25800878,25801907,1029,0.3037114763944841
8810,860.401133,860.404433,1,25812033,25812132,99,0.7116735236644413
8811,860.426467,860.448567,1,25812794,25813457,663,0.429554972816095
8812,860.750667,860.853933,1,25822520,25825617,3097,0.14824545959413396
8813,860.8577,860.9,1,25825731,25827000,1269,0.16639775830572148
8814,860.913433,860.923967,1,25827402,25827719,317,0.634427247150256
8815,860.934967,860.9464,1,25828049,25828392,343,0.3479502309546784
8816,860.9527,860.956067,1,25828581,25828682,101,0.7329692247150774
8817,860.966767,860.9761,1,25829003,25829283,280,0.15231243209539908
8818,860.990467,861.009167,1,25829714,25830275,561,0.32020739543119714
8819,861.0142,861.097733,1,25830426,25832931,2505,0.3054451464338951
8820,861.1047,861.1083,1,25833141,25833249,108,0.8355885328168328
8821,861.5989,861.616133,1,25847967,25848483,516,0.0721967914504843
8822,861.6174,861.695733,1,25848522,25850871,2349,0.09270032378773718
8823,861.696833,861.7595,1,25850904,25852785,1881,0.2856656628886595
8824,861.770733,861.808333,1,25853121,25854249,1128,0.15850647753676952
8825,861.811467,861.8983,1,25854344,25856949,2605,0.17795100768136027
8826,861.907767,861.933967,1,25857233,25858019,786,0.16289742266432142
8827,861.9487,861.9537,1,25858461,25858611,150,0.7618228424507688
8828,862.1947,862.204433,1,25865841,25866132,291,0.09610569487807709
8829,862.205667,862.2927,1,25866170,25868781,2611,0.1764744895694135
8830,862.294167,862.2996,1,25868825,25868988,163,0.8987907865060596
8831,862.305467,862.3114,1,25869164,25869342,178,0.8596257057027857
8832,862.313467,862.316767,1,25869404,25869503,99,0.894883244928449
8833,862.3431,862.408733,1,25870293,25872261,1968,0.13028524863649618
8834,862.412567,862.520467,1,25872377,25875614,3237,0.10491066369603426
8835,862.535667,862.557733,1,25876070,25876731,661,0.061035829500737604
8836,862.559167,862.5973,1,25876775,25877919,1144,0.23142704150836735
8837,862.624133,862.635133,1,25878723,25879053,330,0.7225399378753403
8838,862.636167,862.6863,1,25879085,25880589,1504,0.360100558273226
8839,862.744433,862.749633,1,25882332,25882488,156,0.7732309049576287
8840,862.754633,862.819367,1,25882638,25884581,1943,0.2019634581291879
8841,862.856833,862.939133,1,25885704,25888173,2469,0.1559787252265045
8842,862.940267,863.0248,1,25888208,25890744,2536,0.19364558741431434
8843,863.025933,863.029067,1,25890777,25890872,95,0.9414104997529501
8844,863.036933,863.0632,1,25891107,25891896,789,0.567005737718375
8845,863.648867,863.7344,1,25909466,25912032,2566,0.12408902892406458
8846,863.735867,863.843333,1,25912076,25915299,3223,0.12886186935922872
8847,863.8546,863.876067,1,25915638,25916282,644,0.1355376751023307
8848,863.897567,863.9068,1,25916927,25917204,277,0.3761123211345794
8849,863.913767,863.994633,1,25917413,25919838,2425,0.34958039661434576
8850,865.247867,865.343133,1,25957436,25960293,2857,0.1804128023702597
8851,865.3516,865.395933,1,25960548,25961877,1329,0.23174635026806067
8852,865.401267,865.406533,1,25962038,25962195,157,0.9191873376480201
8853,865.408033,865.547933,1,25962240,25966437,4197,0.19020592264744077
8854,865.555533,865.5591,1,25966665,25966773,108,0.9466633346738921
8855,865.581867,865.6089,1,25967456,25968267,811,0.34071396253891045
8856,866.111467,866.121467,1,25983344,25983644,300,0.11182268926639663
8857,866.1286,866.200533,1,25983858,25986015,2157,0.17821881853604024
8858,866.2029,866.217767,1,25986087,25986533,446,0.3329698112991617
8859,866.2349,866.243767,1,25987047,25987313,266,0.8923051663385517
8860,866.245133,866.258,1,25987353,25987740,387,0.2905179809694256
8861,866.259033,866.293667,1,25987770,25988810,1040,0.26846571511249834
8862,866.301333,866.4168,1,25989039,25992504,3465,0.1463590425455814
8863,866.4267,866.448433,1,25992801,25993452,651,0.20539593067717457
8864,866.546333,866.562167,1,25996389,25996865,476,0.5549472119449125
8865,866.590567,866.6047,1,25997717,25998141,424,0.24861676502720081
8866,866.7339,866.799767,1,26002017,26003993,1976,0.7341725695841058
8867,866.8678,867.3073,1,26006034,26019219,13185,0.731963757221267
8868,867.309467,867.360533,1,26019284,26020815,1531,0.722847451755422
8869,867.370933,867.374267,1,26021127,26021228,101,0.8276470711018912
8870,867.597167,867.676167,1,26027915,26030285,2370,0.14514377891095037
8871,867.679533,867.7362,1,26030385,26032086,1701,0.20034261752662616
8872,867.756267,867.854067,1,26032688,26035622,2934,0.11374179737294285
8873,867.8698,867.954467,1,26036094,26038634,2540,0.19905818828715632
8874,867.9666,868.001467,1,26038998,26040044,1046,0.10894503630401077
8875,868.005733,868.050033,1,26040171,26041500,1329,0.0908041947799395
8876,868.0601,868.119467,1,26041803,26043584,1781,0.13892685268381721
8877,868.217833,868.221033,1,26046534,26046630,96,0.9481863000277535
8878,868.239333,868.2638,1,26047179,26047914,735,0.31083117088930096
8879,868.2673,868.2707,1,26048019,26048121,102,0.8343586571558013
8880,868.2911,868.37,1,26048733,26051100,2367,0.10697987643484118
8881,868.377,868.386233,1,26051310,26051586,276,0.407301362278089
8882,868.390733,868.397967,1,26051721,26051939,218,0.47786443362163145
8883,868.406433,868.443567,1,26052192,26053307,1115,0.09092484321601473
8884,868.444567,868.45,1,26053337,26053500,163,0.6726791428892813
8885,868.4511,868.468367,1,26053533,26054051,518,0.6136993882967668
8886,868.4695,868.530367,1,26054085,26055911,1826,0.2446243136943779
8887,868.535867,868.5753,1,26056076,26057259,1183,0.4403385991331658
8888,868.5763,868.5816,1,26057289,26057448,159,0.76559905182902
8889,868.589933,868.6099,1,26057697,26058297,600,0.20120781886135453
8890,868.610967,868.671833,1,26058329,26060154,1825,0.49817466989330317
8891,868.6789,868.7613,1,26060367,26062839,2472,0.5217857936570678
8892,868.763433,868.9608,1,26062902,26068824,5922,0.28485435921118046
8893,868.968067,869.0079,1,26069042,26070237,1195,0.2444855987781762
8894,869.0148,869.0403,1,26070444,26071209,765,0.2842269848579209
8895,869.044267,869.085967,1,26071328,26072579,1251,0.45403689621784726
8896,869.091267,869.127,1,26072738,26073810,1072,0.3418637758646561
8897,869.149,869.156733,1,26074470,26074701,231,0.519847827770552
8898,869.1789,869.1888,1,26075367,26075664,297,0.20917389814073856
8899,869.1903,869.198033,1,26075709,26075940,231,0.7529147670701952
8900,869.2618,869.2769,1,26077854,26078307,453,0.6090009029699
8901,869.373067,869.380233,1,26081192,26081406,214,0.3716065679566949
8902,869.3831,869.390533,1,26081493,26081715,222,0.6068684192887552
8903,869.391533,869.417033,1,26081745,26082510,765,0.678750608569055
8904,869.439967,869.459667,1,26083199,26083790,591,0.7102139842067827
8905,869.648167,869.6513,1,26089445,26089539,94,0.8035048148059629
8906,869.661033,869.778367,1,26089830,26093351,3521,0.35317718008022386
8907,869.789367,869.8158,1,26093681,26094474,793,0.013143390230513316
8908,869.823667,869.8375,1,26094710,26095125,415,0.14690901137495085
8909,869.839,869.857067,1,26095170,26095712,542,0.3985681938665029
8910,869.859033,869.866067,1,26095770,26095982,212,0.7684249952707373
8911,869.872333,869.892767,1,26096169,26096783,614,0.12118520622359781
8912,869.8972,869.947933,1,26096916,26098437,1521,0.3310411401555439
8913,869.958967,869.967433,1,26098769,26099022,253,-0.034408141370480504
8914,869.987433,869.991233,1,26099622,26099736,114,0.8426917717268007
8915,869.994233,870.0053,1,26099826,26100159,333,0.4530238182005726
8916,870.0064,870.010733,1,26100192,26100321,129,0.7372630277317207
8917,870.022667,870.052633,1,26100680,26101578,898,0.13613576786937415
8918,870.086633,870.102067,1,26102598,26103062,464,0.2373418954174471
8919,870.104933,870.115467,1,26103147,26103464,317,0.35891134813776
8920,870.149267,870.153033,1,26104478,26104590,112,0.8315532857269418
8921,870.266367,870.273233,1,26107991,26108196,205,0.7779462020466027
8922,870.276767,870.309,1,26108303,26109270,967,0.5981780628707226
8923,870.317467,870.323833,1,26109524,26109714,190,0.44982964608212417
8924,870.339633,870.344133,1,26110188,26110323,135,0.5584211776306006
8925,870.345233,870.3484,1,26110356,26110452,96,0.2735972998749013
8926,870.350367,870.361367,1,26110511,26110841,330,0.7565041653076094
8927,870.380367,870.397667,1,26111411,26111930,519,0.4735060907586808
8928,870.401667,870.408733,1,26112050,26112261,211,0.42122141385449463
8929,870.4249,870.436067,1,26112747,26113082,335,0.5021768998544806
8930,870.465733,870.471667,1,26113971,26114150,179,0.6258383270811853
8931,870.5246,870.529033,1,26115738,26115870,132,0.6272650754076017
8932,870.545667,870.5516,1,26116370,26116548,178,0.45776585145463994
8933,870.555267,870.6317,1,26116658,26118951,2293,0.20508121994298617
8934,870.648767,870.652,1,26119463,26119560,97,0.6204585801893542
8935,870.653367,870.6711,1,26119601,26120133,532,0.7240045149526378
8936,870.691767,870.773767,1,26120753,26123213,2460,0.21747538128170044
8937,870.7755,870.7829,1,26123265,26123487,222,0.24452311835535936
8938,870.8255,870.828533,1,26124765,26124855,90,0.3396164818219376
8939,870.830133,870.845633,1,26124903,26125368,465,0.39639001536517127
8940,870.889833,870.902667,1,26126694,26127080,386,0.6417316642036872
8941,871.3789,871.386267,1,26141367,26141588,221,0.4204392390765108
8942,871.430267,871.491933,1,26142908,26144757,1849,0.22441260736340476
8943,871.500033,871.720533,1,26145000,26151615,6615,0.22079542203830096
8944,871.727,871.769,1,26151810,26153070,1260,0.24289573751958937
8945,871.7712,871.814667,1,26153136,26154440,1304,0.20688083326862994
8946,871.818267,871.8213,1,26154548,26154639,91,0.8107604825306888
8947,871.848933,871.881267,1,26155467,26156438,971,0.25672218092425214
8948,871.890133,871.925267,1,26156703,26157758,1055,0.11512039742066074
8949,871.949333,871.9869,1,26158479,26159607,1128,0.1370474825551003
8950,871.996667,872.000567,1,26159900,26160017,117,0.904626697744841
8951,872.002733,872.036733,1,26160081,26161101,1020,0.3059208085086958
8952,872.718,872.8736,1,26181540,26186208,4668,0.11919628544044666
8953,872.875033,872.878667,1,26186250,26186360,110,0.8841493168001067
8954,872.8911,873.025433,1,26186733,26190762,4029,0.14176906565300523
8955,873.035167,873.0782,1,26191055,26192346,1291,0.15916980680651485
8956,873.095133,873.1087,1,26192853,26193261,408,0.3432019938517955
8957,873.436133,873.518233,1,26203083,26205546,2463,0.2730339606257212
8958,873.519333,873.674567,1,26205579,26210237,4658,0.08545245724097929
8959,873.6774,873.713133,1,26210322,26211393,1071,0.29827526819579303
8960,873.717667,873.724933,1,26211530,26211747,217,0.2721207543877457
8961,873.7521,873.795367,1,26212563,26213861,1298,0.45290957856845027
8962,873.7994,873.8075,1,26213982,26214225,243,0.504006804858484
8963,873.808967,873.844733,1,26214269,26215341,1072,0.20625046331858607
8964,873.924867,873.929833,1,26217746,26217894,148,0.8545863774755519
8965,873.931633,873.966267,1,26217948,26218988,1040,0.20691054320198402
8966,873.9698,873.988733,1,26219094,26219661,567,0.3609462625743258
8967,873.9925,874.004967,1,26219775,26220149,374,0.5986780680174771
8968,874.0079,874.084267,1,26220237,26222528,2291,0.1299184149131809
8969,874.1302,874.169967,1,26223906,26225099,1193,0.07359312687274283
8970,874.189433,874.2091,1,26225682,26226273,591,0.12999189263724692
8971,874.222133,874.242833,1,26226663,26227284,621,0.04224180343121035
8972,874.250333,874.282233,1,26227509,26228466,957,0.16907286420999354
8973,874.322333,874.354833,1,26229669,26230644,975,0.35387466656426714
8974,874.3585,874.3659,1,26230755,26230977,222,0.8980153762850541
8975,874.370867,874.388533,1,26231126,26231655,529,0.26749062663731354
8976,874.398133,874.407733,1,26231943,26232231,288,0.3513199984766695
8977,874.532367,874.556133,1,26235971,26236683,712,0.048853689203259866
8978,874.558267,874.6193,1,26236748,26238579,1831,0.2062745806773168
8979,874.6251,874.637333,1,26238753,26239119,366,0.14434321974648529
8980,874.638767,874.656467,1,26239163,26239694,531,0.1457432810043756
8981,874.658033,874.685533,1,26239740,26240565,825,0.1980833343582122
8982,874.6869,874.719833,1,26240607,26241594,987,0.12443819353021308
8983,874.743333,874.792633,1,26242299,26243778,1479,0.1407905889266953
8984,874.796533,874.879633,1,26243895,26246388,2493,0.16504464055284704
8985,874.927933,874.961533,1,26247837,26248845,1008,0.13530764617243238
8986,874.974267,874.995,1,26249228,26249850,622,0.11108479589163492
8987,875.016733,875.0682,1,26250501,26252046,1545,0.017906970274335153
8988,875.090433,875.112867,1,26252712,26253386,674,0.17484550142989233
8989,875.151567,875.196333,1,26254547,26255889,1342,0.2675371560478496
8990,875.2076,875.211133,1,26256228,26256333,105,0.6074033221130433
8991,875.231933,875.2436,1,26256957,26257308,351,0.5738915833020785
8992,875.2473,875.251933,1,26257419,26257557,138,0.826447926571936
8993,875.273133,875.276533,1,26258193,26258295,102,0.7124558584701318
8994,875.277533,875.295733,1,26258325,26258871,546,0.0459367342991026
8995,875.357,875.3682,1,26260710,26261046,336,0.8306311761147203
8996,875.376633,875.379867,1,26261298,26261396,98,0.7253080318868227
8997,875.4672,875.479767,1,26264016,26264393,377,0.47555024459332107
8998,875.482467,875.493033,1,26264474,26264790,316,0.2095699547475444
8999,875.499433,875.566567,1,26264982,26266997,2015,0.3052690651262902
9000,875.580367,875.5879,1,26267411,26267637,226,0.437189032950535
9001,875.589267,875.5991,1,26267678,26267973,295,0.6422479651414741
9002,875.600267,875.669833,1,26268008,26270094,2086,0.39196940630121
9003,875.684233,875.6919,1,26270526,26270757,231,0.46970735479308484
9004,875.6962,875.7496,1,26270886,26272488,1602,0.44342373380415095
9005,875.753567,875.7741,1,26272607,26273223,616,0.25189972263356025
9006,875.776833,875.788633,1,26273304,26273658,354,0.4739913814113662
9007,875.8011,875.812733,1,26274033,26274381,348,0.5889760552319999
9008,875.8176,875.821233,1,26274528,26274636,108,0.9369236798053181
9009,875.8229,875.910867,1,26274687,26277326,2639,0.27559311683587395
9010,875.9228,875.931133,1,26277684,26277933,249,0.6440264079220552
9011,875.938967,875.945567,1,26278169,26278367,198,0.3878945576324293
9012,875.946933,875.9887,1,26278407,26279661,1254,0.39437501293799476
9013,875.994667,876.020333,1,26279840,26280609,769,0.3069117490819828
9014,876.0225,876.042167,1,26280675,26281265,590,0.7303298114426194
9015,876.0433,876.048067,1,26281299,26281442,143,0.8175924892585301
9016,876.080667,876.084533,1,26282420,26282535,115,0.6222147410174447
9017,876.0863,876.118533,1,26282589,26283555,966,0.5734396917879327
9018,876.1197,876.126633,1,26283591,26283798,207,0.7678974710013833
9019,876.127833,876.130833,1,26283834,26283924,90,0.7892883412798605
9020,876.146033,876.1736,1,26284380,26285208,828,0.5420456576213452
9021,878.548,878.556833,1,26356440,26356704,264,0.7400518379265006
9022,878.5615,878.576767,1,26356845,26357303,458,0.33066411063295814
9023,878.5813,878.611867,1,26357439,26358356,917,0.43543382013620446
9024,878.6156,878.625633,1,26358468,26358768,300,0.6528489816690688
9025,878.653067,878.686933,1,26359592,26360607,1015,0.5237115124348852
9026,878.688633,878.700567,1,26360658,26361017,359,0.863366271390158
9027,878.708767,878.809967,1,26361263,26364299,3036,0.2311461824041789
9028,878.845267,878.848933,1,26365358,26365467,109,0.8459834243947056
9029,879.074633,879.075733,1,26372238,26372271,33,0.9953559978941643
9030,880.006633,880.0102,1,26400198,26400306,108,0.5572748985430099
9031,880.0133,880.029467,1,26400399,26400884,485,-0.020625194784170162
9032,880.109633,880.1184,1,26403288,26403552,264,0.10130816485629038
9033,880.377133,880.383567,1,26411313,26411507,194,0.5583498495895236
9034,881.447667,881.594233,1,26443430,26447826,4396,0.1807575472124406
9035,881.596567,881.680567,1,26447897,26450417,2520,0.09128472050295648
9036,881.682333,881.701967,1,26450469,26451059,590,0.21751289637149052
9037,881.724033,881.745167,1,26451720,26452355,635,0.0448650163454699
9038,881.7547,881.773533,1,26452641,26453205,564,0.03396027253637653
9039,881.7833,881.7932,1,26453499,26453796,297,0.1371678754633039
9040,881.8057,881.8207,1,26454171,26454621,450,0.21052966725607306
9041,881.838967,881.862,1,26455169,26455860,691,0.32160240668343054
9042,881.906667,881.952367,1,26457200,26458571,1371,0.128319991615207
9043,881.984967,881.9975,1,26459549,26459925,376,0.7477989141792563
9044,882.007833,882.017067,1,26460234,26460512,278,0.731089524408612
9045,882.029467,882.035667,1,26460884,26461070,186,0.5824503067922393
9046,882.7138,882.7714,1,26481414,26483142,1728,0.11902415627498267
9047,882.784567,882.7927,1,26483537,26483781,244,0.33019026975652455
9048,882.7972,882.8753,1,26483916,26486259,2343,0.02996265239474486
9049,882.877433,882.8971,1,26486322,26486913,591,0.5452738248765658
9050,882.945467,882.996267,1,26488364,26489888,1524,0.15677586692967196
9051,883.0115,883.015333,1,26490345,26490459,114,0.8851154736652381
9052,883.019833,883.025067,1,26490594,26490752,158,0.6311710432361886
9053,883.0306,883.057367,1,26490918,26491721,803,0.43664804237677224
9054,883.059133,883.124133,1,26491773,26493723,1950,0.15380305899783267
9055,883.168267,883.1725,1,26495048,26495175,127,0.9233653355818674
9056,883.1837,883.202033,1,26495511,26496060,549,0.5045249860589985
9057,883.2058,883.210633,1,26496174,26496318,144,-0.027743531516960258
9058,883.241567,883.249933,1,26497247,26497497,250,0.9025208300007902
9059,883.374467,883.383733,1,26501234,26501511,277,0.024955007851729407
9060,883.389367,883.427033,1,26501681,26502810,1129,0.26976541772374607
9061,883.448767,883.4522,1,26503463,26503566,103,0.44088504487929087
9062,883.460933,883.480833,1,26503827,26504424,597,0.3064300197159039
9063,883.4824,883.5071,1,26504472,26505213,741,-0.019760103211328834
9064,883.509933,883.5749,1,26505297,26507247,1950,0.3153274250897148
9065,883.5763,883.598033,1,26507289,26507940,651,0.5627138911266321
9066,883.611033,883.614033,1,26508330,26508420,90,0.8691002675483015
9067,883.6189,883.6231,1,26508567,26508693,126,0.5805786377587551
9068,883.625933,883.663933,1,26508777,26509917,1140,0.39716255477561324
9069,883.666967,883.704833,1,26510009,26511144,1135,0.17252576395149513
9070,883.710333,883.762633,1,26511309,26512878,1569,0.3078859412971607
9071,883.7679,883.814433,1,26513037,26514432,1395,0.6385398837691258
9072,883.8156,883.822667,1,26514468,26514680,212,0.8871483073906352
9073,883.873733,883.904367,1,26516211,26517131,920,0.5232091401637254
9074,883.906733,883.913633,1,26517201,26517408,207,0.919548605991568
9075,883.945467,883.951033,1,26518364,26518530,166,0.8349189706931011
9076,883.9832,884.001133,1,26519496,26520033,537,0.30178580048257625
9077,884.002733,884.018133,1,26520081,26520543,462,0.21973976732641504
9078,884.02,884.046133,1,26520600,26521383,783,0.24994489207372805
9079,884.1359,884.1496,1,26524077,26524488,411,0.8267276065898902
9080,884.160467,884.192433,1,26524814,26525772,958,0.8113663617996267
9081,884.195867,884.199967,1,26525876,26525999,123,0.8028847846820961
9082,884.209333,884.2301,1,26526279,26526903,624,0.8058611259573691
9083,884.2353,884.262167,1,26527059,26527865,806,0.75020138956564
9084,884.291,884.295033,1,26528730,26528850,120,0.7151779853139697
9085,884.306467,884.319533,1,26529194,26529585,391,0.8244936073274102
9086,884.3229,884.329933,1,26529687,26529897,210,0.760589697524874
9087,884.344533,884.347933,1,26530335,26530437,102,0.870503559639438
9088,884.349567,884.4289,1,26530487,26532867,2380,0.5280960283468124
9089,884.4894,884.493167,1,26534682,26534795,113,0.9134086312290557
9090,884.495433,884.5372,1,26534862,26536116,1254,0.6144109399133536
9091,884.735967,884.743767,1,26542079,26542313,234,0.9177032804720247
9092,884.782467,884.7866,1,26543474,26543598,124,0.7625470867843873
9093,884.787867,884.8053,1,26543636,26544159,523,0.7774415352073639
9094,884.806433,884.812667,1,26544192,26544380,188,0.5034673136835305
9095,884.813733,884.817967,1,26544411,26544539,128,0.6830861620289095
9096,884.889033,884.892067,1,26546670,26546762,92,0.9139389153836401
9097,884.894533,884.8984,1,26546835,26546952,117,0.8786216139981762
9098,884.994233,884.997333,1,26549826,26549919,93,0.8311396039109757
9099,885.0287,885.072033,1,26550861,26552160,1299,0.6141944736129443
9100,885.073733,885.0769,1,26552211,26552307,96,0.8074179810103483
9101,885.0786,885.083833,1,26552358,26552514,156,0.7313942420893094
9102,885.085167,885.098533,1,26552555,26552955,400,0.3875636136812947
9103,885.1108,885.120633,1,26553324,26553618,294,0.7022713582137815
9104,885.122033,885.1357,1,26553660,26554071,411,0.788336670041844
9105,885.137233,885.169,1,26554116,26555070,954,0.778640181887591
9106,885.185267,885.1911,1,26555558,26555733,175,0.7990582054179167
9107,885.1996,885.2032,1,26555988,26556096,108,0.7881256119742727
9108,885.2109,885.214033,1,26556327,26556420,93,0.9418755582631158
9109,885.2299,885.2725,1,26556897,26558175,1278,0.8224178303194043
9110,885.355267,885.362067,1,26560658,26560862,204,0.21192621904644765
9111,885.3826,885.4021,1,26561478,26562063,585,0.8191109391025279
9112,885.461167,885.5125,1,26563835,26565375,1540,0.7873088423296783
9113,885.613633,885.647633,1,26568408,26569428,1020,0.5600117704157414
9114,885.6674,885.676267,1,26570022,26570288,266,0.8174349010062344
9115,885.677967,885.683467,1,26570339,26570504,165,0.8508254531628451
9116,885.7411,885.7532,1,26572233,26572596,363,0.7363683180811404
9117,885.7542,885.7587,1,26572626,26572761,135,0.6587264765211904
9118,885.816733,885.8224,1,26574501,26574672,171,0.8538180326581716
9119,885.8567,885.860467,1,26575701,26575814,113,0.8285157414857598
9120,885.861467,885.864667,1,26575844,26575940,96,0.8897476342436601
9121,885.8658,885.871733,1,26575974,26576151,177,0.6719822081426051
9122,885.902833,885.914933,1,26577084,26577447,363,0.7975448102064717
9123,885.944633,885.948067,1,26578338,26578442,104,0.9274602141624818
9124,885.990733,886.014833,1,26579721,26580444,723,0.5697886040411347
9125,886.021633,886.032033,1,26580648,26580960,312,0.7528248492349104
9126,886.063967,886.068467,1,26581919,26582054,135,0.7264298014032136
9127,886.070767,886.084667,1,26582123,26582540,417,0.1986229512317346
9128,886.1227,886.139967,1,26583681,26584199,518,0.8869714250583962
9129,886.141667,886.145733,1,26584250,26584371,121,0.8844780466287748
9130,886.1471,886.152467,1,26584413,26584574,161,0.8394219321995096
9131,886.194867,886.200133,1,26585846,26586003,157,0.9670319132028989
9132,886.201167,886.209833,1,26586035,26586294,259,0.8310150457857833
9133,886.220667,886.228333,1,26586620,26586849,229,0.5152155317278573
9134,886.229733,886.234167,1,26586891,26587025,134,0.695242554159896
9135,886.235433,886.243767,1,26587062,26587313,251,0.8451490901938282
9136,886.245267,886.248333,1,26587358,26587449,91,0.8048433533933457
9137,886.2524,886.3044,1,26587572,26589132,1560,0.5231354459173218
9138,886.306033,886.327267,1,26589180,26589818,638,0.9058369434140868
9139,886.3367,886.3495,1,26590101,26590485,384,0.905647353384734
9140,886.3674,886.3756,1,26591022,26591268,246,0.48561421304117314
9141,886.397267,886.418033,1,26591918,26592540,622,0.2844312372440895
9142,886.436767,886.451467,1,26593103,26593544,441,0.82714863237176
9143,886.4531,886.480267,1,26593593,26594408,815,0.630420166351076
9144,886.484967,886.488367,1,26594549,26594651,102,0.3357883479556255
9145,886.489367,886.506867,1,26594681,26595206,525,0.881460787196619
9146,886.512867,886.528133,1,26595386,26595843,457,0.8586292795322933
9147,886.549633,886.5635,1,26596488,26596905,417,0.7757951366121909
9148,886.579433,886.584367,1,26597382,26597531,149,0.6356757966714983
9149,886.764367,886.770567,1,26602931,26603117,186,0.8664252019813192
9150,886.7906,886.806133,1,26603718,26604183,465,0.24414659314629564
9151,886.8073,886.810333,1,26604219,26604309,90,0.9234148810433759
9152,886.824733,886.828433,1,26604741,26604852,111,0.8908306517171013
9153,886.8419,886.8449,1,26605257,26605347,90,0.7104380591006509
9154,886.892633,886.897367,1,26606778,26606921,143,0.4856725719603214
9155,886.940933,886.9498,1,26608227,26608494,267,0.6739350726307527
9156,887.1093,887.1218,1,26613279,26613654,375,0.8256690778505302
9157,887.143633,887.149033,1,26614308,26614470,162,0.8552724271627339
9158,887.1784,887.187033,1,26615352,26615610,258,0.38680044039773115
9159,887.196667,887.212967,1,26615900,26616389,489,0.3604383325165764
9160,887.216767,887.2211,1,26616503,26616633,130,0.7845544933258775
9161,887.226,887.232033,1,26616780,26616960,180,0.8692971972879635
9162,887.2843,887.292367,1,26618529,26618771,242,0.8044576447527215
9163,887.2989,887.304367,1,26618967,26619131,164,0.8220630520522567
9164,887.305867,887.316567,1,26619176,26619497,321,0.6664315331336367
9165,887.3178,887.321067,1,26619534,26619632,98,0.8961051842843684
9166,887.327267,887.332433,1,26619818,26619972,154,0.8707609052121617
9167,887.3636,887.400433,1,26620908,26622012,1104,0.6762225158156178
9168,887.401933,887.406567,1,26622057,26622197,140,0.8191447901487539
9169,887.4126,887.4166,1,26622378,26622498,120,0.9382343667608564
9170,887.446333,887.449567,1,26623389,26623487,98,0.650573018650485
9171,887.478633,887.4825,1,26624358,26624475,117,0.5073254696597324
9172,887.513667,887.5269,1,26625410,26625807,397,0.659378819790545
9173,887.533633,887.546633,1,26626008,26626398,390,0.8184335325997659
9174,887.5485,887.554867,1,26626455,26626646,191,0.17921817017139552
9175,887.7896,887.800567,1,26633688,26634017,329,0.8351160144894809
9176,887.8027,887.806733,1,26634081,26634201,120,0.652111247109406
9177,887.809567,887.891933,1,26634287,26636757,2470,0.6684632332412986
9178,888.016333,888.019433,1,26640489,26640582,93,0.018653326854376078
9179,888.026567,888.0334,1,26640797,26641002,205,0.8571408677204226
9180,888.0344,888.068267,1,26641032,26642048,1016,0.7587315659849911
9181,888.093933,888.099467,1,26642817,26642984,167,0.8478714150415669
9182,888.124,888.1457,1,26643720,26644371,651,0.7096040469722161
9183,888.1476,888.153467,1,26644428,26644604,176,0.7733778315459032
9184,888.174367,888.1798,1,26645231,26645394,163,0.7808387261329338
9185,888.181233,888.184433,1,26645436,26645532,96,0.8405676859271789
9186,888.1858,888.2009,1,26645574,26646027,453,0.5739489427217149
9187,888.205733,888.216867,1,26646171,26646506,335,0.85600112011209
9188,888.218233,888.240367,1,26646546,26647211,665,0.7252038563867661
9189,888.254233,888.2899,1,26647626,26648697,1071,0.7253472688522578
9190,888.329333,888.3409,1,26649879,26650227,348,0.034384169253507416
9191,888.4177,888.422133,1,26652531,26652663,132,0.866953395581048
9192,888.640567,888.6575,1,26659217,26659725,508,0.2722093340733053
9193,888.824933,888.829933,1,26664747,26664897,150,-0.23746413120385185
9194,888.864667,888.871633,1,26665940,26666148,208,0.06014672451342961
9195,888.875167,888.879,1,26666255,26666370,115,0.4247494803847612
9196,888.882433,888.8858,1,26666472,26666574,102,0.8163504559021485
9197,888.9152,888.931467,1,26667456,26667944,488,0.2265396730871245
9198,888.989233,888.993233,1,26669676,26669796,120,0.40686059003598546
9199,888.9943,889.006567,1,26669829,26670197,368,0.7548637844578263
9200,889.132867,889.136167,1,26673986,26674085,99,-0.006541459728065456
9201,889.282867,889.289067,1,26678486,26678672,186,0.1768998016763809
9202,889.867367,889.8719,1,26696021,26696157,136,0.887548622014913
9203,889.876333,889.900567,1,26696289,26697017,728,0.47179434414282
9204,889.911533,889.939433,1,26697345,26698182,837,0.5768166481319386
9205,889.996167,890.014367,1,26699885,26700431,546,0.42334795752984794
9206,890.024267,890.029567,1,26700728,26700887,159,0.8154214908526906
9207,890.035567,890.058067,1,26701067,26701742,675,0.574020969208585
9208,890.0727,890.092567,1,26702181,26702777,596,0.7392907008361355
9209,890.126433,890.157467,1,26703792,26704724,932,0.2412444323906467
9210,890.158633,890.194333,1,26704758,26705829,1071,0.24295713952172107
9211,890.1971,890.2127,1,26705913,26706381,468,0.6963889287352408
9212,890.291967,890.327933,1,26708759,26709837,1078,0.2020224428337249
9213,890.329633,890.379333,1,26709888,26711379,1491,0.46578696853983337
9214,890.382567,890.394067,1,26711477,26711822,345,0.5254152078999524
9215,890.398033,890.494533,1,26711940,26714835,2895,0.3033620636519707
9216,890.519067,890.554567,1,26715572,26716637,1065,0.4448524224146327
9217,890.566,890.582233,1,26716980,26717466,486,0.20099924195993707
9218,890.6234,890.6514,1,26718702,26719542,840,0.23289474518165404
9219,890.6562,890.661467,1,26719686,26719844,158,0.8265242283113682
9220,890.677867,890.692367,1,26720336,26720771,435,0.17360602199920666
9221,890.751633,890.757833,1,26722548,26722734,186,0.5948876661244024
9222,890.9949,891.014967,1,26729847,26730449,602,0.2107427165887014
9223,891.176367,891.1906,1,26735291,26735718,427,0.7205699907800732
9224,891.197067,891.201333,1,26735912,26736039,127,0.8749033889824537
9225,891.205067,891.232967,1,26736152,26736989,837,0.5289731057676305
9226,891.2483,891.280167,1,26737449,26738405,956,0.7596494781009991
9227,891.286767,891.309467,1,26738603,26739284,681,0.8505217037618209
9228,891.311767,891.320367,1,26739353,26739611,258,0.6465295613814979
9229,891.322533,891.337733,1,26739675,26740131,456,0.7169696319354161
9230,891.3448,891.348,1,26740344,26740440,96,0.8292793711789997
9231,891.362967,891.366067,1,26740889,26740982,93,0.6839490231738301
9232,891.367167,891.4018,1,26741015,26742054,1039,0.7802539182357434
9233,891.403033,891.407833,1,26742090,26742234,144,0.6607646617796726
9234,891.4213,891.428433,1,26742639,26742852,213,0.843632352200368
9235,891.434367,891.445033,1,26743031,26743350,319,0.8664395612544444
9236,891.449267,891.454833,1,26743478,26743644,166,0.8184201206298247
9237,891.5104,891.558533,1,26745312,26746755,1443,0.6361473260726953
9238,891.566633,891.571433,1,26746998,26747142,144,0.9184777458886082
9239,891.629333,891.632967,1,26748879,26748989,110,0.8085527728723305
9240,891.6755,891.686767,1,26750265,26750603,338,0.8291056450330624
9241,891.687933,891.703267,1,26750637,26751098,461,0.7664408320988197
9242,891.7245,891.732667,1,26751735,26751980,245,0.5552996173518774
9243,891.8806,891.888633,1,26756418,26756658,240,0.8461339644571306
9244,891.9742,891.9781,1,26759226,26759343,117,0.9765110235028662
9245,891.9793,891.982933,1,26759379,26759487,108,0.9613810368979806
9246,891.985033,891.997267,1,26759550,26759918,368,0.6221552068825937
9247,892.0247,892.0362,1,26760741,26761086,345,0.8504502795832651
9248,892.0573,892.0991,1,26761719,26762973,1254,0.5578933577326277
9249,892.113267,892.1205,1,26763398,26763615,217,0.7607762830077051
9250,892.185267,892.194233,1,26765558,26765826,268,0.7836759167011353
9251,892.2176,892.2231,1,26766528,26766693,165,0.9051784632937548
9252,892.2321,892.236867,1,26766963,26767106,143,0.8916893868061939
9253,892.238233,892.243933,1,26767146,26767317,171,0.9039600255394604
9254,892.289433,892.296033,1,26768682,26768880,198,0.7072513945292161
9255,892.3006,892.305933,1,26769018,26769177,159,0.6783877358562403
9256,892.310467,892.321833,1,26769314,26769654,340,0.6231420658786853
9257,892.339833,892.348367,1,26770194,26770451,257,0.6179019773455265
9258,892.3702,892.377867,1,26771106,26771336,230,0.6724259001831987
9259,892.3792,892.384967,1,26771376,26771549,173,0.862683840288149
9260,892.399133,892.412567,1,26771973,26772377,404,0.8300646860775666
9261,892.418767,892.4359,1,26772563,26773077,514,0.7374824134209452
9262,892.4602,892.467067,1,26773806,26774012,206,0.788161425272366
9263,892.471667,892.4868,1,26774150,26774604,454,0.3441546853800513
9264,892.497967,892.501,1,26774939,26775030,91,0.9359758452156776
9265,892.581433,892.5872,1,26777442,26777616,174,0.809891691298253
9266,892.608133,892.612133,1,26778243,26778363,120,0.8123266818916726
9267,892.619533,892.631567,1,26778585,26778947,362,0.5124952209748889
9268,892.635333,892.639433,1,26779059,26779182,123,0.8248089659343565
9269,892.655933,892.6591,1,26779677,26779773,96,0.923818655388785
9270,892.746333,892.753067,1,26782389,26782592,203,0.917394979125492
9271,892.759333,892.762567,1,26782779,26782877,98,0.841410384758164
9272,892.794233,892.817133,1,26783826,26784513,687,0.7689472280322518
9273,892.871133,892.875733,1,26786133,26786271,138,0.8170002251719312
9274,892.880533,892.906167,1,26786415,26787185,770,0.7633022545718916
9275,892.907367,892.910867,1,26787221,26787326,105,0.6942144059323783
9276,892.927567,892.930767,1,26787827,26787923,96,0.8354739772625336
9277,892.9463,892.956667,1,26788389,26788700,311,0.758706831003711
9278,892.996867,893.010533,1,26789906,26790315,409,0.6883929790910653
9279,893.011767,893.0293,1,26790353,26790879,526,0.31181911024626774
9280,893.249167,893.2954,1,26797475,26798862,1387,0.7404495019993256
9281,893.355833,893.377067,1,26800674,26801312,638,0.7742390802249268
9282,893.403733,893.410067,1,26802111,26802302,191,0.7932333456800895
9283,893.4537,893.465533,1,26803611,26803965,354,0.8580750072514854
9284,893.482867,893.5007,1,26804486,26805021,535,0.4516274983180555
9285,893.502133,893.5351,1,26805063,26806053,990,0.645685330510313
9286,893.5505,893.5577,1,26806515,26806731,216,0.8760373731144383
9287,893.770433,893.7752,1,26813112,26813256,144,0.7374885395149061
9288,893.819367,893.859433,1,26814581,26815782,1201,0.6025770473131303
9289,893.8653,893.8684,1,26815959,26816052,93,0.9696385550636784
9290,893.8798,893.9118,1,26816394,26817354,960,0.7378559972712614
9291,893.920967,893.943533,1,26817629,26818305,676,0.5703136115013423
9292,893.9454,893.948633,1,26818362,26818458,96,0.6610892916954685
9293,893.9822,893.994467,1,26819466,26819834,368,0.8835526303024239
9294,894.023767,894.0365,1,26820713,26821095,382,0.2758394260043788
9295,894.085533,894.0952,1,26822565,26822856,291,0.8078345976702302
9296,894.100133,894.1043,1,26823003,26823129,126,0.3740326181269299
9297,894.107833,894.131067,1,26823234,26823932,698,0.8522352573225481
9298,894.1434,894.214433,1,26824302,26826432,2130,0.5951479736295262
9299,894.216367,894.221833,1,26826491,26826654,163,0.9074051316423228
9300,894.6412,894.646067,1,26839236,26839382,146,-0.16841794195950016
9301,894.725567,894.7387,1,26841767,26842161,394,0.05470259981346452
9302,894.963233,894.968133,1,26848896,26849043,147,0.12654047334657897
9303,895.115367,895.119133,1,26853461,26853573,112,0.7715040464702857
9304,895.240633,895.248133,1,26857218,26857443,225,0.8460914300324742
9305,895.2492,895.252867,1,26857476,26857586,110,0.8558586484719585
9306,895.256867,895.297967,1,26857706,26858939,1233,0.22780515000668008
9307,895.299133,895.320033,1,26858973,26859600,627,0.38612478549899487
9308,895.342033,895.347833,1,26860260,26860434,174,0.6345306412424092
9309,895.385133,895.422833,1,26861553,26862684,1131,0.43069508974164183
9310,895.430267,895.4401,1,26862908,26863203,295,0.1897575541643794
9311,895.4423,895.457267,1,26863269,26863718,449,0.38984276888659153
9312,895.463733,895.4847,1,26863911,26864541,630,0.14515851591593054
9313,895.4857,895.502367,1,26864571,26865071,500,0.09241208609364178
9314,895.508067,895.5988,1,26865242,26867964,2722,0.2494761698239719
9315,895.601967,895.609467,1,26868059,26868284,225,0.8234845449789678
9316,895.675933,895.679067,1,26870277,26870372,95,0.8737855205214992
9317,895.695667,895.699133,1,26870870,26870973,103,0.893417577826978
9318,895.713733,895.793533,1,26871411,26873805,2394,0.8863597735884012
9319,895.7953,895.804533,1,26873859,26874135,276,0.9207752913576582
9320,895.839333,895.845367,1,26875179,26875361,182,0.9497187796991665
9321,895.8647,895.898567,1,26875941,26876957,1016,0.79886573278014
9322,895.9146,895.938067,1,26877438,26878142,704,0.5748998661419721
9323,895.944167,895.972333,1,26878325,26879169,844,0.8674097016094265
9324,895.980233,895.986567,1,26879406,26879597,191,0.9026136287565434
9325,895.991767,896.000933,1,26879753,26880027,274,0.8678000872781593
9326,896.002433,896.016533,1,26880072,26880495,423,0.9060203731378675
9327,896.022433,896.084533,1,26880672,26882535,1863,0.8693101250831595
9328,896.0931,896.0961,1,26882793,26882883,90,0.8627640284930247
9329,896.126467,896.133733,1,26883794,26884011,217,0.7743004341160212
9330,896.138367,896.141367,1,26884151,26884241,90,0.9779543176063503
9331,896.145467,896.149833,1,26884364,26884494,130,0.907641022340097
9332,896.1509,896.155,1,26884527,26884650,123,0.9401543108419963
9333,896.167967,896.1745,1,26885039,26885235,196,0.6864770119235538
9334,896.295167,896.299967,1,26888855,26888999,144,0.8036046182971819
9335,896.3386,896.342233,1,26890158,26890266,108,0.8849617101707711
9336,896.3433,896.3466,1,26890299,26890398,99,0.8961284402699338
9337,896.355167,896.361533,1,26890655,26890845,190,0.8732846932206807
9338,896.3712,896.387033,1,26891136,26891610,474,0.7468193454066571
9339,896.3918,896.415667,1,26891754,26892470,716,0.698602934109997
9340,896.419133,896.4235,1,26892573,26892705,132,0.7994830157445291
9341,896.432467,896.438267,1,26892974,26893148,174,0.7028609053549939
9342,896.447533,896.4579,1,26893425,26893737,312,0.6615249923151175
9343,896.458933,896.462633,1,26893767,26893878,111,0.8732808037126631
9344,896.465833,896.517033,1,26893974,26895510,1536,0.5982300605174525
9345,896.522667,896.6064,1,26895680,26898192,2512,0.5490001153215031
9346,896.617333,896.634767,1,26898519,26899043,524,0.5753736933779217
9347,896.641433,896.653167,1,26899242,26899595,353,0.6617717054325934
9348,896.657367,896.6682,1,26899721,26900046,325,0.49219589184196183
9349,896.672967,896.681133,1,26900189,26900433,244,0.8156131891148236
9350,896.682667,896.713333,1,26900480,26901399,919,0.4991473970066986
9351,896.7181,896.7227,1,26901543,26901681,138,0.5485165005881016
9352,896.734133,896.742733,1,26902023,26902281,258,0.7520010911849258
9353,896.744467,896.7659,1,26902334,26902977,643,0.5019337629673137
9354,896.7728,896.806633,1,26903184,26904198,1014,0.7843289486010055
9355,896.818,896.8521,1,26904540,26905563,1023,0.5877158853160069
9356,896.885433,896.897233,1,26906562,26906916,354,0.6225723633375955
9357,896.900167,896.913667,1,26907005,26907410,405,0.9151725953743522
9358,896.915967,896.926567,1,26907479,26907797,318,0.8595831605893322
9359,896.9497,896.9567,1,26908491,26908701,210,0.8372675964380373
9360,896.959467,896.974133,1,26908784,26909223,439,0.7178156254415881
9361,897.0178,897.024167,1,26910534,26910725,191,0.5625299306697591
9362,897.0366,897.042933,1,26911098,26911287,189,0.842018073088309
9363,897.071467,897.0856,1,26912144,26912568,424,0.538223276402774
9364,897.090167,897.0984,1,26912705,26912952,247,0.6419891406819518
9365,897.116667,897.129633,1,26913500,26913888,388,0.8833683177171764
9366,897.146767,897.1589,1,26914403,26914767,364,0.7317027115160638
9367,897.1613,897.168833,1,26914839,26915064,225,0.7977563761877872
9368,897.174033,897.180767,1,26915220,26915423,203,0.8489036918830872
9369,897.189333,897.197867,1,26915679,26915936,257,0.5823862883350676
9370,897.205033,897.208633,1,26916150,26916258,108,0.6983145639920917
9371,897.249667,897.2643,1,26917490,26917929,439,0.5357772700377315
9372,897.266633,897.276967,1,26917998,26918309,311,0.7797128777878782
9373,897.279833,897.2918,1,26918394,26918754,360,0.6922349252264275
9374,897.296767,897.301933,1,26918903,26919057,154,0.8597558237744778
9375,897.304133,897.318833,1,26919123,26919564,441,0.7620551058028482
9376,897.3247,897.3389,1,26919741,26920167,426,0.7192516496729258
9377,897.361033,897.368,1,26920830,26921040,210,0.8012756155457323
9378,897.3747,897.378467,1,26921241,26921354,113,0.9421121220800682
9379,897.3839,897.394067,1,26921517,26921822,305,0.729094063230988
9380,897.4012,897.4419,1,26922036,26923257,1221,0.43926550857770863
9381,897.494967,897.4993,1,26924849,26924979,130,0.5745056082680183
9382,897.500467,897.504433,1,26925014,26925132,118,0.7493449098827611
9383,897.540933,897.5842,1,26926227,26927526,1299,0.7651645763329915
9384,897.5855,897.5901,1,26927565,26927703,138,0.7407668224947526
9385,897.6017,897.607567,1,26928051,26928227,176,0.7175633725117927
9386,897.609233,897.618367,1,26928276,26928551,275,0.8770353088064213
9387,897.644067,897.652833,1,26929322,26929584,262,0.8849346570271273
9388,897.8208,897.8566,1,26934624,26935698,1074,0.8282035009276705
9389,897.863533,897.871033,1,26935905,26936130,225,0.8513602782714461
9390,897.8828,897.8873,1,26936484,26936619,135,0.9450330189989495
9391,897.897367,897.900767,1,26936921,26937023,102,0.9161284405636592
9392,897.901933,897.9082,1,26937057,26937246,189,0.8897122822048098
9393,897.929767,897.9464,1,26937893,26938392,499,0.6213694731210629
9394,897.9563,897.965133,1,26938689,26938953,264,0.4438182322135865
9395,897.968067,897.9714,1,26939042,26939142,100,0.8363924790003757
9396,897.980333,898.019967,1,26939409,26940599,1190,0.47423074810789306
9397,898.0234,898.0301,1,26940702,26940903,201,0.8921251783086326
9398,898.031333,898.037333,1,26940939,26941119,180,0.6265941782733313
9399,898.065167,898.068467,1,26941955,26942054,99,0.8784189198552239
9400,898.072233,898.081233,1,26942166,26942436,270,0.7654372153242173
9401,898.086767,898.0963,1,26942603,26942889,286,0.93215953095587
9402,898.1064,898.115,1,26943192,26943450,258,0.8605964084650568
9403,898.1581,898.1617,1,26944743,26944851,108,0.8626150542729284
9404,898.183667,898.193433,1,26945510,26945802,292,0.7627436953096098
9405,898.207633,898.212167,1,26946228,26946365,137,0.9150741114916158
9406,898.224767,898.229633,1,26946743,26946888,145,0.7658448289726608
9407,898.3057,898.440767,1,26949171,26953223,4052,0.7398026182040511
9408,898.442567,898.445933,1,26953277,26953377,100,0.8507270546260476
9409,898.489433,898.494267,1,26954682,26954828,146,0.9151011831822938
9410,898.505733,898.508733,1,26955171,26955261,90,0.7867903248910315
9411,898.513933,898.524733,1,26955417,26955741,324,0.29667395916796846
9412,898.549033,898.552467,1,26956470,26956574,104,0.7372962315168252
9413,898.6557,898.661567,1,26959671,26959847,176,0.884871622886592
9414,898.6755,898.682633,1,26960265,26960478,213,0.8441762098817224
9415,898.6844,898.692867,1,26960532,26960786,254,0.7824131414672122
9416,898.7108,898.757567,1,26961324,26962727,1403,0.5282720272510346
9417,898.758733,898.804633,1,26962761,26964138,1377,0.7894633406848484
9418,898.8203,898.829433,1,26964609,26964882,273,0.8422611668662958
9419,898.831933,898.9228,1,26964957,26967684,2727,0.34289697048248485
9420,898.927267,898.976133,1,26967818,26969283,1465,0.3121839003697322
9421,898.9773,898.989033,1,26969319,26969670,351,0.3948680162068688
9422,899.0064,899.0372,1,26970192,26971116,924,0.7083804833698323
9423,899.042067,899.0459,1,26971262,26971377,115,0.9189637668792757
9424,899.047033,899.0544,1,26971410,26971632,222,0.9085209788092046
9425,899.068067,899.0933,1,26972042,26972799,757,0.8125267535826145
9426,899.103333,899.133733,1,26973099,26974011,912,0.8050678809610968
9427,899.141367,899.1842,1,26974241,26975526,1285,0.7462440840878624
9428,899.190433,899.211067,1,26975712,26976332,620,0.760584317529344
9429,899.212067,899.2431,1,26976362,26977293,931,0.6561530517519495
9430,899.254133,899.309,1,26977623,26979270,1647,0.7713723971108721
9431,899.325633,899.3304,1,26979768,26979912,144,0.6083665864534713
9432,899.347433,899.354133,1,26980422,26980623,201,0.8163949503998146
9433,899.36,899.430367,1,26980800,26982911,2111,0.637363825952908
9434,899.431433,899.436533,1,26982942,26983095,153,0.8340126301493647
9435,899.4376,899.4455,1,26983128,26983365,237,0.6231813597916563
9436,899.4535,899.4593,1,26983605,26983779,174,0.889174160324191
9437,899.460567,899.4873,1,26983817,26984619,802,0.550434054927872
9438,899.4968,899.502533,1,26984904,26985075,171,0.5159300990057387
9439,899.504567,899.510433,1,26985137,26985312,175,0.9362433581796694
9440,899.512833,899.5607,1,26985384,26986821,1437,0.5888819907921842
9441,899.5658,899.5798,1,26986974,26987394,420,0.8905242112562946
9442,899.583667,899.604733,1,26987510,26988141,631,0.6862809186819256
9443,899.610067,899.632167,1,26988302,26988965,663,0.6252834150127644
9444,899.6364,899.655067,1,26989092,26989652,560,0.7663198784984407
9445,899.661367,899.686333,1,26989841,26990589,748,0.7307578883118934
9446,899.688333,899.693033,1,26990649,26990790,141,0.7486242503487232
9447,899.694033,899.7198,1,26990820,26991594,774,0.604462488875885
9448,899.722633,899.744667,1,26991678,26992340,662,0.6465831764208173
9449,899.747633,899.7736,1,26992428,26993208,780,0.7270903571296153
9450,899.783033,899.798267,1,26993490,26993948,458,0.7411506741465358
9451,899.805033,899.8114,1,26994150,26994342,192,0.7358846742289844
9452,899.814733,899.827967,1,26994441,26994839,398,0.7669865140554635
9453,899.838367,899.9224,1,26995151,26997672,2521,0.6950040310424795
9454,899.9234,900.0041,1,26997702,27000123,2421,0.49701612079410057
9455,900.0156,900.022767,1,27000468,27000683,215,0.8952491438062545
9456,900.025867,900.056467,1,27000776,27001694,918,0.5925562727887207
9457,900.062867,900.0689,1,27001886,27002067,181,0.7944198334767041
9458,900.07,900.174267,1,27002100,27005228,3128,0.519454668101709
9459,900.181167,900.191467,1,27005435,27005744,309,0.8864320269456254
9460,900.206167,900.2366,1,27006185,27007098,913,0.7664052605100188
9461,900.241033,900.2448,1,27007230,27007344,114,0.8221504605719444
9462,900.248633,900.2528,1,27007458,27007584,126,0.8532927917956535
9463,900.2565,900.263967,1,27007695,27007919,224,0.850833825472608
9464,900.265,900.272367,1,27007950,27008171,221,0.8032892903919819
9465,900.277467,900.324933,1,27008324,27009747,1423,0.44589454883457
9466,900.325967,900.335233,1,27009779,27010056,277,0.5851487379362469
9467,900.338667,900.342467,1,27010160,27010274,114,0.7671408849391796
9468,900.345533,900.3527,1,27010365,27010581,216,0.6808877721797602
9469,900.354933,900.3727,1,27010647,27011181,534,0.8735811851149533
9470,900.3767,900.380733,1,27011301,27011421,120,0.8291483077197619
9471,900.3829,900.410733,1,27011487,27012321,834,0.30718141004531113
9472,900.4143,900.423633,1,27012429,27012708,279,0.8027505503286265
9473,900.424667,900.485467,1,27012740,27014564,1824,0.657474726774444
9474,900.486733,900.5012,1,27014601,27015036,435,0.803277353115936
9475,900.5032,900.509933,1,27015096,27015297,201,0.9113037363186473
9476,900.510967,900.514733,1,27015329,27015441,112,0.704294051645114
9477,900.515933,900.520433,1,27015477,27015612,135,0.8553260407863111
9478,900.5244,900.533,1,27015732,27015990,258,0.8808910249462184
9479,900.542267,900.552567,1,27016268,27016577,309,0.9164551513869488
9480,900.5537,900.5704,1,27016611,27017112,501,0.7650014819463804
9481,900.578967,900.586933,1,27017369,27017607,238,0.890487244770671
9482,900.591067,900.601633,1,27017732,27018048,316,0.7461883590393437
9483,900.622167,900.627367,1,27018665,27018821,156,0.9007267971495345
9484,900.645433,900.651333,1,27019362,27019539,177,0.9016974855606386
9485,900.654133,900.7304,1,27019623,27021912,2289,0.6994952681410139
9486,900.735267,900.795667,1,27022058,27023870,1812,0.6855068293593747
9487,900.797667,900.811933,1,27023930,27024357,427,0.7676884271773335
9488,900.814133,900.8625,1,27024423,27025875,1452,0.6617836674997031
9489,900.8705,900.883833,1,27026115,27026514,399,0.6711296827626698
9490,900.885067,900.9108,1,27026552,27027324,772,0.38877771250919674
9491,900.912967,900.9692,1,27027389,27029076,1687,0.6230579888594925
9492,900.978633,901.040767,1,27029358,27031223,1865,0.2800519000180562
9493,901.0419,901.0578,1,27031257,27031734,477,0.7544255882706206
9494,901.062,901.066933,1,27031860,27032007,147,0.8150504173972911
9495,901.081833,901.085333,1,27032454,27032559,105,0.7538339861071336
9496,901.086667,901.0916,1,27032600,27032748,148,0.8010041689202887
9497,901.0989,901.1029,1,27032967,27033087,120,0.8922029380560226
9498,901.1156,901.1254,1,27033468,27033762,294,0.2532142535119204
9499,901.129767,901.144667,1,27033893,27034340,447,0.6239864243262312
9500,901.146367,901.154867,1,27034391,27034646,255,0.7709035571144813
9501,901.1566,901.1766,1,27034698,27035298,600,0.8404232861384445
9502,901.1788,901.1867,1,27035364,27035601,237,0.8125432616623363
9503,901.190333,901.2009,1,27035709,27036027,318,0.794396777483896
9504,901.205767,901.2325,1,27036173,27036975,802,0.7045542906535587
9505,901.233567,901.254033,1,27037007,27037620,613,0.6404287503804026
9506,901.256767,901.277,1,27037703,27038310,607,0.5171206263078602
9507,901.283,901.309267,1,27038490,27039278,788,0.24068614933912952
9508,901.336133,901.341633,1,27040083,27040248,165,0.8812832362693138
9509,901.3713,901.437067,1,27041139,27043112,1973,0.7314644558037814
9510,901.438933,901.4579,1,27043167,27043737,570,0.8783095022342754
9511,901.459,901.480067,1,27043770,27044402,632,0.7931732862066959
9512,901.4818,901.518033,1,27044454,27045540,1086,0.8019711559574157
9513,901.519067,901.544633,1,27045572,27046338,766,0.6351700437924167
9514,901.5523,901.593433,1,27046569,27047802,1233,0.5526265293784347
9515,901.5948,901.6027,1,27047844,27048081,237,0.6112766219679224
9516,901.606467,901.614267,1,27048194,27048428,234,0.7140653778054193
9517,901.6159,901.620067,1,27048477,27048602,125,0.7887510142681876
9518,901.621233,901.6249,1,27048636,27048747,111,0.7899062276463116
9519,901.634467,901.668233,1,27049034,27050046,1012,0.6366062280589073
9520,901.669467,901.682067,1,27050084,27050462,378,0.749690195063993
9521,901.6836,901.694333,1,27050508,27050829,321,0.5370721255430195
9522,901.6992,901.7336,1,27050976,27052008,1032,0.740182561685994
9523,901.742033,901.807633,1,27052260,27054228,1968,0.6998590344954091
9524,901.809167,901.833867,1,27054275,27055016,741,0.5383974364599377
9525,901.8387,901.849333,1,27055161,27055479,318,0.9012905648536453
9526,901.857267,901.866067,1,27055718,27055982,264,0.7350544629167287
9527,901.868667,901.8841,1,27056060,27056523,463,0.8747591219672759
9528,901.886467,901.9143,1,27056594,27057429,835,0.7673695188674305
9529,901.916667,901.921167,1,27057500,27057635,135,0.9310852712343332
9530,901.936633,901.956633,1,27058098,27058698,600,0.8420769633575084
9531,902.003767,902.057133,1,27060113,27061713,1600,0.2867600944374253
9532,902.067733,902.079433,1,27062031,27062382,351,0.4388995032413817
9533,902.082167,902.107933,1,27062465,27063237,772,0.5821550530896566
9534,902.1142,902.142767,1,27063426,27064283,857,0.8951573415754389
9535,902.1476,902.150967,1,27064428,27064529,101,0.8497176235712515
9536,902.154267,902.171533,1,27064628,27065145,517,0.7617405519638141
9537,902.1733,902.188867,1,27065199,27065666,467,0.8772255306169435
9538,902.203233,902.211767,1,27066096,27066353,257,0.9200577048278239
9539,902.213,902.216333,1,27066390,27066489,99,0.8475103460487549
9540,902.219767,902.226233,1,27066593,27066786,193,0.6429910630595942
9541,902.2318,902.238967,1,27066954,27067169,215,0.7291411247790199
9542,902.285967,902.2926,1,27068579,27068778,199,0.9062333291773047
9543,902.310367,902.328933,1,27069311,27069867,556,0.0686425748560089
9544,902.3531,902.3577,1,27070593,27070731,138,0.6348989973206691
9545,902.359,902.381767,1,27070770,27071453,683,0.852135706948202
9546,902.387833,902.402433,1,27071634,27072072,438,0.9330650145563187
9547,902.4047,902.549733,1,27072141,27076491,4350,0.4369063398874395
9548,902.5632,902.652933,1,27076896,27079587,2691,0.6450642859915705
9549,902.656,902.817767,1,27079680,27084533,4853,0.6327262580037292
9550,902.823067,902.845467,1,27084692,27085364,672,0.7264075086342225
9551,902.849733,902.8691,1,27085491,27086073,582,0.6680179521390106
9552,902.874367,902.895167,1,27086231,27086855,624,0.5859673474182913
9553,902.901967,902.907233,1,27087059,27087216,157,0.08599027421007284
9554,902.910967,902.940033,1,27087329,27088200,871,0.4087985847419723
9555,902.943433,902.969833,1,27088302,27089094,792,0.4765700448881319
9556,902.976233,903.0005,1,27089286,27090015,729,0.7216556659555782
9557,903.005433,903.029367,1,27090162,27090881,719,0.7410209811101546
9558,903.040567,903.0662,1,27091217,27091986,769,0.6215829465048317
9559,903.072667,903.1004,1,27092180,27093012,832,0.6622461267512956
9560,903.101533,903.1378,1,27093045,27094134,1089,0.43871725965861685
9561,903.141233,903.145233,1,27094236,27094356,120,0.8192096731792439
9562,903.1498,903.174133,1,27094494,27095223,729,0.3551775577495647
9563,903.180067,903.185633,1,27095402,27095568,166,0.5947516101335434
9564,903.186933,903.221733,1,27095607,27096651,1044,0.49563870795281
9565,903.225433,903.249367,1,27096762,27097481,719,0.38005881127586544
9566,903.2529,903.2908,1,27097587,27098724,1137,0.6904670050352747
9567,903.292867,903.2998,1,27098786,27098994,208,0.9024054614588048
9568,903.302533,903.3265,1,27099075,27099795,720,0.620433372908806
9569,903.3307,903.362833,1,27099921,27100884,963,0.7856894498516225
9570,903.366233,903.4414,1,27100986,27103242,2256,0.2746330981800032
9571,903.442767,903.491233,1,27103283,27104736,1453,0.20492682194953246
9572,903.5088,903.667567,1,27105264,27110027,4763,0.7401486438053952
9573,903.668867,903.850933,1,27110066,27115527,5461,0.37633335086374536
9574,903.8535,903.922933,1,27115605,27117687,2082,0.5501010903555286
9575,903.93,903.935067,1,27117900,27118052,152,0.8076850422214824
9576,903.940033,903.9629,1,27118200,27118887,687,0.8481848169102847
9577,903.976233,904.012833,1,27119286,27120384,1098,0.5135299484096777
9578,904.0162,904.020633,1,27120486,27120618,132,0.7556179655691196
9579,904.031167,904.063933,1,27120935,27121917,982,0.5557767222366814
9580,904.064933,904.0692,1,27121947,27122076,129,0.9261466606838543
9581,904.0827,904.093933,1,27122481,27122817,336,0.8086459589974576
9582,904.099267,904.1671,1,27122978,27125013,2035,0.3542880677315778
9583,904.1684,904.196767,1,27125052,27125903,851,0.558864584218735
9584,904.198467,904.212367,1,27125954,27126371,417,0.6499443608318208
9585,904.2135,904.216667,1,27126405,27126500,95,0.950449065941285
9586,904.218133,904.2217,1,27126543,27126651,108,0.6066487912018765
9587,904.223567,904.2626,1,27126707,27127878,1171,0.5485718783295677
9588,904.264067,904.300167,1,27127922,27129005,1083,0.7616921404902619
9589,904.302833,904.334733,1,27129084,27130041,957,0.806042694985619
9590,904.337867,904.347733,1,27130136,27130431,295,0.7913287544361286
9591,904.3555,904.359567,1,27130665,27130787,122,0.64867861408942
9592,904.370333,904.403,1,27131109,27132090,981,0.6953226997139038
9593,904.404433,904.4312,1,27132132,27132936,804,0.7894437111620857
9594,904.432467,904.480733,1,27132974,27134421,1447,0.685829104915148
9595,904.490133,904.521533,1,27134703,27135645,942,0.38283278104774243
9596,904.525333,904.561267,1,27135759,27136838,1079,0.5505112141736827
9597,904.574767,904.683033,1,27137243,27140490,3247,0.634224693467291
9598,904.689567,904.7599,1,27140687,27142797,2110,0.3995474900277296
9599,904.761333,904.767933,1,27142839,27143037,198,0.7057891017389886
9600,904.7707,904.7927,1,27143121,27143781,660,0.5803943488071056
9601,904.793767,904.804,1,27143813,27144120,307,0.8329722741966383
9602,904.806267,904.861033,1,27144188,27145830,1642,0.4548704121958701
9603,904.8622,904.890233,1,27145866,27146706,840,0.3376054976238114
9604,904.891667,904.904467,1,27146750,27147134,384,0.9145938088960176
9605,904.932133,904.943633,1,27147963,27148308,345,0.7471430467710615
9606,904.951933,904.9593,1,27148557,27148779,222,0.8935679043942419
9607,904.9781,904.984867,1,27149343,27149546,203,0.7456180205631671
9608,905.0057,905.0134,1,27150171,27150402,231,0.7901213351203356
9609,905.030733,905.034,1,27150921,27151020,99,0.7629279352112318
9610,905.042233,905.045233,1,27151266,27151356,90,0.8947746005892535
9611,905.054667,905.061833,1,27151640,27151854,214,0.7535910148260418
9612,905.0669,905.074267,1,27152007,27152228,221,0.8620668208624348
9613,905.075533,905.187367,1,27152265,27155621,3356,0.5256213067883062
9614,905.1996,905.204767,1,27155988,27156143,155,0.6071566319892655
9615,905.571367,905.5754,1,27167141,27167262,121,0.7883647140699748
9616,905.5965,905.599967,1,27167895,27167999,104,0.8215896374207097
9617,905.648867,905.6521,1,27169466,27169563,97,0.9027410859097057
9618,906.7325,906.758333,1,27201975,27202749,774,0.20001793520862454
9619,906.7826,906.789933,1,27203478,27203697,219,0.49213842776010974
9620,906.791667,906.808233,1,27203750,27204246,496,0.3035456070344143
9621,906.826167,906.833033,1,27204785,27204990,205,0.598892672485473
9622,906.835633,906.864033,1,27205068,27205920,852,0.4023778220043852
9623,906.872067,906.8913,1,27206162,27206739,577,0.6131692022291632
9624,906.911433,906.9581,1,27207342,27208743,1401,0.5020465995090615
9625,906.9731,906.9787,1,27209193,27209361,168,0.44543151240770756
9626,906.982667,907.0403,1,27209480,27211209,1729,0.42036872233272643
9627,907.0596,907.064633,1,27211788,27211938,150,0.5967823656225085
9628,907.3828,907.386133,1,27221484,27221583,99,0.9188202032313217
9629,908.193933,908.197533,1,27245817,27245925,108,0.43611135820246105
9630,908.205533,908.2086,1,27246165,27246258,93,-0.016134375959541477
9631,908.2278,908.249533,1,27246834,27247485,651,0.4465438504534221
9632,908.636267,908.667433,1,27259088,27260022,934,0.3007978608185592
9633,908.670733,908.6894,1,27260121,27260682,561,0.06538739376696927
9634,908.691533,908.696667,1,27260745,27260900,155,0.09090340294280112
9635,908.701267,908.7069,1,27261038,27261207,169,0.7050007884464697
9636,908.774633,908.853433,1,27263238,27265602,2364,0.10554428546667602
9637,908.889133,908.893767,1,27266673,27266813,140,0.5052905150938142
9638,908.921533,908.953233,1,27267645,27268596,951,0.24662133926592167
9639,908.9596,908.982067,1,27268788,27269462,674,0.07366147455157811
9640,908.983367,908.993933,1,27269501,27269817,316,0.3243446487399973
9641,908.9969,909.0086,1,27269907,27270258,351,0.42304016835059105
9642,909.068933,909.100833,1,27272067,27273024,957,0.3934976628918726
9643,909.106533,909.146,1,27273195,27274380,1185,0.1656361709875454
9644,909.149233,909.1654,1,27274476,27274962,486,0.23869704548939027
9645,909.1692,909.1723,1,27275076,27275169,93,0.873187238392228
9646,909.238767,909.2733,1,27277163,27278199,1036,0.2521191293548378
9647,909.280533,909.305667,1,27278415,27279170,755,0.3182934816432277
9648,909.3145,909.3183,1,27279435,27279549,114,0.20840995715331376
9649,909.8227,909.830633,1,27294681,27294918,237,0.6065067163634972
9650,910.601667,910.607267,1,27318050,27318218,168,0.7326921497716449
9651,910.609867,910.7145,1,27318296,27321435,3139,0.17662067097655929
9652,910.725367,910.7477,1,27321761,27322431,670,0.20118752115353844
9653,910.749033,910.7531,1,27322470,27322593,123,0.9026586950310378
9654,910.7541,910.796433,1,27322623,27323892,1269,0.24257672880213016
9655,910.800367,910.8359,1,27324011,27325077,1066,0.215743437706521
9656,910.8413,910.849133,1,27325239,27325473,234,0.44165836707510925
9657,910.851167,910.873133,1,27325535,27326193,658,0.8207032379301411
9658,910.8946,910.905167,1,27326838,27327155,317,0.8460716993667639
9659,911.428433,911.4679,1,27342852,27344037,1185,0.16138575653178241
9660,911.470667,911.4908,1,27344120,27344724,604,0.4789093602925892
9661,911.498433,911.505333,1,27344952,27345159,207,0.8707203136616789
9662,911.506533,911.5826,1,27345195,27347478,2283,0.1771692436703533
9663,911.584567,911.595167,1,27347537,27347855,318,0.7152921153844366
9664,911.597133,911.6009,1,27347913,27348027,114,0.9360899860813282
9665,911.6021,911.6108,1,27348063,27348324,261,0.849246510862956
9666,911.612,911.615033,1,27348360,27348450,90,0.8719142785893643
9667,911.635767,911.6393,1,27349073,27349179,106,0.3801485093436483
9668,911.778533,911.8041,1,27353355,27354123,768,0.24275038947927025
9669,912.034867,912.0402,1,27361046,27361206,160,0.656071152218779
9670,912.0725,912.078967,1,27362175,27362369,194,0.7155489511855881
9671,915.080733,915.086667,1,27452421,27452600,179,-0.10463545847976838
9672,915.0877,915.109767,1,27452631,27453293,662,0.24267819420244402
9673,915.112167,915.130233,1,27453365,27453906,541,0.7355458607665507
9674,915.138067,915.143633,1,27454142,27454308,166,0.8829937415118043
9675,915.2494,915.252433,1,27457482,27457572,90,0.19200487823756893
9676,915.295767,915.3007,1,27458873,27459021,148,0.5436071674150632
9677,915.305533,915.310333,1,27459165,27459309,144,0.6580904652282776
9678,915.3114,915.320733,1,27459342,27459621,279,0.8133303070534441
9679,915.332567,915.3364,1,27459977,27460092,115,0.6756943698234767
9680,915.337633,915.3441,1,27460128,27460323,195,0.8537633154776386
9681,915.3451,915.3511,1,27460353,27460533,180,0.2676500777478516
9682,915.379567,915.3841,1,27461387,27461523,136,0.9137675404364949
9683,915.433533,915.455933,1,27463005,27463677,672,0.8482175104055819
9684,915.483333,915.487067,1,27464499,27464612,113,0.7364612691156736
9685,915.502033,915.507533,1,27465060,27465225,165,0.8894627555669298
9686,915.511133,915.537833,1,27465333,27466134,801,0.7947066604324601
9687,915.5467,915.581867,1,27466401,27467456,1055,0.7572976798041582
9688,915.632867,915.638833,1,27468986,27469164,178,0.9722264127191178
9689,915.6404,915.6446,1,27469212,27469338,126,0.8228785088575589
9690,915.646133,915.649767,1,27469383,27469493,110,0.8342502744965131
9691,915.651833,915.655933,1,27469554,27469677,123,0.9130194453178005
9692,915.688967,915.6925,1,27470669,27470775,106,0.664161266482679
9693,915.6937,915.708733,1,27470811,27471261,450,0.8649106610769002
9694,915.7117,915.725967,1,27471351,27471779,428,0.8540742825567075
9695,915.830867,915.8377,1,27474926,27475131,205,0.8257677669901025
9696,915.843433,915.8488,1,27475302,27475464,162,0.8390960028174062
9697,915.852367,915.8568,1,27475571,27475704,133,0.9063994454175837
9698,915.866333,915.878233,1,27475989,27476346,357,0.731637741325402
9699,915.880767,915.893133,1,27476423,27476793,370,0.789495017317277
9700,915.915367,915.918833,1,27477461,27477564,103,0.7594468211994045
9701,915.921733,915.927733,1,27477651,27477831,180,0.8911614320070332
9702,915.934333,915.946733,1,27478029,27478401,372,0.6972162743190456
9703,915.949033,915.975067,1,27478470,27479252,782,0.8106642630616676
9704,915.976933,915.988933,1,27479307,27479667,360,0.6004592552161145
9705,915.992767,915.9971,1,27479783,27479913,130,-0.5475690183055042
9706,916.011367,916.017,1,27480341,27480510,169,0.7948525168942315
9707,916.0205,916.030633,1,27480615,27480918,303,0.8459848478972133
9708,916.031633,916.0401,1,27480948,27481203,255,0.7975789129338541
9709,916.051567,916.0557,1,27481547,27481671,124,0.8697944923961832
9710,916.061067,916.0717,1,27481832,27482151,319,0.7370398809166934
9711,916.089667,916.1054,1,27482690,27483162,472,0.5340573419681705
9712,916.121067,916.132733,1,27483632,27483981,349,0.860778879734012
9713,916.2123,916.220467,1,27486369,27486614,245,0.7783330818773825
9714,916.224433,916.229033,1,27486732,27486870,138,0.34025905083694186
9715,916.3068,916.314,1,27489204,27489420,216,0.9648870009494475
9716,916.3201,916.338133,1,27489603,27490143,540,0.23766389816889116
9717,916.363967,916.3692,1,27490919,27491076,157,0.8364979866100879
9718,916.372933,916.3791,1,27491187,27491373,186,0.7748509117571593
9719,916.4055,916.427733,1,27492165,27492831,666,0.586189210385985
9720,916.4894,916.492467,1,27494682,27494774,92,0.48284595855565526
9721,916.620267,916.6292,1,27498608,27498876,268,0.7043344854912722
9722,916.632133,916.6397,1,27498963,27499191,228,0.4658340025077391
9723,916.6763,916.6802,1,27500289,27500406,117,-0.19996534247240882
9724,916.900333,916.904,1,27507009,27507120,111,0.5957880384613357
9725,917.1442,917.167333,1,27514326,27515019,693,0.07512582321754488
9726,917.508333,917.513167,1,27525249,27525395,146,0.7191004301552992
9727,918.0317,918.038133,1,27540951,27541143,192,0.7893362468810629
9728,918.873967,918.8783,1,27566219,27566349,130,0.13130165884107256
9729,919.167433,919.170467,1,27575022,27575114,92,0.945412586585596
9730,919.4292,919.4322,1,27582876,27582966,90,0.608673179825883
9731,921.125633,921.1289,1,27633768,27633867,99,0.5973738686893345
9732,921.13,921.184733,1,27633900,27635541,1641,0.36583864051866694
9733,921.1871,921.193133,1,27635613,27635793,180,0.9239360140494621
9734,921.2457,921.2503,1,27637371,27637509,138,0.8634221205026713
9735,921.252933,921.257067,1,27637587,27637712,125,0.9216527547276855
9736,921.3092,921.369167,1,27639276,27641075,1799,0.16488267594961792
9737,921.3797,921.389,1,27641391,27641670,279,0.4127330919714899
9738,921.392067,921.4437,1,27641762,27643311,1549,0.201074549181119
9739,921.445733,921.449833,1,27643371,27643494,123,0.7947121523988245
9740,921.4513,921.518133,1,27643539,27645543,2004,0.1500285437895577
9741,921.529433,921.5482,1,27645882,27646446,564,0.531462258092643
9742,921.551133,921.562033,1,27646533,27646860,327,0.41540446486175325
9743,921.565567,921.571133,1,27646967,27647133,166,0.8673752431718862
9744,921.584567,921.587667,1,27647537,27647630,93,0.8794888198951036
9745,921.619733,921.6854,1,27648591,27650562,1971,0.35038782378689465
9746,921.689133,921.696433,1,27650673,27650892,219,0.8102903978239699
9747,921.7255,921.733267,1,27651765,27651998,233,0.8673362297983
9748,921.734467,921.7421,1,27652034,27652263,229,0.8041806852320329
9749,921.7473,921.7512,1,27652419,27652536,117,0.785652948118261
9750,921.7724,921.776733,1,27653172,27653301,129,0.20140255187936834
9751,921.7902,921.7964,1,27653706,27653892,186,0.477371212559024
9752,921.797667,921.8019,1,27653930,27654057,127,0.9534505765691876
9753,921.829633,921.8351,1,27654888,27655053,165,0.8654281700686102
9754,921.8409,921.8685,1,27655227,27656055,828,0.6872715064591433
9755,921.891233,921.9031,1,27656736,27657093,357,0.5494040157529372
9756,921.916067,921.921733,1,27657482,27657651,169,0.923573686638744
9757,921.9805,921.984367,1,27659415,27659531,116,0.9432024584674824
9758,922.000833,922.0039,1,27660024,27660117,93,0.8715458730536735
9759,922.032267,922.041467,1,27660968,27661244,276,0.8029112763738467
9760,922.230033,922.2331,1,27666900,27666993,93,0.6839519102454527
9761,922.444567,922.454767,1,27673337,27673643,306,0.5224651243201748
9762,922.456867,922.4604,1,27673706,27673812,106,0.69791280421439
9763,922.760933,922.903567,1,27682827,27687107,4280,0.14383600638217758
9764,922.905,922.914367,1,27687150,27687431,281,0.2265344091606072
9765,922.924633,923.050267,1,27687738,27691508,3770,0.6071809373998507
9766,923.0532,923.087667,1,27691596,27692630,1034,0.8406498982785238
9767,923.229,923.233567,1,27696870,27697007,137,0.7902471228011292
9768,923.235333,923.2408,1,27697059,27697224,165,0.8779578773755162
9769,923.241867,923.251533,1,27697256,27697545,289,0.8681950837679232
9770,923.2568,923.2603,1,27697704,27697809,105,0.8231244505669477
9771,923.276133,923.2802,1,27698283,27698406,123,0.9658341956122796
9772,923.289933,923.4455,1,27698697,27703365,4668,0.8118597743166862
9773,923.458533,923.465033,1,27703755,27703950,195,0.8686513166212845
9774,923.466267,923.4724,1,27703988,27704172,184,0.9072578889842746
9775,923.625767,923.632133,1,27708773,27708963,190,0.8445472970410801
9776,923.6332,923.655067,1,27708996,27709652,656,0.7722075271673667
9777,923.656267,923.7433,1,27709688,27712299,2611,0.8509112892258436
9778,923.7445,923.765267,1,27712335,27712958,623,0.8835625612315675
9779,923.766367,923.771767,1,27712991,27713153,162,0.8091629585499405
9780,923.777867,923.781033,1,27713336,27713430,94,0.9338553373415373
9781,923.7825,923.7882,1,27713475,27713646,171,0.8958918880255698
9782,923.789767,923.794367,1,27713693,27713831,138,0.898472310407506
9783,923.795433,923.814733,1,27713862,27714441,579,0.8286539587764029
9784,923.830667,923.836133,1,27714920,27715083,163,0.8156786782449029
9785,923.837167,923.8494,1,27715115,27715482,367,0.7794563535734688
9786,923.862467,923.871333,1,27715874,27716139,265,0.819024514311275
9787,923.876033,923.884533,1,27716280,27716535,255,0.8069840047220901
9788,923.9036,923.9066,1,27717108,27717198,90,0.894813220863683
9789,923.909833,923.914433,1,27717294,27717432,138,0.8397770474406175
9790,924.3389,924.361667,1,27730167,27730850,683,0.18039641026985428
9791,924.866033,924.873067,1,27745980,27746192,212,0.7503793544635202
9792,924.877233,924.8885,1,27746316,27746655,339,0.8474608604321171
9793,924.889533,924.911067,1,27746685,27747332,647,0.45369086654091295
9794,924.990067,924.9978,1,27749702,27749934,232,0.8528128131934545
9795,925.053967,925.065333,1,27751619,27751959,340,0.6040010244565837
9796,925.068667,925.135033,1,27752060,27754050,1990,0.5311975826973607
9797,925.151233,925.180933,1,27754536,27755427,891,0.2933826515282541
9798,925.515767,925.518833,1,27765473,27765564,91,0.5553398251805752
9799,926.039,926.104533,1,27781170,27783135,1965,0.1596026633932463
9800,926.218767,926.249967,1,27786563,27787499,936,0.4595741460357536
9801,926.259433,926.2781,1,27787782,27788343,561,0.4485791280159242
9802,926.279833,926.2932,1,27788394,27788796,402,0.7227344834039495
9803,926.354933,926.360467,1,27790647,27790814,167,0.4988592518028826
9804,926.3662,926.3692,1,27790986,27791076,90,0.7021598195596687
9805,926.373467,926.406767,1,27791204,27792203,999,0.2689419240028404
9806,926.409967,926.450533,1,27792299,27793515,1216,0.04916717713326541
9807,926.4639,926.472067,1,27793917,27794162,245,0.8002973146220229
9808,926.5311,926.5644,1,27795933,27796932,999,0.4160954909416826
9809,926.573533,926.605667,1,27797205,27798170,965,0.22580541004507598
9810,926.682967,926.6916,1,27800489,27800748,259,0.6718648303680904
9811,926.696467,926.710767,1,27800894,27801323,429,0.44874614083701303
9812,926.711833,926.717667,1,27801354,27801530,176,0.734517081410814
9813,926.731233,926.761967,1,27801936,27802859,923,0.2841809942562717
9814,927.012767,927.015867,1,27810383,27810476,93,-0.2779615983886222
9815,927.033367,927.038467,1,27811001,27811154,153,0.6021066576347393
9816,927.0397,927.069867,1,27811191,27812096,905,0.6651822303029429
9817,927.095033,927.102333,1,27812850,27813069,219,0.46373975743106893
9818,927.103767,927.1183,1,27813113,27813549,436,0.7748308189363785
9819,927.238767,927.273933,1,27817163,27818217,1054,0.7940783249446034
9820,927.2918,927.303033,1,27818754,27819090,336,0.697143889972083
9821,927.510633,927.519033,1,27825318,27825570,252,0.08561374811543206
9822,927.5212,927.531367,1,27825636,27825941,305,-0.08657534674809836
9823,927.573633,927.6023,1,27827208,27828069,861,0.24171972803108077
9824,928.320733,928.3487,1,27849621,27850461,840,0.2970155011593727
9825,928.376367,928.382967,1,27851291,27851489,198,0.8484818450583781
9826,928.388967,928.4023,1,27851669,27852069,400,0.2839713062301958
9827,928.452867,928.4693,1,27853586,27854079,493,0.395023127003391
9828,928.480933,928.5173,1,27854427,27855519,1092,0.16907670094281058
9829,929.404267,929.431767,1,27882128,27882953,825,0.19946007288433926
9830,929.4629,929.476133,1,27883887,27884283,396,0.35414345194028884
9831,929.4793,929.493067,1,27884379,27884792,413,0.07522368267460465
9832,929.5208,929.6341,1,27885624,27889023,3399,0.16434050455132018
9833,929.640133,929.659467,1,27889203,27889784,581,-0.04736966970765682
9834,929.6689,929.826167,1,27890067,27894785,4718,0.1311827257332874
9835,929.844133,929.8627,1,27895323,27895881,558,0.014972406624082966
9836,929.8767,929.892033,1,27896301,27896760,459,0.03717869944937727
9837,929.902367,929.914833,1,27897071,27897444,373,0.42275565816230687
9838,929.931233,929.959167,1,27897936,27898775,839,0.1373837796307727
9839,929.969933,930.012167,1,27899097,27900365,1268,0.07829167274327631
9840,930.013567,930.039033,1,27900407,27901170,763,0.04960397288912962
9841,930.0404,930.060767,1,27901212,27901823,611,0.14046043869148248
9842,930.071667,930.129867,1,27902150,27903896,1746,0.22701048943993676
9843,930.130867,930.143633,1,27903926,27904308,382,0.5818258897742398
9844,930.150933,930.155767,1,27904527,27904673,146,0.9020801780644614
9845,930.1633,930.1673,1,27904899,27905019,120,0.9520571650143216
9846,930.245167,930.2507,1,27907355,27907521,166,0.4950985928773035
9847,930.253367,930.259167,1,27907601,27907775,174,0.866654194743297
9848,930.272167,930.279633,1,27908165,27908388,223,0.8109445027659153
9849,930.3095,930.312533,1,27909285,27909375,90,0.7888120909364416
9850,930.860633,930.898367,1,27925818,27926951,1133,0.05556935680214004
9851,930.911733,930.929967,1,27927351,27927899,548,0.663762582699823
9852,931.1763,931.192433,1,27935289,27935772,483,0.5894055083595835
9853,931.202167,931.2089,1,27936065,27936267,202,0.7314118435542006
9854,931.243533,931.250433,1,27937305,27937512,207,0.84159120236894
9855,931.254767,931.265067,1,27937643,27937952,309,0.8797267558456182
9856,931.2665,931.274233,1,27937995,27938226,231,0.839348737061426
9857,931.320967,931.376433,1,27939629,27941292,1663,0.7486682771351799
9858,931.384533,931.4226,1,27941535,27942678,1143,0.17628181565850795
9859,931.433633,931.440667,1,27943008,27943220,212,0.2593639945416636
9860,931.444867,931.4873,1,27943346,27944619,1273,0.24871881871337373
9861,931.4912,931.509067,1,27944736,27945272,536,0.13828498251949184
9862,931.5114,931.5639,1,27945342,27946917,1575,0.17219141787276865
9863,931.565333,931.606567,1,27946959,27948197,1238,0.1186932651935472
9864,931.6099,931.629533,1,27948297,27948885,588,0.6983300320340797
9865,931.6362,931.640067,1,27949086,27949202,116,0.9126304835362848
9866,931.6472,931.660133,1,27949416,27949803,387,0.22269601252963603
9867,931.664967,931.674667,1,27949949,27950240,291,0.35701672793182915
9868,931.676367,931.6797,1,27950291,27950391,100,0.7845698153806399
9869,931.681433,931.700533,1,27950442,27951015,573,0.2626976004871199
9870,931.7153,931.743933,1,27951459,27952317,858,0.7091917335727136
9871,931.8477,931.969567,1,27955431,27959087,3656,0.4976902267802282
9872,931.977633,931.987433,1,27959328,27959622,294,0.8824272142337626
9873,931.9962,931.999867,1,27959886,27959996,110,0.931143707918521
9874,932.001567,932.005067,1,27960047,27960152,105,0.8945316432550517
9875,932.065067,932.0699,1,27961952,27962097,145,0.8442557117335134
9876,932.0793,932.0892,1,27962379,27962676,297,0.888523484095297
9877,932.093033,932.096167,1,27962790,27962885,95,0.8021686991376481
9878,932.097233,932.136467,1,27962916,27964094,1178,0.7704421138076911
9879,932.137733,932.148433,1,27964131,27964452,321,0.8266647801021132
9880,932.154133,932.159267,1,27964623,27964778,155,0.9535689831100324
9881,932.230333,932.233467,1,27966909,27967004,95,0.944189312291505
9882,932.2879,932.291867,1,27968637,27968756,119,0.8683989450041053
9883,932.3292,932.3328,1,27969876,27969984,108,0.910982082868716
9884,932.506467,932.516733,1,27975194,27975501,307,0.6436226960736365
9885,932.633,932.6368,1,27978990,27979104,114,0.777641480057061
9886,932.696533,932.703633,1,27980895,27981108,213,0.17131507430705645
9887,932.7152,932.725433,1,27981456,27981762,306,0.8094174308232003
9888,932.735233,932.742333,1,27982056,27982269,213,0.7891184798424886
9889,932.766633,932.7697,1,27982998,27983091,93,0.9727714801518301
9890,932.814233,932.8205,1,27984426,27984615,189,0.8956533815228638
9891,932.832367,932.843333,1,27984971,27985299,328,0.6345275016452588
9892,932.8484,932.8515,1,27985452,27985545,93,0.42587351208904484
9893,933.031733,933.0719,1,27990951,27992157,1206,0.7780582488445785
9894,933.077867,933.081133,1,27992336,27992433,97,0.8730934341538357
9895,933.082767,933.0858,1,27992483,27992574,91,0.8870574822595864
9896,933.087433,933.092667,1,27992622,27992780,158,0.8487316507288665
9897,933.1612,933.166533,1,27994836,27994995,159,0.908321317884704
9898,933.373133,933.3771,1,28001193,28001313,120,0.8084384070121804
9899,933.4095,933.484567,1,28002285,28004537,2252,0.6982497321902045
9900,933.656567,933.732367,1,28009697,28011971,2274,0.6488124588118944
9901,933.733433,933.782233,1,28012002,28013466,1464,0.7086746560036987
9902,935.273667,935.2839,1,28058210,28058517,307,0.8024539646949818
9903,935.3042,935.317533,1,28059126,28059525,399,0.8098910594141784
9904,935.3192,935.323167,1,28059576,28059695,119,0.8256321932241802
9905,935.324967,935.3582,1,28059749,28060746,997,0.8525083354252956
9906,935.371267,935.383667,1,28061138,28061510,372,0.7702371386554906
9907,935.542933,935.598,1,28066287,28067940,1653,0.8193392817855761
9908,935.602333,935.606067,1,28068069,28068182,113,0.8825545843387745
9909,935.7989,935.802767,1,28073967,28074083,116,0.020568205006597177
9910,936.2362,936.270933,1,28087086,28088127,1041,0.7849645726508737
9911,936.271933,936.287067,1,28088157,28088612,455,0.9262946002875043
9912,936.295367,936.3082,1,28088861,28089246,385,0.6504984113822899
9913,936.380033,936.388067,1,28091400,28091642,242,0.6649752972695869
9914,936.392233,936.398,1,28091766,28091940,174,0.8433163010985361
9915,936.461733,936.472967,1,28093851,28094189,338,0.5980108177930596
9916,936.506467,936.5354,1,28095194,28096062,868,0.278118158515437
9917,936.562767,936.566367,1,28096883,28096991,108,0.3263348869022429
9918,936.7106,936.8418,1,28101318,28105254,3936,0.6861839222214079
9919,936.847467,937.012033,1,28105424,28110360,4936,0.6196818749055569
9920,937.013033,937.020567,1,28110390,28110617,227,0.8229137516597804
9921,937.027367,937.032667,1,28110821,28110980,159,0.8865688407354222
9922,937.0338,937.044,1,28111014,28111320,306,0.8202144019373476
9923,937.059133,937.0743,1,28111773,28112229,456,0.7328632918882888
9924,937.080067,937.1445,1,28112402,28114335,1933,0.6343191394501663
9925,937.1648,937.7078,1,28114944,28131234,16290,0.5323794744323803
9926,937.708833,937.715867,1,28131264,28131476,212,0.8844203273100834
9927,937.8042,937.807933,1,28134126,28134237,111,0.9570472120334526
9928,937.824033,937.8295,1,28134720,28134885,165,0.8251054672322301
9929,937.8406,937.8503,1,28135218,28135509,291,0.8662720595792778
9930,937.968733,937.974833,1,28139061,28139244,183,0.9371421397036293
9931,937.9853,937.9944,1,28139559,28139832,273,0.7529202477277543
9932,938.021433,938.026567,1,28140642,28140797,155,0.7081890768792565
9933,938.136533,938.142667,1,28144095,28144280,185,0.8295083778854453
9934,938.235533,938.239467,1,28147065,28147184,119,0.793987946666892
9935,938.404867,938.4124,1,28152146,28152372,226,0.695142842361031
9936,938.485733,938.496533,1,28154571,28154895,324,0.8422712285771571
9937,938.499733,938.502733,1,28154991,28155081,90,0.6935683353012106
9938,938.514967,938.523233,1,28155449,28155696,247,0.8969333225440668
9939,938.5636,938.5857,1,28156908,28157571,663,0.7075030319556411
9940,938.823967,938.854633,1,28164719,28165638,919,0.48589543000222474
9941,938.913733,938.919933,1,28167411,28167597,186,0.4667118613381154
9942,938.937,938.947533,1,28168110,28168425,315,0.8033166978538387
9943,939.022267,939.113567,1,28170668,28173407,2739,0.6018595371978313
9944,939.1327,939.1367,1,28173981,28174101,120,0.9312458988190138
9945,940.671367,940.6773,1,28220141,28220319,178,0.12995944886741073
9946,941.233933,941.2434,1,28237017,28237302,285,0.6070176431591983
9947,941.5803,941.596933,1,28247409,28247907,498,0.5856144990137869
9948,941.6053,941.609367,1,28248159,28248281,122,0.9328038168961221
9949,941.931167,941.934333,1,28257935,28258029,94,0.6157698441231275
9950,942.0094,942.0134,1,28260282,28260402,120,0.7396476082319778
9951,942.057433,942.104033,1,28261722,28263120,1398,0.4514273982823704
9952,942.129267,942.210833,1,28263878,28266324,2446,0.7136457587384988
9953,942.261767,942.290333,1,28267853,28268709,856,0.7097985157895951
9954,942.305167,942.382233,1,28269155,28271466,2311,0.6338626654593179
9955,942.383633,942.400633,1,28271508,28272018,510,0.8557423402390628
9956,942.402233,942.5122,1,28272066,28275366,3300,0.6410438137760202
9957,942.5458,942.5495,1,28276374,28276485,111,0.749420449036259
9958,942.558367,942.561733,1,28276751,28276851,100,0.7229365001897109
9959,942.567333,942.5764,1,28277019,28277292,273,0.7137079591708071
9960,942.5816,942.585767,1,28277448,28277573,125,0.8911257786135858
9961,942.890267,942.896333,1,28286708,28286889,181,0.8954326638297562
9962,942.9631,942.9882,1,28288893,28289646,753,0.8859293218960173
9963,942.989233,943.234533,1,28289676,28297035,7359,0.5355794491672995
9964,943.277867,943.281,1,28298336,28298430,94,0.11760834049910339
9965,943.402933,943.4655,1,28302087,28303965,1878,0.14422616142667427
9966,943.4689,943.474833,1,28304067,28304244,177,0.8532067551895657
9967,943.4807,943.489433,1,28304421,28304682,261,0.5662351153419602
9968,943.957767,943.998733,1,28318733,28319961,1228,0.6624501434091012
9969,944.064,944.192933,1,28321920,28325787,3867,0.08482261366996859
9970,944.202033,944.308533,1,28326060,28329255,3195,0.7365212943792679
9971,944.496267,944.4996,1,28334888,28334988,100,0.6573925903238824
9972,944.502233,944.510333,1,28335066,28335309,243,0.8447483384877622
9973,944.604733,944.613667,1,28338141,28338410,269,0.30418342113957914
9974,944.623233,944.627767,1,28338696,28338833,137,0.8553416349674288
9975,944.773033,944.776367,1,28343190,28343291,101,0.8829822871567956
9976,944.779433,944.784133,1,28343382,28343523,141,0.8460219063988107
9977,944.7863,944.800867,1,28343589,28344026,437,0.9287051158012277
9978,944.8255,944.829933,1,28344765,28344897,132,0.7889230715538083
9979,944.8315,944.835233,1,28344945,28345056,111,0.8764625195213489
9980,944.867,944.875867,1,28346010,28346276,266,0.30306577783944383
9981,944.885767,944.895,1,28346573,28346850,277,0.74910480760933
9982,944.897833,944.9019,1,28346934,28347057,123,0.5231334532406782
9983,944.9667,944.9699,1,28349001,28349097,96,0.8476955117008579
9984,945.159467,945.162533,1,28354784,28354875,91,0.8900252156685796
9985,945.179867,945.183733,1,28355396,28355511,115,0.7995069642906393
9986,945.184767,945.195833,1,28355543,28355874,331,0.8093674756080594
9987,945.197133,945.203133,1,28355913,28356093,180,0.9436291585660981
9988,945.235033,945.239733,1,28357050,28357191,141,0.4271118595049113
9989,945.516867,945.519967,1,28365506,28365599,93,0.39878459945668226
9990,946.573667,946.5903,1,28397210,28397709,499,0.26771147936721845
9991,946.592,946.6428,1,28397760,28399284,1524,0.23654078397837972
9992,946.6524,946.656967,1,28399572,28399709,137,0.6521911773458579
9993,946.658533,946.6674,1,28399755,28400022,267,0.37340952219322726
9994,946.7043,946.707433,1,28401129,28401222,93,0.8875398605197453
9995,946.714833,946.7181,1,28401444,28401543,99,-0.28245603475378417
9996,946.721,946.7277,1,28401630,28401831,201,0.8119973742915843
9997,946.743833,946.806267,1,28402314,28404188,1874,0.4213319939053106
9998,946.810367,946.8157,1,28404311,28404471,160,0.4677269530442138
9999,946.8236,946.8364,1,28404708,28405092,384,0.4083510382806734
10000,946.8402,946.8594,1,28405206,28405782,576,0.3158558782345994
10001,946.860867,946.9248,1,28405826,28407744,1918,0.3175179084554684
10002,946.925867,946.931233,1,28407776,28407936,160,0.8298068618119491
10003,946.973067,946.9823,1,28409192,28409469,277,0.8355539155671524
10004,947.395633,947.399133,1,28421868,28421973,105,0.7128289023861932
10005,947.631233,947.648,1,28428936,28429440,504,0.0585988086115072
10006,948.095467,948.104467,1,28442864,28443134,270,0.5307616589963575
10007,948.116833,948.123533,1,28443504,28443705,201,0.08913785904545661
10008,948.373,948.376367,1,28451190,28451291,101,0.8195904768952978
10009,948.585133,948.590067,1,28457553,28457702,149,0.853425761930247
10010,948.5911,948.5989,1,28457733,28457967,234,0.614940084954386
10011,948.640667,948.646767,1,28459220,28459403,183,0.7009489901681853
10012,948.648,948.714933,1,28459440,28461447,2007,0.11274726454715922
10013,948.717467,948.731433,1,28461524,28461942,418,0.4960940287530283
10014,948.762767,948.8002,1,28462883,28464006,1123,0.13139336353981673
10015,948.802067,948.822033,1,28464062,28464660,598,0.5545526591520323
10016,948.834433,948.8751,1,28465032,28466253,1221,0.32635698445054623
10017,948.876167,948.881867,1,28466285,28466456,171,0.8620338639160073
10018,948.882967,949.096533,1,28466489,28472895,6406,0.7062410330023332
10019,949.1794,949.213467,1,28475382,28476404,1022,0.6316808416089311
10020,950.226467,950.230067,1,28506794,28506902,108,0.7652560700040107
10021,953.093633,953.1038,1,28592808,28593114,306,0.46705768825663974
10022,953.5465,953.609233,1,28606395,28608276,1881,0.22193377364368563
10023,953.615833,953.713633,1,28608474,28611408,2934,0.2101145478678936
10024,953.7195,953.778567,1,28611585,28613357,1772,0.22048627420391564
10025,953.7843,953.7875,1,28613529,28613625,96,0.9312079002120642
10026,953.797867,953.966833,1,28613936,28619004,5068,0.20479801529137204
10027,954.042567,954.058,1,28621277,28621740,463,0.5617521259988144
10028,954.161633,954.177467,1,28624848,28625324,476,0.050061268447241944
10029,954.178733,954.200833,1,28625361,28626024,663,0.20204158701954925
10030,954.315367,954.321767,1,28629461,28629653,192,0.48286312927878866
10031,954.330667,954.340367,1,28629920,28630211,291,0.6711267010159199
10032,954.3476,954.3628,1,28630428,28630884,456,0.13169354850115833
10033,954.367333,954.3802,1,28631019,28631406,387,0.40461355903668617
10034,954.387467,954.403933,1,28631624,28632117,493,0.3133876344525965
10035,954.4082,954.414833,1,28632246,28632444,198,0.7527935261012464
10036,954.4203,954.423633,1,28632609,28632708,99,0.9536270248518569
10037,954.433433,954.454667,1,28633002,28633640,638,0.26227219606857044
10038,954.4646,954.468433,1,28633938,28634052,114,0.8238525289881614
10039,954.474167,954.4855,1,28634225,28634565,340,0.6914566825732908
10040,954.487433,954.4939,1,28634622,28634817,195,0.8572150982978177
10041,954.5008,954.5056,1,28635024,28635168,144,0.6753847507570225
10042,954.5115,954.525933,1,28635345,28635777,432,0.6142043851209817
10043,954.567833,954.5734,1,28637034,28637202,168,0.8966155154409635
10044,954.591667,954.6086,1,28637750,28638258,508,0.7920557053473373
10045,954.611267,954.618233,1,28638338,28638546,208,0.8656115389294339
10046,954.633567,954.679,1,28639007,28640370,1363,0.5133562706919129
10047,954.724033,954.727233,1,28641720,28641816,96,0.954807363327593
10048,954.731367,954.7474,1,28641941,28642422,481,0.5825669972829034
10049,954.749467,954.7535,1,28642484,28642605,121,0.6279190217191845
10050,954.770967,954.795567,1,28643129,28643867,738,0.69553379467173
10051,954.820533,954.8389,1,28644615,28645167,552,0.8193795858955096
10052,954.839933,954.880267,1,28645197,28646408,1211,0.3540616798988262
10053,954.9041,954.915867,1,28647123,28647476,353,0.6732007677897711
10054,954.9323,954.935567,1,28647969,28648067,98,0.9075480466825402
10055,954.940167,954.943267,1,28648205,28648298,93,0.4471475574547102
10056,954.946233,954.980167,1,28648386,28649405,1019,0.8317914520688319
10057,954.993,955.005167,1,28649790,28650155,365,0.8330593324710097
10058,955.0266,955.032467,1,28650798,28650974,176,0.9273103400450529
10059,955.034433,955.054267,1,28651032,28651628,596,0.8743468665977235
10060,955.055467,955.067233,1,28651664,28652016,352,0.8205352262706083
10061,955.068433,955.071467,1,28652052,28652144,92,0.7523327268204058
10062,955.178033,955.1857,1,28655340,28655571,231,0.7707650421082535
10063,955.196933,955.201967,1,28655907,28656059,152,0.9616362335155407
10064,955.214533,955.2302,1,28656435,28656906,471,0.8884855962952717
10065,955.231367,955.2358,1,28656941,28657074,133,0.9085479927920209
10066,955.245667,955.281067,1,28657370,28658432,1062,0.8857587590829019
10067,955.292667,955.3137,1,28658780,28659411,631,0.8919086420167418
10068,955.329933,955.386433,1,28659897,28661592,1695,0.4636468569574869
10069,955.387433,955.400667,1,28661622,28662020,398,0.8154181678217398
10070,955.405,955.410933,1,28662150,28662327,177,0.9252059595328663
10071,955.418133,955.498833,1,28662543,28664964,2421,0.8274230831217154
10072,955.531067,955.539933,1,28665932,28666197,265,0.7688298417259601
10073,955.549333,955.5534,1,28666479,28666602,123,0.6291787358402408
10074,955.563467,955.569567,1,28666904,28667087,183,0.8262746934661068
10075,955.598633,955.629667,1,28667958,28668890,932,0.8439609406857661
10076,955.6308,955.6424,1,28668924,28669272,348,0.866411972450477
10077,955.65,955.7314,1,28669500,28671942,2442,0.8101990950641401
10078,955.733267,955.737467,1,28671998,28672124,126,0.8967085290141241
10079,955.7533,955.7571,1,28672599,28672713,114,0.8502008005065601
10080,955.777133,955.8296,1,28673313,28674888,1575,0.8987609847595716
10081,955.830667,955.834367,1,28674920,28675031,111,0.8982921673507728
10082,955.841167,955.8449,1,28675235,28675347,112,0.8833708390907351
10083,955.866133,955.8756,1,28675983,28676268,285,0.867223676089124
10084,955.876767,955.8871,1,28676303,28676613,310,0.8647625560354604
10085,955.888867,955.892033,1,28676666,28676760,94,0.7935606238844785
10086,955.907533,955.912333,1,28677225,28677369,144,0.9145455085396638
10087,955.916767,955.926433,1,28677503,28677792,289,0.8733788044147681
10088,956.010733,956.020667,1,28680321,28680620,299,0.7653859765372445
10089,956.025767,956.129567,1,28680773,28683887,3114,0.7472659518898068
10090,956.143533,956.151267,1,28684305,28684538,233,0.9387641885072755
10091,956.157367,956.1618,1,28684721,28684854,133,0.802623969941821
10092,956.1628,956.1888,1,28684884,28685664,780,0.8287257804382556
10093,956.1898,956.195067,1,28685694,28685852,158,0.7106515517225669
10094,956.2215,956.236433,1,28686645,28687092,447,0.7530116664459452
10095,956.252967,956.262333,1,28687589,28687869,280,0.8024577677190199
10096,956.2666,956.2728,1,28687998,28688184,186,0.8764113174802732
10097,956.276967,956.284033,1,28688309,28688520,211,0.8523094298601334
10098,956.322633,956.331867,1,28689678,28689956,278,0.7939988709981387
10099,956.351667,956.354733,1,28690550,28690641,91,0.8382355599192054
10100,956.3594,956.3624,1,28690782,28690872,90,0.6229847374133619
10101,956.371133,956.396533,1,28691133,28691895,762,0.722109009428049
10102,956.418967,956.425167,1,28692569,28692755,186,0.8488314879205576
10103,956.4269,956.4307,1,28692807,28692921,114,0.4841846524950046
10104,956.440433,956.456367,1,28693212,28693691,479,0.893224913991992
10105,956.459867,956.478033,1,28693796,28694340,544,0.837929036340402
10106,956.485133,956.518133,1,28694553,28695543,990,0.604246151766903
10107,956.5236,956.569567,1,28695708,28697087,1379,0.7410699201212716
10108,956.5709,956.586867,1,28697127,28697606,479,0.5862040883678711
10109,956.590267,956.593567,1,28697708,28697807,99,0.8732488317057311
10110,956.600267,956.603433,1,28698008,28698102,94,0.8975962106914834
10111,956.604467,956.655767,1,28698134,28699673,1539,0.7893398680304435
10112,956.661567,956.668133,1,28699847,28700043,196,0.4678748352482903
10113,956.6822,956.7165,1,28700466,28701495,1029,0.5372176886165397
10114,956.7436,956.762,1,28702308,28702860,552,0.4488678469792312
10115,956.7712,956.7926,1,28703136,28703778,642,0.560541924591997
10116,956.794767,956.832833,1,28703843,28704984,1141,0.7456623649066828
10117,956.8339,956.878033,1,28705017,28706340,1323,0.6755013362289981
10118,956.8793,956.950267,1,28706379,28708508,2129,0.6006950596548011
10119,956.957067,956.965333,1,28708712,28708959,247,0.8238249985011931
10120,956.9674,957.020633,1,28709022,28710618,1596,0.7333571738481475
10121,957.044333,957.047733,1,28711329,28711431,102,0.8551274580790178
10122,957.061267,957.101733,1,28711838,28713051,1213,0.490894388873101
10123,957.102967,957.157,1,28713089,28714710,1621,0.4472668641935608
10124,957.1637,957.171667,1,28714911,28715150,239,0.9288594051491592
10125,957.1728,957.1897,1,28715184,28715691,507,0.6963732109020986
10126,957.1945,957.220367,1,28715835,28716611,776,0.8505141295807324
10127,957.286867,957.321433,1,28718606,28719642,1036,0.7300817056885959
10128,957.322633,957.348567,1,28719678,28720457,779,0.7625121913909996
10129,957.350433,957.3552,1,28720512,28720656,144,0.8584450149857535
10130,957.374433,957.378467,1,28721232,28721354,122,0.7532298881238476
10131,957.411233,957.4154,1,28722336,28722462,126,0.7400939676276496
10132,957.423833,957.443433,1,28722714,28723302,588,0.8198742111448947
10133,957.4492,957.5164,1,28723476,28725492,2016,0.6593257396053629
10134,957.5226,957.546033,1,28725678,28726380,702,0.6818561168932593
10135,957.574267,957.577333,1,28727228,28727319,91,-0.27125019067981543
10136,957.578733,957.582767,1,28727361,28727483,122,0.5102958814303664
10137,957.586033,957.6101,1,28727580,28728303,723,0.6899732305270491
10138,957.6161,957.649333,1,28728483,28729479,996,0.8055239377802518
10139,957.650633,957.654133,1,28729518,28729623,105,0.7433196803418703
10140,957.655633,957.661233,1,28729668,28729836,168,0.42197048912804286
10141,957.667033,957.675433,1,28730010,28730262,252,0.7635813583185534
10142,957.678533,957.6832,1,28730355,28730496,141,0.9149454629639928
10143,957.700733,957.716367,1,28731021,28731491,470,0.8768155744588109
10144,957.718633,957.766733,1,28731558,28733001,1443,0.8667193613244336
10145,957.777233,957.784967,1,28733316,28733549,233,0.8538751095064857
10146,957.8541,957.858333,1,28735623,28735749,126,0.82098079247075
10147,957.882333,957.8942,1,28736469,28736826,357,0.8859654165122494
10148,957.9076,957.9127,1,28737228,28737381,153,0.8765347721772233
10149,957.913933,957.960633,1,28737417,28738818,1401,0.8899641865299773
10150,957.961867,957.9769,1,28738856,28739307,451,0.4924598210717664
10151,957.9792,957.982933,1,28739376,28739487,111,0.7601681579252143
10152,958.020167,958.0373,1,28740605,28741119,514,0.7491122445568471
10153,958.043133,958.049333,1,28741293,28741479,186,0.7857874058516167
10154,958.050733,958.058833,1,28741521,28741764,243,0.8740554626150636
10155,958.093433,958.098767,1,28742802,28742963,161,0.9376781981750016
10156,958.1029,958.1073,1,28743087,28743219,132,0.7223416333245446
10157,958.1083,958.157767,1,28743249,28744733,1484,0.8880709930809009
10158,958.174767,958.195167,1,28745243,28745855,612,0.6339910955050796
10159,958.196633,958.253067,1,28745898,28747592,1694,0.6995206273057544
10160,958.2598,958.2727,1,28747794,28748181,387,0.8221439010447438
10161,958.278867,958.4101,1,28748366,28752303,3937,0.6937930798260029
10162,958.4135,958.436333,1,28752405,28753089,684,0.49640876444657944
10163,958.437567,958.445967,1,28753127,28753379,252,0.7541603850592489
10164,958.448167,958.4517,1,28753445,28753551,106,0.8232611697630773
10165,958.454933,958.465633,1,28753647,28753968,321,0.6447363450586026
10166,958.4681,958.4878,1,28754043,28754634,591,0.7133509971700691
10167,958.489533,958.4961,1,28754685,28754883,198,0.8322579350890583
10168,958.514167,958.574367,1,28755425,28757231,1806,0.37810953104095446
10169,958.583333,958.587433,1,28757499,28757622,123,0.6755915263520417
10170,958.589233,958.596867,1,28757676,28757906,230,0.9237997559543116
10171,958.605633,958.6097,1,28758168,28758291,123,0.9582216204397046
10172,958.612267,958.6155,1,28758368,28758465,97,0.9529849252286113
10173,958.618067,958.623867,1,28758542,28758716,174,0.9462664871596529
10174,958.625133,958.632667,1,28758753,28758980,227,0.953786163454893
10175,958.634167,958.642933,1,28759025,28759287,262,0.42111255840794404
10176,958.6478,958.6509,1,28759434,28759527,93,0.9296980133294125
10177,958.652133,958.655167,1,28759563,28759655,92,0.9527353532336565
10178,958.657367,958.675933,1,28759721,28760277,556,0.7671312961226993
10179,958.6778,958.718467,1,28760334,28761554,1220,0.5916323417987956
10180,958.721033,958.7268,1,28761630,28761804,174,0.835852658520896
10181,958.736433,958.743233,1,28762092,28762296,204,0.3877618449736225
10182,958.744733,958.752667,1,28762341,28762580,239,0.8319247245360761
10183,958.7566,958.7624,1,28762698,28762872,174,0.8618440860130832
10184,958.7748,958.780833,1,28763244,28763424,180,0.9064553081953844
10185,958.784033,958.788567,1,28763520,28763657,137,0.8995270701498349
10186,958.792533,958.852267,1,28763775,28765568,1793,0.6752029690029728
10187,958.855367,958.903067,1,28765661,28767092,1431,0.5213715971814487
10188,958.904133,958.908833,1,28767123,28767264,141,0.7120223023401989
10189,958.909967,958.959533,1,28767299,28768785,1486,0.3326111138335633
10190,958.976267,959.001167,1,28769288,28770035,747,0.8040035859911078
10191,959.0133,959.0632,1,28770399,28771896,1497,0.7954175122274939
10192,959.070733,959.104567,1,28772121,28773137,1016,0.30508500711847447
10193,959.1213,959.1243,1,28773639,28773729,90,0.7844863581803994
10194,959.126233,959.1408,1,28773786,28774224,438,0.7932917574104392
10195,959.1427,959.1575,1,28774281,28774725,444,0.7989003475099923
10196,959.159133,959.163833,1,28774773,28774914,141,0.38314576473724715
10197,959.165367,959.181267,1,28774961,28775438,477,0.7806831655900063
10198,959.182667,959.193167,1,28775480,28775795,315,0.7209045930828627
10199,959.195367,959.2589,1,28775861,28777767,1906,0.8516276991923198
10200,959.260533,959.281233,1,28777815,28778436,621,0.8583681285923969
10201,959.296533,959.315833,1,28778895,28779474,579,0.6936208624380782
10202,959.3197,959.3462,1,28779591,28780386,795,0.7764740385810579
10203,959.3499,959.358833,1,28780497,28780764,267,0.8337702819930934
10204,959.359867,959.375133,1,28780796,28781253,457,0.6138557598435643
10205,959.378767,959.3914,1,28781363,28781742,379,0.8588661137757299
10206,959.396133,959.440967,1,28781883,28783229,1346,0.8404507168082676
10207,959.442167,959.469167,1,28783265,28784075,810,0.7172549234722583
10208,959.4756,959.508133,1,28784268,28785243,975,0.7790025817645533
10209,959.5093,959.513867,1,28785279,28785416,137,0.6813932565520225
10210,959.5209,959.524967,1,28785627,28785749,122,0.6394200388458188
10211,959.525967,959.529733,1,28785779,28785891,112,0.7881121793158679
10212,959.5318,959.537133,1,28785954,28786113,159,0.5931665340377092
10213,959.5385,959.547467,1,28786155,28786424,269,0.5756615747499851
10214,959.570367,959.575,1,28787111,28787250,139,0.13127216391642263
10215,959.576033,959.579967,1,28787280,28787399,119,0.38968972543737107
10216,959.6403,959.6929,1,28789209,28790787,1578,0.915397084848098
10217,959.695933,959.7118,1,28790877,28791354,477,0.4961453929063302
10218,959.725567,959.735167,1,28791767,28792055,288,0.7769466269582324
10219,959.754,959.761267,1,28792620,28792838,218,0.6703137151346147
10220,959.7635,959.774567,1,28792905,28793237,332,0.8380719632872382
10221,959.7767,959.8288,1,28793301,28794864,1563,0.6919940197326775
10222,959.830367,959.838533,1,28794911,28795155,244,0.9001853653516764
10223,959.842133,959.852733,1,28795263,28795581,318,0.8163319943747362
10224,959.854333,959.868033,1,28795629,28796040,411,0.6147424187460205
10225,959.869067,959.875267,1,28796072,28796258,186,0.8890017152444863
10226,959.882167,959.886933,1,28796465,28796607,142,0.913492994161836
10227,959.8989,959.963367,1,28796967,28798901,1934,0.6117276605777273
10228,959.9723,959.977833,1,28799169,28799334,165,0.8908234307264661
10229,959.979867,959.997033,1,28799396,28799910,514,0.7871305746439861
10230,960.0095,960.0581,1,28800285,28801743,1458,0.7535732071675949
10231,960.059333,960.120033,1,28801779,28803600,1821,0.8633172086731388
10232,960.122133,960.1353,1,28803663,28804059,396,0.7669374179781528
10233,960.137233,960.140633,1,28804116,28804218,102,0.943498300502209
10234,960.147733,960.159167,1,28804431,28804775,344,0.7408813146892637
10235,960.160433,960.173633,1,28804812,28805208,396,0.5749573151751235
10236,960.214533,960.217733,1,28806435,28806531,96,0.9769636861256141
10237,960.219633,960.247167,1,28806588,28807415,827,0.7651448252026996
10238,960.248333,960.256333,1,28807449,28807689,240,0.6856438375297214
10239,960.2621,960.279933,1,28807863,28808397,534,0.7743718172258253
10240,960.2826,960.2924,1,28808478,28808772,294,0.5430552582677518
10241,960.296233,960.350233,1,28808886,28810506,1620,0.7034713930549349
10242,960.3513,960.3671,1,28810539,28811013,474,0.38186015780337135
10243,960.3697,960.394833,1,28811091,28811844,753,0.8099727482508818
10244,960.396533,960.480467,1,28811895,28814414,2519,0.6022149781856946
10245,960.4825,960.497467,1,28814475,28814924,449,0.781762642766528
10246,960.499267,960.5079,1,28814978,28815237,259,0.6250814861701146
10247,960.509,960.5453,1,28815270,28816359,1089,0.5809128959897284
10248,960.549033,960.5558,1,28816470,28816674,204,0.6387690323213493
10249,960.556833,960.5637,1,28816704,28816911,207,0.7548341372016962
10250,960.564767,960.574,1,28816943,28817220,277,0.7639138258372732
10251,960.5765,960.6272,1,28817295,28818816,1521,0.7196741866031464
10252,960.6361,960.6509,1,28819083,28819527,444,0.6520681430862018
10253,960.6557,960.661233,1,28819671,28819836,165,0.8887265846227339
10254,960.666833,960.681367,1,28820004,28820441,437,0.42558495591836615
10255,960.684867,960.6957,1,28820546,28820871,325,0.8335666327678765
10256,960.697333,960.7069,1,28820919,28821207,288,0.42520246567674996
10257,960.709267,960.7254,1,28821278,28821762,484,0.8063477060325173
10258,960.726933,960.751633,1,28821807,28822548,741,0.7069812694615256
10259,960.766067,960.772467,1,28822982,28823174,192,0.8391483122924984
10260,960.773733,960.790133,1,28823211,28823703,492,0.6459182730994082
10261,960.806433,960.837867,1,28824192,28825136,944,0.41506501335528134
10262,960.862367,960.875433,1,28825871,28826262,391,0.9148667344115043
10263,960.9296,960.9362,1,28827888,28828086,198,0.7652423681571441
10264,960.937467,960.946167,1,28828124,28828385,261,0.7340006074440977
10265,960.9531,960.977467,1,28828593,28829324,731,0.43480290505238206
10266,960.9855,961.001733,1,28829565,28830051,486,0.8605944739715189
10267,961.006133,961.034233,1,28830183,28831026,843,0.754598878315707
10268,961.035633,961.049767,1,28831068,28831493,425,0.8240182440957932
10269,961.1601,961.2361,1,28834803,28837083,2280,0.3452009810638176
10270,961.238033,961.262467,1,28837140,28837874,734,0.8663888448148569
10271,961.267633,961.278067,1,28838028,28838342,314,0.8009608121069655
10272,961.279233,961.326867,1,28838376,28839806,1430,0.6583138992103439
10273,961.375933,961.390767,1,28841277,28841723,446,0.7459723423636969
10274,961.3942,961.434033,1,28841826,28843020,1194,0.5451272349329682
10275,961.436533,961.4422,1,28843095,28843266,171,0.9722105786669841
10276,961.443933,961.4577,1,28843317,28843731,414,0.9050543310846401
10277,961.4592,961.466533,1,28843776,28843995,219,0.6870050264966989
10278,961.467667,961.4759,1,28844030,28844277,247,0.8139967652933456
10279,961.4775,961.483367,1,28844325,28844501,176,0.7308131821024201
10280,961.502233,961.520667,1,28845066,28845620,554,0.599627859205933
10281,961.5224,961.538567,1,28845672,28846157,485,0.8455155332898971
10282,961.569367,961.5724,1,28847081,28847172,91,0.9014207775526392
10283,961.5815,961.5922,1,28847445,28847766,321,0.9100206355808611
10284,961.632833,961.639667,1,28848984,28849190,206,0.7475165045299024
10285,961.6453,961.658567,1,28849359,28849757,398,0.5984584802365154
10286,961.671867,961.691533,1,28850156,28850745,589,0.7625751958609834
10287,961.696367,961.734033,1,28850891,28852020,1129,0.725700993324
10288,961.739267,961.765433,1,28852178,28852962,784,0.5562618330563831
10289,961.786333,961.800467,1,28853589,28854014,425,0.3541921652176916
10290,961.801633,961.806067,1,28854048,28854182,134,0.8338359943247657
10291,961.816867,961.8237,1,28854506,28854711,205,0.858328323778208
10292,961.827233,961.830267,1,28854816,28854908,92,0.8177670586987704
10293,961.845833,961.856633,1,28855374,28855698,324,0.4693677044599896
10294,961.8628,961.8659,1,28855884,28855977,93,0.8809519160570773
10295,961.869767,961.880933,1,28856093,28856427,334,0.11394033833556527
10296,961.881967,961.893067,1,28856459,28856792,333,0.7536212682786647
10297,961.897567,961.905833,1,28856927,28857174,247,0.4353515810446912
10298,961.9103,961.958033,1,28857309,28858740,1431,0.3318214303306318
10299,961.9695,962.0181,1,28859085,28860543,1458,0.8599958081484368
10300,962.031867,962.057167,1,28860956,28861715,759,0.38606754792963355
10301,962.059167,962.0737,1,28861775,28862211,436,0.9574712139514999
10302,962.075,962.081967,1,28862250,28862459,209,0.9241765596668317
10303,962.083033,962.091367,1,28862490,28862741,251,0.85700115048303
10304,962.0944,962.1004,1,28862832,28863012,180,0.8973769252025673
10305,962.117033,962.1362,1,28863510,28864086,576,0.61011752930005
10306,962.1374,962.169433,1,28864122,28865082,960,0.7548521022576044
10307,962.184067,962.188233,1,28865522,28865646,124,0.44734457865621047
10308,962.203233,962.213333,1,28866096,28866399,303,0.7628846951336598
10309,962.214333,962.220567,1,28866429,28866617,188,0.8758032484902211
10310,962.2383,962.257933,1,28867149,28867737,588,0.8719766918656795
10311,962.2596,962.265233,1,28867788,28867956,168,0.7517304144565788
10312,962.2668,962.3009,1,28868004,28869027,1023,0.8481951048419848
10313,962.3034,962.306967,1,28869102,28869209,107,0.9028421507863679
10314,962.310367,962.320133,1,28869311,28869603,292,0.9355211786675891
10315,962.3454,962.359167,1,28870362,28870775,413,0.5307312246930277
10316,962.368067,962.382667,1,28871042,28871480,438,0.2530066887245242
10317,962.393933,962.397567,1,28871817,28871927,110,0.5956947735101831
10318,962.4122,962.4274,1,28872366,28872822,456,0.6657292504005274
10319,962.4284,962.433633,1,28872852,28873008,156,0.9037266567131704
10320,962.437667,962.444267,1,28873130,28873328,198,0.8490929658253796
10321,962.446367,962.4571,1,28873391,28873713,322,0.8494659291473032
10322,962.516267,962.520467,1,28875488,28875614,126,0.7947634732617266
10323,962.5215,962.546567,1,28875645,28876397,752,0.8793690158450768
10324,962.582433,962.595667,1,28877472,28877870,398,0.3188456930248871
10325,962.6173,962.801533,1,28878519,28884045,5526,0.26515814850337216
10326,962.8163,962.870033,1,28884489,28886100,1611,0.6704403098940249
10327,962.8719,962.9057,1,28886157,28887171,1014,0.5101604037619003
10328,962.916267,962.946533,1,28887488,28888395,907,0.6009737488417441
10329,962.9563,962.9813,1,28888689,28889439,750,0.5744128739353349
10330,962.9827,962.991867,1,28889481,28889756,275,0.7993260482906901
10331,962.999833,963.060833,1,28889994,28891824,1830,0.5384404136106284
10332,963.063933,963.092667,1,28891917,28892780,863,0.6074208381832644
10333,963.0955,963.099267,1,28892865,28892978,113,0.8684377107728324
10334,963.1017,963.106867,1,28893051,28893206,155,0.2153937480526853
10335,963.110667,963.174633,1,28893320,28895238,1918,0.7189925373665051
10336,963.1817,963.186433,1,28895451,28895592,141,0.8409063256355569
10337,963.1936,963.2049,1,28895808,28896147,339,0.6772962888866026
10338,963.206367,963.227,1,28896191,28896810,619,0.4298442704032577
10339,963.232067,963.267267,1,28896962,28898018,1056,0.6740932526770749
10340,963.2714,963.275433,1,28898142,28898262,120,0.39891128070968884
10341,963.279267,963.2987,1,28898378,28898961,583,0.16176925845555623
10342,963.3002,963.336333,1,28899006,28900089,1083,0.6995507162222172
10343,963.3395,963.346533,1,28900185,28900395,210,0.6168037948759855
10344,963.361033,963.365333,1,28900830,28900959,129,0.8946965489921779
10345,963.3751,963.3888,1,28901253,28901664,411,0.7770629011948745
10346,963.391367,963.396233,1,28901741,28901886,145,0.8144125175583362
10347,963.4059,963.442467,1,28902177,28903274,1097,0.8055351109937477
10348,963.450267,963.454,1,28903508,28903620,112,0.623337566620863
10349,963.464667,963.497267,1,28903940,28904918,978,0.5661320193456132
10350,963.507233,963.514133,1,28905216,28905423,207,0.8121564627458707
10351,963.5198,963.525567,1,28905594,28905767,173,0.9456204175745325
10352,963.526667,963.557167,1,28905800,28906715,915,0.634191389803872
10353,963.558333,963.572233,1,28906749,28907166,417,0.7459451737944814
10354,963.580367,963.6005,1,28907411,28908015,604,0.9464322797676973
10355,963.602333,963.632067,1,28908069,28908962,893,0.6101680243401065
10356,963.634233,963.6373,1,28909026,28909119,93,0.8914213530710114
10357,963.653333,963.755333,1,28909599,28912659,3060,0.6004235535292591
10358,963.758133,963.7632,1,28912743,28912896,153,0.5518188870752178
10359,963.764233,963.857033,1,28912926,28915710,2784,0.28001585763465825
10360,963.8624,963.877333,1,28915872,28916319,447,0.8372564897800882
10361,963.878733,963.9518,1,28916361,28918554,2193,0.7285109475727232
10362,963.955533,963.964067,1,28918665,28918922,257,0.855877248512949
10363,963.9659,963.986967,1,28918977,28919609,632,0.6183788330472776
10364,963.989133,964.001867,1,28919673,28920056,383,0.5287642982963682
10365,964.0042,964.0169,1,28920126,28920507,381,0.3873147205416839
10366,964.019067,964.063233,1,28920572,28921896,1324,0.5758720993349559
10367,964.0727,964.103833,1,28922181,28923114,933,0.5676137660859998
10368,964.108333,964.119233,1,28923249,28923576,327,0.7729907623310871
10369,964.120267,964.1632,1,28923608,28924896,1288,0.6684420106691824
10370,964.164633,964.193867,1,28924938,28925816,878,0.8220567699816009
10371,964.199567,964.240533,1,28925987,28927215,1228,0.5683846172483701
10372,964.2429,964.285933,1,28927287,28928577,1290,0.5453798454832405
10373,964.3036,964.3289,1,28929108,28929867,759,0.5708213123804917
10374,964.335433,964.3479,1,28930062,28930437,375,0.3922086090873014
10375,964.380367,964.441067,1,28931411,28933232,1821,0.32621621311494753
10376,964.4422,964.532267,1,28933266,28935968,2702,0.5460629538646662
10377,964.533767,964.537133,1,28936013,28936113,100,0.8144449215196623
10378,964.5416,964.568967,1,28936248,28937069,821,0.7050615033693901
10379,964.5718,964.607133,1,28937154,28938213,1059,0.2991883795289796
10380,964.611833,964.6172,1,28938354,28938516,162,0.7380991561951398
10381,964.619033,964.6237,1,28938570,28938711,141,0.8324848027612174
10382,964.637933,964.6485,1,28939137,28939455,318,0.2705393140904023
10383,964.6501,964.653433,1,28939503,28939602,99,0.6838988666664692
10384,964.698167,964.703133,1,28940945,28941093,148,0.915179287576435
10385,964.755133,964.773,1,28942653,28943190,537,0.3316015856076193
10386,964.777367,964.7883,1,28943321,28943649,328,0.6669330374093129
10387,964.7898,964.815967,1,28943694,28944479,785,0.35039576927406924
10388,964.8278,964.840867,1,28944834,28945226,392,0.8121076115146054
10389,964.845833,964.859767,1,28945374,28945793,419,0.8906664712761312
10390,965.1,965.1038,1,28953000,28953114,114,0.7858387402143724
10391,965.104867,965.1402,1,28953146,28954206,1060,0.1253308394978524
10392,965.213733,965.232833,1,28956411,28956984,573,0.8317810198886277
10393,965.261767,965.2817,1,28957853,28958451,598,0.6650536132598455
10394,965.298633,965.352233,1,28958958,28960566,1608,0.5243403625257042
10395,965.358433,965.392167,1,28960752,28961765,1013,0.7437478789881288
10396,965.397,965.4113,1,28961910,28962339,429,0.6693963710903241
10397,965.420533,965.607767,1,28962615,28968233,5618,0.7020184928226232
10398,965.6092,965.6753,1,28968276,28970259,1983,0.620358063756004
10399,965.676367,965.7338,1,28970291,28972014,1723,0.6998715967986711
10400,965.747233,965.7632,1,28972416,28972896,480,0.7123163605995655
10401,965.764867,965.8013,1,28972946,28974039,1093,0.6879840676275181
10402,965.8023,965.8223,1,28974069,28974669,600,0.7028839617940662
10403,965.8288,965.8325,1,28974864,28974975,111,0.7289497854440012
10404,966.145233,966.148233,1,28984356,28984446,90,0.6813459132986197
10405,966.536933,966.5401,1,28996107,28996203,96,0.8618877226706875
10406,966.563333,966.579967,1,28996899,28997399,500,0.05458830024287848
10407,966.608667,966.613767,1,28998260,28998413,153,0.6350666472220994
10408,966.618,966.631233,1,28998540,28998936,396,0.4075010439248399
10409,966.666667,966.671833,1,29000000,29000154,154,-0.07328712829913882
10410,966.718667,966.7292,1,29001560,29001876,316,0.2705183997459798
10411,966.772567,966.776067,1,29003177,29003282,105,-0.50857913565972
10412,966.794,966.797767,1,29003820,29003933,113,0.46366378649715867
10413,966.825267,966.828533,1,29004758,29004855,97,0.34845915747273537
10414,967.000867,967.006333,1,29010026,29010189,163,0.04450096057682948
10415,967.122633,967.126733,1,29013678,29013801,123,0.6660648852099246
10416,967.3016,967.308,1,29019048,29019240,192,0.851556741306799
10417,967.3093,967.322133,1,29019279,29019663,384,0.18062981707649656
10418,967.444833,967.4492,1,29023344,29023476,132,0.2826907628009932
10419,967.497167,967.503367,1,29024915,29025101,186,0.030389650190053512
10420,968.044667,968.079467,1,29041340,29042384,1044,0.47522063823530913
10421,968.237767,968.2434,1,29047133,29047302,169,0.8639037029312465
10422,968.2766,968.305933,1,29048298,29049177,879,0.3781860898770819
10423,968.319267,968.324267,1,29049578,29049728,150,0.9245688782387589
10424,968.3321,968.3394,1,29049963,29050182,219,0.9059936304986974
10425,968.3498,968.3536,1,29050494,29050608,114,0.8179627333941589
10426,968.3761,968.4093,1,29051283,29052279,996,0.8094429690087453
10427,968.415867,968.424033,1,29052476,29052720,244,0.9252411768587363
10428,968.463333,968.469567,1,29053899,29054087,188,0.6930818844879452
10429,968.479467,968.572533,1,29054384,29057175,2791,0.23713749674251577
10430,968.58,968.5837,1,29057400,29057511,111,0.9872552542341246
10431,968.589,968.685867,1,29057670,29060576,2906,0.40217373489730235
10432,968.687467,968.713633,1,29060624,29061408,784,0.8086160376929326
10433,968.7148,968.7192,1,29061444,29061576,132,0.8930615621448962
10434,968.725167,968.768733,1,29061755,29063061,1306,0.56866827240819
10435,968.7714,968.7749,1,29063142,29063247,105,0.7520446987059884
10436,968.776333,968.811567,1,29063289,29064347,1058,0.470060075072642
10437,968.812867,968.8439,1,29064386,29065317,931,0.8154007250247884
10438,968.855033,968.896367,1,29065650,29066891,1241,0.3952827607309043
10439,968.8996,968.903833,1,29066988,29067114,126,0.5871508826157594
10440,968.9092,968.915233,1,29067276,29067456,180,0.8893903523501332
10441,968.926533,968.931067,1,29067795,29067932,137,0.8160818363744837
10442,968.937,968.985467,1,29068110,29069564,1454,0.434801564778726
10443,968.987867,968.995033,1,29069636,29069850,214,0.463025739289273
10444,969.0248,969.0397,1,29070744,29071191,447,0.35441117540596623
10445,969.059567,969.092033,1,29071787,29072760,973,0.24395645479492944
10446,969.0987,969.1044,1,29072961,29073132,171,0.9511214742796288
10447,969.105567,969.108633,1,29073167,29073258,91,0.9496279310497941
10448,969.119967,969.220933,1,29073599,29076627,3028,0.42900587248028826
10449,969.223,969.236267,1,29076690,29077088,398,0.4122135482135604
10450,969.244333,969.319733,1,29077329,29079591,2262,0.612861360127875
10451,969.3252,969.328667,1,29079756,29079860,104,0.9375269775988632
10452,969.3302,969.353467,1,29079906,29080604,698,0.16985185047690352
10453,969.369467,969.395333,1,29081084,29081859,775,0.7161708979175156
10454,969.398433,969.485167,1,29081952,29084555,2603,0.6079821591283043
10455,969.486433,969.5042,1,29084592,29085126,534,0.8907027710202491
10456,969.5062,969.509833,1,29085186,29085294,108,0.7769117976432426
10457,969.512067,969.528,1,29085362,29085840,478,0.2746112698727861
10458,969.542567,969.546433,1,29086277,29086392,115,0.15169706608713143
10459,969.556333,969.583067,1,29086689,29087492,803,0.7074144329591933
10460,969.606233,969.6171,1,29088186,29088513,327,0.6012752279102798
10461,969.624067,969.6311,1,29088722,29088933,211,0.9471024870421516
10462,969.633233,969.6631,1,29088996,29089893,897,0.4364243682855892
10463,969.664367,969.695233,1,29089931,29090856,925,0.5868354118531627
10464,969.707133,969.713067,1,29091213,29091392,179,0.9114317477963847
10465,969.7201,969.7444,1,29091603,29092332,729,0.6297906951328551
10466,969.756833,969.7799,1,29092704,29093397,693,0.315957374197868
10467,969.7846,969.842633,1,29093538,29095278,1740,0.7353367310033871
10468,969.8607,969.937433,1,29095821,29098122,2301,0.7447024473468707
10469,969.938633,969.9921,1,29098158,29099763,1605,0.5912329833058478
10470,970.000867,970.0172,1,29100026,29100516,490,0.8414994363688477
10471,970.018333,970.034633,1,29100549,29101038,489,0.6461825559629457
10472,970.0383,970.058633,1,29101149,29101758,609,0.6892365808414033
10473,970.066033,970.069233,1,29101980,29102076,96,0.8053650047846511
10474,970.071767,970.080567,1,29102153,29102417,264,0.807426572338974
10475,970.089933,970.109267,1,29102697,29103278,581,0.6137701374652785
10476,970.1108,970.168533,1,29103324,29105055,1731,0.7227518486946501
10477,970.171667,970.1763,1,29105150,29105289,139,0.7567345156003478
10478,970.216,970.221033,1,29106480,29106630,150,0.509047363603468
10479,970.257933,970.272267,1,29107737,29108168,431,0.2896854281239873
10480,970.277733,970.309067,1,29108331,29109272,941,0.059193016902167335
10481,970.310433,970.3385,1,29109312,29110155,843,0.5124585323208837
10482,970.350233,970.388467,1,29110506,29111654,1148,0.555260232691541
10483,970.390733,970.398,1,29111721,29111940,219,0.7555440807267777
10484,970.405033,970.470267,1,29112150,29114108,1958,0.5573775998342472
10485,970.471333,970.5009,1,29114139,29115027,888,0.6933755266152238
10486,970.5258,970.583433,1,29115774,29117502,1728,0.4950277089911681
10487,970.585533,970.614867,1,29117565,29118446,881,0.49407482484803417
10488,970.6164,970.632833,1,29118492,29118984,492,0.8182936019552863
10489,970.647967,970.672867,1,29119439,29120186,747,0.4028475547008059
10490,970.6817,970.769267,1,29120451,29123078,2627,0.6296487698905383
10491,970.770733,970.8505,1,29123121,29125515,2394,0.1598515017982681
10492,970.852,970.8783,1,29125560,29126349,789,0.35132284029731525
10493,970.880833,970.896467,1,29126424,29126894,470,0.8706340284936921
10494,970.898867,970.924,1,29126966,29127720,754,0.8028236164537843
10495,970.927367,970.9337,1,29127821,29128011,190,0.7316913522952897
10496,970.944467,970.947733,1,29128334,29128431,97,0.8262861091353408
10497,970.952167,970.957833,1,29128565,29128734,169,0.9142005386456701
10498,970.959,970.9621,1,29128770,29128863,93,0.8360664428101486
10499,970.963167,970.992833,1,29128895,29129784,889,0.7753209089185874
10500,971.014967,971.0259,1,29130449,29130777,328,0.5992395545903576
10501,971.029167,971.034767,1,29130875,29131043,168,0.7706167186817687
10502,971.038267,971.0481,1,29131148,29131443,295,0.909638524562626
10503,971.0533,971.080533,1,29131599,29132415,816,0.7006828030796954
10504,971.084633,971.0878,1,29132538,29132634,96,0.845921060868985
10505,971.108567,971.1186,1,29133257,29133558,301,0.6157852361853337
10506,971.121333,971.174967,1,29133639,29135249,1610,0.4705068609790025
10507,971.1782,971.202767,1,29135346,29136083,737,0.6241234701980974
10508,971.2587,971.301733,1,29137761,29139051,1290,0.8125671843590792
10509,971.325567,971.335267,1,29139767,29140058,291,0.8764253271380223
10510,971.369333,971.372333,1,29141079,29141169,90,0.9699221395356118
10511,971.375533,971.420567,1,29141265,29142617,1352,0.8027027030780438
10512,971.4275,971.431233,1,29142825,29142936,111,0.8345585319155654
10513,971.4384,971.4444,1,29143152,29143332,180,0.7835679427193297
10514,971.454733,971.461067,1,29143641,29143832,191,0.395206374141284
10515,971.475367,971.4862,1,29144261,29144586,325,0.06215193363387508
10516,971.4917,971.527,1,29144751,29145810,1059,0.6703627039993475
10517,971.528933,971.562733,1,29145867,29146881,1014,0.5860811793184327
10518,971.566267,971.576533,1,29146988,29147295,307,0.8799613750159032
10519,971.604933,971.610567,1,29148147,29148317,170,0.4043863648440281
10520,971.614233,971.6207,1,29148426,29148621,195,0.07530555874162799
10521,971.6223,971.625333,1,29148669,29148759,90,0.6019342908595156
10522,971.628467,971.634567,1,29148854,29149037,183,0.46753359651727383
10523,971.6423,971.6794,1,29149269,29150382,1113,0.12221975408126314
10524,971.6841,971.695233,1,29150523,29150856,333,0.6582392465916569
10525,971.699733,971.71,1,29150991,29151300,309,0.7975184929716173
10526,971.722533,971.7285,1,29151675,29151855,180,0.8184631490433061
10527,971.7456,971.751833,1,29152368,29152554,186,0.9430112712554566
10528,971.755833,971.760433,1,29152674,29152812,138,0.7534603729917603
10529,971.762133,971.773533,1,29152863,29153205,342,0.8209534797403116
10530,971.775367,971.778733,1,29153261,29153361,100,0.9194535191462091
10531,971.787167,971.8311,1,29153615,29154933,1318,0.8009798315204696
10532,971.8425,971.848533,1,29155275,29155455,180,0.6729254698256909
10533,971.851533,971.9035,1,29155545,29157105,1560,0.8691423676950124
10534,971.945033,971.949,1,29158350,29158470,120,0.9519311910336115
10535,971.950033,971.972833,1,29158500,29159184,684,0.5696240385129949
10536,971.985967,971.999867,1,29159579,29159996,417,0.8215479659062813
10537,972.006033,972.0109,1,29160180,29160327,147,0.8409702372127538
10538,972.015,972.024733,1,29160450,29160741,291,0.6571927074164423
10539,972.031667,972.074367,1,29160950,29162231,1281,0.3425009240727292
10540,972.078433,972.091333,1,29162352,29162739,387,0.7433784207254971
10541,972.0926,972.096567,1,29162778,29162897,119,0.9553053956250028
10542,972.107,972.111967,1,29163210,29163359,149,0.8619446971755725
10543,972.139067,972.148067,1,29164172,29164442,270,0.9215432714224794
10544,972.155033,972.158433,1,29164650,29164752,102,0.9034183273029593
10545,972.171533,972.175567,1,29165145,29165267,122,0.8321063424247458
10546,972.1858,972.203767,1,29165574,29166113,539,0.822317662694782
10547,972.214567,972.2394,1,29166437,29167182,745,0.9366692642900186
10548,972.240733,972.258833,1,29167221,29167764,543,0.865605922082076
10549,972.289033,972.427867,1,29168670,29172836,4166,0.48900692126067885
10550,972.4298,972.451667,1,29172894,29173550,656,0.7949080772241421
10551,972.452967,972.4627,1,29173589,29173881,292,0.7994692851293739
10552,972.4644,972.475,1,29173932,29174250,318,0.8260972644585601
10553,972.479767,972.492567,1,29174393,29174777,384,0.8384069820791207
10554,972.493633,972.575467,1,29174808,29177264,2456,0.46000946090408645
10555,972.577933,972.586933,1,29177337,29177607,270,0.7942576145643683
10556,972.599967,972.603167,1,29177999,29178095,96,0.9643057144733539
10557,972.6061,972.609867,1,29178183,29178296,113,0.7841349462390692
10558,972.612367,972.723167,1,29178371,29181695,3324,0.6672071257890743
10559,972.735067,972.746267,1,29182052,29182388,336,0.6938699627499887
10560,972.747833,972.7637,1,29182434,29182911,477,0.6303005543185958
10561,972.771233,972.7935,1,29183136,29183805,669,0.17010921080135208
10562,972.8067,972.812367,1,29184201,29184371,170,0.922030463905111
10563,972.820833,972.841033,1,29184624,29185230,606,0.8699992004301588
10564,972.842233,972.8466,1,29185266,29185398,132,0.8840005843298874
10565,972.8514,972.893467,1,29185542,29186804,1262,0.6854846385678107
10566,972.8948,972.8981,1,29186844,29186943,99,0.8434002726742329
10567,972.9063,972.9131,1,29187189,29187393,204,0.6047677180757045
10568,972.924967,972.9353,1,29187749,29188059,310,0.8278365248124111
10569,972.941,972.952733,1,29188230,29188581,351,0.804518282530134
10570,972.954667,972.963367,1,29188640,29188901,261,0.9292087888898806
10571,972.964567,972.9828,1,29188937,29189484,547,0.7086141463554102
10572,972.990433,973.063333,1,29189712,29191899,2187,0.43128702736811486
10573,973.0703,973.0736,1,29192109,29192208,99,0.775741952189494
10574,973.078433,973.090667,1,29192352,29192720,368,0.744790372149406
10575,973.111867,973.1203,1,29193356,29193609,253,0.8360897240416555
10576,973.1222,973.127367,1,29193666,29193821,155,0.7843481206724043
10577,973.1384,973.161067,1,29194152,29194832,680,0.6388038346619352
10578,973.163033,973.1765,1,29194890,29195295,405,0.8245022753621503
10579,973.177667,973.1869,1,29195330,29195607,277,0.488408450474012
10580,973.192367,973.1969,1,29195771,29195907,136,0.6457110488764288
10581,973.228133,973.2343,1,29196843,29197029,186,0.6911782924191471
10582,973.235867,973.241667,1,29197076,29197250,174,0.6885124345411624
10583,973.243,973.304667,1,29197290,29199140,1850,0.6026719612129643
10584,973.323233,973.335233,1,29199696,29200056,360,0.8678928460902303
10585,973.336733,973.347033,1,29200101,29200410,309,0.7199146198197475
10586,973.350833,973.356033,1,29200524,29200680,156,0.6594355427538808
10587,973.363,973.370667,1,29200890,29201120,230,0.7511719030648786
10588,973.374267,973.383433,1,29201228,29201502,274,0.5441052984011552
10589,973.4104,973.418367,1,29202312,29202551,239,0.7816820522695112
10590,973.4196,973.435567,1,29202588,29203067,479,0.6487344404162643
10591,973.4374,973.443533,1,29203122,29203305,183,0.5759275347043457
10592,973.452667,973.4567,1,29203580,29203701,121,0.8983004562063911
10593,973.469633,973.475733,1,29204088,29204271,183,0.9032804939789939
10594,973.480433,973.4902,1,29204412,29204706,294,0.7681741698608016
10595,973.497167,973.5056,1,29204915,29205168,253,0.5658209380688658
10596,973.510167,973.538467,1,29205305,29206154,849,0.7183213563849338
10597,973.5397,973.551733,1,29206191,29206551,360,0.8217268029557852
10598,973.553433,973.5632,1,29206602,29206896,294,0.8705886919658371
10599,973.5651,973.5909,1,29206953,29207727,774,0.6740463728143429
10600,973.599733,973.6396,1,29207991,29209188,1197,0.7109302994354454
10601,973.6466,973.719833,1,29209398,29211594,2196,0.5619210744644798
10602,973.7209,973.7616,1,29211627,29212848,1221,0.6536436918435975
10603,973.768233,973.821,1,29213046,29214630,1584,0.7702897695184104
10604,973.8246,973.916267,1,29214738,29217488,2750,0.22849956171670963
10605,973.9217,973.926067,1,29217651,29217782,131,0.8604503165583254
10606,973.935733,973.971467,1,29218071,29219144,1073,0.7135722461339812
10607,973.974,973.981433,1,29219220,29219442,222,0.8370144668475897
10608,973.993067,974.002133,1,29219792,29220063,271,0.7903301689432992
10609,974.005733,974.014067,1,29220171,29220422,251,0.75969331507752
10610,974.023567,974.0497,1,29220707,29221491,784,0.6388734192567632
10611,974.061867,974.091433,1,29221856,29222742,886,0.905706017971018
10612,974.094,974.1851,1,29222820,29225553,2733,0.6167012953081036
10613,974.196367,974.2026,1,29225891,29226078,187,0.7845168515028518
10614,974.2131,974.3041,1,29226393,29229123,2730,0.7238281283620988
10615,974.307067,974.3206,1,29229212,29229618,406,0.8678587710137573
10616,974.3216,974.450867,1,29229648,29233526,3878,0.5017193841233494
10617,974.461867,974.5045,1,29233856,29235135,1279,0.7641769697349566
10618,974.516433,974.527433,1,29235492,29235822,330,0.8651880114423329
10619,974.5333,974.5412,1,29235999,29236236,237,0.9233769012553377
10620,974.550467,974.557833,1,29236514,29236734,220,0.8642988880103796
10621,974.559233,974.564567,1,29236776,29236937,161,0.6957662848678178
10622,974.568867,974.573267,1,29237066,29237198,132,0.8754136404717033
10623,974.582833,974.6293,1,29237484,29238879,1395,0.35482157465194913
10624,974.630633,974.6775,1,29238918,29240325,1407,0.7863025932661938
10625,974.678967,974.691,1,29240369,29240730,361,0.4704164577599719
10626,974.692633,974.707767,1,29240778,29241233,455,0.8836466026216298
10627,974.709133,974.732733,1,29241273,29241981,708,0.7652219441654649
10628,974.735067,974.739767,1,29242052,29242193,141,0.9029131752149343
10629,974.740867,974.752933,1,29242226,29242587,361,0.6560827354429699
10630,974.756367,974.815467,1,29242691,29244464,1773,0.7806277370628227
10631,974.8178,974.833133,1,29244534,29244993,459,0.5976070348624147
10632,974.8344,974.857067,1,29245032,29245712,680,0.5311133271559689
10633,974.8585,974.870367,1,29245755,29246111,356,0.8075341444269328
10634,974.8761,974.8925,1,29246283,29246775,492,0.7387514196675438
10635,974.8962,974.9104,1,29246886,29247312,426,0.6565092900995347
10636,974.9224,974.9371,1,29247672,29248113,441,0.7244692728684062
10637,974.938633,974.992133,1,29248158,29249763,1605,0.8114246950055578
10638,975.0189,975.023633,1,29250567,29250708,141,0.7834168114720578
10639,975.040967,975.055533,1,29251229,29251665,436,0.7520566037314965
10640,975.0585,975.065233,1,29251755,29251956,201,0.8439656278557752
10641,975.066267,975.137467,1,29251988,29254124,2136,0.6184146577883745
10642,975.147933,975.181033,1,29254437,29255430,993,0.6250513446822347
10643,975.1825,975.2002,1,29255475,29256006,531,0.8352736861724082
10644,975.201467,975.2419,1,29256044,29257257,1213,0.7271449398752622
10645,975.2475,975.2579,1,29257425,29257737,312,0.8721808284873583
10646,975.2665,975.2889,1,29257995,29258667,672,0.8700492689322148
10647,975.290133,975.3494,1,29258703,29260482,1779,0.5670359043385609
10648,975.351567,975.374833,1,29260547,29261244,697,0.753386626556727
10649,975.3759,975.384767,1,29261277,29261543,266,0.8570500052268503
10650,975.3913,975.402767,1,29261739,29262083,344,0.6529226338500363
10651,975.415633,975.471433,1,29262468,29264142,1674,0.3087015773839545
10652,975.481,975.502133,1,29264430,29265063,633,0.5531021125869072
10653,975.5032,975.521867,1,29265096,29265656,560,0.8832499784775247
10654,975.53,975.549133,1,29265900,29266473,573,0.44068989869696623
10655,975.5502,975.584933,1,29266506,29267547,1041,0.8646537020413708
10656,975.616067,975.623033,1,29268482,29268690,208,0.8318069041276039
10657,975.6346,975.638067,1,29269038,29269142,104,0.7506465942570335
10658,975.644067,975.6887,1,29269322,29270661,1339,0.6274513741790922
10659,975.6899,975.707,1,29270697,29271210,513,0.8574751591464348
10660,975.709,975.7268,1,29271270,29271804,534,0.8291788720125691
10661,975.728467,975.734533,1,29271854,29272035,181,0.9074993074060929
10662,975.739133,975.744533,1,29272173,29272335,162,0.7626759093668155
10663,975.746667,975.760867,1,29272400,29272826,426,0.8446715193517086
10664,975.7675,975.774333,1,29273025,29273229,204,0.7931332740446756
10665,975.775633,975.778833,1,29273268,29273364,96,0.8578195922480311
10666,975.784467,975.787567,1,29273534,29273627,93,0.8851752157289382
10667,975.7892,975.792267,1,29273676,29273768,92,0.833900440222179
10668,975.793267,975.854267,1,29273798,29275628,1830,0.35050575516012006
10669,975.856933,975.8875,1,29275707,29276625,918,0.7538172242569458
10670,975.888533,975.902967,1,29276655,29277089,434,0.6926390377402103
10671,975.904033,975.9123,1,29277120,29277369,249,0.6349688565349891
10672,975.918233,975.933633,1,29277546,29278008,462,0.101803303905138
10673,975.937133,975.9628,1,29278113,29278884,771,0.7121287535532367
10674,975.969167,976.014767,1,29279075,29280443,1368,0.6699468417236936
10675,976.0193,976.039167,1,29280579,29281175,596,0.40701756247293
10676,976.044,976.0744,1,29281320,29282232,912,0.8642142243793604
10677,976.078733,976.084,1,29282361,29282520,159,0.4341229922165521
10678,976.0894,976.1007,1,29282682,29283021,339,0.42657578285784015
10679,976.1112,976.1144,1,29283336,29283432,96,0.5015573341867396
10680,976.147767,976.155933,1,29284433,29284677,244,0.46682631443532097
10681,976.1632,976.168,1,29284896,29285040,144,0.8725773501073621
10682,976.169567,976.173033,1,29285087,29285190,103,0.6821239964480293
10683,976.1775,976.206233,1,29285325,29286186,861,0.8551377007182245
10684,976.209733,976.2129,1,29286291,29286387,96,0.6000062405510702
10685,976.2145,976.235433,1,29286435,29287062,627,0.46157852975094393
10686,976.236767,976.2725,1,29287103,29288175,1072,0.6528979526712998
10687,976.283267,976.2886,1,29288498,29288658,160,0.9558110888168366
10688,976.291167,976.300867,1,29288735,29289026,291,0.8637170703278595
10689,976.306833,976.314033,1,29289204,29289420,216,0.9058375674081339
10690,976.3264,976.332967,1,29289792,29289989,197,0.8232285078870093
10691,976.345,976.370167,1,29290350,29291105,755,0.4004219023286011
10692,976.371167,976.4012,1,29291135,29292036,901,0.8262825161038322
10693,976.410733,976.421233,1,29292321,29292636,315,0.8827143709040761
10694,976.434533,976.439267,1,29293035,29293178,143,0.8774882069682236
10695,976.457933,976.461333,1,29293737,29293839,102,0.5593952026287714
10696,976.471,976.474567,1,29294130,29294237,107,0.6462879038936639
10697,976.4884,976.5406,1,29294652,29296218,1566,0.3125430995319308
10698,976.542933,976.553167,1,29296287,29296595,308,0.8769226894572544
10699,976.595467,976.603967,1,29297864,29298119,255,0.6561496969315747
10700,976.614433,976.6316,1,29298432,29298948,516,0.817357787061384
10701,976.6384,976.68,1,29299152,29300400,1248,0.26057434651198347
10702,976.6851,976.692067,1,29300553,29300762,209,0.6338377188021307
10703,976.6933,976.6973,1,29300799,29300919,120,0.7818313383359686
10704,976.699633,976.723667,1,29300988,29301710,722,0.810823090616346
10705,976.7257,976.735667,1,29301771,29302070,299,0.7809900623637948
10706,976.739167,976.7606,1,29302175,29302818,643,0.7763579027012726
10707,976.763967,976.8395,1,29302919,29305185,2266,0.2964594306842418
10708,976.8412,976.846733,1,29305236,29305401,165,0.8157570300374933
10709,976.856167,976.870333,1,29305685,29306109,424,0.9247567168770713
10710,976.8829,976.899633,1,29306487,29306988,501,0.7049155206546067
10711,976.907667,976.932367,1,29307230,29307971,741,0.24466869592290671
10712,976.933533,976.952867,1,29308005,29308586,581,0.697645075266908
10713,976.954133,976.968333,1,29308623,29309049,426,0.5882407072616509
10714,976.971933,976.993567,1,29309157,29309807,650,0.6875307845744663
10715,976.9947,977.000567,1,29309841,29310017,176,0.9483550693021029
10716,977.001667,977.0096,1,29310050,29310288,238,0.669712024596475
10717,977.017033,977.026433,1,29310510,29310792,282,0.8995673587842832
10718,977.033833,977.073033,1,29311014,29312190,1176,0.26150184845526453
10719,977.075567,977.115933,1,29312267,29313477,1210,0.7439773406572725
10720,977.124967,977.1386,1,29313749,29314158,409,0.8888550986978093
10721,977.144267,977.1512,1,29314328,29314536,208,0.8545966893462756
10722,977.157033,977.180167,1,29314710,29315405,695,0.5795773326237723
10723,977.182,977.210167,1,29315460,29316305,845,0.837264411512975
10724,977.213667,977.228333,1,29316410,29316849,439,0.7758369977265944
10725,977.2323,977.253767,1,29316969,29317613,644,0.7741179295805978
10726,977.264133,977.277167,1,29317923,29318315,392,0.7012420275856774
10727,977.297833,977.3068,1,29318934,29319204,270,0.2338154028765124
10728,977.308933,977.314633,1,29319267,29319438,171,0.7541726328128313
10729,977.331567,977.384167,1,29319947,29321525,1578,0.5808211543481412
10730,977.3892,977.416667,1,29321676,29322500,824,0.7413832621320303
10731,977.4492,977.4691,1,29323476,29324073,597,0.6101967357085537
10732,977.484733,977.489667,1,29324541,29324690,149,0.8007251520182378
10733,977.490967,977.6034,1,29324729,29328102,3373,0.723748639696152
10734,977.615833,977.620667,1,29328474,29328620,146,0.9249512256897018
10735,977.623967,977.643733,1,29328719,29329311,592,0.8553100104298264
10736,977.646167,977.6513,1,29329385,29329539,154,0.9527192267467517
10737,977.7281,977.736167,1,29331843,29332085,242,0.6068273583411765
10738,977.771367,977.7838,1,29333141,29333514,373,0.7222491017267353
10739,977.8144,977.820333,1,29334432,29334609,177,0.7995365622574183
10740,977.848267,977.874367,1,29335448,29336231,783,0.8244674440266098
10741,977.8759,977.8938,1,29336277,29336814,537,0.5995520184939888
10742,977.8976,977.919767,1,29336928,29337593,665,0.787710521093507
10743,977.923533,977.9402,1,29337705,29338206,501,0.9191843113835302
10744,977.994333,978.013333,1,29339829,29340399,570,-0.012837275382390219
10745,978.0144,978.047867,1,29340432,29341436,1004,0.4173474912142781
10746,978.0647,978.070533,1,29341941,29342115,174,0.9004793179808761
10747,978.148267,978.172167,1,29344448,29345165,717,0.5910912156765821
10748,978.187,978.2009,1,29345610,29346027,417,0.4947145525393904
10749,978.2034,978.213767,1,29346102,29346413,311,0.3225974116885423
10750,978.214933,978.223767,1,29346447,29346713,266,0.6656532465960564
10751,978.2278,978.2335,1,29346834,29347005,171,0.8984127891601934
10752,978.234933,978.242633,1,29347047,29347278,231,0.590858937060768
10753,978.2594,978.2676,1,29347782,29348028,246,0.4172589153826653
10754,978.288733,978.3194,1,29348661,29349582,921,0.2587358987447098
10755,978.3347,978.349433,1,29350041,29350482,441,0.3259795795360691
10756,978.3545,978.3611,1,29350635,29350833,198,0.4053162455165943
10757,978.4486,978.4539,1,29353458,29353617,159,0.41517301306328175
10758,978.480267,978.487067,1,29354408,29354612,204,0.7627819577932949
10759,978.648267,978.6551,1,29359448,29359653,205,0.030667318914945698
10760,978.7029,978.714633,1,29361087,29361438,351,0.7141698503094402
10761,979.342733,979.345967,1,29380281,29380379,98,0.6599216552762134
10762,980.518833,980.522733,1,29415564,29415681,117,0.8930014194750382
10763,980.526233,980.529833,1,29415786,29415894,108,0.8858905357255804
10764,980.5373,980.5403,1,29416119,29416209,90,0.8754515450132893
10765,980.548033,980.556533,1,29416440,29416695,255,0.8924246094996001
10766,980.562,980.5662,1,29416860,29416986,126,0.8584423694014324
10767,980.569067,980.574867,1,29417072,29417246,174,0.8039128221913511
10768,980.5917,980.666633,1,29417751,29419998,2247,0.365937994571877
10769,980.6897,980.698533,1,29420691,29420955,264,0.5718455049441906
10770,980.7221,980.744667,1,29421663,29422340,677,0.1545820840744231
10771,980.771833,980.791733,1,29423154,29423751,597,0.16743657539484247
10772,981.2323,981.235467,1,29436969,29437064,95,0.3180937054854595
10773,985.158033,985.199,1,29554740,29555970,1230,0.18003494190205538
10774,985.2099,985.257633,1,29556297,29557728,1431,0.40531469954341287
10775,985.473233,985.4825,1,29564196,29564475,279,0.5564229131340213
10776,985.5204,985.533733,1,29565612,29566011,399,0.12448145270313311
10777,985.799733,985.805667,1,29573991,29574170,179,0.7084844374654136
10778,985.806967,985.8162,1,29574209,29574486,277,0.6046834562335753
10779,986.165067,986.188667,1,29584952,29585660,708,0.07609958156431557
10780,986.1932,986.2049,1,29585796,29586147,351,-0.007291252460416312
10781,990.071567,990.116033,1,29702147,29703480,1333,0.1939347809095312
10782,990.1201,990.132567,1,29703603,29703977,374,0.4993810112908061
10783,990.133633,990.1394,1,29704008,29704182,174,0.7306792088904741
10784,990.4227,990.4307,1,29712681,29712921,240,0.27084353080398177
10785,990.439167,990.4436,1,29713175,29713308,133,-0.08881340841718187
10786,990.4448,990.4576,1,29713344,29713728,384,0.1389911294042374
10787,990.469233,990.6652,1,29714076,29719956,5880,0.10378930313068065
10788,990.6713,990.693933,1,29720139,29720817,678,0.2818205235439909
10789,990.701,990.7044,1,29721030,29721132,102,0.8279794801486657
10790,990.749967,990.783167,1,29722499,29723495,996,0.48821331749581015
10791,990.788967,990.823433,1,29723669,29724702,1033,0.06560512990777016
10792,990.8255,990.836467,1,29724765,29725094,329,0.5355867432395209
10793,990.884533,990.918967,1,29726535,29727569,1034,0.1664589356493935
10794,990.928833,990.971733,1,29727864,29729151,1287,0.22588948785497828
10795,991.0256,991.063833,1,29730768,29731914,1146,0.36631229452078967
10796,991.074867,991.117433,1,29732246,29733522,1276,0.03924931881468168
10797,991.120567,991.1294,1,29733617,29733882,265,0.721717344894103
10798,991.133433,991.1378,1,29734002,29734134,132,0.6092147354415655
10799,991.1725,991.266667,1,29735175,29738000,2825,0.11860241339265339
10800,991.341433,991.347733,1,29740242,29740431,189,0.5568966733080479
10801,991.355033,991.375533,1,29740650,29741265,615,0.6069542253402336
10802,991.385433,991.415767,1,29741562,29742473,911,0.2568003792519393
10803,991.417267,991.4238,1,29742518,29742714,196,0.24437111608778353
10804,991.4285,991.439267,1,29742855,29743178,323,0.34673967130634437
10805,991.446067,991.449267,1,29743382,29743478,96,0.7063925765086406
10806,993.296033,993.3034,1,29798880,29799102,222,0.4656967247692101
10807,993.305233,993.410433,1,29799156,29802312,3156,0.13104993151600536
10808,993.413467,993.508333,1,29802404,29805249,2845,0.22260963981810852
10809,993.938933,993.9432,1,29818167,29818296,129,0.8695810053717251
10810,994.6135,994.635967,1,29838405,29839079,674,0.4440043621388397
10811,994.667,994.768033,1,29840010,29843040,3030,0.11254998169351468
10812,994.793733,994.8434,1,29843811,29845302,1491,0.19333715890738876
10813,994.847833,994.912967,1,29845434,29847389,1955,0.2518698697419929
10814,994.9216,994.936533,1,29847648,29848095,447,0.23247693714164105
10815,994.938233,994.9439,1,29848146,29848317,171,0.6897247746366177
10816,994.9509,995.054367,1,29848527,29851631,3104,0.10753702948283174
10817,995.0621,995.1351,1,29851863,29854053,2190,0.13241244529390891
10818,995.148033,995.234633,1,29854440,29857038,2598,0.14036508656712446
10819,995.2559,995.271833,1,29857677,29858154,477,0.24681115588805122
10820,995.304333,995.324567,1,29859129,29859737,608,0.3088174286584705
10821,995.327333,995.337067,1,29859819,29860112,293,0.5030031229807744
10822,995.3721,995.3768,1,29861163,29861304,141,0.8430600689072517
10823,995.387433,995.488533,1,29861622,29864655,3033,0.1926630088600492
10824,995.493333,995.5014,1,29864799,29865042,243,0.5661189645614818
10825,995.5028,995.514067,1,29865084,29865422,338,0.7780495918815696
10826,995.521233,995.531033,1,29865636,29865930,294,0.474451996276552
10827,995.535367,995.5576,1,29866061,29866728,667,0.3895854330041884
10828,995.566167,995.5873,1,29866985,29867619,634,0.3022925125734284
10829,995.591067,995.620867,1,29867732,29868626,894,0.291082163663582
10830,995.622567,995.696267,1,29868677,29870888,2211,0.2830696767762257
10831,995.700267,995.734567,1,29871008,29872037,1029,0.6125723788350939
10832,995.736367,995.781533,1,29872091,29873445,1354,0.1650849833894587
10833,995.815167,995.8557,1,29874455,29875671,1216,0.4576892055920934
10834,995.8618,995.928,1,29875854,29877840,1986,0.12275388822443925
10835,995.9827,995.996433,1,29879481,29879892,411,0.7683933415613257
10836,998.29,998.395067,1,29948700,29951852,3152,0.1804104986878965
10837,998.403867,998.4201,1,29952116,29952603,487,0.041537072717391085
10838,998.428467,998.4992,1,29952854,29954976,2122,0.06809133044806776
10839,998.5004,998.537767,1,29955012,29956133,1121,0.309525669303775
10840,998.5426,998.5602,1,29956278,29956806,528,0.8027154925267951
10841,998.566533,998.594,1,29956995,29957820,825,0.20381593759109584
10842,998.604933,998.629533,1,29958147,29958885,738,0.19070766076242313
10843,998.630867,998.634533,1,29958926,29959035,109,0.7278953835510055
10844,998.651167,998.680033,1,29959535,29960400,865,0.098213409163724
10845,999.0504,999.055167,1,29971512,29971655,143,0.6689016002264525
10846,999.058733,999.0702,1,29971761,29972106,345,0.5517067642798741
10847,999.575,999.674533,1,29987250,29990235,2985,0.30010141391784007
10848,999.6791,999.703633,1,29990373,29991108,735,0.4448440562318893
10849,999.706467,999.7224,1,29991194,29991672,478,0.2727494166160494
10850,999.731533,999.735567,1,29991945,29992067,122,0.9312113156821104
10851,999.739533,999.7617,1,29992185,29992851,666,0.21709635456020418
10852,999.777567,999.838933,1,29993327,29995167,1840,0.20601925397170195
10853,999.844567,999.849467,1,29995337,29995484,147,0.6423568423758808
10854,999.8519,999.896433,1,29995557,29996892,1335,0.5593961582670863
10855,999.897433,999.9333,1,29996922,29997999,1077,0.1771875519827487
10856,999.943333,999.9658,1,29998299,29998974,675,0.07456825266359123
10857,1000.014,1000.064533,1,30000420,30001935,1515,0.18103594141208357
10858,1000.0699,1000.106667,1,30002097,30003200,1103,0.18015892694218447
10859,1000.127133,1000.134767,1,30003813,30004043,230,0.21838551389594799
10860,1000.186167,1000.190267,1,30005585,30005708,123,0.658719146836201
10861,1000.550633,1000.631433,1,30016518,30018942,2424,0.12106479255066796
10862,1000.6325,1000.642367,1,30018975,30019271,296,0.4846496252665385
10863,1000.6452,1000.692367,1,30019356,30020771,1415,0.2358044023924252
10864,1000.6982,1000.7042,1,30020946,30021126,180,0.788914025319016
10865,1000.7074,1000.7233,1,30021222,30021699,477,0.45697074431168017
10866,1000.7326,1000.7455,1,30021978,30022365,387,0.2132091663544052
10867,1000.7465,1000.7511,1,30022395,30022533,138,0.8867099427515128
10868,1000.7546,1000.813333,1,30022638,30024399,1761,0.517278241060937
10869,1000.8144,1000.844833,1,30024432,30025344,912,0.39957032162586764
10870,1000.8566,1000.862633,1,30025698,30025878,180,0.8901138270938693
10871,1000.8649,1000.876267,1,30025947,30026288,341,0.4428440980417707
10872,1000.877633,1000.890133,1,30026328,30026703,375,0.8537883128111073
10873,1000.895933,1000.900567,1,30026877,30027017,140,0.9227436644897209
10874,1000.904833,1000.9079,1,30027144,30027237,93,0.8379221942896882
10875,1000.909667,1000.9268,1,30027290,30027804,514,0.5110540042157605
10876,1000.934433,1000.945633,1,30028032,30028368,336,0.6657301948853029
10877,1000.953833,1000.958733,1,30028614,30028761,147,0.7990284093541744
10878,1000.9669,1000.9809,1,30029007,30029427,420,0.8442084234766705
10879,1000.983233,1000.992367,1,30029496,30029771,275,0.7368603874480271
10880,1000.9993,1001.005167,1,30029979,30030155,176,0.663358599178606
10881,1001.012867,1001.0393,1,30030386,30031179,793,0.670467643362732
10882,1001.0448,1001.0524,1,30031344,30031572,228,0.6183331507833025
10883,1001.059233,1001.087967,1,30031776,30032639,863,0.4798053977799724
10884,1001.1245,1001.15,1,30033735,30034500,765,0.6225261843285105
10885,1001.151367,1001.154467,1,30034541,30034634,93,0.8789073957429532
10886,1001.159233,1001.165633,1,30034776,30034968,192,0.8577727067665083
10887,1001.1712,1001.202867,1,30035136,30036086,950,0.6488534929094469
10888,1001.204567,1001.2202,1,30036137,30036606,469,0.5337100159073211
10889,1001.2231,1001.2446,1,30036693,30037338,645,0.5884817426491099
10890,1001.246967,1001.268867,1,30037409,30038066,657,0.686473568804141
10891,1001.2744,1001.297733,1,30038232,30038931,699,0.36056747729640737
10892,1001.2988,1001.316167,1,30038964,30039485,521,0.6126977698338707
10893,1001.317667,1001.326833,1,30039530,30039804,274,0.6690767247994232
10894,1001.333167,1001.426767,1,30039995,30042803,2808,0.32552306152370214
10895,1001.4282,1001.474633,1,30042846,30044238,1392,0.23602731826279638
10896,1001.5394,1001.542633,1,30046182,30046278,96,0.8893575456533122
10897,1001.5532,1001.568133,1,30046596,30047043,447,0.6087339214757993
10898,1001.9932,1001.996733,1,30059796,30059901,105,0.7295014279062214
10899,1002.0101,1002.0217,1,30060303,30060651,348,0.5704022155098535
10900,1002.0504,1002.062,1,30061512,30061860,348,0.747152861035784
10901,1002.064933,1002.0791,1,30061947,30062373,426,0.5016973577727745
10902,1002.124667,1002.1389,1,30063740,30064167,427,0.3869589952877163
10903,1002.142567,1002.160733,1,30064277,30064821,544,0.4432385873217353
10904,1002.1697,1002.2165,1,30065091,30066495,1404,0.2142323050166167
10905,1002.222,1002.242233,1,30066660,30067266,606,0.16939480749265118
10906,1002.243967,1002.2482,1,30067319,30067446,127,0.7736029822515499
10907,1002.250233,1002.280033,1,30067506,30068400,894,0.6130110746829988
10908,1002.282533,1002.316667,1,30068475,30069500,1025,0.2736235821444165
10909,1002.318867,1002.4044,1,30069566,30072132,2566,0.11705182781465426
10910,1002.405767,1002.410833,1,30072173,30072324,151,0.644098861420494
10911,1002.412033,1002.415733,1,30072360,30072471,111,0.9519980733204753
10912,1002.4201,1002.429833,1,30072603,30072894,291,0.317108237628854
10913,1002.4367,1002.445333,1,30073101,30073359,258,0.8206629583719889
10914,1002.4471,1002.464367,1,30073413,30073931,518,0.7013681890552008
10915,1002.485667,1002.508867,1,30074570,30075266,696,0.41433367024951645
10916,1002.5394,1002.542667,1,30076182,30076280,98,0.5829670013767281
10917,1003.3973,1003.496,1,30101919,30104880,2961,0.04656741315462037
10918,1003.529533,1003.5504,1,30105885,30106512,627,0.24562049909253786
10919,1003.552967,1003.562433,1,30106589,30106872,283,0.4857210575857868
10920,1003.570767,1003.674467,1,30107123,30110234,3111,0.06840069635913808
10921,1003.682333,1003.7204,1,30110469,30111612,1143,0.03487129670734131
10922,1003.739433,1003.766833,1,30112182,30113004,822,0.07931507808270975
10923,1003.772033,1003.775333,1,30113160,30113259,99,0.8503227717771883
10924,1003.7796,1003.8031,1,30113388,30114093,705,0.08458678933750176
10925,1003.809167,1003.852533,1,30114275,30115575,1300,0.12960245006521753
10926,1003.862167,1003.867567,1,30115865,30116027,162,0.8896752684069951
10927,1003.872433,1003.881033,1,30116172,30116430,258,0.6497036605561513
10928,1003.903733,1003.911333,1,30117111,30117339,228,0.7649836639045899
10929,1003.925967,1003.9379,1,30117779,30118137,358,0.5333201148710879
10930,1003.943133,1003.9462,1,30118293,30118386,93,0.8391322142871106
10931,1003.952767,1003.960767,1,30118583,30118823,240,0.5124250154961619
10932,1003.982167,1003.993867,1,30119465,30119816,351,0.15531217724289106
10933,1004.277633,1004.348833,1,30128328,30130464,2136,0.16225209436586419
10934,1004.358767,1004.381233,1,30130763,30131436,673,0.17047975046632238
10935,1004.391167,1004.403267,1,30131735,30132098,363,0.1482774207096912
10936,1004.408067,1004.411233,1,30132242,30132336,94,-0.16093731908472556
10937,1004.414633,1004.4263,1,30132438,30132789,351,0.20533180071096344
10938,1004.4305,1004.5173,1,30132915,30135519,2604,0.2226342101538827
10939,1004.545267,1004.552233,1,30136358,30136566,208,0.7786553947780994
10940,1004.553433,1004.571867,1,30136602,30137156,554,0.7861827894290047
10941,1004.5731,1004.581967,1,30137193,30137459,266,0.8601658712536286
10942,1004.583567,1004.588967,1,30137507,30137669,162,0.7875287546935656
10943,1004.593233,1004.625267,1,30137796,30138758,962,0.28482443960889103
10944,1004.7182,1004.753967,1,30141546,30142619,1073,0.21549148896316556
10945,1004.757767,1004.7627,1,30142733,30142881,148,0.8489963627937634
10946,1004.7705,1004.773833,1,30143115,30143214,99,0.8748490061413993
10947,1004.775467,1004.802167,1,30143264,30144065,801,0.2066416732470713
10948,1005.061333,1005.1563,1,30151839,30154689,2850,0.18024131632454618
10949,1005.157467,1005.207433,1,30154724,30156222,1498,0.29347347092610776
10950,1005.2107,1005.229433,1,30156321,30156882,561,0.47732053215512726
10951,1005.2351,1005.256,1,30157053,30157680,627,0.15961012064210256
10952,1005.2576,1005.334333,1,30157728,30160029,2301,0.18550298298487233
10953,1005.336467,1005.344633,1,30160094,30160338,244,0.5659631442582606
10954,1005.365667,1005.3875,1,30160970,30161625,655,0.7247579558252256
10955,1005.388667,1005.397667,1,30161660,30161930,270,0.3785338957076673
10956,1005.4026,1005.444467,1,30162078,30163334,1256,0.0018213344042403293
10957,1005.480733,1005.4899,1,30164421,30164697,276,0.7435092323381145
10958,1005.5022,1005.509533,1,30165066,30165285,219,0.6976343459795912
10959,1005.510967,1005.5546,1,30165329,30166638,1309,0.07382993460215795
10960,1005.5647,1005.592433,1,30166941,30167772,831,0.32386455051319923
10961,1005.593833,1005.611067,1,30167814,30168332,518,0.0743965246709033
10962,1005.623267,1005.695433,1,30168698,30170862,2164,0.13927707952069734
10963,1005.699533,1005.707533,1,30170985,30171225,240,0.7814794362821841
10964,1005.7136,1005.7189,1,30171408,30171567,159,0.9122201248179309
10965,1005.7201,1005.7233,1,30171603,30171699,96,0.7612645161659195
10966,1005.7336,1005.739867,1,30172008,30172196,188,0.7921397343328727
10967,1005.746567,1005.754933,1,30172397,30172647,250,0.6026323484532969
10968,1005.756333,1005.762433,1,30172689,30172872,183,0.3731583212889243
10969,1005.790267,1005.796467,1,30173708,30173894,186,0.6668681120093173
10970,1005.797467,1005.809067,1,30173924,30174272,348,0.5391344723389955
10971,1006.1094,1006.189267,1,30183282,30185678,2396,0.20998163720882926
10972,1006.211467,1006.230467,1,30186344,30186914,570,0.35599142629459296
10973,1006.242533,1006.333133,1,30187275,30189993,2718,0.20113038601802444
10974,1006.345267,1006.428233,1,30190358,30192846,2488,0.18480272724529
10975,1006.4627,1006.465833,1,30193881,30193974,93,0.7656279828052395
10976,1006.4671,1006.4894,1,30194013,30194682,669,0.7228818945960704
10977,1006.5118,1006.5276,1,30195354,30195828,474,0.4439290237295191
10978,1006.529233,1006.532233,1,30195876,30195966,90,0.1748222979327557
10979,1006.555667,1006.5611,1,30196670,30196833,163,-0.006132819302506753
10980,1006.957867,1007.046633,1,30208736,30211398,2662,0.12663682306971075
10981,1007.070767,1007.124033,1,30212123,30213720,1597,0.16415395067017108
10982,1007.125133,1007.162733,1,30213753,30214881,1128,0.143166756470974
10983,1007.1716,1007.2769,1,30215148,30218307,3159,0.15895330225187917
10984,1007.379867,1007.389033,1,30221396,30221670,274,0.8187745183381235
10985,1007.411167,1007.417067,1,30222335,30222512,177,0.27490951469639746
10986,1007.423433,1007.4271,1,30222702,30222813,111,0.43120730658361683
10987,1007.491067,1007.495567,1,30224732,30224867,135,0.6862621764704376
10988,1007.519933,1007.537167,1,30225597,30226115,518,0.25226285976382495
10989,1007.5388,1007.549433,1,30226164,30226482,318,0.48548412132856894
10990,1007.610233,1007.644733,1,30228306,30229341,1035,0.23680657158274254
10991,1007.676,1007.7036,1,30230280,30231108,828,-0.023964759105906126
10992,1007.746433,1007.781,1,30232392,30233430,1038,0.16658804979828823
10993,1007.7869,1007.885033,1,30233607,30236550,2943,0.2700959520129521
10994,1007.894333,1007.897933,1,30236829,30236937,108,0.7375678313153099
10995,1007.9012,1007.905033,1,30237036,30237150,114,0.8588057415990182
10996,1007.9331,1007.966967,1,30237993,30239009,1016,0.3396445958245983
10997,1007.9681,1008.026833,1,30239043,30240804,1761,0.11045738631319131
10998,1010.7614,1010.762567,1,30322842,30322877,35,0.9572855761657764
10999,1010.865233,1010.937933,1,30325956,30328137,2181,0.054379539214908845
11000,1010.9491,1010.958633,1,30328473,30328758,285,0.43823372006592726
11001,1010.965167,1011.009433,1,30328955,30330282,1327,0.2001753168817885
11002,1011.0195,1011.0926,1,30330585,30332778,2193,0.1469150204902223
11003,1011.101867,1011.116967,1,30333056,30333509,453,0.5980398474975657
11004,1011.529867,1011.532967,1,30345896,30345989,93,0.68981267089925
11005,1011.547067,1011.562333,1,30346412,30346869,457,0.22431179432866058
11006,1011.566667,1011.632133,1,30347000,30348963,1963,0.1723074311988498
11007,1011.6344,1011.641967,1,30349032,30349259,227,0.5522175853313563
11008,1011.650933,1011.6794,1,30349527,30350382,855,0.2426067813201584
11009,1011.686233,1011.780533,1,30350586,30353415,2829,0.14104446285740163
11010,1011.8047,1011.8493,1,30354141,30355479,1338,0.21585935104863155
11011,1011.850533,1011.8569,1,30355515,30355707,192,0.6344114112304419
11012,1011.858367,1011.8867,1,30355751,30356601,850,0.04673184259150108
11013,1011.8889,1011.9228,1,30356667,30357684,1017,0.0749908376244633
11014,1011.926767,1011.9357,1,30357803,30358071,268,0.38343492140970364
11015,1011.951667,1012.0239,1,30358550,30360717,2167,0.20634970635511876
11016,1012.034767,1012.056667,1,30361043,30361700,657,0.23607847486536965
11017,1012.1438,1012.148433,1,30364314,30364452,138,0.5052202497525143
11018,1012.179267,1012.185733,1,30365378,30365571,193,0.7267932945747438
11019,1012.446833,1012.477333,1,30373404,30374319,915,0.24855954562679947
11020,1012.9797,1013.061733,1,30389391,30391851,2460,0.20934750739863336
11021,1013.065067,1013.098167,1,30391952,30392945,993,0.31640439562187817
11022,1013.0992,1013.102467,1,30392976,30393074,98,0.8830899590221241
11023,1013.104033,1013.181267,1,30393120,30395438,2318,0.17491642091290482
11024,1013.182533,1013.286833,1,30395475,30398604,3129,0.12302389962638449
11025,1013.3224,1013.3283,1,30399672,30399849,177,0.6995682761851263
11026,1013.330167,1013.349467,1,30399905,30400484,579,0.44976533276364655
11027,1013.6574,1013.663967,1,30409722,30409919,197,0.7679934263416274
11028,1013.666367,1013.678033,1,30409991,30410340,349,0.3655927789713832
11029,1013.680633,1013.729033,1,30410418,30411870,1452,0.09577069041887096
11030,1013.730333,1013.7345,1,30411909,30412035,126,0.8814713505531073
11031,1013.735533,1013.753633,1,30412065,30412608,543,0.35756379227545654
11032,1013.7647,1013.781933,1,30412941,30413457,516,0.17771107593728247
11033,1013.786733,1013.815567,1,30413601,30414467,866,0.09389457347343666
11034,1013.8175,1013.827333,1,30414525,30414819,294,0.6914317681807636
11035,1013.829667,1013.85,1,30414890,30415500,610,0.24833556481275024
11036,1013.861033,1013.965,1,30415830,30418950,3120,0.12595300729897552
11037,1014.021533,1014.027167,1,30420645,30420815,170,0.5169878174600213
11038,1015.6968,1015.823767,1,30470904,30474713,3809,0.27632845997943606
11039,1015.826767,1015.854667,1,30474803,30475640,837,0.19401883276469187
11040,1015.8641,1015.9599,1,30475923,30478797,2874,0.20130718810956882
11041,1015.9727,1015.996633,1,30479181,30479898,717,0.07694011448584659
11042,1016.0129,1016.0348,1,30480387,30481044,657,0.18158530973687573
11043,1016.046533,1016.0938,1,30481395,30482814,1419,0.15072210929369112
11044,1016.1179,1016.121567,1,30483537,30483647,110,0.8537185455259723
11045,1016.1226,1016.126667,1,30483678,30483800,122,0.8607887523093909
11046,1016.1427,1016.146733,1,30484281,30484401,120,0.30741386976429835
11047,1016.179633,1016.185967,1,30485388,30485579,191,0.4458255695096027
11048,1017.826567,1017.844333,1,30534797,30535329,532,0.16688780736337783
11049,1017.8482,1017.937467,1,30535446,30538124,2678,0.18545499120743805
11050,1017.9399,1017.944733,1,30538197,30538341,144,0.663885635653497
11051,1017.947233,1017.975533,1,30538416,30539265,849,0.155049209482302
11052,1017.976867,1017.9987,1,30539306,30539961,655,0.17983090945843982
11053,1018.008567,1018.083767,1,30540257,30542513,2256,0.14160735794564577
11054,1018.0882,1018.109,1,30542646,30543270,624,0.719205768836242
11055,1018.113167,1018.132967,1,30543395,30543989,594,0.7982281252878086
11056,1018.148467,1018.175033,1,30544454,30545250,796,0.02438256450669688
11057,1018.187133,1018.198233,1,30545613,30545946,333,0.18207364800712092
11058,1018.202133,1018.253333,1,30546063,30547599,1536,0.486332401762901
11059,1018.259767,1018.290533,1,30547793,30548715,922,0.35997414499104397
11060,1018.314433,1018.320233,1,30549432,30549606,174,0.3770485610747371
11061,1018.337067,1018.3853,1,30550112,30551559,1447,0.4402758132940503
11062,1018.406167,1018.4258,1,30552185,30552774,589,0.7084442447711364
11063,1018.4883,1018.495933,1,30554649,30554877,228,0.6117545424737192
11064,1018.499833,1018.5046,1,30554994,30555138,144,0.7844672130300642
11065,1018.513867,1018.525533,1,30555416,30555765,349,0.7115100694648475
11066,1018.526533,1018.550633,1,30555795,30556518,723,0.7005342001310123
11067,1018.563333,1018.5775,1,30556899,30557325,426,0.3323792699974474
11068,1018.578833,1018.590133,1,30557364,30557703,339,0.6015567138568232
11069,1018.641767,1018.650467,1,30559253,30559514,261,0.0676605300904304
11070,1018.6517,1018.666233,1,30559551,30559986,435,0.3609111406388455
11071,1018.678433,1018.712367,1,30560352,30561371,1019,0.11774593074360733
11072,1018.8007,1018.808333,1,30564021,30564249,228,0.6268790261583409
11073,1018.8476,1018.8535,1,30565428,30565605,177,0.6278233683484404
11074,1019.046067,1019.049467,1,30571382,30571484,102,0.8970230009423213
11075,1019.0545,1019.063367,1,30571635,30571901,266,0.6654361930237883
11076,1019.069033,1019.0755,1,30572070,30572265,195,0.7079624494961054
11077,1019.101733,1019.124,1,30573051,30573720,669,0.41005235343664265
11078,1019.1252,1019.1357,1,30573756,30574071,315,0.6492874437309746
11079,1020.066867,1020.213367,1,30602006,30606401,4395,0.08341575824904432
11080,1020.2168,1020.2231,1,30606504,30606693,189,0.880174817704827
11081,1020.2331,1020.2365,1,30606993,30607095,102,0.1026405304443916
11082,1020.2378,1020.337233,1,30607134,30610116,2982,0.09115418436081381
11083,1020.3393,1020.3627,1,30610179,30610881,702,0.19267584016900377
11084,1020.375133,1020.398,1,30611253,30611940,687,0.10054578017225611
11085,1020.406467,1020.4274,1,30612194,30612822,628,0.07875053428885549
11086,1020.429067,1020.479367,1,30612872,30614381,1509,0.11081241631862032
11087,1020.5704,1020.573933,1,30617112,30617217,105,0.8787131076398995
11088,1021.2325,1021.2388,1,30636975,30637164,189,0.1385094475339068
11089,1021.245167,1021.4205,1,30637355,30642615,5260,0.10535814533839452
11090,1021.422633,1021.433467,1,30642678,30643004,326,0.5758430608727492
11091,1021.437933,1021.457467,1,30643137,30643724,587,0.16450887426941033
11092,1021.458867,1021.523867,1,30643766,30645716,1950,0.18168973127822022
11093,1021.531467,1021.538233,1,30645944,30646146,202,0.911234841959322
11094,1021.8864,1021.891533,1,30656592,30656745,153,0.5355251954963437
11095,1021.9004,1021.9263,1,30657012,30657789,777,0.22231853100314639
11096,1021.932733,1022.000967,1,30657981,30660029,2048,0.282684877966582
11097,1022.016533,1022.031333,1,30660495,30660939,444,0.44667060769121053
11098,1022.0641,1022.1685,1,30661923,30665055,3132,0.1800663697149047
11099,1022.261167,1022.2647,1,30667835,30667941,106,0.3201895376695115
11100,1022.306967,1022.3173,1,30669209,30669519,310,0.3514570450494523
11101,1022.506,1022.520433,1,30675180,30675612,432,0.011014719448886968
11102,1022.535033,1022.547667,1,30676050,30676430,380,0.13080987390774573
11103,1022.5488,1022.5701,1,30676464,30677103,639,0.5857627576852689
11104,1022.994,1023.008267,1,30689820,30690248,428,0.08771902172206279
11105,1023.0099,1023.0823,1,30690297,30692469,2172,0.08261649015267279
11106,1023.085733,1023.101733,1,30692571,30693051,480,0.20750427041972763
11107,1023.1082,1023.135567,1,30693246,30694067,821,0.11433677830221711
11108,1023.145667,1023.208167,1,30694370,30696245,1875,0.2602169614325827
11109,1023.210833,1023.282467,1,30696324,30698474,2150,0.16857943911274845
11110,1023.2835,1023.2976,1,30698505,30698928,423,0.13163175260427873
11111,1023.299167,1023.314767,1,30698975,30699443,468,0.2261701366996382
11112,1023.377433,1023.3814,1,30701322,30701442,120,0.6994201192368579
11113,1024.572533,1024.579867,1,30737175,30737396,221,0.8849020858679313
11114,1024.582267,1024.606533,1,30737468,30738195,727,0.2561638940807827
11115,1025.029367,1025.0345,1,30750881,30751035,154,0.29226643668236607
11116,1025.035567,1025.184933,1,30751067,30755547,4480,0.09429828746129837
11117,1025.1866,1025.329167,1,30755598,30759875,4277,0.11315008820156823
11118,1025.3363,1025.358233,1,30760088,30760746,658,0.17275477192892774
11119,1025.370767,1025.400233,1,30761123,30762006,883,0.02531334684343088
11120,1025.411533,1025.419967,1,30762345,30762599,254,0.6083892609312772
11121,1025.4226,1025.4437,1,30762678,30763311,633,-0.023376689875105404
11122,1025.4877,1025.495567,1,30764630,30764867,237,0.24685021264346554
11123,1025.498233,1025.5085,1,30764946,30765254,308,0.5953738722329934
11124,1025.518933,1025.530533,1,30765567,30765915,348,0.22851128040657823
11125,1025.531667,1025.561433,1,30765950,30766842,892,0.05984178406502382
11126,1025.5779,1025.603967,1,30767337,30768119,782,0.3057713745809933
11127,1025.620733,1025.6552,1,30768621,30769655,1034,0.1747524155421847
11128,1025.683733,1025.688233,1,30770511,30770646,135,0.8406646123828612
11129,1025.805367,1025.809567,1,30774161,30774287,126,0.09204785061196588
11130,1025.837367,1025.840833,1,30775121,30775224,103,0.6784439754912354
11131,1025.8641,1025.947,1,30775923,30778409,2486,0.25011717684526863
11132,1025.980633,1026.050567,1,30779418,30781517,2099,0.307112602111741
11133,1026.0523,1026.0992,1,30781569,30782976,1407,0.1614942811342524
11134,1026.100267,1026.113233,1,30783008,30783396,388,0.05187346360722959
11135,1026.1461,1026.152167,1,30784382,30784565,183,0.8000508764824379
11136,1026.173433,1026.193767,1,30785202,30785813,611,0.32446422034730243
11137,1026.211967,1026.2342,1,30786359,30787026,667,0.5935841509160099
11138,1026.6355,1026.650733,1,30799065,30799521,456,0.29540957326318557
11139,1026.652367,1026.724167,1,30799571,30801725,2154,0.1902946523819454
11140,1026.725567,1026.746667,1,30801767,30802400,633,0.2784650066730322
11141,1026.7639,1026.789867,1,30802916,30803696,780,0.19292273470922783
11142,1026.790933,1026.866367,1,30803727,30805991,2264,0.07342179852869492
11143,1026.8708,1026.956567,1,30806123,30808697,2574,0.292464696188742
11144,1026.963333,1026.975667,1,30808899,30809270,371,0.211099574332168
11145,1028.9079,1029.087067,1,30867236,30872612,5376,0.13139727939310913
11146,1029.088233,1029.092533,1,30872646,30872775,129,0.5526093120925811
11147,1029.1036,1029.172367,1,30873107,30875171,2064,0.18379813109591986
11148,1029.173367,1029.1966,1,30875201,30875898,697,0.39786914486707337
11149,1029.199167,1029.208,1,30875975,30876240,265,0.721687525908229
11150,1029.5466,1029.5504,1,30886397,30886512,115,0.8029322269172334
11151,1029.5563,1029.5606,1,30886689,30886818,129,0.5678461802476052
11152,1029.596067,1029.606133,1,30887882,30888183,301,0.529166792053597
11153,1029.611833,1029.7026,1,30888354,30891078,2724,0.20746262996750672
11154,1029.705133,1029.7176,1,30891153,30891528,375,0.18666052215324322
11155,1029.718767,1029.7425,1,30891563,30892275,712,0.21385586143905103
11156,1029.752267,1029.8497,1,30892568,30895491,2923,0.13377332222060007
11157,1029.8965,1029.9248,1,30896895,30897744,849,0.04540330816481354
11158,1029.934333,1029.959067,1,30898029,30898772,743,-0.0007892118897764666
11159,1029.965,1030.0106,1,30898949,30900318,1369,0.24331859187422483
11160,1030.036033,1030.067133,1,30901080,30902013,933,0.2528901087433392
11161,1030.0861,1030.0952,1,30902583,30902856,273,0.4842047906040871
11162,1030.115467,1030.118567,1,30903464,30903557,93,0.9667799098501096
11163,1030.1199,1030.142633,1,30903596,30904278,682,0.0882266442534194
11164,1030.163933,1030.168533,1,30904917,30905055,138,0.8502330774203976
11165,1030.1815,1030.195467,1,30905444,30905864,420,0.2852264911434711
11166,1030.2152,1030.244967,1,30906456,30907349,893,0.47561880202750423
11167,1031.621067,1031.741533,1,30948632,30952245,3613,0.2676512873275018
11168,1031.744167,1031.750833,1,30952325,30952524,199,0.7352394227349123
11169,1031.756133,1031.845533,1,30952683,30955365,2682,0.10790452853328253
11170,1031.864533,1031.874467,1,30955935,30956234,299,0.8006650516136173
11171,1031.875767,1031.881233,1,30956273,30956436,163,0.5916396476780154
11172,1031.917767,1031.937633,1,30957533,30958128,595,0.6951540774564998
11173,1031.957567,1031.966033,1,30958727,30958980,253,0.30794680510885986
11174,1031.9682,1031.9744,1,30959046,30959232,186,0.43046939902601977
11175,1031.9876,1031.996533,1,30959627,30959895,268,0.5119895509251241
11176,1031.998833,1032.0284,1,30959964,30960851,887,0.5959295925013964
11177,1032.029733,1032.038333,1,30960891,30961149,258,0.7198585921828269
11178,1032.0475,1032.071367,1,30961424,30962141,717,0.6754698921390213
11179,1032.100067,1032.1055,1,30963002,30963164,162,0.067876233142103
11180,1032.4031,1032.4094,1,30972093,30972282,189,0.7290830767286653
11181,1032.640933,1032.644033,1,30979227,30979320,93,0.8677710917354189
11182,1032.669567,1032.677433,1,30980087,30980322,235,0.6508918284336119
11183,1032.893767,1032.897033,1,30986813,30986910,97,0.486096792087042
11184,1033.995933,1034.0002,1,31019877,31020006,129,0.6267342814281915
11185,1034.141233,1034.384467,1,31024236,31031534,7298,0.05820617141464029
11186,1034.398667,1034.417533,1,31031960,31032525,565,0.09613850550891409
11187,1034.429833,1034.435133,1,31032894,31033053,159,0.9408216115039658
11188,1034.4408,1034.4686,1,31033224,31034057,833,0.08039304899018804
11189,1034.4703,1034.476667,1,31034109,31034300,191,0.8412572473531105
11190,1034.481833,1034.5175,1,31034454,31035524,1070,0.09658637768328766
11191,1035.183033,1035.2837,1,31055490,31058511,3021,0.1441156722139978
11192,1035.285367,1035.327667,1,31058561,31059830,1269,0.2556968812550755
11193,1035.335133,1035.340267,1,31060053,31060208,155,0.9058539333389726
11194,1035.3798,1035.469333,1,31061393,31064079,2686,0.1825973658510768
11195,1035.476033,1035.587967,1,31064280,31067639,3359,0.20718044316763737
11196,1035.589033,1035.598467,1,31067670,31067954,284,0.3116203263294899
11197,1035.616467,1035.6231,1,31068494,31068693,199,0.3384275521389473
11198,1035.631033,1035.6403,1,31068930,31069209,279,0.7731631467628535
11199,1035.6436,1035.664833,1,31069308,31069944,636,0.7093860157661335
11200,1035.6671,1035.697733,1,31070012,31070931,919,0.25720893054504684
11201,1035.709367,1035.718167,1,31071281,31071545,264,0.16917246321978016
11202,1035.722633,1035.7271,1,31071678,31071813,135,0.5847295023126363
11203,1035.751333,1035.843367,1,31072539,31075301,2762,0.1277569693205233
11204,1035.845267,1035.862433,1,31075358,31075872,514,0.001341162536013175
11205,1035.881033,1035.9305,1,31076430,31077915,1485,0.23652942286557432
11206,1035.933467,1035.947467,1,31078004,31078424,420,0.6932229811738475
11207,1035.9515,1036.038,1,31078544,31081140,2596,0.18198420974140986
11208,1036.0396,1036.0556,1,31081188,31081667,479,0.37824266712668725
11209,1036.0595,1036.099067,1,31081785,31082972,1187,0.6503799623508588
11210,1036.111967,1036.1306,1,31083359,31083918,559,0.4727434254229493
11211,1036.140633,1036.147067,1,31084218,31084412,194,0.5859141069207675
11212,1036.230233,1036.234133,1,31086906,31087023,117,0.7414463020141492
11213,1036.4368,1036.5189,1,31093104,31095567,2463,0.20662111073361272
11214,1036.776933,1036.8093,1,31103307,31104278,971,0.22817028237768483
11215,1036.8147,1036.823633,1,31104440,31104708,268,0.0984991709545406
11216,1036.8336,1036.879067,1,31105007,31106372,1365,0.22629221150642498
11217,1036.9442,1036.948733,1,31108325,31108461,136,0.9265553327694582
11218,1036.9606,1036.970567,1,31108818,31109117,299,0.4582444640367506
11219,1036.979967,1036.983033,1,31109399,31109490,91,0.493672240335648
11220,1036.984567,1036.987633,1,31109537,31109628,91,0.8769825054842902
11221,1037.005633,1037.0102,1,31110168,31110306,138,0.36836397042284447
11222,1037.4209,1037.4268,1,31122627,31122804,177,0.14423561023924628
11223,1037.432267,1037.510933,1,31122968,31125327,2359,0.14226314093643586
11224,1037.513933,1037.533533,1,31125417,31126005,588,0.19746272691179842
11225,1037.534967,1037.542633,1,31126049,31126278,229,0.7354048812606698
11226,1037.545333,1037.566033,1,31126359,31126980,621,0.18213947146559753
11227,1037.572333,1037.702967,1,31127169,31131089,3920,0.08119604078561392
11228,1037.719367,1037.727933,1,31131581,31131837,256,0.4473199213911584
11229,1037.755567,1037.772167,1,31132667,31133165,498,0.09695425576423891
11230,1037.793067,1037.823733,1,31133792,31134711,919,0.16296781758307505
11231,1037.825467,1037.834733,1,31134764,31135041,277,0.8123494267203453
11232,1037.8405,1037.863033,1,31135215,31135890,675,0.233138288858421
11233,1037.875967,1037.895333,1,31136279,31136859,580,0.1227016171389172
11234,1037.8994,1037.9112,1,31136982,31137336,354,0.7800787532331482
11235,1037.9194,1037.942567,1,31137582,31138277,695,0.38227489997025377
11236,1037.948333,1037.951833,1,31138449,31138554,105,0.8871010635287567
11237,1038.0515,1038.0569,1,31141545,31141707,162,0.5735201182531496
11238,1038.3071,1038.4112,1,31149213,31152336,3123,0.22991295975197226
11239,1038.422967,1038.459367,1,31152689,31153781,1092,0.23165469121962493
11240,1038.462967,1038.525533,1,31153889,31155765,1876,0.19149223272969074
11241,1038.532733,1038.6045,1,31155981,31158134,2153,0.0939746687402149
11242,1038.6672,1038.7042,1,31160016,31161125,1109,0.05849741723325991
11243,1038.721733,1038.7257,1,31161651,31161771,120,0.8349619899704958
11244,1038.7398,1038.762467,1,31162194,31162874,680,0.2784322429373627
11245,1038.773933,1038.7969,1,31163217,31163907,690,-0.03732041147734797
11246,1038.8057,1038.842233,1,31164170,31165266,1096,0.08963207593302572
11247,1038.850333,1038.8734,1,31165509,31166202,693,0.5839101653918879
11248,1038.883467,1038.892267,1,31166504,31166768,264,0.7834006618658678
11249,1038.909933,1038.913367,1,31167297,31167401,104,0.8460183517236574
11250,1038.915767,1038.9196,1,31167473,31167588,115,0.8925182315784845
11251,1039.102767,1039.1949,1,31173083,31175847,2764,0.16184057475815558
11252,1039.202833,1039.214433,1,31176084,31176432,348,0.7241566613169473
11253,1039.217933,1039.279433,1,31176537,31178382,1845,0.27837053793215377
11254,1039.283567,1039.3746,1,31178507,31181238,2731,0.15172489555865806
11255,1039.379233,1039.397733,1,31181376,31181931,555,0.45076860973925176
11256,1039.398967,1039.402667,1,31181969,31182080,111,0.9360984641097195
11257,1039.4052,1039.409,1,31182155,31182270,115,0.6063694957551202
11258,1039.412067,1039.4577,1,31182362,31183730,1368,0.028639546110433445
11259,1039.470633,1039.5365,1,31184118,31186094,1976,0.2736729310501892
11260,1039.564233,1039.571367,1,31186926,31187141,215,0.7563724200663968
11261,1039.5752,1039.587667,1,31187256,31187630,374,0.37562386540441767
11262,1039.855867,1039.938167,1,31195676,31198145,2469,0.14028777157476494
11263,1039.950433,1039.959067,1,31198512,31198772,260,0.5385505165835682
11264,1039.9602,1039.966633,1,31198806,31198998,192,0.6902171046301557
11265,1039.971733,1039.989067,1,31199151,31199672,521,0.5534519378416488
11266,1039.996567,1040.001467,1,31199897,31200044,147,0.7523334314541318
11267,1040.0061,1040.0206,1,31200183,31200618,435,0.41205908985881246
11268,1040.023633,1040.078533,1,31200708,31202355,1647,0.15213340670726372
11269,1040.1131,1040.1531,1,31203393,31204593,1200,0.2562671673188451
11270,1040.161367,1040.209667,1,31204841,31206290,1449,0.17119472484595194
11271,1040.213233,1040.2269,1,31206396,31206806,410,0.6271663421662362
11272,1040.277633,1040.316467,1,31208328,31209494,1166,0.28029038991944116
11273,1040.321133,1040.327833,1,31209633,31209834,201,0.8248055122982587
11274,1040.333667,1040.376333,1,31210010,31211289,1279,0.1980960348904302
11275,1040.381733,1040.391267,1,31211451,31211738,287,0.5865488735605637
11276,1040.668367,1040.722533,1,31220051,31221675,1624,0.16281749097312156
11277,1040.7236,1040.748733,1,31221708,31222461,753,0.18025489696158672
11278,1040.758333,1040.813467,1,31222749,31224404,1655,0.26975808959746844
11279,1040.8152,1040.8188,1,31224456,31224564,108,0.9011052170357342
11280,1040.8353,1040.844067,1,31225059,31225322,263,0.6666106417707097
11281,1040.847933,1040.885333,1,31225437,31226559,1122,0.06736591048286038
11282,1040.888667,1040.998633,1,31226660,31229958,3298,0.21262853414576888
11283,1041.383533,1041.389833,1,31241505,31241694,189,0.5831009457166109
11284,1041.395933,1041.467467,1,31241877,31244024,2147,0.15414519901689847
11285,1041.4685,1041.472033,1,31244055,31244160,105,0.9434730251673973
11286,1041.482,1041.489333,1,31244460,31244679,219,0.7594688102644
11287,1041.494333,1041.508933,1,31244829,31245267,438,0.4261912398847734
11288,1041.520267,1041.6323,1,31245608,31248969,3361,0.1324533188435423
11289,1041.636933,1041.6664,1,31249107,31249992,885,0.006624539785850688
11290,1041.667533,1041.713567,1,31250025,31251407,1382,0.18872430809119328
11291,1041.715133,1041.7673,1,31251453,31253019,1566,0.10553063030565644
11292,1041.847367,1041.850367,1,31255421,31255511,90,0.8464397551467466
11293,1041.852433,1041.8557,1,31255572,31255671,99,0.639459016947071
11294,1041.8829,1041.887233,1,31256487,31256616,129,0.8664686954496059
11295,1042.274867,1042.357267,1,31268246,31270718,2472,0.15669527046412404
11296,1042.364267,1042.408967,1,31270928,31272269,1341,0.2694929225228807
11297,1042.4127,1042.436067,1,31272381,31273082,701,0.11680794293229797
11298,1042.4371,1042.440133,1,31273113,31273203,90,0.7439665721102955
11299,1042.456033,1042.570833,1,31273680,31277124,3444,0.07084969096249215
11300,1042.613533,1042.6419,1,31278405,31279257,852,0.07466974284886918
11301,1043.258833,1043.3446,1,31297764,31300337,2573,0.13697248761471947
11302,1043.346467,1043.371467,1,31300394,31301144,750,0.26970091494243487
11303,1043.3729,1043.3809,1,31301187,31301427,240,0.808830698816
11304,1043.382567,1043.398167,1,31301477,31301945,468,0.26443605911901447
11305,1043.405067,1043.4285,1,31302152,31302855,703,0.34596559333172133
11306,1043.429933,1043.433533,1,31302897,31303005,108,0.8658368587969174
11307,1043.4456,1043.570333,1,31303368,31307109,3741,0.08976921580454744
11308,1043.606567,1043.638267,1,31308197,31309148,951,0.0187786433015771
11309,1043.648033,1043.652867,1,31309440,31309586,146,0.2710454769446165
11310,1043.668333,1043.6795,1,31310049,31310385,336,0.6556836990345117
11311,1043.979267,1043.991967,1,31319378,31319759,381,0.05896006994009372
11312,1043.993033,1044.096533,1,31319790,31322895,3105,0.192261985059229
11313,1044.0986,1044.119367,1,31322958,31323581,623,0.41793594994394656
11314,1044.125933,1044.155233,1,31323777,31324656,879,0.08091920638762164
11315,1044.164433,1044.302167,1,31324932,31329065,4133,0.16910454869263541
11316,1044.303167,1044.3417,1,31329095,31330251,1156,0.576334268525508
11317,1044.346933,1044.358133,1,31330407,31330743,336,0.7971642366767723
11318,1044.360067,1044.402367,1,31330802,31332071,1269,0.3798136834198827
11319,1044.411733,1044.442233,1,31332351,31333266,915,0.31674520554198865
11320,1044.449533,1044.4535,1,31333485,31333605,120,0.6732695711458786
11321,1044.457267,1044.462267,1,31333718,31333868,150,0.8769613668282319
11322,1044.466767,1044.476133,1,31334003,31334283,280,0.6988922801662993
11323,1044.479233,1044.4853,1,31334376,31334559,183,0.8960049758688996
11324,1044.5006,1044.530833,1,31335018,31335924,906,0.36664703864482473
11325,1044.555467,1044.560667,1,31336664,31336820,156,0.3779851353755975
11326,1044.592433,1044.596233,1,31337772,31337886,114,0.8262117954631074
11327,1044.6039,1044.607367,1,31338117,31338221,104,0.2956467059674935
11328,1044.6089,1044.615733,1,31338267,31338471,204,0.7329988219934637
11329,1044.657,1044.669333,1,31339709,31340079,370,0.4987393142687913
11330,1044.8625,1044.9404,1,31345875,31348212,2337,0.12719179213163267
11331,1044.942,1044.955133,1,31348260,31348653,393,0.22272076136866834
11332,1044.956367,1044.975733,1,31348691,31349271,580,0.0023088908184971217
11333,1044.977867,1045.004767,1,31349336,31350143,807,0.24814488832071951
11334,1045.010033,1045.147633,1,31350300,31354428,4128,0.15846106127727172
11335,1045.1548,1045.193067,1,31354644,31355792,1148,0.13286568511307317
11336,1045.2031,1045.206467,1,31356093,31356194,101,0.7007336364964744
11337,1045.247767,1045.266367,1,31357433,31357991,558,0.29031731897037905
11338,1045.280733,1045.314167,1,31358421,31359425,1004,0.19880326997731562
11339,1045.734667,1045.8201,1,31372040,31374602,2562,0.16494456349915462
11340,1045.8288,1045.837133,1,31374864,31375113,249,0.0558219959454346
11341,1045.8382,1045.867033,1,31375145,31376010,865,0.047965235721786716
11342,1045.8682,1045.928567,1,31376045,31377857,1812,0.25308598996218146
11343,1045.929833,1045.957633,1,31377894,31378728,834,0.335706249979802
11344,1045.9592,1046.0449,1,31378776,31381347,2571,0.26422593488489576
11345,1046.064767,1046.0692,1,31381943,31382075,132,0.5511094034985593
11346,1046.075,1046.080467,1,31382250,31382414,164,0.7140671525361408
11347,1046.081533,1046.086667,1,31382445,31382600,155,0.8100231935573746
11348,1046.087767,1046.106367,1,31382633,31383191,558,0.8011346653358421
11349,1046.111367,1046.146133,1,31383341,31384383,1042,0.34644043162628896
11350,1046.1545,1046.162067,1,31384635,31384862,227,0.6268465135443918
11351,1046.167133,1046.171067,1,31385013,31385132,119,0.908425060899865
11352,1046.1831,1046.283433,1,31385493,31388502,3009,0.28490167356379426
11353,1046.2996,1046.3495,1,31388988,31390485,1497,0.18339706277643208
11354,1046.3513,1046.387533,1,31390539,31391625,1086,0.16476877744885127
11355,1046.390233,1046.3994,1,31391706,31391982,276,0.3907815338496191
11356,1046.436233,1046.484267,1,31393086,31394528,1442,0.4819888809755277
11357,1046.485267,1046.489533,1,31394558,31394685,127,0.8363716325334558
11358,1046.4998,1046.532333,1,31394994,31395969,975,0.5751675954089924
11359,1046.551067,1046.5593,1,31396532,31396778,246,0.3034416654390893
11360,1046.597867,1046.645133,1,31397936,31399353,1417,0.7176930857378152
11361,1046.649767,1046.680467,1,31399493,31400414,921,0.3348156305539767
11362,1046.6883,1046.6914,1,31400649,31400741,92,0.9043146942931591
11363,1046.696267,1046.7032,1,31400888,31401095,207,0.3744424004590043
11364,1046.7551,1046.843167,1,31402653,31405295,2642,0.27242194220554194
11365,1046.845767,1046.852767,1,31405373,31405583,210,0.07534191335015647
11366,1046.904767,1046.910067,1,31407143,31407302,159,0.7869651081264185
11367,1046.913367,1047.037767,1,31407401,31411133,3732,0.14529469476539064
11368,1047.039433,1047.042833,1,31411182,31411284,102,0.8560060439996577
11369,1047.044867,1047.0481,1,31411346,31411443,97,0.5798216510002088
11370,1047.084333,1047.092733,1,31412529,31412781,252,0.5603225123368463
11371,1047.102467,1047.117533,1,31413074,31413525,451,0.41019108575873997
11372,1047.120933,1047.1301,1,31413627,31413903,276,0.6375465488491697
11373,1047.141733,1047.1516,1,31414251,31414547,296,0.8060577538707441
11374,1047.155833,1047.185667,1,31414674,31415570,896,0.3792406800340302
11375,1047.451433,1047.456733,1,31423542,31423701,159,0.32091230304642704
11376,1047.458233,1047.5121,1,31423746,31425362,1616,0.0565046239286063
11377,1047.5131,1047.580133,1,31425392,31427403,2011,-0.0077707099708885915
11378,1047.582067,1047.609167,1,31427462,31428275,813,0.08277848332624127
11379,1047.631067,1047.720233,1,31428932,31431606,2674,0.0967579318208565
11380,1047.723467,1047.7891,1,31431704,31433673,1969,0.2783366129791354
11381,1047.867333,1047.8801,1,31436019,31436403,384,0.5385497602961242
11382,1047.8827,1047.887667,1,31436481,31436630,149,0.5971416827306727
11383,1047.9136,1047.9184,1,31437408,31437552,144,0.6037387208121158
11384,1047.931833,1047.9896,1,31437954,31439688,1734,0.12875061387496312
11385,1048.023267,1048.029333,1,31440698,31440879,181,0.7166853678924362
11386,1048.049067,1048.058467,1,31441472,31441754,282,0.766242452878816
11387,1048.063767,1048.066867,1,31441913,31442006,93,0.8651105468082184
11388,1048.596,1048.623233,1,31457880,31458696,816,0.13050983990584256
11389,1048.636967,1048.639967,1,31459109,31459199,90,0.8078800935854815
11390,1048.656567,1048.801633,1,31459697,31464048,4351,0.16886866740442658
11391,1048.811,1048.8465,1,31464329,31465395,1066,0.1654593180798445
11392,1048.853833,1048.880167,1,31465614,31466405,791,0.11822087843798877
11393,1048.891367,1048.9716,1,31466741,31469148,2407,0.08998543339756332
11394,1048.977767,1049.0102,1,31469333,31470306,973,0.24344627705793848
11395,1049.0212,1049.041767,1,31470635,31471253,618,0.07987414392416448
11396,1049.073533,1049.0932,1,31472205,31472796,591,0.09290732917738416
11397,1049.095667,1049.1319,1,31472870,31473957,1087,0.09481862222051042
11398,1049.198733,1049.203367,1,31475961,31476101,140,0.7297948889957008
11399,1049.2149,1049.218833,1,31476447,31476564,117,0.7044139205884328
11400,1049.2204,1049.228467,1,31476611,31476854,243,0.5848554742400961
11401,1049.240933,1049.2474,1,31477227,31477422,195,0.6610728143683512
11402,1049.258333,1049.267367,1,31477749,31478021,272,0.11982390228425638
11403,1049.283067,1049.291067,1,31478492,31478732,240,0.3619816482816459
11404,1049.297733,1049.3828,1,31478931,31481484,2553,0.12631680021214836
11405,1049.391,1049.450133,1,31481730,31483503,1773,0.27207494307575203
11406,1049.478133,1049.5034,1,31484343,31485102,759,0.79646594369351
11407,1049.527233,1049.5304,1,31485816,31485912,96,0.8612896667636852
11408,1050.0818,1050.096967,1,31502453,31502909,456,0.29198513461881026
11409,1050.099467,1050.102533,1,31502984,31503075,91,0.9368721627314722
11410,1050.105667,1050.118133,1,31503170,31503543,373,0.2924547046780848
11411,1050.1195,1050.251033,1,31503585,31507530,3945,0.15874385789310227
11412,1050.259267,1050.279167,1,31507778,31508375,597,0.15657001756168537
11413,1050.283067,1050.3785,1,31508492,31511355,2863,0.011759778605675533
11414,1050.391167,1050.433833,1,31511735,31513014,1279,0.2015428285966426
11415,1050.445433,1050.450767,1,31513362,31513523,161,0.7843536094278085
11416,1050.4961,1050.501533,1,31514883,31515045,162,0.7369386528888962
11417,1050.8171,1050.8276,1,31524513,31524828,315,0.40026855105155273
11418,1050.8289,1050.900633,1,31524867,31527018,2151,0.19170784095406962
11419,1050.9029,1050.905967,1,31527087,31527179,92,0.9634762577999435
11420,1050.913367,1050.933033,1,31527401,31527990,589,0.4124338849708226
11421,1050.9351,1050.970467,1,31528052,31529114,1062,0.0951295854609463
11422,1050.979433,1051.159233,1,31529382,31534776,5394,0.19139817247798288
11423,1051.162933,1051.230867,1,31534887,31536926,2039,0.35496575662864677
11424,1051.265233,1051.269167,1,31537956,31538075,119,0.8432143338852187
11425,1051.981267,1051.993067,1,31559438,31559792,354,0.11916787004410483
11426,1051.995533,1052.070667,1,31559865,31562120,2255,0.1574980190308912
11427,1052.071733,1052.094967,1,31562151,31562849,698,0.3304392626044205
11428,1052.097867,1052.177333,1,31562936,31565319,2383,0.029421893637532875
11429,1052.184167,1052.308967,1,31565525,31569269,3744,0.10118707126875227
11430,1052.316733,1052.3499,1,31569501,31570496,995,0.1668463640800349
11431,1052.3583,1052.382433,1,31570749,31571472,723,0.096312055014364
11432,1052.4714,1052.490033,1,31574141,31574700,559,0.7758787114031365
11433,1052.496833,1052.536767,1,31574904,31576103,1199,0.2804627599967241
11434,1052.539,1052.542433,1,31576170,31576272,102,0.9669882692789175
11435,1052.623033,1052.627333,1,31578690,31578819,129,0.8386016526912197
11436,1052.646567,1052.6538,1,31579397,31579614,217,0.8264955030185139
11437,1052.6743,1052.714633,1,31580228,31581438,1210,0.25421225575012596
11438,1052.733167,1052.766067,1,31581995,31582982,987,0.3145357242899753
11439,1052.767367,1052.772033,1,31583021,31583160,139,0.6414780141641636
11440,1052.8112,1052.814233,1,31584336,31584426,90,0.9286398089805633
11441,1052.8191,1052.8272,1,31584572,31584816,244,0.7269029594509469
11442,1052.8285,1052.8487,1,31584855,31585461,606,0.42587479826603003
11443,1052.850067,1052.858067,1,31585502,31585742,240,0.9128765264231278
11444,1052.868833,1052.899633,1,31586064,31586988,924,0.49673761229909785
11445,1052.9067,1052.9097,1,31587201,31587290,89,0.8914498531496365
11446,1053.755633,1053.8579,1,31612668,31615737,3069,0.16095124065291838
11447,1053.860667,1053.914967,1,31615820,31617449,1629,0.0844382984476353
11448,1053.923033,1054.155533,1,31617690,31624665,6975,0.13649127467925726
11449,1054.1621,1054.184967,1,31624863,31625549,686,0.42641059624907474
11450,1054.208867,1054.250667,1,31626266,31627520,1254,0.20133936684213918
11451,1054.295767,1054.307133,1,31628873,31629213,340,0.7348815540932893
11452,1054.337133,1054.342833,1,31630113,31630284,171,0.7429425021049325
11453,1054.345333,1054.349033,1,31630359,31630470,111,0.8180379505061764
11454,1054.356133,1054.361167,1,31630683,31630835,152,0.7061137066320129
11455,1054.450233,1054.456567,1,31633506,31633697,191,0.722260019448335
11456,1054.495667,1054.5345,1,31634870,31636035,1165,0.6031675789026699
11457,1054.559333,1054.565733,1,31636779,31636971,192,0.7705922795604228
11458,1054.582833,1054.594067,1,31637484,31637822,338,0.8633339036632952
11459,1055.014967,1055.030067,1,31650449,31650902,453,0.23272201939072984
11460,1055.037433,1055.086233,1,31651122,31652586,1464,0.23376457367995992
11461,1055.091367,1055.0964,1,31652741,31652891,150,0.607871620762834
11462,1055.098333,1055.116333,1,31652949,31653489,540,0.11963090568007077
11463,1055.119233,1055.1473,1,31653576,31654419,843,0.21163445737565606
11464,1055.151367,1055.266233,1,31654541,31657986,3445,0.20445930021641617
11465,1055.9834,1055.993967,1,31679502,31679819,317,0.3206748722234847
11466,1055.994967,1055.998467,1,31679849,31679954,105,0.9780479022259766
11467,1056.1516,1056.1591,1,31684547,31684773,226,0.2952074452394056
11468,1056.170067,1056.222933,1,31685102,31686687,1585,0.18003520406416573
11469,1056.224267,1056.240633,1,31686728,31687218,490,0.19686124823761325
11470,1056.247467,1056.2672,1,31687424,31688016,592,0.5194927288225235
11471,1056.2865,1056.5371,1,31688594,31696113,7519,0.05411516677561528
11472,1056.548067,1056.554333,1,31696442,31696629,187,0.5011375736740972
11473,1056.562733,1056.5668,1,31696881,31697004,123,0.7809379531667653
11474,1056.5709,1056.578767,1,31697126,31697363,237,0.7784294353958976
11475,1056.6192,1056.6324,1,31698576,31698972,396,0.8025605052172797
11476,1056.873967,1056.8773,1,31706219,31706319,100,0.7898271109068896
11477,1056.9049,1056.912533,1,31707147,31707375,228,0.6433222903379369
11478,1056.9154,1057.0003,1,31707462,31710008,2546,0.1593622429364766
11479,1057.0062,1057.051533,1,31710186,31711545,1359,0.3374795048725802
11480,1057.0537,1057.0749,1,31711610,31712247,637,0.11200083446155269
11481,1057.079633,1057.084633,1,31712388,31712538,150,0.9103123137849005
11482,1057.105567,1057.198067,1,31713167,31715942,2775,0.13779764024255403
11483,1057.202967,1057.231733,1,31716089,31716951,862,0.17991441619503165
11484,1057.234067,1057.241,1,31717022,31717230,208,0.859784708190003
11485,1057.243033,1057.265667,1,31717290,31717970,680,0.1516955132602645
11486,1057.2683,1057.295933,1,31718049,31718877,828,0.15107320903928528
11487,1057.298567,1057.338467,1,31718957,31720154,1197,0.18938441521640062
11488,1057.410367,1057.4142,1,31722311,31722425,114,0.56581581045484
11489,1057.432333,1057.587433,1,31722969,31727622,4653,0.12941451389426045
11490,1057.594633,1057.601033,1,31727838,31728030,192,0.5963884126530193
11491,1057.6049,1057.609833,1,31728147,31728294,147,0.3827900384506585
11492,1057.626533,1057.648233,1,31728795,31729446,651,0.1696301436576898
11493,1057.680433,1057.6977,1,31730412,31730931,519,0.2908279488411843
11494,1057.703033,1057.708633,1,31731090,31731258,168,0.48555661473385753
11495,1057.712833,1057.7619,1,31731384,31732857,1473,0.39500625473215734
11496,1057.776867,1057.782367,1,31733306,31733471,165,0.6696585156748533
11497,1057.790733,1057.8283,1,31733721,31734848,1127,0.2571846640955737
11498,1057.834333,1057.854833,1,31735029,31735644,615,0.34066148608415425
11499,1057.863467,1057.870967,1,31735904,31736129,225,0.5515043252439712
11500,1058.274067,1058.301067,1,31748222,31749032,810,0.07024492017395616
11501,1058.302967,1058.418967,1,31749089,31752569,3480,0.13492636774734001
11502,1058.4242,1058.434533,1,31752725,31753035,310,0.23854014853472172
11503,1058.435633,1058.493667,1,31753068,31754810,1742,0.12421654117021776
11504,1058.4955,1058.4985,1,31754865,31754954,89,0.9071401754335883
11505,1058.506233,1058.612067,1,31755186,31758362,3176,0.04927410124339953
11506,1058.619733,1058.6474,1,31758591,31759422,831,-0.06430805028579076
11507,1058.648533,1058.674933,1,31759455,31760247,792,0.12818910733430255
11508,1058.6764,1058.679667,1,31760292,31760390,98,0.7336571655626617
11509,1058.690633,1058.742767,1,31760718,31762283,1565,0.16606706340044566
11510,1058.802833,1058.806133,1,31764084,31764183,99,0.8021576010314713
11511,1058.819867,1058.8242,1,31764596,31764726,130,0.8525965756924596
11512,1058.826067,1058.8319,1,31764782,31764956,174,0.780822690882552
11513,1058.838667,1058.841867,1,31765160,31765256,96,0.8723527701718661
11514,1058.845267,1058.850767,1,31765358,31765523,165,0.6013002300255644
11515,1058.851833,1058.870467,1,31765554,31766114,560,0.6464342335545809
11516,1059.903233,1059.912,1,31797096,31797360,264,0.7256993139143006
11517,1060.627233,1060.7231,1,31818816,31821692,2876,0.17476225439255613
11518,1060.7356,1060.7889,1,31822068,31823667,1599,0.1204454691193695
11519,1060.790233,1060.7951,1,31823706,31823853,147,0.4355679974101396
11520,1060.7988,1060.882467,1,31823964,31826474,2510,0.17482872872107771
11521,1062.5217,1062.528533,1,31875651,31875855,204,0.3921283790136556
11522,1062.543367,1062.633367,1,31876301,31879001,2700,0.24643186119111987
11523,1062.6346,1062.643633,1,31879038,31879308,270,0.46668291474361423
11524,1062.647733,1062.651467,1,31879431,31879544,113,0.15122848824822274
11525,1062.654633,1062.702433,1,31879638,31881072,1434,0.15129305027328657
11526,1062.7155,1062.8169,1,31881465,31884507,3042,0.12844735047838812
11527,1062.821633,1062.839033,1,31884648,31885170,522,0.017629021051399518
11528,1062.841633,1062.8456,1,31885248,31885368,120,0.6524350112800243
11529,1062.850467,1062.871,1,31885514,31886130,616,0.1451629789722036
11530,1062.872633,1062.906033,1,31886178,31887180,1002,0.21350703642692367
11531,1062.907067,1062.919933,1,31887212,31887597,385,0.5492275420029787
11532,1062.9212,1062.940367,1,31887636,31888211,575,0.1171261115207521
11533,1062.956033,1063.032333,1,31888680,31890969,2289,0.24680710927713842
11534,1063.033667,1063.036933,1,31891010,31891107,97,0.8419256987603989
11535,1063.0669,1063.071467,1,31892007,31892144,137,0.8754828468090557
11536,1063.072767,1063.081333,1,31892183,31892439,256,0.08059567853682455
11537,1064.318467,1064.3276,1,31929554,31929828,274,0.6487696617821403
11538,1064.337967,1064.498333,1,31930139,31934949,4810,0.12177270167912653
11539,1064.502367,1064.612367,1,31935071,31938371,3300,0.08856785886213858
11540,1064.631833,1064.678467,1,31938954,31940354,1400,0.19317720456037035
11541,1064.683,1064.735133,1,31940490,31942053,1563,0.34812509310581796
11542,1064.7541,1064.757133,1,31942623,31942713,90,0.7030959843768559
11543,1065.037,1065.040433,1,31951110,31951212,102,0.764855487798474
11544,1065.0433,1065.049333,1,31951299,31951479,180,0.6581858347693396
11545,1065.051167,1065.0544,1,31951535,31951632,97,0.9802517312596968
11546,1065.3469,1065.3511,1,31960407,31960533,126,-0.3106896244501107
11547,1065.352167,1065.452733,1,31960565,31963581,3016,0.1325144858747421
11548,1065.458633,1065.6765,1,31963758,31970295,6537,0.11627341837635301
11549,1065.710033,1065.717933,1,31971300,31971537,237,0.7841695971486632
11550,1065.735267,1065.7387,1,31972058,31972161,103,0.5202127181210829
11551,1065.739933,1065.7661,1,31972197,31972983,786,0.2063528130290304
11552,1065.7812,1065.831633,1,31973435,31974948,1513,0.2171813902294432
11553,1065.848867,1065.878167,1,31975466,31976345,879,0.20578547417547668
11554,1065.884033,1065.8927,1,31976520,31976781,261,0.9203892856393929
11555,1065.8968,1065.932067,1,31976904,31977962,1058,0.11053387377038028
11556,1065.9867,1065.990267,1,31979600,31979708,108,0.6167943888035817
11557,1065.997333,1066.001733,1,31979919,31980051,132,0.6466699599737493
11558,1066.003333,1066.0246,1,31980099,31980738,639,0.20301843192081295
11559,1066.049733,1066.068933,1,31981491,31982067,576,0.3233136903399048
11560,1066.1314,1066.134567,1,31983942,31984037,95,0.851934447797801
11561,1066.138167,1066.222833,1,31984145,31986684,2539,0.10996107354255287
11562,1066.229467,1066.249,1,31986884,31987470,586,0.35980997890080907
11563,1066.2543,1066.347933,1,31987629,31990437,2808,0.24589056196097234
11564,1066.349433,1066.360833,1,31990482,31990824,342,0.16625360433427222
11565,1066.373467,1066.440967,1,31991204,31993229,2025,0.22499876323886323
11566,1066.442367,1066.489333,1,31993271,31994679,1408,0.17012260508665888
11567,1066.4998,1066.567233,1,31994994,31997016,2022,0.01505503788515277
11568,1066.572633,1066.616333,1,31997178,31998489,1311,0.18544593778560878
11569,1066.6233,1066.626333,1,31998699,31998789,90,0.8286978958930725
11570,1066.639267,1066.650933,1,31999178,31999527,349,0.025663819756684567
11571,1066.652633,1066.662467,1,31999578,31999874,296,0.5351928525375028
11572,1066.663633,1066.6955,1,31999908,32000865,957,0.22523684730223295
11573,1066.699967,1066.704633,1,32000999,32001138,139,0.6431412191489997
11574,1066.705833,1066.744067,1,32001174,32002322,1148,0.34944533783736226
11575,1066.747233,1066.7545,1,32002416,32002635,219,0.6579469829230867
11576,1066.793867,1066.7979,1,32003816,32003937,121,0.724204507542359
11577,1066.7998,1066.8128,1,32003994,32004383,389,0.5403213480598946
11578,1066.8138,1066.856967,1,32004413,32005709,1296,0.39714805366675526
11579,1066.8584,1066.888867,1,32005752,32006666,914,0.1949361279347981
11580,1066.889967,1066.903467,1,32006699,32007104,405,0.37706646160751633
11581,1066.905233,1066.910833,1,32007156,32007324,168,0.7731524795219035
11582,1066.927367,1066.9348,1,32007821,32008044,223,0.5528692784895338
11583,1066.9647,1066.969067,1,32008941,32009072,131,0.773496572614594
11584,1066.972633,1067.0188,1,32009178,32010564,1386,0.10868057257304718
11585,1067.030367,1067.0445,1,32010911,32011335,424,0.7983098438493466
11586,1067.0594,1067.062833,1,32011782,32011884,102,0.4574502093334819
11587,1067.0778,1067.172467,1,32012334,32015174,2840,0.17622406029593382
11588,1067.194933,1067.2131,1,32015847,32016393,546,0.3129567015570508
11589,1067.2144,1067.240667,1,32016432,32017220,788,0.23705271098570485
11590,1067.243167,1067.3099,1,32017295,32019297,2002,0.3217763038729831
11591,1067.3451,1067.351267,1,32020353,32020538,185,0.3169151866591958
11592,1067.408533,1067.4161,1,32022255,32022482,227,0.8209752838169644
11593,1067.4272,1067.4349,1,32022816,32023047,231,0.16522357963296572
11594,1067.439467,1067.5183,1,32023184,32025549,2365,0.17965977547186582
11595,1067.532367,1067.543567,1,32025971,32026307,336,0.12268292871154764
11596,1067.5453,1067.558333,1,32026359,32026749,390,0.08047565677656017
11597,1067.5622,1067.5948,1,32026866,32027844,978,0.19097626852795643
11598,1067.5984,1067.6199,1,32027952,32028596,644,0.23889970385938997
11599,1067.645467,1067.7423,1,32029364,32032268,2904,0.20498319719925068
11600,1067.797333,1067.832767,1,32033919,32034983,1064,0.13483284313569316
11601,1067.8528,1067.8571,1,32035583,32035713,130,0.6868912144266854
11602,1067.8704,1067.896467,1,32036112,32036894,782,0.20454289436327708
11603,1067.900433,1067.9295,1,32037012,32037885,873,0.17921396630665504
11604,1067.952467,1067.973633,1,32038574,32039208,634,0.07815961888331756
11605,1067.978167,1068.023633,1,32039345,32040708,1363,-0.010528121529075367
11606,1068.029533,1068.046367,1,32040885,32041391,506,0.9354816673656754
11607,1068.059667,1068.084,1,32041790,32042520,730,0.4879564158177713
11608,1068.210967,1068.2588,1,32046329,32047764,1435,0.06491228954968953
11609,1068.2625,1068.315267,1,32047875,32049458,1583,0.32842847624846283
11610,1068.328567,1068.331567,1,32049857,32049947,90,0.804372638431464
11611,1068.333533,1068.3773,1,32050005,32051319,1314,0.14221776576388395
11612,1068.3886,1068.4011,1,32051658,32052033,375,0.3962875567947067
11613,1068.4069,1068.475167,1,32052207,32054255,2048,0.14776877408955486
11614,1068.950267,1069.0601,1,32068508,32071802,3294,0.11459698285278146
11615,1069.067833,1069.1077,1,32072034,32073231,1197,0.2204833275057521
11616,1069.1087,1069.1657,1,32073261,32074971,1710,0.2887450062223902
11617,1069.182467,1069.294933,1,32075474,32078847,3373,0.07829445415270767
11618,1069.319967,1069.3432,1,32079599,32080296,697,0.05643095515384719
11619,1069.404933,1069.4247,1,32082147,32082741,594,-0.031563924864168855
11620,1069.429767,1069.522033,1,32082893,32085660,2767,0.039290495037858995
11621,1069.5238,1069.548467,1,32085713,32086454,741,0.3469695161309294
11622,1069.58,1069.662433,1,32087399,32089872,2473,0.24423453981660545
11623,1069.686333,1069.703033,1,32090589,32091090,501,0.4278105801042734
11624,1069.715467,1069.7986,1,32091464,32093958,2494,0.1579697069651086
11625,1069.820933,1069.845767,1,32094627,32095373,746,0.19033287995486148
11626,1069.918267,1069.921867,1,32097548,32097656,108,0.3640155410744843
11627,1069.932567,1070.044567,1,32097977,32101337,3360,0.18471499877556447
11628,1070.046833,1070.053567,1,32101404,32101607,203,0.6406867694505933
11629,1070.060733,1070.080167,1,32101821,32102405,584,0.19255080659044924
11630,1070.081333,1070.087567,1,32102439,32102627,188,0.3959675274668873
11631,1070.089933,1070.1123,1,32102697,32103369,672,0.1900014141677017
11632,1070.113567,1070.118133,1,32103407,32103543,136,0.8814879111586713
11633,1070.1232,1070.2633,1,32103696,32107899,4203,0.09825080152860938
11634,1070.264967,1070.2696,1,32107949,32108088,139,0.9544788295057406
11635,1070.272267,1070.2921,1,32108168,32108762,594,0.5387300934000656
11636,1070.301933,1070.3069,1,32109057,32109207,150,0.5338663532352775
11637,1070.361533,1070.3758,1,32110845,32111274,429,0.11412789782439503
11638,1070.381567,1070.384567,1,32111447,32111537,90,0.5915922341187072
11639,1070.386267,1070.3934,1,32111588,32111801,213,0.12155986007630946
11640,1070.3946,1070.4128,1,32111838,32112384,546,0.1560084301078363
11641,1070.414067,1070.4388,1,32112422,32113163,741,0.2392502391013144
11642,1070.466167,1070.482267,1,32113985,32114468,483,0.31165419030033853
11643,1070.536233,1070.545767,1,32116086,32116373,287,0.585470955273949
11644,1070.556567,1070.561933,1,32116697,32116857,160,0.8330468431738697
11645,1070.662633,1070.666233,1,32119878,32119986,108,0.36368247884099675
11646,1070.673133,1070.6893,1,32120193,32120679,486,0.24152768243338626
11647,1070.700333,1070.7038,1,32121009,32121114,105,0.47905987913119524
11648,1070.704867,1070.709933,1,32121146,32121297,151,0.7177829736652842
11649,1070.7116,1070.717267,1,32121348,32121518,170,0.7172665795281792
11650,1070.719433,1070.723533,1,32121582,32121705,123,0.7309170545010845
11651,1070.7878,1070.8231,1,32123634,32124693,1059,0.3026122589281701
11652,1070.8474,1070.873867,1,32125422,32126216,794,0.0011609043129293818
11653,1070.936033,1071.016533,1,32128080,32130495,2415,0.04300283514047484
11654,1071.0206,1071.1044,1,32130618,32133132,2514,0.11920289108109153
11655,1071.120067,1071.183067,1,32133602,32135492,1890,0.11494692895590838
11656,1071.184133,1071.215567,1,32135523,32136467,944,0.2321201929983535
11657,1071.2168,1071.3266,1,32136503,32139798,3295,0.13949599112699998
11658,1071.339367,1071.361033,1,32140181,32140830,649,0.21757110394458035
11659,1071.363267,1071.367067,1,32140898,32141012,114,0.5885487626335384
11660,1071.370667,1071.375167,1,32141120,32141255,135,0.5987301375266395
11661,1071.3806,1071.396767,1,32141418,32141903,485,0.11972958633803142
11662,1071.3978,1071.402933,1,32141934,32142087,153,0.7487956663866112
11663,1071.41,1071.4341,1,32142300,32143023,723,0.05413516040634362
11664,1071.4422,1071.4711,1,32143266,32144133,867,0.20584832250072857
11665,1071.504033,1071.544033,1,32145120,32146320,1200,0.21163498992318813
11666,1071.6081,1071.649933,1,32148242,32149497,1255,0.23435783763624612
11667,1071.658433,1071.662733,1,32149752,32149881,129,0.7813059245195757
11668,1071.796967,1071.801833,1,32153909,32154054,145,0.7961886259268233
11669,1071.813467,1071.870667,1,32154404,32156120,1716,-0.021973131117260927
11670,1071.871667,1071.8944,1,32156150,32156831,681,0.291985087478851
11671,1071.938433,1071.987333,1,32158152,32159619,1467,0.3036313287654451
11672,1072.048,1072.051033,1,32161440,32161530,90,0.8778549940426722
11673,1072.456133,1072.528467,1,32173683,32175854,2171,0.08094196657238618
11674,1072.535733,1072.595367,1,32176071,32177861,1790,0.09586572874241717
11675,1072.596533,1072.7146,1,32177895,32181438,3543,0.2911528925412261
11676,1073.309333,1073.398067,1,32199279,32201942,2663,0.1097890866987495
11677,1073.399167,1073.456233,1,32201975,32203686,1711,0.11816955082354517
11678,1073.468133,1073.592133,1,32204043,32207763,3720,0.13213497129583107
11679,1073.600367,1073.6222,1,32208011,32208666,655,0.13134658336104246
11680,1073.628233,1073.660067,1,32208846,32209802,956,0.23853908144676372
11681,1073.663167,1073.683567,1,32209895,32210507,612,0.2835824534126339
11682,1073.7137,1073.726467,1,32211411,32211794,383,0.7185903717870193
11683,1073.7656,1073.769133,1,32212968,32213073,105,0.6147035062688774
11684,1073.775633,1073.7829,1,32213268,32213486,218,0.7013651290728081
11685,1073.796,1073.8213,1,32213880,32214639,759,0.4227521524994928
11686,1073.8389,1073.866467,1,32215167,32215994,827,0.28455060271955934
11687,1073.8999,1073.9073,1,32216996,32217219,223,0.29898384119419696
11688,1073.920367,1074.019233,1,32217611,32220576,2965,0.2169608505384979
11689,1074.021967,1074.030767,1,32220659,32220923,264,0.16954599700176928
11690,1074.033,1074.0396,1,32220989,32221188,199,0.1801034446923034
11691,1074.0752,1074.154267,1,32222256,32224628,2372,0.15210367477800718
11692,1074.168133,1074.175633,1,32225043,32225268,225,0.42068159444776076
11693,1074.451967,1074.456467,1,32233559,32233694,135,0.7352339621228648
11694,1074.462633,1074.515433,1,32233878,32235462,1584,0.10429365835831898
11695,1074.518567,1074.5336,1,32235557,32236008,451,-0.045165032596137224
11696,1074.535067,1074.567967,1,32236052,32237039,987,-0.09484912259866932
11697,1074.570667,1074.602033,1,32237120,32238060,940,0.140433056034699
11698,1074.616,1074.7137,1,32238480,32241411,2931,0.0814079926437693
11699,1074.721967,1074.726867,1,32241659,32241806,147,0.592015593091639
11700,1074.7308,1074.764167,1,32241924,32242925,1001,0.16021201596587728
11701,1074.774833,1074.7924,1,32243244,32243772,528,0.172220154188298
11702,1074.8011,1074.821933,1,32244032,32244657,625,-0.0193816926877688
11703,1074.8342,1074.8563,1,32245026,32245688,662,0.1374784827775244
11704,1074.900867,1074.944067,1,32247026,32248322,1296,0.23149441534656817
11705,1074.955667,1074.959267,1,32248670,32248778,108,0.8673352083949439
11706,1075.039833,1075.0445,1,32251194,32251335,141,0.4532089022353942
11707,1075.0487,1075.0607,1,32251461,32251821,360,0.6837913396801515
11708,1075.063633,1075.0852,1,32251908,32252556,648,0.3446902017991304
11709,1075.263167,1075.3185,1,32257895,32259555,1660,0.18132488252161647
11710,1075.329967,1075.3382,1,32259899,32260145,246,0.6442767840831789
11711,1075.366267,1075.4065,1,32260988,32262195,1207,0.5918186962908443
11712,1075.4077,1075.419,1,32262231,32262570,339,0.6946466556231952
11713,1075.508,1075.554467,1,32265240,32266634,1394,0.14837224571392635
11714,1075.5555,1075.593033,1,32266665,32267790,1125,0.057000447969462666
11715,1075.594333,1075.6061,1,32267829,32268183,354,0.017494510795563877
11716,1075.6071,1075.745367,1,32268213,32272361,4148,0.26360850729496005
11717,1075.756833,1075.763433,1,32272704,32272902,198,0.9050555422332452
11718,1075.999933,1076.051567,1,32279997,32281547,1550,0.2607877366004825
11719,1076.055633,1076.064667,1,32281668,32281940,272,0.6202315209315407
11720,1076.072033,1076.0777,1,32282160,32282331,171,0.8998101284793908
11721,1076.0795,1076.083633,1,32282385,32282508,123,0.7942160101787168
11722,1076.089033,1076.096167,1,32282670,32282885,215,0.8465059509972287
11723,1076.110533,1076.122533,1,32283315,32283675,360,0.38738531786736047
11724,1076.127733,1076.180767,1,32283831,32285423,1592,0.34879660097736837
11725,1076.191667,1076.2327,1,32285750,32286981,1231,0.0028844808580638505
11726,1076.2524,1076.311133,1,32287572,32289333,1761,0.10594577430349858
11727,1076.313133,1076.421267,1,32289393,32292638,3245,0.22567859580740124
11728,1076.426267,1076.4311,1,32292788,32292933,145,0.793167738885308
11729,1076.436267,1076.4663,1,32293088,32293989,901,0.0928747739360819
11730,1076.4685,1076.476133,1,32294055,32294283,228,0.5679588861474623
11731,1076.4911,1076.5413,1,32294733,32296239,1506,0.10328262269816085
11732,1076.545,1076.5493,1,32296350,32296478,128,0.8633207034721152
11733,1076.5512,1076.5613,1,32296536,32296839,303,0.4052945557883039
11734,1076.562433,1076.581333,1,32296872,32297439,567,0.062089433697653094
11735,1076.591667,1076.668567,1,32297750,32300057,2307,0.1295497138205736
11736,1076.699967,1076.7436,1,32300999,32302308,1309,0.15421817787741937
11737,1076.744733,1076.753667,1,32302341,32302610,269,0.6538213476091024
11738,1076.765567,1076.785067,1,32302967,32303552,585,0.23886050482388943
11739,1076.788367,1076.8025,1,32303651,32304075,424,0.3460462055151554
11740,1076.862667,1076.866167,1,32305880,32305985,105,-0.12974344319570905
11741,1076.897833,1076.901967,1,32306934,32307059,125,0.2769134460305888
11742,1076.9073,1076.933533,1,32307219,32308005,786,0.265654745650346
11743,1076.936033,1076.955233,1,32308080,32308656,576,-0.03449356929033755
11744,1076.978433,1077.016167,1,32309352,32310485,1133,0.588904888076592
11745,1077.0815,1077.091267,1,32312445,32312738,293,0.6672653013155818
11746,1077.157633,1077.229933,1,32314728,32316897,2169,0.07787354938431285
11747,1077.2346,1077.255533,1,32317038,32317665,627,0.41725072404860997
11748,1077.268267,1077.287267,1,32318048,32318618,570,0.13335287675413607
11749,1077.288533,1077.312467,1,32318655,32319374,719,0.334580442276719
11750,1077.3148,1077.319133,1,32319444,32319573,129,0.6824886582381425
11751,1077.323367,1077.400533,1,32319701,32322015,2314,0.1303875770151221
11752,1077.4217,1077.429367,1,32322651,32322881,230,0.11839985863425088
11753,1077.431267,1077.458233,1,32322938,32323746,808,0.5570043670361112
11754,1077.460333,1077.4646,1,32323809,32323938,129,0.92315074166071
11755,1077.4806,1077.501967,1,32324418,32325059,641,0.23575106801203125
11756,1077.5113,1077.515367,1,32325338,32325461,123,0.8164846635263296
11757,1077.523933,1077.5275,1,32325717,32325824,107,0.9001900304328798
11758,1077.748367,1077.756967,1,32332451,32332709,258,0.4955778291474986
11759,1077.814267,1077.831933,1,32334428,32334957,529,0.3089891495231899
11760,1077.8697,1077.8758,1,32336091,32336274,183,0.5203579855659873
11761,1077.893233,1077.897867,1,32336796,32336936,140,-0.1561447610739048
11762,1077.917467,1077.9449,1,32337524,32338347,823,-0.04176523045353353
11763,1077.949133,1077.9628,1,32338473,32338884,411,0.17140713112738803
11764,1077.976533,1078.009633,1,32339295,32340288,993,0.08209712731217376
11765,1078.010633,1078.030233,1,32340318,32340906,588,0.27036784352672016
11766,1078.032033,1078.072067,1,32340960,32342162,1202,0.13331728044116065
11767,1078.102033,1078.1179,1,32343060,32343537,477,0.13237888804916426
11768,1078.1421,1078.161333,1,32344263,32344839,576,0.6312908567448144
11769,1078.166733,1078.1729,1,32345001,32345187,186,0.3409229731916403
11770,1078.180533,1078.249733,1,32345415,32347491,2076,0.18672826731080583
11771,1078.251333,1078.265167,1,32347539,32347955,416,0.33065703715822664
11772,1078.2767,1078.290933,1,32348300,32348727,427,0.3647488922601178
11773,1078.295233,1078.313967,1,32348856,32349419,563,-0.1279019741050891
11774,1078.315067,1078.381867,1,32349452,32351456,2004,0.09962123483738243
11775,1078.385367,1078.391467,1,32351561,32351744,183,0.7520923745822966
11776,1078.8839,1078.8872,1,32366517,32366615,98,0.35228276308103323
11777,1078.890367,1078.894567,1,32366711,32366837,126,0.5584858035113958
11778,1078.9029,1078.911867,1,32367087,32367356,269,0.5002567101955185
11779,1078.913867,1078.918933,1,32367416,32367567,151,0.5112095296886462
11780,1078.9207,1078.9248,1,32367620,32367744,124,0.3097068816377028
11781,1078.927033,1078.931567,1,32367810,32367947,137,-0.01736481921796942
11782,1078.9953,1078.997067,1,32369859,32369912,53,0.8157383746371993
11783,1079.003733,1079.082233,1,32370111,32372466,2355,0.17161756843070364
11784,1079.088267,1079.141933,1,32372648,32374257,1609,0.25062601766214243
11785,1079.1491,1079.194967,1,32374473,32375849,1376,0.16578805475531597
11786,1079.1969,1079.300467,1,32375906,32379014,3108,0.1873979230088411
11787,1079.3069,1079.315433,1,32379207,32379462,255,0.41381353640376256
11788,1079.320533,1079.327167,1,32379615,32379815,200,0.8446445692176364
11789,1079.3323,1079.3372,1,32379969,32380116,147,0.9502075086629718
11790,1079.3431,1079.3504,1,32380293,32380512,219,0.8708654991749837
11791,1079.356067,1079.3606,1,32380682,32380818,136,0.8318201103798747
11792,1079.363567,1079.393433,1,32380907,32381802,895,0.298734401624326
11793,1079.4475,1079.454,1,32383425,32383620,195,0.6112552312958581
11794,1079.458767,1079.4968,1,32383763,32384903,1140,0.4451637479943748
11795,1079.498333,1079.5061,1,32384949,32385183,234,0.7192238594792443
11796,1079.507867,1079.532367,1,32385236,32385971,735,0.4183719199289271
11797,1079.533467,1079.555033,1,32386004,32386650,646,0.35027060108826746
11798,1079.642767,1079.6482,1,32389283,32389446,163,0.5154022767919666
11799,1079.683467,1079.6983,1,32390504,32390949,445,0.8154470272612456
11800,1080.178367,1080.188,1,32405351,32405640,289,0.2654349965305599
11801,1080.189067,1080.1953,1,32405672,32405859,187,0.34490076465957875
11802,1080.198267,1080.238933,1,32405948,32407167,1219,0.16011336949911925
11803,1080.264067,1080.278133,1,32407922,32408343,421,0.44322583183926856
11804,1080.283133,1080.346067,1,32408493,32410382,1889,-0.09984942219036912
11805,1080.355167,1080.376067,1,32410655,32411282,627,0.37882492315251637
11806,1080.380633,1080.390867,1,32411418,32411726,308,0.40324685327973114
11807,1080.3952,1080.4405,1,32411855,32413214,1359,0.32409654798492515
11808,1080.4859,1080.540267,1,32414576,32416208,1632,0.6977957801854059
11809,1080.541367,1080.6672,1,32416241,32420016,3775,0.6274771518380601
11810,1080.6684,1080.6733,1,32420052,32420198,146,0.9481478682568879
11811,1080.6833,1080.693,1,32420498,32420790,292,0.9320404665173977
11812,1080.7127,1080.716367,1,32421381,32421491,110,0.9282947492529129
11813,1080.718633,1080.7226,1,32421558,32421678,120,0.4939743519190085
11814,1080.7283,1080.733567,1,32421849,32422007,158,0.8587974706259778
11815,1080.8125,1080.8185,1,32424375,32424555,180,0.8513290162515846
11816,1080.8294,1080.837733,1,32424882,32425131,249,0.8839547852976081
11817,1080.858433,1080.877433,1,32425752,32426322,570,0.40439941604791896
11818,1080.889133,1080.8948,1,32426673,32426844,171,0.901395031414001
11819,1080.936867,1080.9417,1,32428106,32428251,145,0.8907795728933955
11820,1080.946767,1080.9587,1,32428403,32428760,357,0.7349571083787959
11821,1080.985767,1080.988967,1,32429573,32429669,96,0.7046134985885645
11822,1080.994,1081.0071,1,32429819,32430213,394,0.6475354456875592
11823,1081.017867,1081.0252,1,32430536,32430756,220,0.8595279876961606
11824,1081.066467,1081.069533,1,32431994,32432085,91,0.8920513301312095
11825,1081.079133,1081.1561,1,32432373,32434682,2309,0.10144915461274562
11826,1081.170633,1081.175933,1,32435118,32435277,159,0.4081272195941394
11827,1081.209167,1081.222767,1,32436275,32436683,408,0.30261837660669477
11828,1081.2394,1081.387233,1,32437181,32441616,4435,0.10635597458273273
11829,1081.412133,1081.4171,1,32442363,32442512,149,0.3686719459641574
11830,1081.423333,1081.440333,1,32442699,32443209,510,-0.06479201761006817
11831,1081.458367,1081.496233,1,32443751,32444886,1135,0.3181910736342756
11832,1081.504067,1081.5162,1,32445122,32445486,364,0.32970364523513557
11833,1081.518667,1081.553367,1,32445560,32446601,1041,0.1508820381190734
11834,1081.575667,1081.599567,1,32447270,32447987,717,0.24897700674903217
11835,1081.6515,1081.663967,1,32449545,32449919,374,0.5056069088898582
11836,1081.6757,1081.695933,1,32450271,32450877,606,0.15514213764388063
11837,1081.708733,1081.733267,1,32451261,32451998,737,0.012941819451310014
11838,1081.7359,1081.749267,1,32452076,32452478,402,0.09534118106085196
11839,1081.752567,1081.786067,1,32452577,32453582,1005,0.04333457175069748
11840,1081.8209,1081.8431,1,32454626,32455293,667,0.5457154253156843
11841,1081.846767,1081.851167,1,32455403,32455535,132,0.48696049846758016
11842,1081.8726,1081.877667,1,32456177,32456330,153,0.6850643672014092
11843,1081.897433,1081.900533,1,32456922,32457015,93,0.6588532191200548
11844,1081.902567,1081.911567,1,32457077,32457347,270,0.8710860096249182
11845,1081.9176,1081.9242,1,32457528,32457725,197,0.8817538263584681
11846,1081.944967,1081.948167,1,32458349,32458445,96,0.21255039801119427
11847,1081.960033,1081.965567,1,32458800,32458967,167,0.15047337148906892
11848,1082.004567,1082.0137,1,32460137,32460411,274,0.6029281214350484
11849,1082.0185,1082.088567,1,32460554,32462657,2103,0.11330247346813734
11850,1082.089567,1082.110733,1,32462687,32463321,634,0.3404120910799452
11851,1082.114,1082.339767,1,32463420,32470193,6773,0.2540552577161534
11852,1082.3484,1082.3537,1,32470452,32470610,158,0.8374350701875503
11853,1082.374033,1082.392333,1,32471220,32471769,549,0.24205516914637096
11854,1082.419633,1082.4714,1,32472588,32474141,1553,0.29934800952171453
11855,1082.473267,1082.501433,1,32474198,32475042,844,0.08091742237386962
11856,1082.545267,1082.562633,1,32476358,32476878,520,0.07927913307445712
11857,1082.6179,1082.6216,1,32478537,32478648,111,0.8313178545977551
11858,1082.639667,1082.651567,1,32479190,32479547,357,0.4612068271831431
11859,1082.656867,1082.675667,1,32479706,32480270,564,0.4168721062782806
11860,1082.676733,1082.7175,1,32480301,32481525,1224,0.3493854787196817
11861,1082.7249,1082.7453,1,32481746,32482359,613,0.3285298371594342
11862,1082.783667,1082.798033,1,32483510,32483940,430,0.6759529059379229
11863,1083.048767,1083.101667,1,32491463,32493050,1587,0.14008230915897152
11864,1083.106967,1083.122333,1,32493209,32493669,460,0.6193731260005045
11865,1083.134767,1083.144633,1,32494043,32494338,295,0.0704858020628315
11866,1083.156633,1083.2802,1,32494698,32498405,3707,0.17951839052193583
11867,1083.2943,1083.329133,1,32498829,32499873,1044,0.806144636510134
11868,1083.3302,1083.337267,1,32499906,32500118,212,0.11987465903365267
11869,1083.342533,1083.363567,1,32500275,32500907,632,0.6967977482749418
11870,1083.3715,1083.378733,1,32501145,32501361,216,0.4736818980086139
11871,1083.560267,1083.567967,1,32506808,32507039,231,0.8792761873329732
11872,1083.583267,1083.5879,1,32507498,32507637,139,0.653319678604722
11873,1083.597233,1083.6197,1,32507916,32508591,675,0.7933361098157924
11874,1083.6602,1083.668033,1,32509806,32510040,234,0.8395692675545171
11875,1083.669233,1083.6743,1,32510076,32510228,152,0.5920312069896918
11876,1083.7315,1083.770167,1,32511945,32513105,1160,0.7071991988441768
11877,1083.8468,1083.85,1,32515404,32515499,95,0.8378770894336618
11878,1083.863033,1083.866233,1,32515890,32515986,96,0.8332128021436902
11879,1083.874933,1083.878,1,32516247,32516339,92,0.8734225767724689
11880,1083.884533,1083.888833,1,32516535,32516664,129,0.5562108667963623
11881,1083.890633,1083.944333,1,32516718,32518329,1611,0.6240123317658465
11882,1083.949233,1083.985833,1,32518476,32519574,1098,0.7037402544289915
11883,1083.993267,1083.9978,1,32519798,32519934,136,0.09473568782136398
11884,1084.022233,1084.027633,1,32520666,32520828,162,0.8975089593994726
11885,1084.0453,1084.056333,1,32521359,32521689,330,0.8394298841726892
11886,1084.063733,1084.078567,1,32521911,32522357,446,0.7265516369828711
11887,1084.083967,1084.091733,1,32522519,32522751,232,0.7986252786802357
11888,1084.110967,1084.115333,1,32523329,32523459,130,0.7899830064513992
11889,1084.116467,1084.119867,1,32523494,32523596,102,0.9080284962139324
11890,1084.123367,1084.1364,1,32523701,32524092,391,0.5444132266592648
11891,1084.140833,1084.148767,1,32524224,32524463,239,0.8829550480289844
11892,1084.158067,1084.348033,1,32524742,32530440,5698,0.20143809102792057
11893,1084.352633,1084.357333,1,32530578,32530719,141,0.8971090215177043
11894,1084.361133,1084.368233,1,32530833,32531046,213,0.8167671743766832
11895,1084.386833,1084.392167,1,32531604,32531765,161,0.6807979726327444
11896,1084.402867,1084.416667,1,32532086,32532500,414,0.19538253476767767
11897,1084.5137,1084.522267,1,32535411,32535668,257,0.5859336309991261
11898,1084.5523,1084.564233,1,32536569,32536926,357,0.8489418258949761
11899,1084.570367,1084.6118,1,32537111,32538353,1242,0.3388380262024336
11900,1084.627267,1084.666667,1,32538818,32540000,1182,0.6302016344688034
11901,1084.6712,1084.683633,1,32540136,32540508,372,0.5616918760642738
11902,1084.689967,1084.700933,1,32540699,32541027,328,0.6515937993462025
11903,1084.704233,1084.7432,1,32541126,32542295,1169,0.7184342650007243
11904,1084.7442,1084.752633,1,32542326,32542578,252,0.7506247802243953
11905,1084.766467,1084.7777,1,32542994,32543331,337,0.4723503838643477
11906,1084.779467,1084.7906,1,32543384,32543718,334,0.8843559078449081
11907,1085.093833,1085.1729,1,32552814,32555187,2373,0.11208218615695624
11908,1085.180833,1085.201,1,32555424,32556030,606,0.403163918457209
11909,1085.2102,1085.2138,1,32556306,32556414,108,0.5343358041382508
11910,1085.219467,1085.254167,1,32556584,32557625,1041,0.04516184996139984
11911,1085.260167,1085.273933,1,32557805,32558217,412,0.2888485226850545
11912,1085.295433,1085.300567,1,32558862,32559017,155,0.5945399133445605
11913,1085.302067,1085.326267,1,32559062,32559788,726,0.48323399744184625
11914,1085.327333,1085.331333,1,32559819,32559939,120,0.9226859087426295
11915,1085.332833,1085.3469,1,32559984,32560407,423,0.7030462610674523
11916,1085.421267,1085.4355,1,32562638,32563065,427,0.5214161773514067
11917,1085.444433,1085.457867,1,32563332,32563736,404,0.4002335835781167
11918,1085.459033,1085.467033,1,32563770,32564010,240,0.5723425322943435
11919,1086.357567,1086.367267,1,32590727,32591018,291,0.3820037005891086
11920,1086.401667,1086.4662,1,32592050,32593986,1936,0.38098932178605066
11921,1086.467767,1086.474033,1,32594033,32594220,187,0.5267923471714547
11922,1086.490333,1086.507267,1,32594709,32595218,509,0.2031081138040766
11923,1086.5279,1086.532,1,32595837,32595959,122,0.4957009351333955
11924,1087.207633,1087.212133,1,32616228,32616363,135,0.5696091476664542
11925,1087.2194,1087.2239,1,32616582,32616717,135,0.2705977127277611
11926,1087.2316,1087.25,1,32616948,32617500,552,-0.14992301871575545
11927,1087.3412,1087.4346,1,32620236,32623038,2802,0.16725169250689972
11928,1087.448133,1087.492333,1,32623443,32624769,1326,0.12704665026188422
11929,1087.506767,1087.591433,1,32625203,32627742,2539,0.12659179562143216
11930,1087.7541,1087.7579,1,32632623,32632737,114,0.5468595583963962
11931,1087.8328,1087.852667,1,32634983,32635580,597,0.3875893402384824
11932,1087.971767,1087.9777,1,32639153,32639330,177,0.35822228249957605
11933,1087.9794,1088.066267,1,32639382,32641988,2606,0.07112786298695577
11934,1088.076167,1088.138833,1,32642285,32644164,1879,0.005737736312670637
11935,1088.140167,1088.180433,1,32644205,32645412,1207,0.36791950044629684
11936,1088.182933,1088.285467,1,32645487,32648564,3077,0.08857440204726907
11937,1088.287267,1088.330567,1,32648618,32649917,1299,0.20812403311343355
11938,1088.385933,1088.390067,1,32651577,32651702,125,0.8273753599997397
11939,1088.392967,1088.3975,1,32651789,32651925,136,0.5229893673800459
11940,1088.402933,1088.4257,1,32652087,32652771,684,0.17884776370440228
11941,1088.429333,1088.4562,1,32652879,32653686,807,0.188669215998547
11942,1088.4757,1088.516433,1,32654271,32655492,1221,0.14099261177464448
11943,1088.5195,1088.523133,1,32655585,32655693,108,0.8191428990616524
11944,1088.574433,1088.6049,1,32657232,32658147,915,0.1342921520011708
11945,1088.606567,1088.610367,1,32658197,32658311,114,0.6865149836540965
11946,1088.6797,1088.687333,1,32660390,32660619,229,0.033113966524907626
11947,1088.688833,1088.7111,1,32660664,32661333,669,0.06598358525123614
11948,1088.712267,1088.7694,1,32661368,32663081,1713,0.07508614419509611
11949,1088.807933,1088.832367,1,32664237,32664971,734,0.31346174662242343
11950,1088.838133,1088.8494,1,32665143,32665482,339,0.2857271225622771
11951,1088.874433,1088.878833,1,32666232,32666364,132,0.868955619923882
11952,1088.885533,1088.9008,1,32666565,32667023,458,0.2848625142847658
11953,1088.9086,1088.9176,1,32667258,32667528,270,0.27703283493614833
11954,1088.9187,1088.954867,1,32667561,32668646,1085,0.3966114882621342
11955,1088.9561,1088.976133,1,32668683,32669283,600,0.6119730281367055
11956,1088.979033,1088.9877,1,32669370,32669630,260,0.8677824612572503
11957,1088.995467,1089.0188,1,32669864,32670564,700,0.3441465870483859
11958,1089.0251,1089.029167,1,32670753,32670875,122,0.8533626041879989
11959,1089.032667,1089.045733,1,32670980,32671371,391,0.7055023792993609
11960,1089.083333,1089.1114,1,32672499,32673342,843,0.24289357768855632
11961,1089.125867,1089.169833,1,32673776,32675094,1318,0.25207723841702767
11962,1089.204767,1089.282267,1,32676143,32678468,2325,0.1136952160043272
11963,1089.2911,1089.370367,1,32678732,32681111,2379,0.07533376203818974
11964,1089.372533,1089.387233,1,32681175,32681616,441,0.1894972692589447
11965,1089.388367,1089.3964,1,32681651,32681892,241,0.49094988485177965
11966,1089.4001,1089.406267,1,32682003,32682188,185,0.7747929177004858
11967,1089.409967,1089.5129,1,32682299,32685387,3088,0.26653424317132696
11968,1089.514133,1089.522667,1,32685423,32685680,257,0.7316361454245335
11969,1089.526367,1089.550467,1,32685791,32686514,723,-0.04980371382062637
11970,1089.554067,1089.6139,1,32686622,32688417,1795,0.1685753400374403
11971,1089.620433,1089.639167,1,32688612,32689175,563,0.20117205366579113
11972,1089.6404,1089.6478,1,32689212,32689434,222,0.6543025942445903
11973,1089.6635,1089.6665,1,32689905,32689995,90,0.7589778003341127
11974,1089.670433,1089.682367,1,32690112,32690471,359,0.08841045205883723
11975,1089.684667,1089.709733,1,32690540,32691291,751,0.0785202592452479
11976,1089.720233,1089.727033,1,32691606,32691810,204,0.24573892236678438
11977,1089.734667,1089.754467,1,32692040,32692634,594,0.10179471266315508
11978,1089.779333,1089.793367,1,32693379,32693801,422,0.8503032159078824
11979,1089.801333,1089.819867,1,32694039,32694596,557,0.22029884156462612
11980,1089.8242,1089.832867,1,32694726,32694986,260,0.3374804830587281
11981,1089.834433,1089.881767,1,32695032,32696453,1421,0.11700905261364683
11982,1089.9256,1089.9505,1,32697768,32698514,746,0.517007834782255
11983,1089.958033,1089.966067,1,32698740,32698982,242,0.4442322755683669
11984,1090.0054,1090.0144,1,32700162,32700432,270,0.6916171033281988
11985,1090.0189,1090.032733,1,32700567,32700981,414,0.5861662349007667
11986,1090.434733,1090.456133,1,32713041,32713683,642,0.24952977574031163
11987,1090.4579,1090.5274,1,32713737,32715822,2085,0.1945526884745589
11988,1090.528967,1090.558233,1,32715869,32716746,877,0.3690001758348668
11989,1090.5615,1090.578467,1,32716845,32717354,509,0.10994288797125201
11990,1090.588933,1090.682033,1,32717667,32720460,2793,0.05482887380658665
11991,1090.7058,1090.712333,1,32721174,32721369,195,0.24255751708532616
11992,1090.714833,1090.722667,1,32721444,32721680,236,0.792938235643901
11993,1090.723767,1090.7393,1,32721713,32722179,466,0.8380494378342266
11994,1090.7611,1090.7875,1,32722833,32723624,791,0.27448329109394454
11995,1091.257433,1091.2861,1,32737722,32738583,861,0.04663269877591502
11996,1091.2872,1091.397667,1,32738616,32741930,3314,0.11526103973973686
11997,1091.4004,1091.515567,1,32742012,32745467,3455,0.1219531227852754
11998,1091.517067,1091.556567,1,32745512,32746697,1185,0.19594328219875118
11999,1091.5647,1091.579367,1,32746940,32747381,441,0.35164217025300654
12000,1091.5806,1091.585267,1,32747418,32747558,140,0.6523621106038354
12001,1091.603567,1091.618633,1,32748107,32748558,451,0.12365656029827318
12002,1091.626033,1091.675067,1,32748780,32750252,1472,0.1430828210472334
12003,1091.710533,1091.731533,1,32751315,32751945,630,0.20757573994449485
12004,1091.791,1091.804467,1,32753730,32754134,404,0.5118076213057404
12005,1091.8059,1091.887933,1,32754177,32756637,2460,-0.010202425752542198
12006,1091.894133,1091.904333,1,32756823,32757129,306,0.03267836421976044
12007,1091.924667,1091.9582,1,32757740,32758746,1006,-0.18489642586043123
12008,1091.961667,1091.9751,1,32758850,32759253,403,0.42368379097754977
12009,1092.0647,1092.0736,1,32761940,32762208,268,0.527028077322307
12010,1092.079533,1092.091933,1,32762385,32762757,372,0.8027740213986492
12011,1092.119567,1092.126033,1,32763587,32763780,193,0.396031702423378
12012,1092.133233,1092.1423,1,32763996,32764269,273,0.5055866902220152
12013,1092.144333,1092.184733,1,32764329,32765541,1212,0.09563068265053921
12014,1092.227167,1092.249067,1,32766815,32767472,657,0.1946462690089022
12015,1092.2505,1092.256233,1,32767515,32767686,171,0.8087345747633029
12016,1092.257867,1092.2875,1,32767736,32768624,888,0.2217041337528234
12017,1092.3049,1092.311433,1,32769147,32769342,195,0.8113609860217356
12018,1092.313367,1092.332333,1,32769401,32769969,568,0.42467046773853234
12019,1092.464533,1092.523267,1,32773935,32775698,1763,0.049070224441582724
12020,1092.5256,1092.562733,1,32775768,32776881,1113,0.14948888431077595
12021,1092.569967,1092.5731,1,32777099,32777193,94,0.8740892558478446
12022,1092.5742,1092.672233,1,32777226,32780166,2940,0.14747147799710716
12023,1092.7035,1092.806633,1,32781105,32784198,3093,0.11363959100772197
12024,1092.8083,1092.8478,1,32784248,32785434,1186,0.22712094238948122
12025,1092.8499,1092.8737,1,32785496,32786211,715,0.12223488667887916
12026,1092.8763,1092.9347,1,32786288,32788041,1753,0.08068656381502387
12027,1092.9622,1092.966033,1,32788866,32788980,114,0.7041676482859238
12028,1092.9672,1093.0034,1,32789016,32790102,1086,0.20289045669441538
12029,1093.0081,1093.016067,1,32790243,32790482,239,0.8758441857469149
12030,1093.021467,1093.041167,1,32790644,32791235,591,0.2915182516255592
12031,1093.0458,1093.059433,1,32791374,32791782,408,0.3949715090882686
12032,1093.137367,1093.1417,1,32794121,32794250,129,0.506043551955814
12033,1093.159633,1093.240133,1,32794788,32797203,2415,0.1618970413152999
12034,1093.256633,1093.262467,1,32797698,32797874,176,0.7713690684629632
12035,1093.305067,1093.513167,1,32799152,32805395,6243,0.21288332556506082
12036,1093.514833,1093.537867,1,32805444,32806136,692,0.08479838006338743
12037,1093.5401,1093.5688,1,32806203,32807064,861,0.20499106589011237
12038,1093.572567,1093.594033,1,32807177,32807820,643,0.36573492057835544
12039,1093.632,1093.661,1,32808960,32809830,870,0.10997346854204006
12040,1093.6644,1093.705533,1,32809931,32811165,1234,0.2395830137941367
12041,1093.837467,1093.867667,1,32815124,32816030,906,0.15574849538696323
12042,1094.3033,1094.391633,1,32829099,32831748,2649,0.16978416290287154
12043,1094.392633,1094.4013,1,32831778,32832039,261,0.8423437736556595
12044,1094.501433,1094.613133,1,32835042,32838393,3351,0.18356809437980334
12045,1094.6237,1094.6299,1,32838711,32838896,185,0.22338732012979853
12046,1094.631767,1094.642333,1,32838953,32839269,316,0.41892591835229126
12047,1094.646533,1094.652,1,32839395,32839560,165,0.539480756401455
12048,1094.653,1094.664033,1,32839590,32839920,330,0.6563863786346772
12049,1094.671133,1094.713667,1,32840133,32841410,1277,0.23163968426592169
12050,1094.758067,1094.762833,1,32842742,32842884,142,0.63760593602772
12051,1094.765033,1094.817867,1,32842950,32844536,1586,0.18750833372755074
12052,1094.831067,1094.9069,1,32844932,32847207,2275,0.02690264915956755
12053,1094.9144,1094.981633,1,32847431,32849448,2017,0.01025475179446097
12054,1094.986667,1095.022433,1,32849600,32850672,1072,0.14291653604736546
12055,1095.040467,1095.0438,1,32851214,32851313,99,0.8949766725127565
12056,1095.0458,1095.050533,1,32851374,32851515,141,0.883512941370778
12057,1095.053767,1095.0818,1,32851613,32852453,840,0.18176381935033223
12058,1095.083267,1095.092367,1,32852498,32852771,273,0.5765893923542547
12059,1095.100133,1095.159133,1,32853003,32854773,1770,0.12326571571626395
12060,1095.1786,1095.1817,1,32855358,32855451,93,0.5405748970545579
12061,1095.184033,1095.200433,1,32855520,32856012,492,0.00390746498091475
12062,1095.212267,1095.2162,1,32856368,32856486,118,0.8509096829925898
12063,1095.218367,1095.2515,1,32856551,32857545,994,0.04605864141680615
12064,1095.252533,1095.263567,1,32857575,32857907,332,0.2061544489388587
12065,1095.2749,1095.294633,1,32858246,32858838,592,0.42329352353805116
12066,1095.295767,1095.3066,1,32858873,32859197,324,0.6792236997088915
12067,1095.392433,1095.403933,1,32861772,32862117,345,0.5028467144295539
12068,1095.519367,1095.577633,1,32865581,32867328,1747,0.007729336387467822
12069,1095.5905,1095.614667,1,32867715,32868440,725,0.12360918898093201
12070,1095.628267,1095.646767,1,32868848,32869403,555,0.09882202799639465
12071,1095.648233,1095.655633,1,32869446,32869668,222,0.6304584849567756
12072,1095.6574,1095.7191,1,32869722,32871573,1851,0.24437547279850494
12073,1095.7236,1095.729467,1,32871708,32871884,176,0.8146969320524085
12074,1095.744767,1095.756133,1,32872343,32872683,340,0.8251899112959217
12075,1095.757433,1095.784567,1,32872722,32873537,815,0.7061976588432004
12076,1095.790467,1095.809867,1,32873714,32874296,582,0.348899996442243
12077,1095.810867,1095.826033,1,32874326,32874780,454,0.23746238765979447
12078,1095.8749,1095.8847,1,32876247,32876541,294,0.13108094430710593
12079,1095.887533,1095.893367,1,32876625,32876801,176,0.7285958911997114
12080,1095.902167,1095.912733,1,32877065,32877381,316,0.8389005774616013
12081,1095.9141,1095.918467,1,32877423,32877554,131,0.600238710256159
12082,1095.920133,1095.926133,1,32877603,32877783,180,0.7594525118819583
12083,1095.946367,1095.961267,1,32878391,32878838,447,0.6533308316772615
12084,1096.073133,1096.0763,1,32882193,32882289,96,0.783755951239568
12085,1096.081867,1096.085567,1,32882456,32882567,111,0.8531139999106477
12086,1096.1046,1096.1083,1,32883137,32883249,112,0.7212515979834409
12087,1096.1278,1096.1308,1,32883834,32883923,89,0.9141626739673372
12088,1096.1349,1096.150633,1,32884047,32884518,471,0.5911739913352325
12089,1096.393133,1096.474,1,32891793,32894219,2426,0.11724426647447463
12090,1096.480667,1096.4958,1,32894420,32894873,453,0.3885587040288046
12091,1096.5009,1096.559067,1,32895027,32896772,1745,0.08681143347373449
12092,1096.5632,1096.590667,1,32896896,32897720,824,0.22407472177944224
12093,1096.592533,1096.695433,1,32897775,32900862,3087,0.08616275970826615
12094,1096.699233,1096.705633,1,32900976,32901168,192,0.5013208708888337
12095,1096.7152,1096.735567,1,32901456,32902067,611,0.0337403574118562
12096,1096.7463,1096.762533,1,32902389,32902875,486,-0.06463226051512694
12097,1096.763667,1096.768367,1,32902910,32903051,141,0.8020095593634127
12098,1096.794733,1096.8402,1,32903841,32905206,1365,0.1626620553199239
12099,1096.9553,1096.962267,1,32908659,32908868,209,0.36621364408192775
12100,1096.9683,1096.977333,1,32909049,32909319,270,0.8118362140812908
12101,1097.6434,1097.720433,1,32929301,32931612,2311,0.027411667428985324
12102,1097.721433,1097.7325,1,32931642,32931975,333,0.4414955709549118
12103,1097.741467,1097.760167,1,32932244,32932805,561,0.35647972908676917
12104,1097.761233,1097.8194,1,32932836,32934582,1746,0.08205023950863398
12105,1097.832767,1097.849967,1,32934983,32935499,516,0.07534121338206114
12106,1097.852233,1097.951267,1,32935566,32938538,2972,0.14176850285182488
12107,1097.955533,1097.9725,1,32938665,32939175,510,0.2799192349613364
12108,1097.9736,1097.986733,1,32939208,32939601,393,0.24460164784605082
12109,1097.9887,1098.006267,1,32939661,32940188,527,0.17435710748413927
12110,1098.010767,1098.0139,1,32940323,32940416,93,0.8024553812968946
12111,1098.021033,1098.0976,1,32940630,32942928,2298,0.19947059312369417
12112,1098.110567,1098.1144,1,32943317,32943431,114,0.855126607340979
12113,1098.1164,1098.137933,1,32943492,32944137,645,0.21070134629072212
12114,1098.139133,1098.144633,1,32944173,32944338,165,0.8819337786802869
12115,1098.158933,1098.197433,1,32944767,32945922,1155,0.09997862453201353
12116,1098.253833,1098.266367,1,32947614,32947991,377,0.5298062572439302
12117,1098.276433,1098.284267,1,32948292,32948528,236,0.4430244035151822
12118,1098.291933,1098.298933,1,32948757,32948967,210,-0.08819140514330386
12119,1098.3029,1098.377933,1,32949086,32951337,2251,-0.057454177641956504
12120,1098.386667,1098.398967,1,32951600,32951969,369,0.16068370184197867
12121,1098.411967,1098.420233,1,32952359,32952606,247,-0.04049358848881928
12122,1098.4475,1098.4875,1,32953425,32954625,1200,-0.023611260742125578
12123,1098.488867,1098.598033,1,32954666,32957940,3274,0.17031324563051037
12124,1099.0032,1099.0142,1,32970096,32970426,330,0.47764374966451384
12125,1099.031233,1099.109,1,32970936,32973269,2333,0.08125172893863106
12126,1099.1137,1099.1284,1,32973411,32973852,441,0.2998594913789089
12127,1099.1294,1099.146233,1,32973882,32974386,504,0.38412373566186997
12128,1099.148967,1099.182333,1,32974469,32975469,1000,0.20377935072386744
12129,1099.183833,1099.211267,1,32975514,32976338,824,0.24694667419762212
12130,1099.2127,1099.245533,1,32976381,32977365,984,0.33548829774284866
12131,1099.2468,1099.258233,1,32977403,32977746,343,0.1980008419903212
12132,1099.2645,1099.296267,1,32977935,32978888,953,0.14834346891812827
12133,1099.320267,1099.3722,1,32979608,32981166,1558,0.05979108045290111
12134,1099.3782,1099.448933,1,32981346,32983467,2121,0.0957373705038481
12135,1099.456533,1099.468767,1,32983695,32984063,368,0.11733109492354842
12136,1099.9472,1099.9572,1,32998416,32998716,300,0.41810373803581335
12137,1099.9652,1100.0223,1,32998956,33000669,1713,0.09852359090030553
12138,1100.029467,1100.044833,1,33000884,33001344,460,0.4744144703728618
12139,1100.0554,1100.063333,1,33001662,33001899,237,0.04703319479486087
12140,1100.0668,1100.0856,1,33002004,33002568,564,0.43504857704964706
12141,1100.0892,1100.092933,1,33002675,33002787,112,0.8034183580110746
12142,1100.120167,1100.147133,1,33003605,33004413,808,0.15587847710358999
12143,1100.1628,1100.231767,1,33004884,33006953,2069,0.015270324478158254
12144,1100.702067,1100.709967,1,33021062,33021299,237,0.7661047086102429
12145,1100.749833,1100.833567,1,33022494,33025007,2513,0.09558439583063844
12146,1100.834967,1100.866167,1,33025049,33025985,936,0.30890927794367457
12147,1100.869467,1100.889033,1,33026084,33026670,586,0.08879989972180619
12148,1100.890067,1100.8981,1,33026702,33026943,241,0.7211600265915136
12149,1100.899333,1101.040733,1,33026979,33031221,4242,0.21863436432115924
12150,1101.051633,1101.0816,1,33031548,33032448,900,0.4566606761839244
12151,1101.113067,1101.1478,1,33033392,33034434,1042,0.025589777787980005
12152,1101.173533,1101.192633,1,33035205,33035778,573,-0.01179768319395185
12153,1101.2063,1101.243933,1,33036189,33037317,1128,0.138017928375713
12154,1101.245433,1101.248967,1,33037362,33037469,107,0.9206679886075496
12155,1101.266367,1101.300933,1,33037991,33039027,1036,0.3565657479426331
12156,1101.343667,1101.356,1,33040310,33040680,370,0.8405515349023496
12157,1101.371833,1101.395833,1,33041154,33041874,720,0.2254170713817518
12158,1101.468467,1101.476667,1,33044054,33044300,246,0.8985142733069991
12159,1101.680567,1101.694333,1,33050417,33050829,412,-0.3194766436879516
12160,1101.7556,1101.837867,1,33052668,33055136,2468,0.04379386350783967
12161,1101.852533,1102.0228,1,33055575,33060684,5109,0.0207283911218001
12162,1102.0244,1102.036633,1,33060732,33061098,366,0.10011895044517247
12163,1102.0494,1102.0697,1,33061482,33062091,609,0.09950413406898594
12164,1102.084133,1102.1027,1,33062523,33063080,557,0.02186656708631152
12165,1102.113067,1102.1585,1,33063392,33064755,1363,-0.016736529442818723
12166,1102.256867,1102.263267,1,33067706,33067898,192,0.691083853527911
12167,1102.294333,1102.304333,1,33068829,33069129,300,0.29212790628735313
12168,1102.6957,1102.700267,1,33080871,33081008,137,0.2846336850202466
12169,1102.7743,1102.783033,1,33083229,33083490,261,0.0614234879444488
12170,1102.796533,1102.911067,1,33083895,33087332,3437,0.203542355097928
12171,1102.918067,1102.937467,1,33087542,33088124,582,0.0861935836596106
12172,1102.9561,1103.047633,1,33088683,33091428,2745,0.04636710798128446
12173,1103.049833,1103.067867,1,33091494,33092036,542,0.30661965924422946
12174,1103.086033,1103.0913,1,33092580,33092739,159,0.7633516871489883
12175,1103.0939,1103.118,1,33092817,33093540,723,0.3405784887273625
12176,1103.122733,1103.128633,1,33093681,33093858,177,0.382326450728601
12177,1103.145,1103.1506,1,33094350,33094518,168,0.5948515577930354
12178,1103.1988,1103.218633,1,33095963,33096558,595,0.39286793065975456
12179,1103.236733,1103.2408,1,33097101,33097224,123,0.6023833189611886
12180,1103.253,1103.264367,1,33097589,33097931,342,0.720963989316434
12181,1103.648533,1103.653767,1,33109455,33109613,158,0.6083066606911752
12182,1103.664367,1103.726167,1,33109931,33111785,1854,0.12783782971310567
12183,1103.7278,1103.747267,1,33111833,33112418,585,0.27058820374826403
12184,1103.757167,1103.772267,1,33112715,33113168,453,0.3465969709875073
12185,1103.825167,1103.957,1,33114755,33118710,3955,0.16127647833281294
12186,1104.004567,1104.0081,1,33120137,33120243,106,0.4804850620669924
12187,1104.0125,1104.018733,1,33120375,33120561,186,0.6449189593674716
12188,1104.022267,1104.025333,1,33120668,33120759,91,0.9361242308963893
12189,1104.027733,1104.035733,1,33120831,33121071,240,0.8948929475450782
12190,1104.074133,1104.0838,1,33122223,33122514,291,0.4576416559590013
12191,1104.1538,1104.159233,1,33124614,33124776,162,0.9543150123691335
12192,1104.160867,1104.177733,1,33124826,33125331,505,0.8096493554181637
12193,1104.1946,1104.2197,1,33125838,33126591,753,0.7393327272981401
12194,1104.2259,1104.245967,1,33126776,33127379,603,0.8442190012098193
12195,1104.248533,1104.279167,1,33127455,33128375,920,0.24087435441286295
12196,1104.354667,1104.385133,1,33130640,33131553,913,0.2957261724779054
12197,1104.420933,1104.435,1,33132627,33133050,423,0.6609167507117794
12198,1104.4479,1104.452933,1,33133436,33133587,151,0.9447440799188194
12199,1104.9658,1105.117333,1,33148974,33153519,4545,0.12446863452063499
12200,1105.130933,1105.272033,1,33153927,33158160,4233,0.12817401343129428
12201,1105.277533,1105.306567,1,33158325,33159197,872,0.08169513278278653
12202,1105.3077,1105.3152,1,33159231,33159456,225,0.43609236057727124
12203,1105.330733,1105.359567,1,33159921,33160787,866,0.07844891128187592
12204,1105.365533,1105.369433,1,33160965,33161082,117,-0.003720729708945295
12205,1105.3755,1105.402333,1,33161265,33162069,804,0.11218776591152678
12206,1105.406033,1105.411133,1,33162180,33162333,153,0.8945363769664495
12207,1105.416733,1105.4367,1,33162501,33163101,600,0.1295755650865315
12208,1105.4445,1105.4518,1,33163335,33163554,219,0.546560776872156
12209,1105.452867,1105.485567,1,33163586,33164567,981,0.06280806946038792
12210,1105.489233,1105.517633,1,33164676,33165528,852,0.14131394270959602
12211,1105.5511,1105.569067,1,33166532,33167072,540,0.14193133592464788
12212,1105.570467,1105.5756,1,33167114,33167267,153,0.6466875849879196
12213,1105.580733,1105.586367,1,33167421,33167591,170,0.2397794491666402
12214,1105.5949,1105.643033,1,33167847,33169290,1443,0.2897685209995892
12215,1105.649667,1105.658333,1,33169490,33169749,259,0.7397407411505194
12216,1105.6688,1105.691233,1,33170063,33170736,673,0.22905720531083765
12217,1105.7261,1105.733167,1,33171783,33171995,212,0.1500517757063355
12218,1105.781167,1105.788767,1,33173435,33173663,228,0.07193426696552006
12219,1105.795633,1105.819867,1,33173868,33174596,728,0.17088418445819506
12220,1105.8213,1105.861967,1,33174639,33175859,1220,0.1894727049060022
12221,1105.868533,1105.873133,1,33176055,33176193,138,0.7211654876205987
12222,1105.8986,1105.925267,1,33176958,33177758,800,0.3357572344517659
12223,1105.929533,1105.946,1,33177885,33178379,494,0.45974102426458485
12224,1105.9537,1105.961867,1,33178611,33178856,245,0.7760802286246822
12225,1105.973833,1106.008067,1,33179214,33180242,1028,0.46352929574045404
12226,1106.875233,1106.956333,1,33206256,33208689,2433,0.14761222747446354
12227,1106.958367,1107.038433,1,33208751,33211152,2401,0.02849373917978687
12228,1107.045767,1107.197067,1,33211373,33215912,4539,0.2047776418842691
12229,1107.202733,1107.250933,1,33216081,33217527,1446,0.254470897931973
12230,1107.305033,1107.330667,1,33219150,33219920,770,0.15501018761867172
12231,1107.339367,1107.3428,1,33220181,33220283,102,0.8823497679859809
12232,1107.350333,1107.366633,1,33220509,33220998,489,0.26280943427989406
12233,1107.3966,1107.403433,1,33221898,33222102,204,0.2864441376921703
12234,1107.4105,1107.418133,1,33222315,33222543,228,0.6412576328333226
12235,1107.524933,1107.529233,1,33225747,33225876,129,0.4926488961965452
12236,1107.591533,1107.604,1,33227745,33228120,375,0.6690305418001642
12237,1107.677167,1107.731033,1,33230315,33231930,1615,0.2368145086019972
12238,1107.736067,1107.766833,1,33232082,33233004,922,0.5046726941106321
12239,1107.777233,1107.836433,1,33233316,33235092,1776,0.10555258116189653
12240,1107.859633,1108.004133,1,33235788,33240123,4335,0.1573295548871422
12241,1108.023767,1108.050933,1,33240713,33241527,814,0.07270262354252471
12242,1108.052233,1108.058533,1,33241566,33241755,189,0.7852938246545074
12243,1108.060033,1108.088067,1,33241800,33242642,842,0.12540067190513843
12244,1108.095133,1108.102233,1,33242853,33243066,213,0.8200405683937901
12245,1108.103567,1108.1424,1,33243107,33244272,1165,0.11510164988451506
12246,1108.143433,1108.1476,1,33244302,33244428,126,0.6221228343611235
12247,1108.168167,1108.187967,1,33245045,33245639,594,0.12492685730236064
12248,1108.235867,1108.240433,1,33247076,33247212,136,0.787921369562113
12249,1108.3301,1108.3449,1,33249902,33250347,445,0.33824872912445836
12250,1108.346,1108.4017,1,33250380,33252050,1670,-0.05993575316475747
12251,1108.4316,1108.464067,1,33252947,33253922,975,0.3009650835413473
12252,1108.466767,1108.470967,1,33254003,33254129,126,0.7832653119694251
12253,1108.474567,1108.4885,1,33254237,33254654,417,0.22482996171356923
12254,1108.499267,1108.508267,1,33254978,33255248,270,0.2296418731912428
12255,1108.5142,1108.5511,1,33255426,33256532,1106,0.42353574153906887
12256,1108.5553,1108.561067,1,33256659,33256832,173,0.803350530677071
12257,1108.5623,1108.586567,1,33256869,33257597,728,0.29716694317142367
12258,1108.694533,1108.704767,1,33260835,33261143,308,0.6769470060619213
12259,1108.761633,1108.770867,1,33262848,33263126,278,0.4682570220899388
12260,1108.800733,1108.810433,1,33264021,33264312,291,0.8280951498503248
12261,1108.813733,1108.858867,1,33264411,33265766,1355,0.5700293273044019
12262,1108.8707,1108.8922,1,33266121,33266766,645,0.5125943000843639
12263,1108.905733,1108.9132,1,33267171,33267396,225,0.3799150392846686
12264,1108.952133,1109.002067,1,33268563,33270062,1499,0.5109159291402261
12265,1109.023167,1109.0435,1,33270695,33271305,610,0.4910186980352244
12266,1109.059,1109.063667,1,33271770,33271910,140,0.8293046548041726
12267,1109.064767,1109.0687,1,33271943,33272061,118,0.8240384281236608
12268,1109.130933,1109.136467,1,33273927,33274094,167,0.904134931477338
12269,1109.138933,1109.157067,1,33274167,33274712,545,0.7348666041383825
12270,1109.158067,1109.166533,1,33274742,33274995,253,0.8090088835804388
12271,1109.1676,1109.172767,1,33275028,33275183,155,0.889563130773097
12272,1109.191633,1109.207133,1,33275748,33276213,465,0.4482430947066273
12273,1109.512967,1109.634833,1,33285389,33289044,3655,0.23140468227585612
12274,1109.649267,1109.7706,1,33289478,33293118,3640,0.17648768175926396
12275,1109.797933,1109.802667,1,33293937,33294080,143,0.1849104464409781
12276,1109.809133,1109.826467,1,33294273,33294794,521,0.7470579545174832
12277,1109.8711,1109.8871,1,33296133,33296612,479,0.649535409044789
12278,1110.3745,1110.4786,1,33311234,33314357,3123,0.038935622121882514
12279,1110.487167,1110.5084,1,33314615,33315251,636,0.2891177163079426
12280,1110.528067,1110.547933,1,33315842,33316437,595,0.2413788391305945
12281,1110.5502,1110.6099,1,33316505,33318296,1791,0.20062589863552246
12282,1110.611967,1110.634933,1,33318359,33319047,688,0.40005256465553213
12283,1110.6361,1110.639967,1,33319083,33319199,116,0.7485330029313976
12284,1110.641467,1110.7316,1,33319244,33321948,2704,0.059465114729675334
12285,1110.7339,1110.7375,1,33322017,33322125,108,0.960654844143101
12286,1110.738533,1110.741867,1,33322155,33322256,101,0.7856294680954612
12287,1110.753133,1110.7808,1,33322593,33323424,831,0.10824350636085159
12288,1110.7903,1110.7935,1,33323708,33323805,97,0.862630888451915
12289,1110.801133,1110.979933,1,33324033,33329397,5364,0.141583029047653
12290,1110.993467,1111.0008,1,33329804,33330024,220,0.20163747559386794
12291,1111.045133,1111.0863,1,33331353,33332588,1235,0.21322361127352069
12292,1111.112067,1111.132567,1,33333362,33333977,615,0.44255727196617267
12293,1111.160433,1111.166,1,33334812,33334980,168,0.5186837709387188
12294,1111.182933,1111.199633,1,33335487,33335988,501,0.16811665488593933
12295,1111.202033,1111.215267,1,33336060,33336458,398,0.5867935728849228
12296,1111.234567,1111.255967,1,33337037,33337679,642,0.1692696950816651
12297,1111.3047,1111.3381,1,33339140,33340143,1003,0.2986616769495164
12298,1111.3554,1111.3715,1,33340661,33341145,484,0.1222897757639814
12299,1111.382367,1111.3965,1,33341471,33341895,424,0.43947903694786367
12300,1111.404433,1111.4218,1,33342132,33342654,522,0.29185379560800767
12301,1111.500033,1111.503233,1,33345000,33345096,96,0.7736980013572613
12302,1111.511333,1111.571233,1,33345339,33347136,1797,0.42818510879648775
12303,1111.586433,1111.591033,1,33347592,33347730,138,0.7000973446240324
12304,1111.605733,1111.6503,1,33348171,33349509,1338,0.300731755207409
12305,1111.664133,1111.6883,1,33349923,33350649,726,0.21719068573881403
12306,1111.689633,1111.711333,1,33350688,33351339,651,0.36078116597317156
12307,1111.719867,1111.738067,1,33351596,33352142,546,0.5959673028422436
12308,1111.739133,1111.7612,1,33352173,33352835,662,0.7394473129914712
12309,1111.763367,1111.802267,1,33352901,33354068,1167,0.15587872983391607
12310,1112.257533,1112.345733,1,33367725,33370371,2646,0.028362730745787764
12311,1112.350533,1112.4213,1,33370515,33372639,2124,0.301261216924602
12312,1112.432533,1112.513633,1,33372975,33375408,2433,0.08945989506318557
12313,1112.516667,1112.520833,1,33375500,33375624,124,0.9792625585799278
12314,1112.550433,1112.583267,1,33376512,33377498,986,0.13332297594045747
12315,1112.5862,1112.6119,1,33377586,33378357,771,-0.04475193793667218
12316,1112.619267,1112.645933,1,33378578,33379377,799,0.022714288524909153
12317,1112.676767,1112.695167,1,33380303,33380855,552,-0.024830969514744103
12318,1112.696533,1112.702833,1,33380895,33381084,189,0.7638475211256297
12319,1112.759367,1112.773133,1,33382781,33383193,412,0.49203769056689395
12320,1112.793867,1112.801667,1,33383816,33384050,234,0.2607048514480473
12321,1113.3306,1113.3947,1,33399918,33401841,1923,0.15561477258163003
12322,1113.3959,1113.4417,1,33401877,33403251,1374,0.19989603861635474
12323,1113.4427,1113.4633,1,33403281,33403898,617,0.24752501090860482
12324,1113.472167,1113.488667,1,33404165,33404660,495,0.25507814251245536
12325,1113.501533,1113.594067,1,33405045,33407822,2777,0.11425552818075731
12326,1113.597467,1113.678233,1,33407924,33410346,2422,0.15370659702616718
12327,1114.2699,1114.280167,1,33428097,33428405,308,0.6517134913284329
12328,1114.285733,1114.371167,1,33428571,33431135,2564,-0.05043585558389167
12329,1114.3883,1114.391733,1,33431649,33431751,102,0.7802465264267742
12330,1114.4131,1114.4375,1,33432393,33433125,732,0.16552715027164827
12331,1114.447367,1114.4684,1,33433421,33434052,631,0.14372335539925296
12332,1114.476433,1114.5762,1,33434292,33437286,2994,0.12987239916675794
12333,1114.601567,1114.6297,1,33438047,33438891,844,-0.052146804363431366
12334,1114.6307,1114.658133,1,33438920,33439743,823,0.06851480758444968
12335,1114.670633,1114.717267,1,33440118,33441518,1400,0.020720623642239526
12336,1114.737033,1114.748433,1,33442110,33442452,342,0.4854022963808943
12337,1114.758267,1114.7615,1,33442748,33442845,97,0.5290513042171607
12338,1114.7826,1114.789767,1,33443478,33443693,215,0.7955870589061753
12339,1115.645033,1115.650033,1,33469350,33469500,150,0.4945990209514678
12340,1115.653167,1115.670533,1,33469595,33470115,520,0.25578809682353304
12341,1116.263133,1116.266167,1,33487893,33487985,92,0.64854940562678
12342,1120.3873,1120.486967,1,33611619,33614609,2990,0.13380367713930835
12343,1120.491933,1120.504367,1,33614757,33615131,374,0.27691712364226584
12344,1120.5124,1120.544067,1,33615372,33616322,950,0.1475020371261729
12345,1120.545167,1120.565133,1,33616355,33616953,598,-0.013987320071990548
12346,1120.567167,1120.573767,1,33617015,33617213,198,0.7990637947543902
12347,1120.5802,1120.586867,1,33617406,33617606,200,0.512878371491422
12348,1120.5903,1120.676833,1,33617709,33620304,2595,0.2997153303582559
12349,1121.208,1121.2234,1,33636240,33636702,462,0.17286761814498713
12350,1121.224967,1121.2798,1,33636749,33638394,1645,0.15174619044885104
12351,1121.280833,1121.3322,1,33638424,33639966,1542,0.186589219911498
12352,1121.339833,1121.3614,1,33640194,33640842,648,0.07018270584412971
12353,1121.363867,1121.416567,1,33640916,33642497,1581,0.16208785856236016
12354,1121.423667,1121.4557,1,33642710,33643671,961,0.12058176387656308
12355,1121.4632,1121.482867,1,33643896,33644486,590,0.1055270501493049
12356,1121.484,1121.581033,1,33644520,33647430,2910,0.3366312452734736
12357,1121.586333,1121.595967,1,33647589,33647879,290,0.4740354212548055
12358,1124.4561,1124.4592,1,33733683,33733776,93,0.5749328806134718
12359,1124.4622,1124.599667,1,33733866,33737990,4124,0.06464134660154912
12360,1124.6011,1124.6333,1,33738033,33738999,966,0.26443957580496347
12361,1124.639367,1124.751733,1,33739181,33742551,3370,0.2328506964162146
12362,1124.993233,1124.998533,1,33749796,33749955,159,0.3475455965075216
12363,1125.0094,1125.018967,1,33750282,33750569,287,0.2898222632493667
12364,1125.027767,1125.0393,1,33750833,33751179,346,0.25101267473674793
12365,1125.041667,1125.0555,1,33751250,33751665,415,0.09950922262372158
12366,1125.188967,1125.239333,1,33755669,33757179,1510,0.044589015055520785
12367,1125.2416,1125.245067,1,33757248,33757352,104,0.8122901915648234
12368,1125.272,1125.304933,1,33758160,33759147,987,0.16182628087707307
12369,1125.3346,1125.3406,1,33760038,33760218,180,0.7636178315653412
12370,1125.379367,1125.389033,1,33761381,33761670,289,0.34296532698855325
12371,1125.391033,1125.433,1,33761730,33762990,1260,0.10339226274550521
12372,1125.438067,1125.487533,1,33763142,33764625,1483,0.23933646870262468
12373,1125.633067,1125.637333,1,33768992,33769119,127,0.39892957188104133
12374,1125.657233,1125.683,1,33769716,33770490,774,0.39913401307755464
12375,1125.6891,1125.696767,1,33770673,33770903,230,0.20269419957959242
12376,1125.7195,1125.726467,1,33771585,33771794,209,0.6537275737451024
12377,1125.873467,1125.887133,1,33776204,33776613,409,0.20017349411225582
12378,1125.903267,1125.9117,1,33777098,33777351,253,0.09955280438955719
12379,1125.913,1125.917033,1,33777390,33777510,120,0.6659991821608489
12380,1125.923167,1125.951733,1,33777695,33778551,856,0.4088273870242521
12381,1125.9574,1125.9646,1,33778722,33778938,216,0.4759649180617543
12382,1125.977333,1125.992467,1,33779319,33779774,455,0.054587857485116666
12383,1126.012033,1126.064667,1,33780360,33781940,1580,0.11887837303658796
12384,1126.065833,1126.069067,1,33781974,33782072,98,0.7627933395140618
12385,1126.076467,1126.079733,1,33782294,33782391,97,0.030445117338921298
12386,1126.084367,1126.136067,1,33782531,33784082,1551,0.17666938669635215
12387,1126.137333,1126.150867,1,33784119,33784526,407,0.29134530081747173
12388,1126.152133,1126.1567,1,33784563,33784701,138,0.8841585392366915
12389,1126.159433,1126.1686,1,33784782,33785058,276,0.5851484023840262
12390,1126.196467,1126.252033,1,33785894,33787560,1666,0.2876012448943452
12391,1126.2605,1126.265667,1,33787815,33787970,155,0.6825351376540719
12392,1126.266967,1126.2885,1,33788009,33788655,646,0.5169562868578684
12393,1126.300567,1126.304767,1,33789017,33789143,126,0.9021121694161008
12394,1126.314367,1126.326,1,33789431,33789780,349,0.39814640509537
12395,1126.373933,1126.3966,1,33791217,33791898,681,0.7083878179814147
12396,1126.400367,1126.405367,1,33792011,33792161,150,0.854884600248348
12397,1126.416933,1126.4202,1,33792507,33792606,99,0.9082174674310843
12398,1126.424267,1126.443633,1,33792728,33793308,580,0.3360503319086958
12399,1126.4494,1126.4591,1,33793482,33793773,291,0.4735131355436012
12400,1126.466133,1126.4783,1,33793983,33794349,366,0.5621744194567366
12401,1126.4801,1126.515967,1,33794403,33795479,1076,0.7347762377316531
12402,1126.5193,1126.549733,1,33795579,33796491,912,0.26328336940081704
12403,1126.564067,1126.5719,1,33796922,33797157,235,0.5887449461876207
12404,1126.577433,1126.581633,1,33797322,33797448,126,0.6449253410102891
12405,1126.597,1126.603,1,33797910,33798090,180,0.814405152148013
12406,1126.604267,1126.607733,1,33798128,33798231,103,0.8385786370094909
12407,1126.6128,1126.6177,1,33798384,33798531,147,0.71887140889005
12408,1126.618733,1126.641167,1,33798561,33799235,674,0.6303109541761883
12409,1126.649133,1126.680533,1,33799473,33800415,942,0.3753951842122757
12410,1126.694367,1126.701667,1,33800831,33801050,219,0.817926563238474
12411,1126.7479,1126.7949,1,33802437,33803847,1410,0.6623959720051286
12412,1126.7976,1126.8022,1,33803928,33804066,138,0.8580023812459161
12413,1126.813133,1126.834733,1,33804393,33805041,648,0.5158835763302613
12414,1126.892833,1126.897267,1,33806784,33806918,134,0.4270265008906665
12415,1126.935067,1126.9462,1,33808052,33808386,334,0.7048332844901589
12416,1126.950767,1126.958567,1,33808523,33808757,234,0.7984320255689937
12417,1126.996733,1127.017667,1,33809901,33810530,629,0.44781796790945544
12418,1128.270733,1128.4324,1,33848121,33852972,4851,0.2416196823332783
12419,1128.4359,1128.460567,1,33853077,33853817,740,0.2447238775884722
12420,1128.463,1128.466867,1,33853890,33854006,116,0.70721944665328
12421,1128.468567,1128.551367,1,33854057,33856541,2484,0.15416541896653757
12422,1128.553567,1128.573,1,33856607,33857190,583,0.24692841729597692
12423,1129.092867,1129.098133,1,33872786,33872943,157,0.508559464693447
12424,1129.146967,1129.2309,1,33874409,33876927,2518,0.11080790588396293
12425,1129.2474,1129.2761,1,33877422,33878283,861,0.0822416776475258
12426,1129.277133,1129.2988,1,33878313,33878964,651,0.12430865970226243
12427,1129.303467,1129.414433,1,33879104,33882432,3328,0.13600721032800808
12428,1129.426767,1129.448933,1,33882803,33883467,664,0.15511864465454428
12429,1129.450467,1129.455267,1,33883514,33883658,144,0.7770100172950698
12430,1129.456967,1129.483833,1,33883709,33884514,805,-0.023598266601766112
12431,1129.5031,1129.53,1,33885093,33885900,807,0.042586432431320646
12432,1129.552467,1129.5829,1,33886574,33887487,913,0.11531461223076538
12433,1129.587367,1129.6022,1,33887621,33888066,445,0.004975066468028305
12434,1129.6032,1129.638633,1,33888096,33889158,1062,0.18807936950678128
12435,1129.684933,1129.7188,1,33890547,33891564,1017,0.07279075663285946
12436,1129.782433,1129.794067,1,33893472,33893822,350,0.5200663186897628
12437,1129.797933,1129.804033,1,33893937,33894120,183,0.7995630072302073
12438,1129.807567,1129.8185,1,33894227,33894555,328,0.3592611374818119
12439,1129.829,1129.908367,1,33894870,33897251,2381,0.048406053355125774
12440,1129.922067,1129.930233,1,33897662,33897906,244,0.37551030624937853
12441,1129.937633,1129.9789,1,33898128,33899367,1239,0.15896405148744228
12442,1130.446533,1130.539467,1,33913395,33916184,2789,0.10088004565349361
12443,1130.556267,1130.633167,1,33916688,33918995,2307,0.1448321209088908
12444,1130.647533,1130.680667,1,33919425,33920420,995,0.16950839365153797
12445,1130.685467,1130.822433,1,33920564,33924672,4108,0.0919746492420136
12446,1130.83,1130.833033,1,33924900,33924990,90,0.8738164331835375
12447,1130.840967,1130.8545,1,33925229,33925635,406,0.12846926358311445
12448,1130.874333,1130.880167,1,33926229,33926405,176,0.7190557711967098
12449,1130.882767,1130.8874,1,33926483,33926622,139,0.7926564721088664
12450,1130.8914,1130.919067,1,33926742,33927572,830,0.21797327204530148
12451,1130.935,1130.975633,1,33928050,33929268,1218,0.337705520647089
12452,1131.006933,1131.010667,1,33930207,33930320,113,0.9441128907398917
12453,1131.051067,1131.054133,1,33931532,33931623,91,0.6605024284665896
12454,1131.063667,1131.0678,1,33931910,33932034,124,0.8271597299088811
12455,1131.0762,1131.086533,1,33932286,33932595,309,0.35929080163055077
12456,1131.087733,1131.099067,1,33932631,33932972,341,0.4285264535226986
12457,1131.353533,1131.3572,1,33940605,33940716,111,0.38694597317580115
12458,1131.372633,1131.458933,1,33941178,33943767,2589,0.12625373699865325
12459,1131.460067,1131.4633,1,33943802,33943899,97,0.5840191485222456
12460,1131.4648,1131.479433,1,33943944,33944382,438,0.5813160446450955
12461,1131.4878,1131.541567,1,33944634,33946247,1613,0.1928663049114804
12462,1131.562,1131.648733,1,33946860,33949461,2601,0.18826755538267037
12463,1131.6619,1131.7041,1,33949857,33951123,1266,0.1903113136863987
12464,1131.7051,1131.722333,1,33951153,33951669,516,0.08021007138729055
12465,1131.7651,1131.7957,1,33952953,33953871,918,0.13265314477562892
12466,1131.824067,1131.837533,1,33954722,33955125,403,0.6755722548431881
12467,1131.872267,1131.877733,1,33956168,33956331,163,0.9016613780138547
12468,1132.3199,1132.4251,1,33969597,33972753,3156,0.1666230616438236
12469,1132.428133,1132.486433,1,33972843,33974592,1749,0.1631157563367411
12470,1132.5083,1132.619367,1,33975249,33978581,3332,0.23308252526305004
12471,1132.628,1132.631067,1,33978840,33978932,92,-0.5030218256958457
12472,1132.9772,1132.984933,1,33989316,33989547,231,0.44928626763932794
12473,1132.985933,1132.9924,1,33989577,33989772,195,0.060644891047964264
12474,1133.0405,1133.052,1,33991215,33991560,345,0.49031425590008354
12475,1133.0591,1133.2056,1,33991773,33996168,4395,0.08458598010627949
12476,1133.206633,1133.2342,1,33996198,33997026,828,0.04353298924452777
12477,1133.2461,1133.331867,1,33997383,33999956,2573,0.09426905633024432
12478,1133.334367,1133.3526,1,34000031,34000578,547,0.4359508495467491
12479,1133.3956,1133.399767,1,34001868,34001993,125,0.5269018430691234
12480,1133.4008,1133.416267,1,34002024,34002488,464,0.3000826240597022
12481,1133.435233,1133.4388,1,34003056,34003164,108,0.6541018094685886
12482,1133.440067,1133.474633,1,34003202,34004238,1036,0.056941727505124266
12483,1133.4911,1133.518167,1,34004733,34005545,812,0.09124305757556726
12484,1133.544,1133.566967,1,34006320,34007009,689,0.055017579555189565
12485,1133.624333,1133.6572,1,34008729,34009716,987,0.1382853304824911
12486,1133.672933,1133.676,1,34010187,34010280,93,0.8459272872403509
12487,1133.6811,1133.7351,1,34010433,34012053,1620,0.11834197623670056
12488,1133.756867,1133.8016,1,34012706,34014048,1342,0.46339997436862135
12489,1133.8885,1133.9036,1,34016655,34017108,453,0.6364279354376895
12490,1134.606667,1134.655933,1,34038200,34039677,1477,0.04214453654451747
12491,1134.677667,1134.7183,1,34040330,34041549,1219,0.12443402491735334
12492,1134.770067,1134.821167,1,34043102,34044635,1533,0.19253770682751667
12493,1134.8546,1134.858267,1,34045638,34045748,110,0.9318907346545365
12494,1134.859333,1134.886033,1,34045779,34046580,801,0.17808944237873903
12495,1134.887233,1134.891433,1,34046616,34046742,126,0.9318603569675779
12496,1134.8928,1134.92,1,34046784,34047600,816,0.2470748452804885
12497,1134.9435,1134.9673,1,34048305,34049019,714,0.07740012232673724
12498,1134.975033,1135.0068,1,34049250,34050204,954,0.17080514383553128
12499,1135.0122,1135.015867,1,34050366,34050476,110,0.8706741139406806
12500,1135.019467,1135.029467,1,34050584,34050884,300,0.4704573843055134
12501,1135.0483,1135.051633,1,34051449,34051548,99,0.9337151134760519
12502,1135.083233,1135.140233,1,34052496,34054206,1710,0.2829967313157701
12503,1135.1455,1135.1501,1,34054365,34054503,138,0.9509990190546173
12504,1135.2126,1135.225433,1,34056378,34056762,384,0.40772828195037386
12505,1135.2477,1135.2632,1,34057431,34057896,465,0.3572972938094323
12506,1135.3039,1135.3075,1,34059117,34059225,108,0.47848013971835635
12507,1135.3141,1135.346633,1,34059423,34060398,975,0.2697485298559488
12508,1135.353067,1135.3568,1,34060592,34060704,112,0.0871412842460138
12509,1135.363433,1135.368733,1,34060902,34061061,159,0.7484787777604518
12510,1135.369967,1135.3799,1,34061099,34061397,298,0.5620990768923848
12511,1135.615033,1135.6786,1,34068450,34070358,1908,0.14798894142103455
12512,1135.685433,1135.691867,1,34070562,34070756,194,0.4988118330019971
12513,1135.701233,1135.705267,1,34071036,34071158,122,0.8152270800560202
12514,1135.706333,1135.713433,1,34071189,34071402,213,0.4968005771941169
12515,1135.7261,1135.744933,1,34071783,34072347,564,0.2832345474063165
12516,1135.7648,1135.782633,1,34072944,34073478,534,0.4391672889819795
12517,1135.79,1135.871633,1,34073700,34076148,2448,0.22837222349725908
12518,1135.9284,1135.959633,1,34077852,34078788,936,0.2141110161364277
12519,1135.9701,1135.990733,1,34079103,34079721,618,0.4061294301628028
12520,1135.995967,1136.0091,1,34079879,34080273,394,0.6847774729869913
12521,1136.086467,1136.089833,1,34082594,34082694,100,0.5726132363075946
12522,1136.371033,1136.4515,1,34091130,34093545,2415,0.15770107765629746
12523,1136.4529,1136.4658,1,34093587,34093974,387,0.25576515086800716
12524,1136.4669,1136.523367,1,34094007,34095701,1694,0.34231322929052005
12525,1136.5244,1136.5344,1,34095732,34096032,300,0.4233876649217419
12526,1136.5391,1136.555233,1,34096173,34096656,483,-0.03456889531708998
12527,1136.556667,1136.575733,1,34096700,34097271,571,0.3883182802888129
12528,1136.576933,1136.584033,1,34097307,34097520,213,0.6973280032276786
12529,1136.6249,1136.719533,1,34098747,34101585,2838,0.10717978742443318
12530,1136.720567,1136.723867,1,34101617,34101716,99,0.47699955494159524
12531,1136.726467,1136.7339,1,34101794,34102017,223,0.39649057710959973
12532,1136.736867,1136.741067,1,34102106,34102232,126,0.7650894037516923
12533,1136.7486,1136.762133,1,34102458,34102863,405,0.6963446372307439
12534,1136.7793,1136.814667,1,34103379,34104440,1061,0.18126911525277237
12535,1136.940167,1136.992933,1,34108205,34109787,1582,-0.005425866385671913
12536,1136.995467,1137.011933,1,34109864,34110357,493,0.006681969825291746
12537,1137.0175,1137.042433,1,34110525,34111272,747,0.062395409086303096
12538,1137.047867,1137.1447,1,34111436,34114341,2905,0.17425310808190655
12539,1137.155433,1137.2673,1,34114662,34118019,3357,0.0897412755692452
12540,1137.268667,1137.275433,1,34118060,34118262,202,-0.38299821049928995
12541,1137.536733,1137.613833,1,34126101,34128414,2313,0.09105449877704676
12542,1137.621367,1137.745333,1,34128641,34132359,3718,0.08927170052270479
12543,1137.752033,1137.756667,1,34132560,34132700,140,0.7084853096326487
12544,1137.7586,1137.880533,1,34132758,34136415,3657,0.09341906966946743
12545,1137.903967,1137.907433,1,34137119,34137222,103,0.443431332833999
12546,1139.2388,1139.244967,1,34177164,34177349,185,0.4678749346283633
12547,1139.246133,1139.261733,1,34177383,34177851,468,0.3942127060324802
12548,1139.308133,1139.385167,1,34179243,34181555,2312,0.2445672714348496
12549,1139.388633,1139.395333,1,34181658,34181859,201,0.5226007237215977
12550,1139.3984,1139.4192,1,34181952,34182576,624,0.2797810088551708
12551,1139.422233,1139.487667,1,34182666,34184630,1964,0.19670786670695783
12552,1139.488867,1139.563533,1,34184666,34186905,2239,0.16730787873696185
12553,1139.564733,1139.5782,1,34186941,34187346,405,0.4203091771021976
12554,1139.5792,1139.612033,1,34187376,34188360,984,0.5031271478100607
12555,1139.614,1139.6432,1,34188420,34189296,876,0.23538844528454522
12556,1139.6503,1139.6537,1,34189509,34189611,102,0.5041836936124572
12557,1139.666067,1139.6698,1,34189982,34190094,112,0.8304372166957952
12558,1139.681,1139.687633,1,34190430,34190628,198,0.5049756539715532
12559,1139.6893,1139.738533,1,34190679,34192155,1476,0.5082579229718747
12560,1139.751333,1139.763967,1,34192539,34192919,380,0.3777413910257328
12561,1139.7689,1139.787467,1,34193067,34193624,557,0.4641897701713414
12562,1139.835733,1139.8521,1,34195071,34195563,492,0.3029651217186661
12563,1139.860733,1139.886633,1,34195821,34196598,777,0.47820786139693416
12564,1139.902967,1139.919533,1,34197089,34197585,496,0.4133025724202815
12565,1139.922233,1139.935833,1,34197666,34198074,408,0.283674371385322
12566,1139.987767,1139.997867,1,34199633,34199936,303,0.2559330878436941
12567,1140.005367,1140.089133,1,34200161,34202673,2512,0.15299045506438316
12568,1140.090133,1140.108033,1,34202703,34203240,537,0.2726500092865312
12569,1140.1167,1140.141,1,34203501,34204230,729,0.15231032553784749
12570,1140.1583,1140.202733,1,34204749,34206081,1332,0.04719750440163892
12571,1140.2104,1140.2457,1,34206312,34207371,1059,-0.17116347369548093
12572,1140.2475,1140.250633,1,34207425,34207518,93,0.2775232809463155
12573,1140.258333,1140.287733,1,34207749,34208631,882,0.012734865782083013
12574,1140.344267,1140.3609,1,34210328,34210827,499,0.23322262445407954
12575,1140.364067,1140.369533,1,34210922,34211085,163,0.46643965687636535
12576,1140.3753,1140.381633,1,34211259,34211448,189,0.5943751019398915
12577,1140.608867,1140.687867,1,34218266,34220636,2370,0.13876124551476934
12578,1140.692233,1140.709367,1,34220766,34221281,515,0.6265639130583491
12579,1140.724733,1140.8815,1,34221741,34226445,4704,0.1388236974334127
12580,1140.9299,1141.004967,1,34227897,34230149,2252,0.08796818535407239
12581,1141.010233,1141.024867,1,34230306,34230746,440,0.1816625324489724
12582,1141.037967,1141.042433,1,34231139,34231272,133,0.9051537784660403
12583,1141.064733,1141.076567,1,34231941,34232297,356,0.5833695409259491
12584,1141.71,1141.718167,1,34251300,34251545,245,0.15058203436699988
12585,1141.719333,1141.816133,1,34251579,34254483,2904,0.0687397333219814
12586,1141.839833,1141.900233,1,34255194,34257006,1812,0.2419317596742501
12587,1141.910833,1142.0456,1,34257324,34261368,4044,0.05765277690284062
12588,1142.049767,1142.1004,1,34261493,34263012,1519,0.08954849151383353
12589,1142.145333,1142.1681,1,34264359,34265043,684,0.16209374644636954
12590,1142.237767,1142.243867,1,34267133,34267316,183,0.37737947702554137
12591,1142.254067,1142.267367,1,34267622,34268021,399,0.008967626921114904
12592,1142.268933,1142.364733,1,34268067,34270941,2874,0.11205218967984902
12593,1142.367033,1142.374133,1,34271010,34271223,213,0.4442705405612155
12594,1142.3788,1142.383433,1,34271364,34271502,138,0.6235500337778372
12595,1142.387467,1142.391933,1,34271624,34271757,133,0.8774489593502873
12596,1142.395167,1142.404467,1,34271855,34272134,279,0.5599220508171512
12597,1142.406433,1142.4197,1,34272192,34272591,399,0.07808695058158382
12598,1142.422367,1142.435167,1,34272671,34273055,384,0.35512977529136175
12599,1142.438367,1142.5153,1,34273151,34275459,2308,0.21608996025133378
12600,1143.193733,1143.3441,1,34295811,34300323,4512,0.01999519722760905
12601,1143.3468,1143.4936,1,34300404,34304808,4404,0.23240937158767336
12602,1145.209133,1145.2941,1,34356273,34358823,2550,0.1676447496877194
12603,1145.296467,1145.314333,1,34358894,34359429,535,0.3851452351546107
12604,1145.3157,1145.325067,1,34359471,34359752,281,0.31399755026561876
12605,1145.330533,1145.565133,1,34359915,34366953,7038,0.11762458958922246
12606,1145.5707,1145.635233,1,34367121,34369056,1935,0.04005161823526989
12607,1145.642967,1145.670467,1,34369289,34370114,825,0.19248618812151802
12608,1145.674333,1145.698067,1,34370229,34370942,713,0.10279536081727372
12609,1145.706067,1145.7156,1,34371182,34371468,286,0.6006586303077498
12610,1145.722733,1145.7338,1,34371681,34372014,333,0.10805295990726968
12611,1145.775333,1145.792367,1,34373259,34373771,512,0.07478458808448332
12612,1145.812733,1145.816767,1,34374381,34374503,122,0.5477892740129471
12613,1146.153067,1146.236733,1,34384592,34387101,2509,0.24766513695037332
12614,1146.238367,1146.243,1,34387151,34387290,139,0.8725816819283341
12615,1146.248833,1146.2625,1,34387464,34387875,411,0.5091961627921726
12616,1146.263767,1146.278533,1,34387913,34388355,442,0.42662181678154043
12617,1146.286233,1146.2916,1,34388586,34388748,162,0.8139803300358092
12618,1146.2929,1146.305467,1,34388787,34389164,377,0.8626274712911554
12619,1146.314967,1146.4603,1,34389449,34393809,4360,0.07113825512835803
12620,1146.481333,1146.527867,1,34394439,34395836,1397,0.10530619383257193
12621,1146.5343,1146.5402,1,34396029,34396206,177,0.38997531575765393
12622,1146.559267,1146.582,1,34396778,34397460,682,0.08961671289550645
12623,1146.590267,1146.614567,1,34397708,34398437,729,0.08123987841789473
12624,1146.629167,1146.632167,1,34398875,34398965,90,0.543682387264276
12625,1146.638733,1146.681533,1,34399161,34400445,1284,-0.011825046209386557
12626,1146.698667,1146.703467,1,34400960,34401104,144,0.5159944187437038
12627,1148.035733,1148.039733,1,34441071,34441191,120,0.8139141974097196
12628,1148.0413,1148.0476,1,34441239,34441428,189,0.5461411528262288
12629,1148.096533,1148.239733,1,34442895,34447191,4296,0.0632663634262444
12630,1148.241233,1148.256133,1,34447236,34447683,447,0.3193725778508064
12631,1148.257533,1148.260533,1,34447725,34447815,90,0.9360514206566695
12632,1148.267567,1148.316267,1,34448027,34449488,1461,0.0952638327711307
12633,1148.3173,1148.324767,1,34449519,34449743,224,0.7556534849477
12634,1148.339433,1148.422067,1,34450182,34452662,2480,0.05707326239430218
12635,1148.423567,1148.4317,1,34452707,34452951,244,0.8289889702269245
12636,1148.432833,1148.445967,1,34452984,34453379,395,0.4214722360273912
12637,1149.182567,1149.282267,1,34475477,34478468,2991,0.16268736191166355
12638,1149.3122,1149.416633,1,34479366,34482498,3132,0.1585184809542554
12639,1149.418867,1149.4346,1,34482566,34483038,472,0.08206843998684452
12640,1149.4362,1149.439267,1,34483086,34483178,92,0.9449656031206037
12641,1149.489233,1149.520733,1,34484676,34485621,945,0.12168047329679624
12642,1149.612867,1149.620867,1,34488386,34488626,240,0.55777005099292
12643,1149.655367,1149.659367,1,34489661,34489781,120,0.3325401163335716
12644,1149.6836,1149.690867,1,34490508,34490726,218,0.15430404378040147
12645,1149.9903,1150.017933,1,34499709,34500537,828,0.06675422437478996
12646,1150.057767,1150.233333,1,34501733,34506999,5266,0.0944580323497066
12647,1150.236433,1150.2411,1,34507092,34507233,141,0.5454050251071478
12648,1150.2527,1150.2828,1,34507581,34508484,903,0.10998675839090138
12649,1150.302533,1150.4132,1,34509075,34512396,3321,0.1519104588610233
12650,1150.418867,1150.436733,1,34512566,34513101,535,0.022449616140376605
12651,1150.4426,1150.5079,1,34513278,34515237,1959,0.11923481786602429
12652,1150.9448,1150.955533,1,34528344,34528665,321,0.06586343916014237
12653,1151.001567,1151.007767,1,34530047,34530233,186,0.39045840165091544
12654,1151.0175,1151.095833,1,34530525,34532874,2349,0.09267015034229605
12655,1151.1292,1151.147033,1,34533876,34534410,534,0.10914217306444106
12656,1151.148267,1151.2375,1,34534448,34537125,2677,-0.0422645113610965
12657,1151.387467,1151.394467,1,34541624,34541834,210,0.5500175132773373
12658,1151.424467,1151.431833,1,34542734,34542954,220,0.1295376961174339
12659,1151.436033,1151.467633,1,34543080,34544028,948,0.03945312385638961
12660,1151.5314,1151.5398,1,34545942,34546194,252,-0.051569808472768354
12661,1151.6063,1151.683433,1,34548189,34550502,2313,-0.022262028763648745
12662,1151.684933,1151.7012,1,34550547,34551036,489,0.06030153010896169
12663,1151.703367,1151.734167,1,34551101,34552025,924,0.10882402696837362
12664,1151.745467,1151.843767,1,34552364,34555313,2949,0.06575029681933812
12665,1151.845,1151.9591,1,34555350,34558773,3423,0.14522373922746992
12666,1151.960533,1151.964133,1,34558815,34558923,108,0.8409207347994561
12667,1151.973333,1151.977233,1,34559199,34559316,117,0.7159167070527742
12668,1151.9994,1152.004367,1,34559982,34560131,149,0.8450716596838798
12669,1152.009967,1152.0156,1,34560299,34560468,169,0.5478913130822007
12670,1152.9972,1153.003433,1,34589916,34590102,186,0.5958377126360718
12671,1153.0103,1153.1067,1,34590309,34593201,2892,0.10024684828842188
12672,1153.1078,1153.175667,1,34593234,34595270,2036,0.13025052029582027
12673,1153.201033,1153.3571,1,34596030,34600713,4683,0.06145967907676326
12674,1153.360233,1153.391367,1,34600806,34601741,935,0.5413763441951231
12675,1153.417167,1153.4782,1,34602515,34604346,1831,0.25094937651958027
12676,1153.479333,1153.482433,1,34604379,34604472,93,0.917840057999791
12677,1153.536533,1153.540933,1,34606095,34606227,132,0.7353765545856977
12678,1153.541933,1153.550967,1,34606257,34606529,272,0.502857869268727
12679,1153.6737,1153.678333,1,34610211,34610349,138,0.15703582002443703
12680,1153.6795,1153.6841,1,34610385,34610523,138,0.6302374618038097
12681,1153.699933,1153.703533,1,34610997,34611105,108,0.44014664915052887
12682,1153.985,1154.123033,1,34619550,34623690,4140,0.10816941548180957
12683,1154.128033,1154.267867,1,34623840,34628036,4196,0.1832526655815545
12684,1154.3364,1154.3566,1,34630092,34630698,606,0.1936843052432347
12685,1154.3793,1154.403367,1,34631379,34632101,722,0.17099442697919381
12686,1154.4204,1154.450667,1,34632612,34633520,908,-0.013929350923576297
12687,1154.4833,1154.501867,1,34634499,34635056,557,-0.051532546380626196
12688,1154.5483,1154.585767,1,34636449,34637573,1124,0.01790468287838376
12689,1154.726167,1154.731033,1,34641785,34641930,145,0.5151715841654122
12690,1154.758167,1154.775267,1,34642745,34643258,513,0.14419268668730315
12691,1154.777567,1154.781433,1,34643327,34643442,115,0.9661068670999261
12692,1154.783767,1154.849033,1,34643513,34645470,1957,0.16907291845360406
12693,1154.862233,1154.867833,1,34645866,34646034,168,0.6339810435434249
12694,1154.884467,1154.949233,1,34646534,34648476,1942,0.3147463534099746
12695,1154.950333,1154.9637,1,34648509,34648911,402,-0.060897063152080634
12696,1154.965067,1154.969,1,34648952,34649070,118,0.9715315817146887
12697,1154.970567,1155.006567,1,34649117,34650197,1080,0.08593197395179104
12698,1155.0744,1155.0946,1,34652232,34652838,606,0.00878529830568195
12699,1155.102133,1155.127133,1,34653063,34653813,750,0.20791899292071428
12700,1155.1312,1155.146233,1,34653936,34654386,450,-0.0589157803137812
12701,1155.159967,1155.1966,1,34654799,34655898,1099,0.010373949299368856
12702,1155.197833,1155.2343,1,34655934,34657029,1095,0.3032406482279154
12703,1155.291033,1155.294767,1,34658730,34658843,113,0.7993094615299612
12704,1155.615867,1155.624467,1,34668476,34668734,258,0.8447449466554249
12705,1155.6695,1155.6889,1,34670085,34670667,582,0.22532985475004666
12706,1155.699467,1155.741333,1,34670984,34672239,1255,0.19801675833969068
12707,1156.035233,1156.038367,1,34681056,34681151,95,0.6890654723412234
12708,1156.0688,1156.081033,1,34682064,34682430,366,0.22060561193250347
12709,1156.145,1156.1531,1,34684350,34684593,243,0.45314241528331733
12710,1157.005533,1157.010933,1,34710165,34710327,162,0.07419797486459083
12711,1157.016267,1157.020133,1,34710488,34710603,115,-0.18024285415322103
12712,1157.057667,1157.067133,1,34711730,34712013,283,0.07525359546643984
12713,1157.079967,1157.1173,1,34712399,34713519,1120,0.4500409993644281
12714,1157.119633,1157.1511,1,34713588,34714533,945,-0.26299931763527024
12715,1157.168333,1157.197667,1,34715049,34715930,881,0.13064363928280215
12716,1157.201267,1157.204367,1,34716038,34716131,93,0.79381907149226
12717,1157.8971,1157.9997,1,34736913,34739991,3078,0.2055591205261981
12718,1158.0139,1158.132167,1,34740417,34743965,3548,0.06664016461935808
12719,1158.1343,1158.145233,1,34744029,34744356,327,0.005777187040181291
12720,1158.163367,1158.168833,1,34744901,34745064,163,0.8265104967592108
12721,1158.172767,1158.197467,1,34745183,34745924,741,0.7292971078426801
12722,1158.1991,1158.2047,1,34745973,34746141,168,0.8804583937462169
12723,1158.209433,1158.213467,1,34746282,34746404,122,0.8126097833981942
12724,1158.218433,1158.2383,1,34746552,34747149,597,0.38538173383132956
12725,1158.2393,1158.251033,1,34747179,34747530,351,0.5678697166861193
12726,1158.318467,1158.351733,1,34749554,34750551,997,0.732116328965544
12727,1158.3839,1158.3956,1,34751517,34751868,351,0.8173843771291579
12728,1158.399767,1158.404167,1,34751993,34752125,132,0.37686971471723035
12729,1158.428867,1158.4835,1,34752866,34754505,1639,0.37135889804166045
12730,1158.507867,1158.524333,1,34755236,34755729,493,0.6145274538649419
12731,1158.569033,1158.5769,1,34757070,34757307,237,0.3631928791712114
12732,1158.5979,1158.644967,1,34757937,34759349,1412,0.597475971311859
12733,1158.6666,1158.686867,1,34759998,34760606,608,0.49758950175936295
12734,1158.738033,1158.745633,1,34762140,34762368,228,0.4914564104538455
12735,1158.803467,1158.8071,1,34764104,34764213,109,0.3910049840818416
12736,1158.8688,1158.8747,1,34766064,34766241,177,0.9102631676674099
12737,1158.970667,1158.975667,1,34769120,34769270,150,0.8032737043680388
12738,1158.9767,1159.0356,1,34769301,34771068,1767,0.09090695578619375
12739,1159.0409,1159.050933,1,34771227,34771527,300,0.49340443031148684
12740,1159.065033,1159.204467,1,34771950,34776134,4184,0.03909357105872683
12741,1159.220233,1159.244333,1,34776606,34777329,723,0.09147733314424325
12742,1159.2465,1159.2915,1,34777395,34778745,1350,0.06857029604822835
12743,1159.3048,1159.3133,1,34779144,34779399,255,0.48934818117145856
12744,1159.314333,1159.3177,1,34779429,34779531,102,
12745,1159.336533,1159.358133,1,34780095,34780743,648,0.4013661374285222
12746,1159.463967,1159.469,1,34783919,34784070,151,0.7719798937706438
12747,1159.561833,1159.592433,1,34786854,34787772,918,0.1818142820327656
12748,1159.631533,1159.640033,1,34788945,34789200,255,0.5905942846956521
12749,1159.655433,1159.692833,1,34789662,34790784,1122,0.12503336748527394
12750,1159.711133,1159.715133,1,34791333,34791453,120,0.7995610432336199
12751,1159.7163,1159.719333,1,34791489,34791579,90,0.9573102224826813
12752,1159.720333,1159.8256,1,34791609,34794768,3159,0.12703232905436643
12753,1159.8291,1159.859367,1,34794873,34795781,908,-0.10808508973917501
12754,1159.861,1159.941333,1,34795830,34798239,2409,-0.14179746185959424
12755,1159.9425,1159.969,1,34798275,34799070,795,0.28690683681598955
12756,1159.980233,1160.1323,1,34799406,34803969,4563,0.09154789278814457
12757,1160.1706,1160.195233,1,34805118,34805856,738,0.08469704422551262
12758,1160.215,1160.2657,1,34806450,34807971,1521,0.1300470456496916
12759,1160.278167,1160.315867,1,34808345,34809476,1131,0.19648335271573977
12760,1160.335567,1160.438567,1,34810067,34813157,3090,0.01296749259937585
12761,1160.453333,1160.490867,1,34813599,34814726,1127,0.05197753535126059
12762,1160.545133,1160.6019,1,34816353,34818057,1704,0.230722974742072
12763,1160.607333,1160.627167,1,34818219,34818815,596,0.30095783180923236
12764,1160.6306,1160.635367,1,34818918,34819061,143,0.8215393311962402
12765,1160.708367,1160.7238,1,34821251,34821714,463,0.09757549071955243
12766,1160.732533,1160.800333,1,34821975,34824009,2034,0.16057053932038995
12767,1160.807333,1160.817667,1,34824219,34824530,311,0.6198939171637439
12768,1160.818933,1160.8346,1,34824567,34825038,471,0.570402343109793
12769,1160.874067,1160.889733,1,34826222,34826691,469,0.14748614828261825
12770,1160.8911,1160.968467,1,34826733,34829054,2321,0.13606827090045612
12771,1161.0504,1161.079333,1,34831512,34832379,867,0.146513807908606
12772,1161.089833,1161.125633,1,34832694,34833768,1074,0.1365015741293943
12773,1161.141633,1161.186067,1,34834248,34835582,1334,0.007134563930245393
12774,1161.2278,1161.259033,1,34836834,34837770,936,0.21812449801794492
12775,1161.273833,1161.2915,1,34838214,34838745,531,0.4801918155885144
12776,1161.313333,1161.3207,1,34839399,34839621,222,0.19914007272721523
12777,1162.8085,1162.845,1,34884255,34885350,1095,0.0702628665188549
12778,1162.846,1162.8956,1,34885380,34886868,1488,0.15794511606715847
12779,1162.9087,1162.923167,1,34887261,34887695,434,0.19984453569233204
12780,1162.9244,1162.928,1,34887732,34887840,108,0.9261560176785973
12781,1162.935233,1162.961433,1,34888056,34888842,786,0.18764740409338385
12782,1162.967667,1162.9707,1,34889030,34889121,91,0.5514756198723125
12783,1162.985567,1163.0191,1,34889567,34890573,1006,0.09650363970817429
12784,1163.040167,1163.080533,1,34891205,34892415,1210,0.010294502400233855
12785,1163.093767,1163.146267,1,34892813,34894388,1575,0.11030085434988483
12786,1163.1476,1163.151667,1,34894428,34894550,122,0.7544288624977067
12787,1163.1959,1163.219133,1,34895877,34896573,696,0.26873015558398106
12788,1163.243567,1163.261067,1,34897307,34897832,525,0.23527300030980963
12789,1163.2897,1163.304067,1,34898691,34899122,431,0.5851284601323807
12790,1163.309967,1163.317867,1,34899299,34899536,237,0.6359364984069283
12791,1163.322167,1163.387567,1,34899665,34901627,1962,0.17472737587654338
12792,1163.3949,1163.409133,1,34901847,34902273,426,0.4988838544090298
12793,1163.4452,1163.471767,1,34903356,34904153,797,0.42768188066444374
12794,1163.473967,1163.4918,1,34904219,34904754,535,0.5429724133300222
12795,1163.511533,1163.543167,1,34905345,34906295,950,0.2854318869866051
12796,1163.563533,1163.5731,1,34906905,34907193,288,0.8192045854378505
12797,1163.600867,1163.6042,1,34908026,34908126,100,0.39558619617354146
12798,1163.651667,1163.654967,1,34909550,34909649,99,0.8159982510392192
12799,1163.722767,1163.7261,1,34911683,34911783,100,0.9425321899722144
12800,1163.826467,1163.890467,1,34914794,34916714,1920,0.20033201947818752
12801,1163.894667,1164.1181,1,34916840,34923543,6703,0.10282653681327782
12802,1164.1197,1164.138367,1,34923591,34924151,560,0.5247982371329203
12803,1164.139933,1164.143533,1,34924197,34924305,108,0.5473192698087971
12804,1164.1525,1164.157933,1,34924575,34924737,162,0.4319169886682966
12805,1164.162333,1164.196833,1,34924869,34925904,1035,0.17639871926495695
12806,1164.198267,1164.2015,1,34925948,34926045,97,0.8727835862945705
12807,1164.2071,1164.216733,1,34926213,34926501,288,-0.04605393133717993
12808,1164.260967,1164.275233,1,34927829,34928256,427,0.24910967313796542
12809,1164.276233,1164.285567,1,34928286,34928567,281,0.8207403527786808
12810,1164.304967,1164.344067,1,34929149,34930322,1173,0.18627619737849432
12811,1164.379367,1164.387667,1,34931381,34931630,249,0.5519649928665504
12812,1164.429467,1164.439567,1,34932884,34933187,303,0.3647708787413522
12813,1164.473067,1164.492967,1,34934192,34934789,597,0.18604367764985805
12814,1164.604867,1164.612333,1,34938146,34938369,223,0.2088901647012349
12815,1164.622367,1164.714733,1,34938671,34941441,2770,0.18849628103625718
12816,1164.739367,1164.744833,1,34942181,34942344,163,0.5439079267622711
12817,1164.764667,1164.775767,1,34942940,34943273,333,0.09009208369204738
12818,1164.7848,1164.8177,1,34943544,34944531,987,0.188267276955175
12819,1164.820067,1164.826467,1,34944602,34944794,192,0.7966735470659604
12820,1164.8319,1164.854667,1,34944957,34945640,683,0.11449089999163213
12821,1164.895,1164.940667,1,34946850,34948220,1370,0.14031468487748575
12822,1164.962767,1164.969067,1,34948883,34949072,189,0.29352979219021974
12823,1164.972633,1164.976933,1,34949178,34949307,129,0.639166332241776
12824,1164.9797,1164.996433,1,34949391,34949892,501,0.16026294120340095
12825,1165.000167,1165.009067,1,34950005,34950272,267,0.15028219342657295
12826,1165.044033,1165.085433,1,34951320,34952562,1242,0.0050823080854418105
12827,1165.0976,1165.1173,1,34952928,34953519,591,0.19292153036777943
12828,1165.130867,1165.173433,1,34953926,34955202,1276,0.05734771794685423
12829,1165.1929,1165.218633,1,34955787,34956558,771,0.09674017583079207
12830,1165.255333,1165.274433,1,34957659,34958232,573,0.23274400887203828
12831,1165.275533,1165.287233,1,34958265,34958616,351,0.29443993822976056
12832,1165.288767,1165.293667,1,34958663,34958810,147,0.8383836505843065
12833,1165.2948,1165.344667,1,34958844,34960340,1496,0.23354655829490223
12834,1165.363867,1165.3749,1,34960916,34961247,331,0.343533055238949
12835,1165.41,1165.430467,1,34962300,34962914,614,0.5472364476047943
12836,1165.446767,1165.451533,1,34963403,34963545,142,0.7708881596041497
12837,1165.517833,1165.521133,1,34965534,34965633,99,0.8889840576721955
12838,1165.529433,1165.5339,1,34965882,34966017,135,0.8858502706826725
12839,1165.618667,1165.693567,1,34968560,34970807,2247,0.22677475625709295
12840,1165.702467,1165.710633,1,34971074,34971318,244,0.49795537769271714
12841,1165.7619,1165.808,1,34972857,34974240,1383,0.05881016414018999
12842,1165.814,1165.8179,1,34974420,34974537,117,0.6951900585152343
12843,1165.819,1165.854967,1,34974570,34975649,1079,0.08367175717667652
12844,1165.8665,1165.870867,1,34975995,34976126,131,0.8795214497772652
12845,1165.876367,1165.891267,1,34976291,34976738,447,0.7166689544648568
12846,1165.893433,1165.974333,1,34976802,34979229,2427,0.21967273293404482
12847,1165.9843,1166.014733,1,34979529,34980441,912,0.5460366975784127
12848,1166.017833,1166.0223,1,34980534,34980669,135,0.7927640686174277
12849,1166.023333,1166.054133,1,34980699,34981623,924,0.2462366769305282
12850,1166.069633,1166.077733,1,34982088,34982331,243,0.11491868635880863
12851,1166.132567,1166.138867,1,34983977,34984166,189,0.8688495454253284
12852,1166.531767,1166.536267,1,34995953,34996088,135,0.8211162825119065
12853,1166.537367,1166.6417,1,34996121,34999251,3130,0.19587875352998504
12854,1166.6515,1166.661533,1,34999545,34999845,300,0.3747939330667753
12855,1166.678667,1166.722267,1,35000360,35001668,1308,0.09092320547100533
12856,1166.723733,1166.865367,1,35001711,35005961,4250,0.12877302235814067
12857,1168.2121,1168.222867,1,35046363,35046686,323,0.5278875344365369
12858,1168.237667,1168.254133,1,35047130,35047623,493,0.15807581911441454
12859,1168.7895,1168.892367,1,35063685,35066771,3086,0.06880392932230806
12860,1168.904633,1168.950967,1,35067138,35068529,1391,0.2083741516151668
12861,1168.9543,1168.958967,1,35068629,35068769,140,0.5037694234033392
12862,1168.9697,1169.0465,1,35069091,35071395,2304,-0.05404710073180316
12863,1169.047633,1169.054867,1,35071428,35071646,218,0.6603987196537839
12864,1169.056667,1169.117733,1,35071700,35073531,1831,0.27409839118931767
12865,1169.127533,1169.1508,1,35073825,35074524,699,0.018523663973911367
12866,1169.152433,1169.199633,1,35074572,35075988,1416,0.15845922733960346
12867,1169.207333,1169.210667,1,35076219,35076320,101,0.477775234892631
12868,1169.212767,1169.233933,1,35076383,35077017,634,-0.1232332735413586
12869,1169.2449,1169.282,1,35077347,35078460,1113,0.03244706427609792
12870,1169.283867,1169.339467,1,35078516,35080184,1668,0.09687739191643124
12871,1169.346467,1169.3699,1,35080394,35081097,703,0.01574187659593146
12872,1169.3709,1169.3924,1,35081127,35081772,645,0.7473168644011774
12873,1169.401733,1169.418533,1,35082051,35082555,504,0.1176817187168217
12874,1169.426967,1169.432967,1,35082809,35082989,180,0.7153818215853446
12875,1169.441633,1169.482233,1,35083248,35084466,1218,0.3853735810830729
12876,1169.487733,1169.492867,1,35084631,35084786,155,0.7102691629631986
12877,1169.501067,1169.520633,1,35085032,35085618,586,0.3976745024217515
12878,1169.540833,1169.544667,1,35086224,35086340,116,0.7534563350692822
12879,1169.7313,1169.741333,1,35091939,35092239,300,0.5520230368960795
12880,1169.7427,1169.8135,1,35092281,35094405,2124,0.15722838494132643
12881,1169.8259,1169.8344,1,35094777,35095032,255,0.3633629059397127
12882,1169.857267,1169.941533,1,35095718,35098245,2527,0.15765161884652987
12883,1169.955567,1170.0347,1,35098667,35101041,2374,0.2329247518587811
12884,1170.490667,1170.5131,1,35114720,35115393,673,0.37652195286370077
12885,1170.516033,1170.588767,1,35115480,35117663,2183,0.10571039403456764
12886,1170.594833,1170.609667,1,35117844,35118290,446,0.20022035952701286
12887,1170.622433,1170.669167,1,35118672,35120075,1403,0.20311506991128203
12888,1170.673533,1170.677767,1,35120205,35120333,128,0.685048488400848
12889,1170.696333,1170.854433,1,35120889,35125632,4743,0.18914897303228348
12890,1170.963233,1170.968433,1,35128896,35129052,156,0.07058206264740652
12891,1170.9764,1170.980833,1,35129292,35129424,132,0.7008889618735374
12892,1170.9819,1170.986867,1,35129457,35129606,149,-0.048204943132001604
12893,1171.478533,1171.551333,1,35144355,35146539,2184,0.0866613910426075
12894,1171.5535,1171.5977,1,35146605,35147931,1326,0.29467689031221933
12895,1171.601533,1171.6053,1,35148045,35148159,114,0.8530022646634221
12896,1171.609633,1171.612667,1,35148288,35148380,92,0.9733792764550157
12897,1171.615733,1171.6652,1,35148471,35149956,1485,0.09696226920111743
12898,1171.685733,1171.829233,1,35150571,35154876,4305,0.10730944886873323
12899,1171.843633,1171.8657,1,35155308,35155971,663,0.27260392865004895
12900,1171.880967,1171.9022,1,35156429,35157066,637,0.09201707365062078
12901,1171.919967,1171.932467,1,35157599,35157974,375,0.5337057426879964
12902,1171.9382,1171.9583,1,35158146,35158749,603,0.14539966540179727
12903,1171.9811,1171.9865,1,35159433,35159595,162,0.34275146306513166
12904,1172.0287,1172.044067,1,35160861,35161322,461,0.08146481195223149
12905,1172.051433,1172.067633,1,35161542,35162028,486,0.19676701981292996
12906,1172.099767,1172.1332,1,35162993,35163996,1003,0.5088495282567744
12907,1172.1421,1172.1556,1,35164263,35164668,405,0.29545324324549216
12908,1172.165,1172.171167,1,35164950,35165135,185,0.6067351672181923
12909,1172.186767,1172.190733,1,35165603,35165721,118,0.3544046685062308
12910,1172.1967,1172.243333,1,35165901,35167299,1398,0.3505268256224643
12911,1172.251967,1172.271867,1,35167559,35168156,597,0.45723150979515315
12912,1172.279433,1172.2852,1,35168382,35168556,174,0.723004472073514
12913,1172.308233,1172.326633,1,35169246,35169798,552,0.17833690582749784
12914,1172.330433,1172.361433,1,35169912,35170842,930,0.16721515287847993
12915,1172.363367,1172.411467,1,35170901,35172344,1443,0.18039426926563118
12916,1172.416833,1172.453133,1,35172504,35173593,1089,0.16078038406253375
12917,1172.459767,1172.481567,1,35173793,35174447,654,0.2805967519320069
12918,1172.493633,1172.532167,1,35174808,35175965,1157,0.1948993193691405
12919,1172.563767,1172.579767,1,35176913,35177393,480,0.025959898279732684
12920,1172.5848,1172.6215,1,35177544,35178645,1101,0.345549337824725
12921,1172.635267,1172.681233,1,35179058,35180436,1378,0.373030113182766
12922,1172.718033,1172.777167,1,35181540,35183315,1775,0.2783693635023065
12923,1172.797733,1172.828833,1,35183931,35184864,933,0.3341638108249474
12924,1172.922567,1172.9309,1,35187677,35187927,250,0.8320456556309463
12925,1172.932033,1172.953167,1,35187960,35188595,635,0.8413728702128088
12926,1172.964033,1172.970067,1,35188920,35189102,182,0.7331711332528612
12927,1172.971467,1173.000767,1,35189144,35190023,879,0.45588603833415214
12928,1173.009933,1173.017833,1,35190297,35190534,237,0.5004149470605528
12929,1173.508033,1173.5125,1,35205240,35205375,135,0.6001215629096281
12930,1173.5301,1173.535133,1,35205903,35206053,150,0.17007960489362955
12931,1173.5914,1173.605067,1,35207742,35208152,410,-0.0500465825509517
12932,1182.301333,1182.322333,1,35469039,35469669,630,0.22953486031480017
12933,1182.356933,1182.362533,1,35470707,35470875,168,0.7656844772838797
12934,1182.645067,1182.648233,1,35479352,35479446,94,0.3323497611449681
12935,1183.974867,1184.015467,1,35519246,35520464,1218,0.09926839637238198
12936,1184.094333,1184.182167,1,35522829,35525465,2636,0.15355704055221336
12937,1184.184933,1184.189767,1,35525547,35525693,146,0.8533843077003671
12938,1184.192967,1184.2003,1,35525789,35526009,220,0.5099306608612788
12939,1184.2036,1184.254167,1,35526108,35527625,1517,0.023928166822489546
12940,1184.2553,1184.307667,1,35527659,35529230,1571,0.13019552224556588
12941,1184.309133,1184.312333,1,35529273,35529369,96,0.9539901769546559
12942,1184.3153,1184.391233,1,35529459,35531736,2277,0.12835345198555798
12943,1184.392267,1184.406767,1,35531768,35532203,435,0.4325463268823959
12944,1184.407967,1184.4222,1,35532239,35532666,427,0.7244186897644028
12945,1184.854567,1184.857767,1,35545637,35545733,96,0.3470297005655229
12946,1184.8651,1184.873267,1,35545953,35546198,245,0.012784192811752191
12947,1184.8761,1184.885267,1,35546283,35546558,275,0.25166865505103253
12948,1185.400333,1185.4104,1,35562009,35562312,303,0.22627425129208234
12949,1185.683933,1185.691767,1,35570517,35570753,236,-0.018037894249830624
12950,1185.777767,1185.822467,1,35573333,35574674,1341,0.2636159621611269
12951,1185.8365,1185.8617,1,35575095,35575851,756,0.07152276840006609
12952,1185.8812,1185.905967,1,35576436,35577179,743,0.14420569498952407
12953,1185.9429,1185.990833,1,35578287,35579724,1437,0.14452290528503234
12954,1186.112167,1186.116067,1,35583365,35583482,117,0.6553741910168424
12955,1186.119633,1186.128233,1,35583588,35583846,258,0.7249972218848026
12956,1186.445567,1186.453367,1,35593367,35593601,234,0.1775454794353126
12957,1186.4563,1186.543633,1,35593689,35596308,2619,0.09244151362060968
12958,1186.547433,1186.570367,1,35596422,35597111,689,0.17482077447061595
12959,1186.580233,1186.605467,1,35597406,35598164,758,0.05801515611669328
12960,1186.606767,1186.692567,1,35598203,35600777,2574,0.20689919205233237
12961,1187.387,1187.4864,1,35621610,35624592,2982,0.13800907940073864
12962,1187.4874,1187.4952,1,35624622,35624856,234,0.25946674708085016
12963,1187.498633,1187.524167,1,35624958,35625725,767,0.14843204831090648
12964,1187.534567,1187.591767,1,35626037,35627753,1716,0.10603127767495678
12965,1187.597667,1187.713467,1,35627930,35631404,3474,0.08810994122176052
12966,1191.4815,1191.4885,1,35744445,35744655,210,0.27153895581807996
12967,1191.496933,1191.502833,1,35744907,35745084,177,-0.03450821910454255
12968,1191.503933,1191.507467,1,35745117,35745224,107,0.10802640249760032
12969,1191.511667,1191.523367,1,35745350,35745701,351,0.012188897401434974
12970,1191.581267,1191.616433,1,35747438,35748492,1054,0.09340996897146124
12971,1191.617567,1191.629167,1,35748527,35748875,348,0.2097326492909171
12972,1191.631833,1191.639,1,35748954,35749170,216,0.3772330085245824
12973,1191.640333,1191.6598,1,35749209,35749794,585,0.09409210731389173
12974,1191.693633,1191.716533,1,35750808,35751495,687,0.20660617881377613
12975,1191.726233,1191.760567,1,35751786,35752817,1031,0.34595155031384056
12976,1192.0374,1192.0441,1,35761122,35761323,201,0.2328483119601804
12977,1192.958733,1192.9984,1,35788761,35789952,1191,-0.09201726653621531
12978,1193.100733,1193.1091,1,35793021,35793273,252,0.03078418606849681
12979,1194.053633,1194.165367,1,35821608,35824961,3353,0.12862005733817614
12980,1194.178833,1194.229167,1,35825364,35826875,1511,-0.024158532264564554
12981,1194.231767,1194.305267,1,35826953,35829158,2205,0.15124391881363483
12982,1194.306433,1194.311467,1,35829192,35829344,152,0.4005059453081958
12983,1194.318967,1194.3259,1,35829569,35829777,208,0.5390134214301799
12984,1194.332467,1194.343433,1,35829974,35830302,328,0.797342272532418
12985,1194.354033,1194.357467,1,35830620,35830724,104,0.6332380128647346
12986,1194.398967,1194.411467,1,35831969,35832344,375,0.812509800796853
12987,1194.451667,1194.458267,1,35833550,35833748,198,0.7574994801245579
12988,1194.4707,1194.481367,1,35834121,35834441,320,0.5839539190025187
12989,1194.614733,1194.658667,1,35838441,35839760,1319,0.6610532167527516
12990,1194.6634,1194.693767,1,35839902,35840813,911,0.21050784869714687
12991,1194.700867,1194.708567,1,35841026,35841257,231,0.13382163873430689
12992,1194.710733,1194.721,1,35841321,35841630,309,0.6044950068134015
12993,1194.759867,1194.8099,1,35842796,35844297,1501,0.6104167306113072
12994,1194.8206,1194.840067,1,35844618,35845202,584,0.3433936271746123
12995,1194.845233,1194.855867,1,35845356,35845676,320,0.004669830137465526
12996,1194.919733,1194.946933,1,35847591,35848407,816,0.4058084667776512
12997,1194.948833,1194.9983,1,35848464,35849949,1485,0.22706787653493915
12998,1195.004467,1195.0126,1,35850134,35850378,244,-0.061274062523475156
12999,1195.093367,1195.116,1,35852801,35853480,679,0.43883648246077306
13000,1195.117033,1195.1282,1,35853510,35853846,336,0.8023670980740738
13001,1195.149767,1195.169333,1,35854493,35855079,586,0.25519214827903186
13002,1196.0699,1196.147267,1,35882097,35884418,2321,0.2123995548920408
13003,1196.197933,1196.2432,1,35885937,35887296,1359,0.1327529239081685
13004,1196.517667,1196.523233,1,35895530,35895696,166,0.2877736818855491
13005,1196.5332,1196.6379,1,35895996,35899137,3141,0.1711988927281425
13006,1196.647633,1196.7399,1,35899428,35902197,2769,0.0897582552844218
13007,1196.741367,1196.791833,1,35902241,35903754,1513,0.1298569942030746
13008,1196.8018,1196.925433,1,35904054,35907762,3708,0.04764007814438475
13009,1196.9319,1196.986233,1,35907957,35909586,1629,0.11954731360672069
13010,1198.037267,1198.0404,1,35941118,35941212,94,0.6947925105231353
13011,1198.046,1198.049467,1,35941380,35941484,104,0.7148528830657345
13012,1198.079367,1198.085967,1,35942381,35942579,198,0.15647011823658377
13013,1198.130633,1198.226367,1,35943918,35946791,2873,-0.01648532053923424
13014,1198.227767,1198.2354,1,35946833,35947062,229,0.1213795506241556
13015,1198.236567,1198.2862,1,35947097,35948586,1489,0.12900316248837843
13016,1198.287233,1198.292067,1,35948616,35948762,146,-0.11467034105069265
13017,1198.293267,1198.2965,1,35948798,35948895,97,0.5028789684362713
13018,1198.3164,1198.396,1,35949492,35951880,2388,0.15653737490915354
13019,1198.3977,1198.431933,1,35951931,35952957,1026,0.11110852004216634
13020,1198.433167,1198.446733,1,35952995,35953401,406,0.3360298109450396
13021,1198.465967,1198.492133,1,35953979,35954763,784,0.15384643931321879
13022,1198.497267,1198.514233,1,35954918,35955426,508,0.32133419250556455
13023,1198.538467,1198.547667,1,35956154,35956430,276,0.3341134692199341
13024,1198.5675,1198.590567,1,35957025,35957717,692,0.02434644398155109
13025,1198.628933,1198.679,1,35958867,35960370,1503,0.23986960451789896
13026,1198.680133,1198.688933,1,35960403,35960667,264,0.7194124302572394
13027,1198.719333,1198.7438,1,35961579,35962314,735,0.058949238034443754
13028,1198.758467,1198.764033,1,35962754,35962920,166,0.693391873562947
13029,1198.765633,1198.7979,1,35962968,35963937,969,0.2950196198407431
13030,1198.799867,1198.822533,1,35963996,35964675,679,0.09825763111073506
13031,1198.864567,1198.897867,1,35965937,35966936,999,0.1611050345210531
13032,1198.9133,1198.922233,1,35967399,35967666,267,0.653059286386693
13033,1198.965067,1198.968833,1,35968952,35969064,112,-0.16545242508452554
13034,1199.056467,1199.0807,1,35971694,35972421,727,-0.07123540775220408
13035,1199.088567,1199.1094,1,35972657,35973282,625,0.07557235658129655
13036,1199.569667,1199.5804,1,35987090,35987412,322,0.08201548938705462
13037,1199.652933,1199.6856,1,35989587,35990568,981,0.011367668266921581
13038,1199.686767,1199.6963,1,35990603,35990889,286,0.1589589136350018
13039,1199.699667,1199.715967,1,35990990,35991479,489,0.1929554260455122
13040,1199.747267,1199.7751,1,35992418,35993253,835,-0.028339151110420322
13041,1199.777733,1199.780733,1,35993331,35993421,90,0.815130473711461
13042,1199.798033,1199.8129,1,35993940,35994387,447,0.13160088259346248
13043,1199.8144,1199.8372,1,35994432,35995116,684,0.0340185395172398
13044,1199.8555,1199.891567,1,35995665,35996747,1082,0.1341355690985902
13045,1199.8927,1199.909733,1,35996781,35997291,510,0.3549967539642017
13046,1199.911133,1199.9437,1,35997333,35998311,978,0.17036124299036973
13047,1199.953,1199.987167,1,35998590,35999615,1025,0.2710192894632266
13048,1199.988867,1199.992133,1,35999666,35999763,97,0.266391529940055
13049,1199.9932,1200.025967,1,35999796,36000779,983,0.21304782147463322
13050,1200.050867,1200.0557,1,36001526,36001671,145,0.8659702534832242
13051,1200.074667,1200.0858,1,36002240,36002574,334,0.6537827997362919
13052,1201.545833,1201.557067,1,36046374,36046712,338,0.35430541661262865
13053,1201.5584,1201.670533,1,36046752,36050115,3363,0.18329428012341148
13054,1201.671967,1201.7102,1,36050159,36051306,1147,0.20178172258521346
13055,1201.713633,1201.734133,1,36051408,36052023,615,0.37425121035365605
13056,1201.735467,1201.787367,1,36052064,36053621,1557,0.29959072771466116
13057,1201.788533,1201.8012,1,36053655,36054036,381,0.5321923710144603
13058,1201.803,1201.900033,1,36054090,36057000,2910,0.11810735513067001
13059,1203.371133,1203.377367,1,36101133,36101321,188,0.41311029907976043
13060,1203.389267,1203.553267,1,36101678,36106598,4920,0.1860706517773697
13061,1203.564433,1203.6652,1,36106932,36109956,3024,0.20726361663718007
13062,1204.532733,1204.567833,1,36135981,36137034,1053,0.10325868992684711
13063,1204.569533,1204.6572,1,36137085,36139716,2631,0.18695804522040574
13064,1204.662867,1204.708467,1,36139886,36141254,1368,0.0846499645996105
13065,1204.713367,1204.847567,1,36141401,36145427,4026,0.03767316183800811
13066,1204.850133,1204.854133,1,36145503,36145623,120,0.5625145980269896
13067,1204.8647,1204.891867,1,36145941,36146756,815,0.15891365701650406
13068,1204.893833,1204.8972,1,36146814,36146916,102,0.9029805508501373
13069,1204.899067,1204.902467,1,36146972,36147074,102,0.6981808086148911
13070,1204.912833,1204.9308,1,36147384,36147924,540,0.07017582616800747
13071,1204.932033,1204.935033,1,36147960,36148050,90,0.7723620445830524
13072,1204.940633,1204.956867,1,36148218,36148706,488,0.2411512627871723
13073,1204.963367,1204.985633,1,36148901,36149568,667,0.08148953652812513
13074,1205.0,1205.033533,1,36150000,36151005,1005,0.18890643642927932
13075,1205.035033,1205.126367,1,36151050,36153791,2741,0.07731195423921636
13076,1205.5526,1205.5596,1,36166578,36166788,210,0.7150212669667828
13077,1205.603367,1205.624533,1,36168101,36168735,634,0.02921106360355713
13078,1205.625867,1205.6986,1,36168776,36170958,2182,0.21399932911869102
13079,1205.723167,1205.763267,1,36171695,36172898,1203,0.14057449632807736
13080,1205.764267,1205.774533,1,36172928,36173235,307,-0.01964162434218493
13081,1205.775533,1205.8926,1,36173265,36176778,3513,0.06590880271041046
13082,1205.910833,1205.9417,1,36177324,36178251,927,0.24148135077184615
13083,1205.947833,1205.969667,1,36178434,36179090,656,0.054177340904961624
13084,1206.013367,1206.038767,1,36180401,36181163,762,0.13082627659781657
13085,1206.043333,1206.077033,1,36181299,36182310,1011,0.45052951132550273
13086,1206.112433,1206.170067,1,36183372,36185102,1730,0.18535768772587843
13087,1206.2153,1206.246167,1,36186459,36187385,926,0.26449281767117777
13088,1206.2534,1206.259933,1,36187602,36187797,195,0.9121645300873703
13089,1206.261367,1206.2848,1,36187841,36188544,703,0.46515142487241384
13090,1206.297367,1206.306167,1,36188921,36189185,264,0.2731825501271683
13091,1206.372033,1206.381567,1,36191160,36191447,287,0.26639796140938393
13092,1206.382733,1206.4679,1,36191481,36194037,2556,0.1279111471206479
13093,1206.494633,1206.547333,1,36194838,36196419,1581,0.23421641919874409
13094,1206.5505,1206.565867,1,36196515,36196976,461,0.32036628462999395
13095,1206.584333,1206.613067,1,36197529,36198392,863,0.41737814406528073
13096,1206.614367,1206.622167,1,36198431,36198665,234,0.7966328579538372
13097,1206.633133,1206.660533,1,36198993,36199815,822,0.3198953997248979
13098,1207.2597,1207.333533,1,36217791,36220005,2214,0.29808140346995393
13099,1207.335533,1207.352333,1,36220065,36220569,504,0.2785259404457197
13100,1207.358033,1207.368933,1,36220740,36221067,327,0.2938109563895294
13101,1207.373033,1207.3779,1,36221190,36221337,147,0.772437689331201
13102,1207.381767,1207.395433,1,36221453,36221862,409,0.38362498235545256
13103,1207.403633,1207.479467,1,36222108,36224384,2276,0.1903509272444069
13104,1207.518533,1207.554033,1,36225555,36226620,1065,-0.01586247749742952
13105,1207.567833,1207.593,1,36227034,36227790,756,0.07643703432548568
13106,1207.595,1207.640867,1,36227850,36229226,1376,0.04388020367156935
13107,1207.681233,1207.6917,1,36230436,36230751,315,0.17291294816181266
13108,1207.6927,1207.696567,1,36230781,36230897,116,0.8155411437630815
13109,1207.7139,1207.724333,1,36231417,36231729,312,0.7951123206520488
13110,1207.729533,1207.733067,1,36231885,36231992,107,0.9297980800164253
13111,1207.745633,1207.762067,1,36232368,36232862,494,0.4089091455504059
13112,1207.803967,1207.8075,1,36234119,36234225,106,0.757230507788792
13113,1207.810067,1207.8324,1,36234302,36234972,670,0.5845513798649657
13114,1207.833667,1207.852167,1,36235010,36235565,555,0.7202427218867833
13115,1207.859267,1207.882433,1,36235778,36236472,694,0.4428097746696027
13116,1207.904133,1207.908667,1,36237123,36237260,137,0.581727083316788
13117,1207.989567,1208.002367,1,36239687,36240071,384,0.7321362287258204
13118,1208.0048,1208.0131,1,36240144,36240393,249,0.3533774839154856
13119,1208.015067,1208.020567,1,36240452,36240617,165,0.8385921258676182
13120,1208.028833,1208.031967,1,36240864,36240959,95,0.4290535669219376
13121,1209.673333,1209.6819,1,36290199,36290457,258,0.7357723358264913
13122,1210.234733,1210.242467,1,36307041,36307274,233,0.052492987297845364
13123,1210.2442,1210.2482,1,36307326,36307446,120,0.5082714567503076
13124,1210.3036,1210.356333,1,36309108,36310689,1581,0.1419240609183071
13125,1210.385133,1210.408167,1,36311553,36312245,692,-0.013310380611619274
13126,1210.424433,1210.445133,1,36312732,36313353,621,0.07696144832139037
13127,1210.455333,1210.4912,1,36313659,36314736,1077,0.13545500308430158
13128,1210.496,1210.4997,1,36314880,36314991,111,0.7927167146742105
13129,1210.559233,1210.579167,1,36316776,36317375,599,0.039682283072826424
13130,1210.580967,1210.606533,1,36317429,36318195,766,0.21170460163123994
13131,1210.634733,1210.647667,1,36319041,36319430,389,0.28189142546738594
13132,1210.648833,1210.651967,1,36319464,36319559,95,0.8198716506973434
13133,1210.6643,1210.6713,1,36319929,36320139,210,0.507740074339157
13134,1210.6944,1210.709867,1,36320832,36321296,464,0.2922454496248838
13135,1210.824067,1210.917233,1,36324722,36327516,2794,0.16031466483080828
13136,1210.934233,1210.941967,1,36328026,36328259,233,0.780829139119944
13137,1210.969633,1211.060633,1,36329088,36331818,2730,0.15789306879738552
13138,1211.070967,1211.088167,1,36332129,36332645,516,0.054536185698434735
13139,1211.126767,1211.160967,1,36333803,36334829,1026,0.05344705210749097
13140,1211.2024,1211.217167,1,36336072,36336515,443,0.14590755724852694
13141,1211.896033,1211.9001,1,36356880,36357003,123,0.6766073816298697
13142,1211.9028,1211.9092,1,36357084,36357276,192,0.8274186036867061
13143,1211.947467,1212.045933,1,36358424,36361377,2953,0.06221646829785006
13144,1212.047167,1212.052067,1,36361415,36361562,147,0.14653124313819765
13145,1212.0678,1212.138067,1,36362034,36364142,2108,0.14459678911511395
13146,1212.139533,1212.142833,1,36364185,36364284,99,0.8733856448598715
13147,1212.150833,1212.2485,1,36364524,36367455,2931,0.09510721084293412
13148,1212.679233,1212.781533,1,36380376,36383445,3069,0.16090312285950803
13149,1212.783033,1212.800433,1,36383490,36384012,522,0.44095634286741725
13150,1212.8042,1212.831867,1,36384126,36384956,830,0.050397020199906946
13151,1212.853567,1212.9198,1,36385607,36387594,1987,0.0825413295287058
13152,1212.926433,1212.971733,1,36387792,36389151,1359,0.13679164924518217
13153,1212.973867,1213.000467,1,36389216,36390014,798,0.20109095681030986
13154,1213.019633,1213.138933,1,36390588,36394167,3579,0.08570453184252289
13155,1213.1408,1213.143967,1,36394224,36394319,95,0.8747513771997042
13156,1213.1475,1213.152333,1,36394425,36394569,144,0.9004681550566386
13157,1213.1596,1213.189667,1,36394788,36395690,902,0.12465725174658275
13158,1213.196633,1213.204,1,36395898,36396120,222,0.8040509986357949
13159,1213.212733,1213.239833,1,36396381,36397194,813,0.29272554610968493
13160,1213.245367,1213.277267,1,36397361,36398318,957,0.15361632626318383
13161,1213.2902,1213.364833,1,36398706,36400944,2238,0.12370765156465556
13162,1213.4103,1213.457967,1,36402309,36403739,1430,0.20548302557893153
13163,1213.459067,1213.4627,1,36403772,36403881,109,0.8825850019925316
13164,1213.491,1213.503233,1,36404730,36405096,366,0.34822504387522535
13165,1213.504833,1213.509133,1,36405144,36405273,129,0.7370723064078152
13166,1213.531033,1213.6011,1,36405930,36408033,2103,0.08063854089027377
13167,1213.613767,1213.6256,1,36408413,36408768,355,0.3648497976786879
13168,1213.626867,1213.6485,1,36408806,36409455,649,0.10090421133322382
13169,1213.659367,1213.696533,1,36409781,36410895,1114,0.23443147114534543
13170,1213.727033,1213.746433,1,36411810,36412392,582,0.048776179908970874
13171,1213.751933,1213.756333,1,36412557,36412689,132,0.8301447360724158
13172,1213.819567,1213.823667,1,36414587,36414710,123,0.7855946744575543
13173,1213.824867,1213.829733,1,36414746,36414891,145,0.3384691433932187
13174,1213.8308,1213.842967,1,36414924,36415289,365,0.25195981716312243
13175,1213.844067,1213.856367,1,36415322,36415691,369,0.32431651764637315
13176,1213.888233,1213.914533,1,36416646,36417435,789,0.1237125823860915
13177,1213.917933,1213.921367,1,36417537,36417641,104,0.6273584666396271
13178,1213.961767,1213.9682,1,36418853,36419046,193,0.749441406767918
13179,1213.969633,1213.9821,1,36419088,36419463,375,0.784392608902621
13180,1215.080033,1215.0831,1,36452400,36452493,93,-0.04075025730517745
13181,1215.090967,1215.168533,1,36452729,36455055,2326,0.15879499452169368
13182,1215.170267,1215.1928,1,36455108,36455784,676,0.08276147143959237
13183,1215.204467,1215.247033,1,36456134,36457410,1276,-0.07581211971572678
13184,1215.2629,1215.313533,1,36457887,36459405,1518,0.062387049347175184
13185,1215.3188,1215.347267,1,36459564,36460418,854,0.268600520505521
13186,1215.356233,1215.359367,1,36460686,36460781,95,0.8621618511170921
13187,1215.3643,1215.464,1,36460929,36463920,2991,0.04896706951827171
13188,1215.472667,1215.483,1,36464180,36464490,310,0.6552561298325801
13189,1215.513567,1215.521833,1,36465407,36465654,247,0.6351546847531616
13190,1215.528267,1215.531367,1,36465848,36465941,93,0.9383035821945841
13191,1215.538567,1215.544033,1,36466157,36466320,163,0.7754301270937073
13192,1215.5464,1215.575667,1,36466392,36467270,878,0.1347332486353431
13193,1215.5771,1215.5812,1,36467313,36467436,123,0.8416850436970971
13194,1215.5858,1215.599567,1,36467574,36467987,413,0.5635742512835089
13195,1215.6194,1215.664467,1,36468582,36469934,1352,0.3343730747369505
13196,1215.666533,1215.689733,1,36469995,36470691,696,0.2611549467437521
13197,1215.6924,1215.705767,1,36470772,36471173,401,0.33519766775521054
13198,1215.7145,1215.718667,1,36471435,36471560,125,0.5131426711072571
13199,1215.722567,1215.738333,1,36471677,36472149,472,0.5940259366710253
13200,1215.770433,1215.774,1,36473112,36473220,108,0.6584721185451359
13201,1215.7814,1215.825833,1,36473442,36474774,1332,0.3884231178475795
13202,1215.843967,1215.881567,1,36475319,36476447,1128,0.7004654033505339
13203,1215.897267,1215.9096,1,36476918,36477288,370,0.5812850650060989
13204,1215.962367,1215.966467,1,36478871,36478994,123,0.9274328371534802
13205,1215.967533,1215.973367,1,36479025,36479201,176,0.30439870636743943
13206,1215.9971,1216.003033,1,36479913,36480090,177,0.6643094989479167
13207,1216.0073,1216.0146,1,36480219,36480438,219,0.4978138471278454
13208,1216.019767,1216.025333,1,36480593,36480759,166,0.6555401409249
13209,1216.0342,1216.041933,1,36481026,36481257,231,0.7092727494370267
13210,1216.044633,1216.072367,1,36481338,36482171,833,-0.02963432620712111
13211,1216.0798,1216.090267,1,36482394,36482708,314,0.06684172895422712
13212,1216.159333,1216.2128,1,36484779,36486384,1605,0.13310453733598307
13213,1216.214467,1216.232433,1,36486434,36486972,538,0.6785682354537562
13214,1216.290733,1216.322,1,36488721,36489660,939,0.23982420913175012
13215,1216.3233,1216.375233,1,36489699,36491256,1557,0.2851962096229171
13216,1216.380767,1216.391367,1,36491423,36491741,318,0.48543538945868236
13217,1216.439533,1216.443467,1,36493185,36493304,119,0.7565802228442544
13218,1216.453433,1216.461533,1,36493602,36493845,243,0.6966629015654116
13219,1216.4638,1216.469767,1,36493914,36494093,179,0.8983495734066601
13220,1216.5026,1216.524367,1,36495078,36495731,653,0.4705182045482484
13221,1216.9789,1216.9821,1,36509367,36509463,96,0.8223058260217203
13222,1216.9877,1216.991067,1,36509631,36509732,101,0.5475748721383213
13223,1217.000433,1217.0956,1,36510012,36512868,2856,0.27483651759242983
13224,1217.0993,1217.152433,1,36512979,36514572,1593,0.15706755296353697
13225,1217.1584,1217.1831,1,36514752,36515493,741,0.17722323274135018
13226,1217.184533,1217.290833,1,36515535,36518724,3189,0.10944445645961685
13227,1217.292067,1217.298333,1,36518762,36518949,187,0.8416747218877776
13228,1217.303167,1217.342067,1,36519095,36520262,1167,0.06913125996014988
13229,1217.355733,1217.359833,1,36520671,36520794,123,0.9186226728151432
13230,1217.3801,1217.411733,1,36521403,36522351,948,-0.040127988301503846
13231,1217.4204,1217.459967,1,36522612,36523799,1187,0.14594895864645674
13232,1217.491267,1217.5057,1,36524738,36525171,433,0.3043741043693826
13233,1217.5093,1217.5129,1,36525279,36525387,108,0.9671787116532014
13234,1217.535,1217.5571,1,36526050,36526713,663,0.24647393833283215
13235,1217.568267,1217.571467,1,36527048,36527144,96,0.41257903792794454
13236,1217.6876,1217.691433,1,36530628,36530742,114,0.8767278861274637
13237,1217.697033,1217.700667,1,36530910,36531020,110,0.6359863905985667
13238,1217.7412,1217.7485,1,36532236,36532455,219,0.757248432115958
13239,1217.7586,1217.7627,1,36532758,36532881,123,0.5558208919982317
13240,1218.122367,1218.130167,1,36543671,36543905,234,0.1700578047587138
13241,1218.162833,1218.178033,1,36544884,36545340,456,0.07990526164526715
13242,1218.179067,1218.267033,1,36545372,36548010,2638,0.15486184293914548
13243,1218.2691,1218.2753,1,36548073,36548259,186,0.49951943872310434
13244,1218.282567,1218.291567,1,36548477,36548747,270,0.33973678258978973
13245,1218.301233,1218.3399,1,36549036,36550197,1161,0.11081462653840535
13246,1218.347833,1218.374367,1,36550434,36551231,797,0.07139006991738946
13247,1218.390167,1218.539767,1,36551705,36556193,4488,0.24398207937768887
13248,1218.555633,1218.590333,1,36556668,36557709,1041,0.20815707422408017
13249,1218.625267,1218.661067,1,36558758,36559832,1074,0.2346670531653947
13250,1218.666433,1218.6742,1,36559992,36560226,234,0.6060306846830765
13251,1218.6759,1218.708033,1,36560277,36561240,963,0.21694523980352046
13252,1218.748833,1218.801133,1,36562464,36564033,1569,0.15001914652612502
13253,1218.804067,1218.8074,1,36564122,36564222,100,0.4356531955139909
13254,1218.8226,1218.8284,1,36564678,36564852,174,0.9182426405537296
13255,1218.830233,1218.837667,1,36564906,36565130,224,0.9004703348041103
13256,1219.3224,1219.3314,1,36579672,36579942,270,0.6513659867741654
13257,1219.3427,1219.446233,1,36580281,36583386,3105,0.21613315860384777
13258,1219.447267,1219.480667,1,36583418,36584420,1002,0.29061032256680225
13259,1219.4824,1219.565867,1,36584472,36586976,2504,0.1454685450905933
13260,1219.568867,1219.5719,1,36587066,36587157,91,0.9413829654289793
13261,1219.573567,1219.596633,1,36587207,36587898,691,0.25699361390049463
13262,1219.601233,1219.705533,1,36588036,36591165,3129,0.15101106260285085
13263,1219.7199,1219.732867,1,36591597,36591986,389,0.06998340686405098
13264,1219.741733,1219.747133,1,36592251,36592413,162,0.4598041603730235
13265,1219.7684,1219.799233,1,36593052,36593976,924,0.2502966461926452
13266,1219.828167,1219.8467,1,36594845,36595401,556,0.2525106443858999
13267,1219.8636,1219.887467,1,36595908,36596624,716,0.17645501897562302
13268,1219.8889,1219.896267,1,36596667,36596888,221,0.7242989456688497
13269,1219.927333,1219.9815,1,36597819,36599445,1626,0.1235835674255818
13270,1219.994933,1219.9961,1,36599847,36599883,36,0.950227814521475
13271,1220.037367,1220.080467,1,36601121,36602414,1293,0.26116327757669505
13272,1220.083633,1220.089067,1,36602508,36602672,164,0.7785473103405629
13273,1220.103433,1220.112433,1,36603102,36603372,270,0.8320029279248856
13274,1220.117,1220.1484,1,36603510,36604452,942,0.08123530997036067
13275,1220.163633,1220.1869,1,36604908,36605607,699,0.15700872994077134
13276,1220.209033,1220.251467,1,36606270,36607544,1274,0.17833518296792053
13277,1220.268633,1220.2721,1,36608058,36608163,105,0.9708066360517841
13278,1220.345333,1220.352267,1,36610359,36610568,209,0.5524785710771358
13279,1220.365467,1220.370267,1,36610964,36611108,144,0.44419692410371686
13280,1220.3836,1220.391033,1,36611508,36611730,222,0.2976648791654516
13281,1220.4018,1220.4147,1,36612054,36612441,387,0.06206822256754192
13282,1220.443233,1220.451033,1,36613296,36613530,234,-0.06717941534162374
13283,1223.125967,1223.1443,1,36693779,36694329,550,0.3082404390050553
13284,1223.145467,1223.155767,1,36694364,36694673,309,0.19696680727391608
13285,1223.996133,1224.015867,1,36719883,36720476,593,0.09682952131417517
13286,1224.1169,1224.195,1,36723507,36725850,2343,0.20072945787299076
13287,1224.1973,1224.218933,1,36725919,36726567,648,0.4210180949068697
13288,1224.2255,1224.233633,1,36726765,36727008,243,0.7803041073722887
13289,1224.238,1224.3077,1,36727140,36729231,2091,0.25966123731774016
13290,1224.314267,1224.3215,1,36729428,36729645,217,0.832205668278464
13291,1224.7576,1224.8324,1,36742728,36744972,2244,0.08675900168981895
13292,1224.8406,1224.891933,1,36745218,36746757,1539,0.20086717617489558
13293,1224.894867,1224.917033,1,36746846,36747510,664,0.025386701506970477
13294,1224.9193,1224.922933,1,36747579,36747687,108,0.806802317878785
13295,1224.9298,1224.958133,1,36747894,36748743,849,-0.044527884709910495
13296,1224.9608,1225.0016,1,36748824,36750048,1224,0.0959148512474023
13297,1225.012133,1225.051,1,36750363,36751530,1167,0.3617096494267631
13298,1225.065133,1225.087267,1,36751953,36752618,665,0.17982293798767865
13299,1225.088433,1225.0923,1,36752652,36752769,117,0.8252506269445989
13300,1225.0958,1225.1018,1,36752874,36753054,180,0.5439421249712842
13301,1225.1608,1225.219,1,36754824,36756570,1746,0.05961477542196071
13302,1225.242533,1225.2753,1,36757275,36758259,984,0.35462824696056466
13303,1225.282533,1225.286533,1,36758475,36758595,120,0.9229412468202626
13304,1225.294767,1225.321733,1,36758843,36759651,808,0.6452738284059518
13305,1225.343633,1225.347467,1,36760308,36760424,116,0.6176538639117054
13306,1225.352167,1225.3608,1,36760565,36760824,259,0.6082358529394596
13307,1225.362267,1225.3656,1,36760868,36760968,100,0.8603187518828199
13308,1225.367633,1225.3712,1,36761028,36761136,108,0.9150182720821785
13309,1225.3891,1225.395967,1,36761673,36761879,206,0.8126885728099784
13310,1225.3972,1225.414233,1,36761916,36762426,510,0.33461634287791275
13311,1225.416667,1225.423467,1,36762500,36762704,204,0.6589903484524129
13312,1226.1641,1226.170767,1,36784923,36785123,200,0.7894027013882152
13313,1226.190333,1226.2786,1,36785709,36788358,2649,0.16226374063502225
13314,1226.279867,1226.2834,1,36788396,36788502,106,0.8487667479101269
13315,1226.285,1226.300833,1,36788550,36789024,474,0.1121166162876408
13316,1226.3044,1226.3328,1,36789132,36789984,852,0.07831261727034622
13317,1226.359633,1226.479567,1,36790788,36794387,3599,0.11742565601694926
13318,1226.483067,1226.4926,1,36794492,36794778,286,0.41986048263978787
13319,1226.4986,1226.522133,1,36794958,36795663,705,0.05328832764421697
13320,1226.5357,1226.557567,1,36796071,36796727,656,0.1288520880196868
13321,1226.5737,1226.6175,1,36797211,36798525,1314,0.2231266451301629
13322,1226.621967,1226.6503,1,36798659,36799509,850,0.45564564634481103
13323,1226.6712,1226.689633,1,36800136,36800688,552,0.25772967017794135
13324,1226.706333,1226.722667,1,36801189,36801680,491,0.07911524044390512
13325,1226.723733,1226.728633,1,36801711,36801858,147,0.46610909486568214
13326,1226.7386,1226.7469,1,36802158,36802407,249,0.2135516568872102
13327,1227.067833,1227.168933,1,36812034,36815067,3033,0.14642332992925564
13328,1227.172067,1227.195467,1,36815162,36815864,702,0.339231739289547
13329,1227.2033,1227.277333,1,36816099,36818319,2220,0.19725441289681042
13330,1227.3004,1227.314133,1,36819012,36819423,411,0.2554867001179004
13331,1227.3152,1227.379333,1,36819456,36821379,1923,0.3078822526317383
13332,1227.381933,1227.398,1,36821457,36821940,483,0.34159159361191993
13333,1227.399267,1227.404433,1,36821978,36822132,154,0.6476338081139507
13334,1227.887733,1227.972233,1,36836631,36839166,2535,0.06045057597508395
13335,1227.973267,1227.987067,1,36839198,36839612,414,0.3933364000886134
13336,1227.989067,1227.992867,1,36839672,36839786,114,0.73642139364339
13337,1227.994567,1228.017367,1,36839837,36840521,684,0.33966789413608384
13338,1228.0254,1228.047433,1,36840762,36841422,660,0.18889883120957432
13339,1228.0526,1228.0717,1,36841578,36842151,573,0.12917711253330746
13340,1228.076,1228.2171,1,36842280,36846513,4233,0.05515364581233381
13341,1228.2355,1228.239067,1,36847065,36847172,107,0.5353032406708254
13342,1228.2404,1228.258167,1,36847212,36847745,533,0.16136380993417632
13343,1228.2814,1228.3038,1,36848442,36849114,672,0.2044749889869803
13344,1228.308133,1228.3208,1,36849243,36849624,381,0.331109403520611
13345,1228.334133,1228.352433,1,36850023,36850572,549,0.3020046325806214
13346,1228.3554,1228.358833,1,36850662,36850764,102,0.7463760740353745
13347,1228.369533,1228.4362,1,36851085,36853086,2001,0.13663051172973373
13348,1228.437533,1228.4485,1,36853125,36853455,330,0.15997166969307847
13349,1228.4597,1228.473967,1,36853791,36854219,428,0.23977183957180648
13350,1228.517567,1228.5267,1,36855527,36855801,274,-0.011471576470184137
13351,1228.528,1228.531433,1,36855840,36855942,102,0.9222350875328952
13352,1228.586967,1228.591667,1,36857609,36857750,141,0.7953199524867364
13353,1228.693967,1228.703133,1,36860819,36861093,274,0.09622842628885853
13354,1228.707767,1228.798367,1,36861233,36863951,2718,0.06921686994794983
13355,1228.808433,1228.812167,1,36864252,36864365,113,0.7446194626680069
13356,1228.821233,1228.832067,1,36864636,36864962,326,0.02352522906190867
13357,1228.843533,1228.8777,1,36865305,36866331,1026,-0.04110390152866215
13358,1228.8801,1228.914467,1,36866403,36867434,1031,0.05356670931499506
13359,1228.915767,1228.938733,1,36867473,36868161,688,0.3151935951112169
13360,1228.941,1228.945233,1,36868230,36868356,126,0.9305264212268166
13361,1228.9513,1229.004467,1,36868539,36870134,1595,0.1281060222346281
13362,1229.008133,1229.025433,1,36870243,36870762,519,0.563483150955538
13363,1229.419033,1229.522267,1,36882570,36885668,3098,0.10748903335474956
13364,1229.5419,1229.703133,1,36886257,36891093,4836,0.12877058546945583
13365,1229.708533,1229.716233,1,36891255,36891486,231,0.3932525530339522
13366,1229.7317,1229.757133,1,36891951,36892713,762,0.052915907237030574
13367,1229.771933,1229.7922,1,36893157,36893766,609,0.236719049575337
13368,1229.804867,1229.812933,1,36894146,36894387,241,0.10869046746777151
13369,1229.838933,1229.8517,1,36895167,36895551,384,0.038313197355010174
13370,1229.882133,1229.899333,1,36896463,36896979,516,0.6107376648861496
13371,1229.902733,1229.913533,1,36897081,36897405,324,0.622336750530958
13372,1229.941133,1229.996267,1,36898233,36899888,1655,0.09729846048174072
13373,1230.0331,1230.0482,1,36900993,36901446,453,0.4108225045260665
13374,1230.051533,1230.058967,1,36901545,36901769,224,0.9339060952163506
13375,1230.080367,1230.094533,1,36902411,36902835,424,0.3241886873044069
13376,1230.922933,1230.9907,1,36927687,36929721,2034,0.13004110097154561
13377,1231.011967,1231.0174,1,36930359,36930522,163,0.6668141707139444
13378,1231.0245,1231.0454,1,36930735,36931362,627,0.007109812096120868
13379,1231.070733,1231.091367,1,36932121,36932741,620,0.1042131061765459
13380,1231.1034,1231.1298,1,36933102,36933894,792,0.20206493450269267
13381,1231.1317,1231.142067,1,36933951,36934262,311,0.5753159857176925
13382,1231.1497,1231.178733,1,36934491,36935361,870,0.08025599401725504
13383,1231.195033,1231.230833,1,36935850,36936924,1074,-0.03085573321339054
13384,1231.2358,1231.251933,1,36937074,36937557,483,0.676398313999056
13385,1231.2829,1231.310067,1,36938487,36939302,815,0.5211446441841903
13386,1231.3111,1231.318333,1,36939333,36939549,216,0.38305434536407185
13387,1231.3711,1231.380933,1,36941133,36941427,294,0.5176515619755271
13388,1231.3958,1231.404633,1,36941874,36942138,264,0.05720874164601975
13389,1231.413833,1231.486133,1,36942414,36944583,2169,0.02629675139903167
13390,1231.4938,1231.498467,1,36944814,36944954,140,0.59156007863026
13391,1231.5184,1231.557467,1,36945552,36946724,1172,0.3440653348505876
13392,1231.559333,1231.568033,1,36946779,36947040,261,0.7411003503652059
13393,1231.5867,1231.6242,1,36947601,36948726,1125,0.24841712853296613
13394,1231.625867,1231.638733,1,36948776,36949161,385,0.5032851573009277
13395,1231.643033,1231.652433,1,36949290,36949572,282,0.6838959511866015
13396,1231.6536,1231.663467,1,36949608,36949904,296,0.63489521889974
13397,1231.667867,1231.695633,1,36950036,36950868,832,0.6497927805846292
13398,1231.702867,1231.725,1,36951086,36951750,664,0.11348792102075983
13399,1231.728967,1231.732867,1,36951869,36951986,117,0.7122039234870675
13400,1231.735933,1231.7455,1,36952077,36952365,288,0.790076393480109
13401,1231.747233,1231.751633,1,36952416,36952548,132,0.9321823560325234
13402,1231.759,1231.7655,1,36952770,36952965,195,0.7000231903999585
13403,1231.766533,1231.8065,1,36952995,36954195,1200,0.6898902749030477
13404,1231.8098,1231.828067,1,36954294,36954842,548,0.22559661570776166
13405,1231.8293,1231.8473,1,36954879,36955419,540,0.46150803944458485
13406,1231.870833,1231.929467,1,36956124,36957884,1760,0.5364902724371865
13407,1231.941767,1231.952333,1,36958253,36958569,316,0.4345637933101093
13408,1231.9544,1231.959067,1,36958632,36958772,140,0.7531915813641366
13409,1231.960867,1231.9788,1,36958826,36959364,538,0.7910773983928728
13410,1232.041467,1232.0482,1,36961244,36961446,202,0.4766289217658478
13411,1232.0508,1232.0548,1,36961524,36961644,120,0.8833327277099359
13412,1232.069067,1232.072567,1,36962072,36962177,105,0.7876360888790881
13413,1232.074133,1232.092433,1,36962223,36962772,549,0.7210223288704409
13414,1232.1294,1232.138767,1,36963882,36964163,281,0.767621375822663
13415,1232.477767,1232.483,1,36974333,36974490,157,0.8691212548453894
13416,1232.484,1232.487467,1,36974520,36974624,104,0.8287153167951035
13417,1232.492033,1232.522033,1,36974760,36975660,900,0.3413763989160141
13418,1232.528133,1232.5338,1,36975843,36976014,171,0.3490632363734408
13419,1232.5354,1232.595867,1,36976062,36977876,1814,0.16948068245291717
13420,1232.597367,1232.625633,1,36977921,36978768,847,0.11931710739435855
13421,1232.682933,1232.6903,1,36980487,36980709,222,0.6691149896540591
13422,1232.693333,1232.704,1,36980799,36981120,321,0.5721322058381005
13423,1232.720933,1232.7315,1,36981627,36981945,318,0.667977755992907
13424,1233.490233,1233.745367,1,37004706,37012361,7655,0.10733080650005124
13425,1233.7589,1233.812633,1,37012767,37014378,1611,0.0935206838411132
13426,1233.876933,1233.906833,1,37016307,37017204,897,0.018392198490062378
13427,1240.600967,1240.634967,1,37218029,37219049,1020,0.07511105038747008
13428,1240.682333,1240.703833,1,37220469,37221114,645,-0.01158318914448376
13429,1240.705367,1240.710767,1,37221161,37221323,162,0.38678196734849835
13430,1244.0521,1244.0581,1,37321563,37321743,180,0.3662493663418351
13431,1246.389633,1246.395733,1,37391688,37391871,183,0.25349222110767
13432,1246.397033,1246.406867,1,37391910,37392206,296,0.26997701003904534
13433,1246.4083,1246.4152,1,37392249,37392456,207,0.22393089329689322
13434,1248.762467,1248.766567,1,37462874,37462997,123,0.13549921346566496
13435,1248.772367,1248.795767,1,37463171,37463873,702,0.1735818593058048
13436,1248.797867,1248.801,1,37463936,37464030,94,0.836390895611799
13437,1250.615833,1250.7353,1,37518474,37522059,3585,0.19856759652868175
13438,1250.7415,1250.759133,1,37522245,37522773,528,0.1968736361129892
13439,1250.760133,1250.8065,1,37522803,37524195,1392,0.040065019156394786
13440,1250.815833,1250.908367,1,37524474,37527251,2777,0.09511235932368868
13441,1250.9098,1250.917967,1,37527294,37527539,245,0.6235035007714527
13442,1250.951533,1250.9929,1,37528545,37529787,1242,0.7811225970508983
13443,1250.994233,1250.997233,1,37529826,37529916,90,0.8226907508743297
13444,1251.0052,1251.0273,1,37530156,37530819,663,0.43138051128222116
13445,1251.034233,1251.038133,1,37531026,37531143,117,0.6679616882480829
13446,1251.039267,1251.0425,1,37531178,37531275,97,0.8275820099861498
13447,1251.087567,1251.0978,1,37532627,37532934,307,0.5850498334806677
13448,1251.100967,1251.131667,1,37533029,37533950,921,0.616185398318193
13449,1251.1333,1251.139133,1,37533999,37534173,174,0.757235034761545
13450,1251.144433,1251.167633,1,37534332,37535028,696,0.4175204120411019
13451,1251.1736,1251.186233,1,37535208,37535586,378,0.6901060736904465
13452,1251.2059,1251.210367,1,37536177,37536311,134,0.7479753477974054
13453,1251.217933,1251.254533,1,37536537,37537635,1098,0.25115688319519036
13454,1251.2557,1251.268733,1,37537671,37538061,390,0.6995747263430098
13455,1251.277367,1251.3085,1,37538321,37539255,934,0.29272559821304145
13456,1251.319167,1251.329233,1,37539575,37539876,301,0.345526932384603
13457,1251.330233,1251.334133,1,37539906,37540023,117,0.5559523993988498
13458,1251.360167,1251.377167,1,37540805,37541315,510,0.26968484103292845
13459,1251.3814,1251.4145,1,37541442,37542435,993,0.7410724679924143
13460,1251.415567,1251.421267,1,37542467,37542638,171,0.6774678556404639
13461,1251.432367,1251.4468,1,37542971,37543404,433,0.6022684305418687
13462,1251.4511,1251.454333,1,37543533,37543629,96,0.8101374635376499
13463,1251.457267,1251.460433,1,37543718,37543812,94,0.0864024083646088
13464,1251.461733,1251.465567,1,37543851,37543967,116,0.5444416678023163
13465,1256.264667,1256.2827,1,37687940,37688481,541,-0.014297625967845576
13466,1257.976667,1257.9799,1,37739300,37739397,97,0.6377912234157934
13467,1259.855933,1259.8771,1,37795677,37796313,636,0.061988439945222976
13468,1259.8792,1259.8841,1,37796376,37796523,147,0.6201535348549786
13469,1259.886567,1259.890367,1,37796597,37796711,114,0.8977151079609804
13470,1260.5323,1260.567033,1,37815969,37817010,1041,0.1832589278335817
13471,1260.568067,1260.572333,1,37817042,37817169,127,0.642458504662526
13472,1260.624633,1260.6324,1,37818738,37818972,234,0.3210302786281018
13473,1262.046067,1262.065767,1,37861382,37861973,591,0.26446234299871774
13474,1262.3075,1262.3137,1,37869225,37869411,186,0.7806501244528986
13475,1262.336567,1262.3406,1,37870097,37870218,121,0.5423528572787041
13476,1262.353267,1262.381033,1,37870598,37871430,832,0.7960850803228828
13477,1262.396833,1262.415433,1,37871904,37872462,558,0.6450245566754137
13478,1262.426333,1262.471867,1,37872789,37874156,1367,0.5941066232060529
13479,1262.472867,1262.480867,1,37874186,37874426,240,0.7174943839070056
13480,1262.4834,1262.512767,1,37874502,37875383,881,0.42445591235285374
13481,1262.513767,1262.518567,1,37875413,37875557,144,0.84928669986259
13482,1262.523667,1262.529,1,37875710,37875870,160,0.8215638636119563
13483,1262.533833,1262.543867,1,37876014,37876316,302,0.7391290498053562
13484,1262.546967,1262.569833,1,37876409,37877094,685,0.340801878132299
13485,1264.3079,1264.3217,1,37929237,37929651,414,0.22912721864916372
13486,1264.898733,1264.919133,1,37946961,37947573,612,0.5258894586975477
13487,1264.9207,1264.968433,1,37947621,37949052,1431,0.2810247981438494
13488,1264.984967,1264.9963,1,37949549,37949889,340,0.2987322318788221
13489,1265.001967,1265.028367,1,37950059,37950851,792,0.009244091234135542
13490,1265.062333,1265.0894,1,37951869,37952682,813,0.1699064386662166
13491,1265.095967,1265.1358,1,37952879,37954074,1195,0.09282911294284463
13492,1265.1391,1265.168267,1,37954173,37955048,875,0.10222354618301857
13493,1265.1705,1265.217067,1,37955115,37956512,1397,0.45031462880319206
13494,1267.0131,1267.0492,1,38010393,38011476,1083,0.023772507846646033
13495,1267.0915,1267.096333,1,38012745,38012889,144,0.7409819897009753
13496,1267.144233,1267.1721,1,38014326,38015163,837,0.12428928694082658
13497,1267.837567,1267.9348,1,38035127,38038044,2917,0.04756871093441409
13498,1267.943567,1267.988233,1,38038307,38039646,1339,0.05511527279529453
13499,1268.006967,1268.114233,1,38040209,38043426,3217,0.1248240458573052
13500,1268.205033,1268.249167,1,38046150,38047475,1325,0.47863431243856813
13501,1268.251433,1268.293333,1,38047542,38048799,1257,0.20361753765983215
13502,1268.296967,1268.312467,1,38048909,38049374,465,0.7020086403688524
13503,1269.0351,1269.064733,1,38071053,38071941,888,0.10475563939482771
13504,1269.1226,1269.1388,1,38073678,38074164,486,0.19509721397751129
13505,1269.1538,1269.190867,1,38074614,38075726,1112,0.1490247489930275
13506,1269.1924,1269.215667,1,38075772,38076470,698,0.3842597695593307
13507,1269.234967,1269.2722,1,38077049,38078166,1117,0.19999935673697403
13508,1269.2911,1269.307267,1,38078733,38079218,485,0.3106188256834497
13509,1269.346967,1269.3659,1,38080409,38080977,568,0.8238687253707635
13510,1269.370333,1269.3761,1,38081109,38081283,174,0.9502387417207898
13511,1269.430367,1269.4337,1,38082911,38083011,100,0.7032483654163241
13512,1269.4384,1269.469033,1,38083152,38084070,918,0.4201820406507752
13513,1269.470667,1269.478467,1,38084120,38084354,234,0.6879993497754028
13514,1269.487667,1269.5242,1,38084630,38085726,1096,0.334738960648818
13515,1269.556967,1269.5642,1,38086709,38086926,217,0.6307097227977053
13516,1269.5655,1269.617233,1,38086965,38088516,1551,0.3762475822811495
13517,1269.6193,1269.663467,1,38088579,38089904,1325,0.22965176566827866
13518,1269.6694,1269.673733,1,38090082,38090211,129,0.6756448635937922
13519,1269.6937,1269.700033,1,38090811,38091000,189,0.577990814645313
13520,1269.703,1269.752433,1,38091090,38092572,1482,0.25722883186680295
13521,1269.756967,1269.766,1,38092709,38092980,271,0.8263817386688795
13522,1269.768233,1269.8415,1,38093046,38095245,2199,0.2296386437879285
13523,1269.851933,1269.897233,1,38095557,38096916,1359,0.6852091653003624
13524,1269.905767,1269.912167,1,38097173,38097365,192,0.6904800423271542
13525,1269.916,1269.937967,1,38097480,38098139,659,0.05598488737988202
13526,1269.9411,1269.957267,1,38098233,38098718,485,0.10460180520986286
13527,1270.0021,1270.010733,1,38100063,38100321,258,0.6803724491760482
13528,1270.011767,1270.050433,1,38100353,38101512,1159,0.28685759788102905
13529,1270.059133,1270.0852,1,38101773,38102556,783,0.2784250894592081
13530,1270.0892,1270.108567,1,38102676,38103257,581,0.6000484967309886
13531,1270.1421,1270.1503,1,38104263,38104509,246,0.33191507042959884
13532,1270.154833,1270.158233,1,38104644,38104746,102,0.7684067299159898
13533,1270.163333,1270.1929,1,38104899,38105787,888,0.5444945643891815
13534,1270.200633,1270.203733,1,38106018,38106111,93,0.8449197697557888
13535,1270.212933,1270.2357,1,38106387,38107071,684,0.34262380045298424
13536,1270.293133,1270.304033,1,38108793,38109120,327,0.35138656071866825
13537,1270.317433,1270.356233,1,38109522,38110686,1164,0.5491478243197563
13538,1270.360067,1270.3863,1,38110802,38111589,787,0.32496605374161847
13539,1272.295767,1272.3377,1,38168873,38170131,1258,0.12962801837489601
13540,1272.351733,1272.374867,1,38170551,38171246,695,0.4360226679419309
13541,1272.394867,1272.4207,1,38171846,38172621,775,-0.04152414493850853
13542,1272.463767,1272.510333,1,38173913,38175309,1396,0.22996605858457214
13543,1272.513133,1272.516367,1,38175393,38175491,98,0.9065074466528482
13544,1273.295233,1273.3028,1,38198856,38199084,228,0.3179694814965277
13545,1273.418767,1273.432267,1,38202563,38202968,405,0.15408703476706553
13546,1273.433267,1273.4561,1,38202998,38203683,685,0.29854361101537713
13547,1273.465567,1273.483267,1,38203967,38204498,531,0.188529590615293
13548,1273.485467,1273.500933,1,38204564,38205027,463,0.12021395086793712
13549,1273.505033,1273.590233,1,38205150,38207706,2556,0.15575613295092353
13550,1273.604867,1273.6409,1,38208146,38209227,1081,0.32105568416033975
13551,1273.6423,1273.652867,1,38209269,38209586,317,0.05110749569468727
13552,1273.655967,1273.666467,1,38209679,38209994,315,0.13619071660777737
13553,1273.668133,1273.691933,1,38210043,38210757,714,0.1868934746555226
13554,1273.7006,1273.711933,1,38211018,38211357,339,0.3560742930685705
13555,1273.715533,1273.723267,1,38211465,38211698,233,0.3847317702917089
13556,1273.736733,1273.756167,1,38212101,38212685,584,0.32353954480011854
13557,1273.759633,1273.765767,1,38212788,38212973,185,0.3225215134378182
13558,1273.7669,1273.7764,1,38213007,38213292,285,0.6185917682030897
13559,1273.7812,1273.854333,1,38213436,38215629,2193,0.2079474803548946
13560,1273.855667,1273.885033,1,38215670,38216550,880,0.41236884768201304
13561,1275.212933,1275.260067,1,38256387,38257802,1415,0.16037590858794476
13562,1275.261567,1275.346833,1,38257847,38260404,2557,0.2139986421529307
13563,1275.348267,1275.378367,1,38260448,38261351,903,0.2553995991578772
13564,1275.381333,1275.3947,1,38261439,38261841,402,0.32568134478108235
13565,1275.397,1275.423333,1,38261910,38262699,789,0.24833813974253502
13566,1275.4297,1275.437333,1,38262891,38263119,228,0.5975400044965185
13567,1275.441767,1275.462333,1,38263253,38263869,616,0.19340807168237892
13568,1275.468,1275.5396,1,38264040,38266188,2148,0.22347302443122136
13569,1275.5407,1275.544133,1,38266221,38266323,102,0.778225194583792
13570,1275.945767,1275.955,1,38278373,38278650,277,0.3710091135002632
13571,1275.994367,1276.029967,1,38279831,38280899,1068,0.12070794367870799
13572,1276.035733,1276.139233,1,38281071,38284176,3105,0.16986980676649022
13573,1276.169667,1276.1888,1,38285090,38285664,574,0.0316492402583676
13574,1276.190467,1276.193667,1,38285714,38285810,96,0.11177600118593736
13575,1276.202833,1276.247733,1,38286084,38287431,1347,0.0924368310293235
13576,1276.253267,1276.259967,1,38287598,38287799,201,0.8544299168210266
13577,1276.2743,1276.309933,1,38288229,38289297,1068,0.09247102197666149
13578,1276.311267,1276.316067,1,38289338,38289482,144,0.8665783654015641
13579,1276.323433,1276.347067,1,38289702,38290412,710,0.09027659898121401
13580,1276.381233,1276.420833,1,38291436,38292624,1188,0.2136486678186099
13581,1276.456733,1276.472233,1,38293701,38294166,465,0.7403212816794262
13582,1276.476233,1276.4841,1,38294286,38294523,237,0.800348716467852
13583,1276.822567,1276.862833,1,38304677,38305884,1207,0.19260347942119083
13584,1276.866633,1276.9063,1,38305998,38307189,1191,0.23472667826940988
13585,1276.9239,1276.9321,1,38307717,38307963,246,0.6884757294302803
13586,1276.933133,1277.024267,1,38307993,38310728,2735,0.13518214988218322
13587,1277.0376,1277.044467,1,38311128,38311334,206,0.5995946745200311
13588,1277.060533,1277.066333,1,38311815,38311989,174,0.6979563632162921
13589,1277.068967,1277.120133,1,38312069,38313603,1534,0.2401483947632584
13590,1277.133133,1277.1399,1,38313993,38314197,204,0.7708356513569563
13591,1277.1561,1277.2119,1,38314683,38316357,1674,0.17598988994157175
13592,1277.213667,1277.2324,1,38316410,38316972,562,0.008313807567118525
13593,1277.234133,1277.318933,1,38317023,38319567,2544,0.1364422954402002
13594,1277.328767,1277.366367,1,38319863,38320991,1128,0.11245423390656367
13595,1277.3764,1277.4089,1,38321292,38322267,975,0.09916029019288163
13596,1277.418567,1277.444233,1,38322557,38323326,769,0.14800038858479359
13597,1277.4453,1277.451433,1,38323359,38323542,183,0.956735242642259
13598,1277.466067,1277.4748,1,38323982,38324244,262,0.4441560717202208
13599,1277.476567,1277.481333,1,38324297,38324439,142,0.8987400464672882
13600,1279.380633,1279.3909,1,38381418,38381727,309,0.5020829422108161
13601,1281.559767,1281.568667,1,38446793,38447060,267,0.3352075514128732
13602,1281.572633,1281.6708,1,38447178,38450124,2946,0.08853784976395582
13603,1281.682867,1281.6882,1,38450486,38450646,160,0.7359422745660095
13604,1281.702467,1281.7236,1,38451074,38451708,634,0.24688301328038734
13605,1281.735533,1281.816633,1,38452065,38454498,2433,0.19194225380549626
13606,1281.823267,1281.833533,1,38454698,38455005,307,0.2595609841321316
13607,1281.837633,1281.867067,1,38455128,38456012,884,0.467783971159192
13608,1281.870867,1281.877467,1,38456126,38456324,198,0.8563956414288441
13609,1281.8816,1281.884633,1,38456448,38456538,90,0.7688908561559479
13610,1281.8918,1281.914233,1,38456754,38457426,672,0.31789850327873515
13611,1281.9174,1281.9299,1,38457522,38457897,375,0.5502951780675291
13612,1281.9412,1281.955767,1,38458236,38458673,437,0.11797262965556148
13613,1281.959333,1281.974633,1,38458779,38459238,459,0.4207403531770327
13614,1281.976433,1281.988567,1,38459292,38459657,365,0.7933616518200728
13615,1281.992033,1282.005333,1,38459760,38460159,399,0.48144202202958924
13616,1282.007033,1282.0113,1,38460210,38460339,129,0.7963634394621371
13617,1282.015667,1282.066633,1,38460470,38461998,1528,0.293229638416525
13618,1282.067633,1282.078833,1,38462028,38462364,336,0.2762014167915967
13619,1282.082733,1282.0975,1,38462481,38462925,444,0.538601606475444
13620,1282.0987,1282.134833,1,38462961,38464044,1083,0.7852641025846168
13621,1282.145733,1282.1799,1,38464371,38465397,1026,0.246392236859857
13622,1282.199667,1282.2116,1,38465990,38466348,358,0.3406168506171327
13623,1282.215867,1282.227467,1,38466476,38466824,348,0.5280913886230816
13624,1282.233333,1282.246433,1,38466999,38467392,393,0.797811320802035
13625,1282.2475,1282.257733,1,38467425,38467731,306,0.7544829176037896
13626,1282.263067,1282.267867,1,38467892,38468036,144,0.712818265110129
13627,1282.2856,1282.3146,1,38468568,38469438,870,0.5310217015064289
13628,1282.3627,1282.381933,1,38470881,38471457,576,0.19171886135177768
13629,1282.383233,1282.4222,1,38471496,38472666,1170,0.31939371349389817
13630,1282.426733,1282.4533,1,38472801,38473599,798,0.3467502699268905
13631,1282.455,1282.465733,1,38473650,38473971,321,0.339477505728245
13632,1282.5417,1282.547233,1,38476251,38476416,165,0.39013998062496286
13633,1282.55,1282.5726,1,38476500,38477178,678,0.5384349370966096
13634,1282.590867,1282.595633,1,38477726,38477868,142,0.7760050684032693
13635,1282.604367,1282.6285,1,38478131,38478855,724,0.25833195849449725
13636,1282.639033,1282.643267,1,38479170,38479298,128,0.6702005203669005
13637,1282.653633,1282.660933,1,38479608,38479827,219,0.39159219436342857
13638,1282.761833,1282.771733,1,38482854,38483151,297,0.4884009585995931
13639,1282.777567,1282.792033,1,38483327,38483760,433,0.3741926318504184
13640,1282.8136,1282.817133,1,38484408,38484513,105,0.9174120674737559
13641,1282.822733,1282.834467,1,38484681,38485034,353,0.3409147233063424
13642,1283.284967,1283.362367,1,38498549,38500871,2322,0.30555116539836547
13643,1283.3642,1283.379833,1,38500926,38501394,468,0.3551771755797669
13644,1283.384833,1283.3881,1,38501544,38501643,99,0.019389226004088895
13645,1283.419867,1283.551867,1,38502596,38506556,3960,0.11718824045900803
13646,1283.554367,1283.568933,1,38506631,38507067,436,0.533067175007259
13647,1284.3713,1284.375433,1,38531139,38531262,123,0.09613794507682276
13648,1284.4365,1284.6429,1,38533095,38539287,6192,0.1176195637709447
13649,1284.647167,1284.7514,1,38539415,38542542,3127,0.16215006776765706
13650,1286.154767,1286.2016,1,38584643,38586048,1405,0.10396041032463522
13651,1286.2049,1286.217133,1,38586147,38586513,366,0.07083129033672479
13652,1286.236333,1286.3368,1,38587089,38590104,3015,0.16767199112268408
13653,1288.168533,1288.198,1,38645055,38645940,885,0.15572387382023709
13654,1288.199,1288.332333,1,38645970,38649969,3999,0.20143546729359849
13655,1288.335233,1288.380967,1,38650056,38651429,1373,0.1352661216877208
13656,1288.383333,1288.4699,1,38651499,38654097,2598,0.2623450337015218
13657,1289.103367,1289.1792,1,38673101,38675376,2275,0.2195378072090748
13658,1289.184667,1289.199867,1,38675540,38675996,456,0.21154152348446745
13659,1289.206167,1289.3015,1,38676185,38679045,2860,0.1818290602517019
13660,1289.3268,1289.3638,1,38679804,38680914,1110,0.055971365461825
13661,1289.373767,1289.392233,1,38681213,38681766,553,0.13918012038837546
13662,1289.3972,1289.402633,1,38681916,38682078,162,0.6635507209728022
13663,1289.403967,1289.490367,1,38682119,38684711,2592,0.23541332210464835
13664,1289.537733,1289.560567,1,38686131,38686817,686,0.1816042631293577
13665,1289.579833,1289.606733,1,38687394,38688201,807,0.09986680106406444
13666,1289.6358,1289.647433,1,38689074,38689422,348,-0.052364954225214165
13667,1289.657333,1289.6798,1,38689719,38690394,675,0.21215586794653066
13668,1289.6808,1289.688967,1,38690424,38690669,245,0.9322963526771321
13669,1289.6902,1289.700333,1,38690706,38691009,303,0.9171300149670806
13670,1289.715367,1289.739867,1,38691461,38692196,735,0.09162177547134161
13671,1289.943433,1290.019033,1,38698302,38700570,2268,0.13490106652928857
13672,1290.0305,1290.039933,1,38700915,38701197,282,0.08655518850906534
13673,1290.044467,1290.051567,1,38701334,38701547,213,0.20480901566567802
13674,1290.058767,1290.0637,1,38701763,38701911,148,0.4313292969356936
13675,1290.065333,1290.1099,1,38701959,38703297,1338,0.1733294459022543
13676,1290.1129,1290.228067,1,38703387,38706842,3455,0.12480476705495791
13677,1290.2785,1290.304633,1,38708355,38709138,783,0.07108734353646431
13678,1290.318933,1290.3473,1,38709567,38710419,852,0.18655492616393468
13679,1290.349167,1290.3617,1,38710475,38710851,376,0.23947367024134852
13680,1290.3706,1290.374767,1,38711118,38711243,125,0.9163670161553142
13681,1290.410567,1290.4144,1,38712317,38712432,115,-0.35417813012040156
13682,1290.425,1290.429467,1,38712750,38712884,134,0.3495827728501909
13683,1290.6545,1290.689767,1,38719635,38720693,1058,-0.12570216112122345
13684,1290.714367,1290.717833,1,38721431,38721534,103,0.6510426072490306
13685,1290.7569,1290.8228,1,38722707,38724684,1977,0.19196712333000013
13686,1290.8253,1290.8392,1,38724759,38725176,417,0.624748112839902
13687,1290.842367,1290.868833,1,38725271,38726064,793,0.36567040375792914
13688,1290.869933,1290.8736,1,38726097,38726208,111,0.9176910868945426
13689,1290.8766,1290.887933,1,38726298,38726637,339,0.8103986178430432
13690,1291.6709,1291.791533,1,38750127,38753745,3618,0.17751394158536293
13691,1291.824433,1291.8537,1,38754732,38755611,879,0.23901097522579814
13692,1291.855967,1291.863767,1,38755679,38755913,234,0.7100518771935775
13693,1291.865867,1291.892567,1,38755976,38756777,801,0.41625862851185574
13694,1291.8979,1291.905233,1,38756937,38757156,219,0.8326984327636228
13695,1291.907067,1291.962433,1,38757212,38758872,1660,0.3160675348026983
13696,1291.966,1291.9822,1,38758980,38759466,486,0.48532446423794456
13697,1291.985367,1291.988533,1,38759561,38759655,94,0.7352991633494026
13698,1292.01,1292.013667,1,38760300,38760410,110,0.8014051292739182
13699,1292.028033,1292.033,1,38760840,38760990,150,0.9027104746793317
13700,1293.492533,1293.4959,1,38804775,38804877,102,0.7822001936172774
13701,1293.507067,1293.523967,1,38805212,38805719,507,0.3646594683103988
13702,1293.526633,1293.607867,1,38805798,38808236,2438,0.2266547071162195
13703,1293.620133,1293.654867,1,38808603,38809646,1043,0.1029462790997785
13704,1293.6567,1293.663767,1,38809701,38809913,212,0.24260088009441005
13705,1293.666967,1293.678767,1,38810009,38810363,354,0.16554628500579147
13706,1293.7085,1293.7154,1,38811255,38811462,207,0.5001288669555076
13707,1293.7169,1293.737467,1,38811507,38812124,617,0.3609895828815828
13708,1293.740533,1293.799433,1,38812215,38813982,1767,0.19039449314633541
13709,1293.813667,1293.816733,1,38814410,38814501,91,0.7029363508084194
13710,1293.819233,1293.825433,1,38814576,38814762,186,0.7794430553205872
13711,1293.8379,1293.8411,1,38815137,38815233,96,0.8509874775998725
13712,1294.201533,1294.287767,1,38826045,38828633,2588,0.12008436276545008
13713,1294.309867,1294.313033,1,38829296,38829390,94,0.8945764789163447
13714,1294.324833,1294.3833,1,38829744,38831499,1755,0.14678533489709739
13715,1294.3847,1294.4968,1,38831541,38834904,3363,0.03231072987281796
13716,1294.521267,1294.5442,1,38835638,38836326,688,0.08463615201738965
13717,1294.549133,1294.5892,1,38836473,38837676,1203,0.22375042628909306
13718,1294.599033,1294.6096,1,38837970,38838288,318,0.2537841195984074
13719,1294.618033,1294.6874,1,38838540,38840622,2082,0.08641397144644303
13720,1294.696067,1294.708133,1,38840882,38841243,361,0.3755880307442132
13721,1294.773967,1294.780333,1,38843219,38843409,190,0.6098319976821747
13722,1294.795033,1294.798967,1,38843850,38843969,119,0.6833523104734857
13723,1294.824967,1294.828667,1,38844749,38844860,111,0.7212300945460006
13724,1295.6221,1295.639733,1,38868663,38869191,528,0.05923542351691809
13725,1295.650167,1295.6754,1,38869505,38870262,757,0.1940424814418387
13726,1295.708467,1295.805167,1,38871254,38874155,2901,0.21091656080059737
13727,1295.806933,1295.862533,1,38874207,38875875,1668,0.21576636202397373
13728,1295.890467,1296.022867,1,38876714,38880686,3972,0.11672900137692065
13729,1296.035367,1296.065967,1,38881061,38881979,918,0.16322310981893273
13730,1296.0724,1296.149533,1,38882172,38884485,2313,0.11213477266556993
13731,1296.159,1296.183233,1,38884770,38885496,726,0.050415842146180265
13732,1296.1843,1296.199833,1,38885529,38885994,465,0.7001899398961529
13733,1296.208467,1296.211967,1,38886254,38886359,105,0.9146237442700385
13734,1296.215667,1296.2245,1,38886470,38886735,265,0.41673550813798227
13735,1296.229233,1296.234867,1,38886876,38887046,170,0.38597798100917863
13736,1296.3911,1296.4007,1,38891733,38892021,288,0.08846478757723994
13737,1296.4077,1296.411533,1,38892231,38892345,114,0.6857607567730439
13738,1296.420633,1296.4248,1,38892618,38892744,126,0.30073413170353214
13739,1296.436533,1296.440067,1,38893095,38893202,107,0.8982030794285547
13740,1296.443733,1296.449467,1,38893311,38893484,173,0.5523918651379873
13741,1296.455,1296.4681,1,38893650,38894043,393,0.43160050314473486
13742,1298.009333,1298.019033,1,38940279,38940570,291,-0.06898121041062251
13743,1298.021167,1298.079533,1,38940635,38942385,1750,0.07589781538175946
13744,1298.097967,1298.104533,1,38942939,38943135,196,0.031044154256953567
13745,1298.113,1298.191033,1,38943390,38945730,2340,0.17744900828622334
13746,1298.2134,1298.220233,1,38946402,38946606,204,0.8909235220419325
13747,1298.2273,1298.231333,1,38946819,38946939,120,0.8399113776115603
13748,1299.840533,1299.924267,1,38995215,38997728,2513,0.061152189851969706
13749,1299.926467,1299.935033,1,38997794,38998050,256,0.8767031467906093
13750,1299.938033,1299.949533,1,38998140,38998485,345,0.7444052996724356
13751,1299.955067,1300.001667,1,38998652,39000050,1398,0.052113091090516886
13752,1300.002767,1300.081067,1,39000083,39002432,2349,0.08800823369708365
13753,1300.082433,1300.0862,1,39002472,39002586,114,0.8170593681084065
13754,1300.128367,1300.184267,1,39003851,39005528,1677,0.15778265283362658
13755,1300.188833,1300.2013,1,39005664,39006039,375,0.08515860523958566
13756,1300.224267,1300.2321,1,39006728,39006963,235,0.22621590350090037
13757,1300.2351,1300.278933,1,39007053,39008367,1314,0.6554344382987761
13758,1300.282933,1300.297567,1,39008487,39008927,440,0.3979353827650346
13759,1300.302033,1300.317233,1,39009060,39009516,456,0.11620425206158873
13760,1300.373067,1300.4431,1,39011192,39013293,2101,0.20141917550713592
13761,1300.457033,1300.461533,1,39013710,39013845,135,0.8106465741350387
13762,1300.465433,1300.542967,1,39013962,39016289,2327,0.09762200311720426
13763,1300.552033,1300.607533,1,39016560,39018225,1665,0.3519313352170869
13764,1300.609667,1300.632,1,39018290,39018960,670,0.08228626050748242
13765,1300.633367,1300.646433,1,39019001,39019392,391,0.4975358212733862
13766,1300.688467,1300.698967,1,39020654,39020969,315,0.42507263895466085
13767,1300.702367,1300.752267,1,39021071,39022568,1497,0.14889640736681636
13768,1300.756167,1300.787267,1,39022685,39023618,933,0.13331245979717773
13769,1300.823667,1300.828567,1,39024710,39024857,147,-0.15063384319189074
13770,1300.8526,1300.9025,1,39025578,39027075,1497,0.20168191279574627
13771,1300.908033,1300.922967,1,39027240,39027689,449,0.13109820578592082
13772,1301.155033,1301.179167,1,39034650,39035375,725,0.29975002282230795
13773,1301.1915,1301.195633,1,39035745,39035868,123,0.7817542682725787
13774,1301.196633,1301.203267,1,39035898,39036098,200,0.8285889187517503
13775,1301.2063,1301.209567,1,39036189,39036287,98,0.9322340732166892
13776,1301.232833,1301.2377,1,39036984,39037131,147,0.767285349258664
13777,1301.238767,1301.2432,1,39037163,39037296,133,0.633707665071256
13778,1301.244433,1301.495433,1,39037332,39044862,7530,0.4995520648572944
13779,1301.599567,1301.603233,1,39047987,39048096,109,0.9298185104368258
13780,1301.604533,1301.627133,1,39048135,39048813,678,0.7974051490642872
13781,1301.699067,1301.7622,1,39050972,39052866,1894,0.7446064639036271
13782,1301.7632,1301.7689,1,39052896,39053067,171,0.9515403199039444
13783,1301.771467,1301.7905,1,39053144,39053715,571,0.8548266805549692
13784,1301.791867,1301.811267,1,39053756,39054338,582,0.7725302203057451
13785,1302.269733,1302.2744,1,39068091,39068232,141,0.905775821885573
13786,1303.4764,1303.4949,1,39104292,39104847,555,0.7840904518421415
13787,1304.038433,1304.0434,1,39121152,39121302,150,0.3930384747223709
13788,1304.090267,1304.1247,1,39122708,39123741,1033,0.2393707475230002
13789,1304.138167,1304.1562,1,39124145,39124686,541,0.21834957233846733
13790,1304.170767,1304.175367,1,39125123,39125261,138,0.9143225584437817
13791,1304.188067,1304.2114,1,39125642,39126342,700,0.07271260315779221
13792,1304.241,1304.272567,1,39127230,39128177,947,0.19565587941819038
13793,1304.290667,1304.3391,1,39128720,39130173,1453,-0.005224475770322757
13794,1304.353233,1304.376067,1,39130596,39131282,686,0.09617194291351111
13795,1304.381033,1304.390633,1,39131430,39131718,288,0.8366118054692488
13796,1304.3917,1304.431633,1,39131751,39132948,1197,0.2980960435427325
13797,1304.479567,1304.4861,1,39134387,39134583,196,0.46400881386116943
13798,1304.487367,1304.5171,1,39134621,39135513,892,0.32168224517317934
13799,1304.541067,1304.5571,1,39136232,39136713,481,0.4287831009811284
13800,1305.294067,1305.302533,1,39158822,39159075,253,0.34905872025454987
13801,1305.3043,1305.3341,1,39159129,39160023,894,0.4363523921521663
13802,1305.3403,1305.370367,1,39160209,39161111,902,0.7410691759501669
13803,1308.501333,1308.5954,1,39255039,39257862,2823,0.29770493909518925
13804,1308.627367,1308.635467,1,39258821,39259064,243,0.7682915134426364
13805,1308.636967,1308.6954,1,39259109,39260862,1753,0.2460984150307017
13806,1308.723,1308.836267,1,39261690,39265088,3398,0.1316323110953505
13807,1308.862967,1308.866167,1,39265889,39265985,96,0.795024497650987
13808,1309.0473,1309.085633,1,39271419,39272568,1149,0.32961406653690073
13809,1309.086633,1309.099267,1,39272598,39272978,380,0.5027747390389405
13810,1309.1235,1309.136067,1,39273705,39274082,377,0.8275886746750208
13811,1309.148233,1309.164833,1,39274446,39274944,498,0.8598734638609138
13812,1309.185867,1309.230333,1,39275576,39276909,1333,0.7026365415258713
13813,1309.287033,1309.306533,1,39278610,39279195,585,0.8491070487209931
13814,1309.307833,1309.317567,1,39279234,39279527,293,0.6969397438545623
13815,1309.319733,1309.5144,1,39279591,39285432,5841,0.5360429375489214
13816,1309.5251,1309.540833,1,39285753,39286224,471,0.17342648278580625
13817,1309.542067,1309.547033,1,39286262,39286410,148,0.7025174640637059
13818,1309.549367,1309.553767,1,39286481,39286613,132,0.8343473091435163
13819,1309.684467,1309.688333,1,39290534,39290649,115,0.8674191613852649
13820,1309.980667,1309.985767,1,39299420,39299573,153,0.8026840646340245
13821,1309.987067,1310.0468,1,39299612,39301404,1792,0.15173655521559845
13822,1310.050167,1310.057,1,39301505,39301710,205,0.340617980379163
13823,1310.0638,1310.073667,1,39301914,39302210,296,-0.05213405840054303
13824,1310.079667,1310.1727,1,39302390,39305181,2791,0.03494427857387827
13825,1310.174033,1310.187533,1,39305220,39305625,405,0.5365552081900958
13826,1310.189067,1310.198033,1,39305672,39305940,268,0.6239966925884183
13827,1310.2236,1310.240033,1,39306708,39307200,492,0.43123318474936634
13828,1310.307433,1310.312133,1,39309222,39309363,141,0.1880878420058114
13829,1310.321367,1310.3276,1,39309641,39309828,187,0.44577068696057276
13830,1310.334,1310.3371,1,39310020,39310113,93,0.9620435333627398
13831,1310.3894,1310.438367,1,39311682,39313151,1469,0.3821678607344643
13832,1310.442333,1310.459233,1,39313269,39313776,507,0.7142230009675662
13833,1310.4653,1310.538567,1,39313959,39316157,2198,0.48146432649665827
13834,1310.54,1310.559433,1,39316200,39316782,582,0.5000704449963049
13835,1310.564967,1310.572167,1,39316949,39317165,216,0.2431823171999964
13836,1310.643067,1310.7069,1,39319292,39321207,1915,0.4148444731788217
13837,1310.7222,1310.7539,1,39321666,39322617,951,0.4440547683521309
13838,1310.755133,1310.8217,1,39322653,39324651,1998,0.4497933004951357
13839,1310.8328,1310.8411,1,39324984,39325233,249,0.7668234283298689
13840,1310.843233,1310.855367,1,39325296,39325661,365,0.3134195629426491
13841,1310.8627,1310.907967,1,39325881,39327239,1358,0.37358735924832237
13842,1310.919233,1310.9349,1,39327576,39328047,471,0.6385955503382038
13843,1310.9419,1310.9737,1,39328257,39329211,954,0.7279208705767224
13844,1310.9789,1310.987333,1,39329367,39329619,252,0.8533460875348143
13845,1311.0081,1311.0158,1,39330243,39330474,231,0.7589957248716498
13846,1311.050267,1311.084567,1,39331508,39332537,1029,0.4891377914746388
13847,1311.091867,1311.177233,1,39332756,39335316,2560,0.4671113898059188
13848,1311.1791,1311.218667,1,39335373,39336560,1187,0.32489073535924806
13849,1311.227133,1311.236433,1,39336813,39337092,279,0.7451370781738645
13850,1311.240367,1311.262833,1,39337211,39337884,673,0.7080100549170472
13851,1311.263867,1311.283533,1,39337916,39338505,589,0.8206291591897475
13852,1311.289233,1311.3217,1,39338676,39339651,975,0.050537476566113855
13853,1311.6408,1311.6457,1,39349224,39349371,147,0.5969443283097706
13854,1311.649667,1311.691533,1,39349490,39350745,1255,0.11874668616002289
13855,1311.6954,1311.699667,1,39350862,39350990,128,0.8923754303305795
13856,1311.702333,1311.7065,1,39351069,39351195,126,0.7075167076577357
13857,1311.713767,1311.736633,1,39351413,39352098,685,0.25967861347184507
13858,1311.7416,1311.764233,1,39352248,39352926,678,0.189475810752824
13859,1311.7866,1311.868767,1,39353598,39356063,2465,0.18608053126527935
13860,1311.931833,1312.008133,1,39357954,39360243,2289,0.2006546907043926
13861,1312.025233,1312.033867,1,39360756,39361016,260,0.48685307419036444
13862,1312.041767,1312.094767,1,39361253,39362843,1590,0.12528533550332283
13863,1312.0969,1312.0999,1,39362907,39362997,90,0.9254807727035097
13864,1312.1473,1312.150433,1,39364419,39364512,93,0.38529615062749506
13865,1312.734767,1312.7519,1,39382043,39382557,514,0.20059499361176988
13866,1312.760767,1312.789733,1,39382823,39383691,868,0.1732091627707218
13867,1312.8131,1312.816967,1,39384393,39384509,116,0.823675060771166
13868,1312.822933,1312.857967,1,39384687,39385739,1052,0.498050442389678
13869,1312.861533,1312.939867,1,39385845,39388196,2351,0.15781671848881673
13870,1312.951267,1312.955867,1,39388538,39388676,138,0.5103901113005876
13871,1312.974267,1312.993467,1,39389228,39389804,576,0.09912374518397918
13872,1313.0107,1313.029233,1,39390321,39390876,555,0.12276784662966256
13873,1313.030433,1313.042167,1,39390912,39391265,353,0.17665788293406925
13874,1313.043967,1313.065933,1,39391319,39391977,658,-0.008904833196239538
13875,1313.0672,1313.139633,1,39392016,39394188,2172,0.06527242352159965
13876,1313.147533,1313.1775,1,39394425,39395325,900,0.27625700249263097
13877,1313.191033,1313.206467,1,39395730,39396194,464,0.3781719757171461
13878,1313.4937,1313.509,1,39404811,39405270,459,0.025511178128022803
13879,1313.510133,1313.569967,1,39405303,39407099,1796,0.08577430023278293
13880,1313.575533,1313.5908,1,39407265,39407724,459,0.875762199058358
13881,1313.594967,1313.654333,1,39407849,39409629,1780,0.19342409657242718
13882,1313.656167,1313.6737,1,39409685,39410211,526,0.4497256884760207
13883,1313.691633,1313.729,1,39410748,39411870,1122,0.7550408990919032
13884,1313.734333,1313.7523,1,39412029,39412569,540,0.07526092012820397
13885,1313.759567,1313.7764,1,39412787,39413292,505,0.38373748980326106
13886,1313.862733,1313.867033,1,39415881,39416010,129,0.4151950581446073
13887,1314.008567,1314.017467,1,39420257,39420524,267,0.25344241873371265
13888,1314.023167,1314.026167,1,39420695,39420785,90,0.8528258680850458
13889,1314.0282,1314.033133,1,39420846,39420993,147,0.8516422191296328
13890,1314.2534,1314.256933,1,39427602,39427707,105,0.8126694328540255
13891,1314.269167,1314.2751,1,39428075,39428253,178,0.6345023207516104
13892,1314.283033,1314.2895,1,39428490,39428685,195,0.7817744949689261
13893,1314.298267,1314.304467,1,39428948,39429134,186,0.22471519473559096
13894,1314.315467,1314.333133,1,39429464,39429993,529,0.37205283633982966
13895,1314.526367,1314.5326,1,39435791,39435978,187,0.8285525542244025
13896,1314.985533,1315.005,1,39449565,39450150,585,0.14179713212165307
13897,1315.236033,1315.239167,1,39457080,39457175,95,0.744760526739506
13898,1315.253933,1315.263367,1,39457617,39457901,284,0.7420828348425057
13899,1315.267067,1315.362133,1,39458012,39460863,2851,0.4555796411706281
13900,1315.363133,1315.3875,1,39460893,39461625,732,0.288222255115116
13901,1315.405033,1315.412433,1,39462150,39462372,222,0.9371735604163692
13902,1315.416667,1315.426,1,39462500,39462780,280,0.4156176726411637
13903,1315.449133,1315.465267,1,39463473,39463958,485,0.23455175570641065
13904,1315.4983,1315.501667,1,39464949,39465050,101,0.251370614549196
13905,1315.949333,1315.957267,1,39478479,39478718,239,0.3448941144534663
13906,1315.965833,1315.969067,1,39478974,39479072,98,0.9278682991809114
13907,1316.394033,1316.405233,1,39491820,39492156,336,0.2936851033760417
13908,1316.662467,1316.672167,1,39499874,39500165,291,0.8949986820482574
13909,1317.565967,1317.5713,1,39526979,39527139,160,0.6482016376381288
13910,1318.4621,1318.4996,1,39553863,39554988,1125,0.5575839710166017
13911,1318.5142,1318.517233,1,39555426,39555516,90,0.36451328871837035
13912,1318.557933,1318.573733,1,39556737,39557211,474,0.46435117787123226
13913,1319.164433,1319.2206,1,39574932,39576618,1686,0.16325609390231272
13914,1319.2459,1319.268767,1,39577377,39578063,686,0.16833030698520354
13915,1319.283933,1319.2988,1,39578517,39578964,447,0.07060331628539375
13916,1319.3296,1319.372533,1,39579888,39581175,1287,0.13541904476698718
13917,1319.383267,1319.412533,1,39581498,39582375,877,0.23990736452010125
13918,1319.418933,1319.468533,1,39582567,39584055,1488,0.10791703029269888
13919,1319.476667,1319.4876,1,39584300,39584628,328,0.3325539966344238
13920,1319.488667,1319.492533,1,39584660,39584775,115,0.5830411688458158
13921,1319.500533,1319.514633,1,39585015,39585438,423,0.6427491843188685
13922,1319.5234,1319.532733,1,39585702,39585981,279,0.4450741404491243
13923,1319.5781,1319.584233,1,39587343,39587526,183,0.6468025317929961
13924,1324.9293,1324.947533,1,39747879,39748425,546,0.09679132561678552
13925,1325.1245,1325.128733,1,39753735,39753861,126,0.9153672034108823
13926,1325.804167,1325.807433,1,39774125,39774222,97,0.7672552924783325
13927,1326.1183,1326.1216,1,39783549,39783648,99,0.7762459477917023
13928,1326.4625,1326.4681,1,39793875,39794043,168,0.8094988827066347
13929,1326.508433,1326.5128,1,39795252,39795384,132,0.6154016117172567
13930,1326.671767,1326.679133,1,39800153,39800373,220,0.9084774791361053
13931,1328.216167,1328.2219,1,39846485,39846657,172,0.7301182035893886
13932,1328.243133,1328.3083,1,39847293,39849249,1956,0.2398786209954301
13933,1328.3196,1328.343933,1,39849588,39850317,729,0.240844998000151
13934,1328.353033,1328.3636,1,39850590,39850908,318,0.4693125748739937
13935,1328.364633,1328.370033,1,39850938,39851100,162,0.6590285370033503
13936,1328.497033,1328.500233,1,39854910,39855006,96,0.19951800805882655
13937,1328.5212,1328.526833,1,39855636,39855804,168,0.42393350210287567
13938,1328.538533,1328.567633,1,39856155,39857028,873,0.2447285970495214
13939,1328.568933,1328.628067,1,39857067,39858842,1775,0.22598179649537264
13940,1328.642833,1328.648133,1,39859284,39859443,159,0.2532595764439602
13941,1328.660833,1328.718933,1,39859824,39861567,1743,0.12158600040537845
13942,1328.720233,1328.737933,1,39861606,39862137,531,0.2462299142913433
13943,1328.740233,1328.7519,1,39862206,39862557,351,0.8219383176247408
13944,1328.776067,1328.7871,1,39863282,39863613,331,0.45881456047881874
13945,1328.788433,1328.806133,1,39863652,39864183,531,0.09784173637910769
13946,1328.816767,1328.8299,1,39864503,39864897,394,0.8328774098285574
13947,1329.787767,1329.878733,1,39893633,39896361,2728,0.3796235046874095
13948,1329.8877,1329.912967,1,39896631,39897389,758,0.5899399944664429
13949,1329.9158,1329.987033,1,39897474,39899610,2136,0.23845964183997848
13950,1329.9964,1330.074133,1,39899892,39902223,2331,0.2681567888419409
13951,1330.083,1330.088633,1,39902490,39902658,168,0.847161131540514
13952,1330.090333,1330.093467,1,39902709,39902804,95,0.9347269669365951
13953,1330.0947,1330.1279,1,39902841,39903837,996,0.3164340261019007
13954,1330.1292,1330.213833,1,39903876,39906414,2538,0.2952202284517747
13955,1330.215667,1330.219433,1,39906470,39906582,112,0.9691237347463141
13956,1330.246533,1330.524967,1,39907395,39915749,8354,0.16750930422693722
13957,1330.544933,1330.555833,1,39916347,39916674,327,0.15779787552004945
13958,1330.5709,1330.5761,1,39917127,39917283,156,0.7254729770194643
13959,1330.587133,1330.590767,1,39917613,39917723,110,0.9113554954343717
13960,1330.6004,1330.609133,1,39918012,39918273,261,0.8044488117456995
13961,1330.612633,1330.619033,1,39918378,39918570,192,0.26085402266554975
13962,1330.620733,1330.6242,1,39918621,39918726,105,0.7936178287492045
13963,1330.635633,1330.6487,1,39919068,39919461,393,0.10838572857925256
13964,1330.765667,1330.776467,1,39922970,39923294,324,0.259251056833114
13965,1330.7783,1330.792767,1,39923349,39923783,434,0.3802419223169291
13966,1330.796033,1330.800333,1,39923880,39924009,129,0.8810313791664007
13967,1330.817533,1330.8232,1,39924525,39924696,171,0.5696216636357548
13968,1330.834633,1330.8517,1,39925038,39925551,513,0.4092669046620705
13969,1331.0291,1331.036133,1,39930873,39931083,210,0.6782861650374534
13970,1331.039233,1331.0612,1,39931176,39931836,660,0.6222120093117274
13971,1331.084667,1331.098733,1,39932540,39932961,421,0.41837649236112134
13972,1331.1019,1331.112333,1,39933057,39933369,312,0.3674690173073791
13973,1331.1574,1331.180967,1,39934722,39935429,707,0.6691437238173464
13974,1331.1862,1331.1937,1,39935586,39935811,225,0.3111482448527385
13975,1331.202367,1331.225033,1,39936071,39936750,679,0.11528685940415132
13976,1331.3263,1331.362167,1,39939789,39940865,1076,0.8196964953648338
13977,1331.367533,1331.400833,1,39941025,39942024,999,0.8206491335890628
13978,1331.729233,1331.736033,1,39951876,39952080,204,0.8474828690178462
13979,1331.755633,1331.762133,1,39952668,39952863,195,0.6526732479640875
13980,1331.8741,1331.8792,1,39956223,39956376,153,0.8871189323322705
13981,1331.936867,1331.940533,1,39958106,39958215,109,0.5961641115771862
13982,1332.050633,1332.0564,1,39961518,39961692,174,0.6798569165404078
13983,1332.057567,1332.1159,1,39961727,39963477,1750,0.26237791892485296
13984,1332.128367,1332.1378,1,39963851,39964134,283,0.3410627955050484
13985,1332.304033,1332.309267,1,39969120,39969278,158,0.7460092564585172
13986,1332.312867,1332.375367,1,39969386,39971261,1875,0.31315151212723247
13987,1332.421567,1332.489167,1,39972647,39974675,2028,0.14750530667680775
13988,1332.492433,1332.498733,1,39974772,39974961,189,0.6732702640593538
13989,1332.518267,1332.529133,1,39975548,39975873,325,0.9020701988521309
13990,1332.742633,1332.7463,1,39982278,39982389,111,0.9360297933177311
13991,1332.747733,1332.7513,1,39982431,39982539,108,0.9396268724613002
13992,1332.755267,1332.881733,1,39982658,39986451,3793,0.24195621376004164
13993,1332.882967,1332.9091,1,39986489,39987273,784,0.23081542885952752
13994,1332.9105,1332.9263,1,39987315,39987789,474,0.6184091194674253
13995,1332.928067,1332.942367,1,39987842,39988271,429,0.8226416025819311
13996,1332.945433,1333.0537,1,39988362,39991611,3249,0.22243142381586833
13997,1333.055867,1333.106767,1,39991676,39993203,1527,0.34485088141046527
13998,1333.108,1333.118533,1,39993240,39993555,315,0.6774401225658045
13999,1333.120067,1333.1652,1,39993602,39994956,1354,0.5666336073722283
14000,1333.189067,1333.204133,1,39995672,39996123,451,0.3711846502119349
14001,1333.2073,1333.267167,1,39996219,39998015,1796,0.24194338818816066
14002,1333.291567,1333.302367,1,39998747,39999071,324,0.7494076840715663
14003,1333.5544,1333.690333,1,40006632,40010709,4077,0.2612913762620515
14004,1333.7046,1333.711833,1,40011138,40011354,216,0.8022091882337501
14005,1333.7138,1333.719167,1,40011414,40011575,161,0.8492924176013402
14006,1333.746167,1333.7529,1,40012385,40012587,202,0.885704603846124
14007,1333.906567,1333.9106,1,40017197,40017318,121,0.6567681969257604
14008,1333.925667,1333.9288,1,40017770,40017864,94,0.8406784966284376
14009,1333.9388,1333.9425,1,40018164,40018275,111,0.9355573432926946
14010,1333.952367,1333.9963,1,40018571,40019889,1318,0.35784539489454614
14011,1334.004533,1334.111033,1,40020135,40023330,3195,0.43510882851010685
14012,1334.114167,1334.145133,1,40023425,40024353,928,0.3783589191110346
14013,1334.146833,1334.156567,1,40024404,40024697,293,0.8515038730002085
14014,1334.180133,1334.194933,1,40025403,40025847,444,0.8450029937922157
14015,1334.196533,1334.2149,1,40025895,40026447,552,0.6613199651396985
14016,1334.2352,1334.2624,1,40027056,40027872,816,0.5565924509657751
14017,1334.264433,1334.380367,1,40027932,40031411,3479,0.11772369608465612
14018,1334.3819,1334.519567,1,40031457,40035587,4130,0.2589669801989927
14019,1334.5209,1334.535233,1,40035627,40036056,429,0.2378224482524014
14020,1334.536267,1334.5398,1,40036088,40036194,106,0.4617838233469478
14021,1334.548,1334.630033,1,40036440,40038900,2460,-0.019514650143323372
14022,1334.643633,1334.708967,1,40039308,40041269,1961,0.012804844182455349
14023,1334.710133,1334.715333,1,40041303,40041459,156,0.5976114908361738
14024,1334.716933,1334.737133,1,40041507,40042113,606,0.008794628229753824
14025,1334.753033,1334.7577,1,40042590,40042731,141,0.35090393118664853
14026,1334.9048,1334.910433,1,40047144,40047312,168,0.7970705482669489
14027,1335.301633,1335.309467,1,40059048,40059284,236,0.7362886802474288
14028,1335.332433,1335.348467,1,40059972,40060454,482,0.27428167259091857
14029,1335.365033,1335.3696,1,40060950,40061088,138,0.8681377023507475
14030,1335.389933,1335.4584,1,40061697,40063752,2055,0.22245639791288535
14031,1335.488533,1335.501833,1,40064655,40065054,399,0.7993826847592101
14032,1335.530467,1335.5344,1,40065914,40066032,118,0.895559490753095
14033,1335.577333,1335.581367,1,40067319,40067441,122,0.8583016695872512
14034,1335.676533,1335.689333,1,40070295,40070679,384,0.6709057888159164
14035,1335.766267,1335.906567,1,40072988,40077197,4209,0.38773867445204063
14036,1335.907567,1335.9173,1,40077227,40077519,292,0.8738247586053436
14037,1335.918633,1335.9608,1,40077558,40078824,1266,0.4306741168115713
14038,1335.961833,1335.968767,1,40078854,40079063,209,0.39656133011305417
14039,1335.969833,1336.017967,1,40079094,40080539,1445,0.24181469306815134
14040,1336.020067,1336.054233,1,40080602,40081626,1024,0.21182791546547752
14041,1336.0561,1336.060733,1,40081683,40081821,138,0.3782484857644064
14042,1336.096433,1336.1012,1,40082892,40083036,144,0.8940958312133005
14043,1336.105633,1336.115233,1,40083168,40083456,288,0.3995328324144099
14044,1336.208567,1336.213467,1,40086257,40086404,147,0.7619633985125119
14045,1336.2251,1336.375467,1,40086753,40091264,4511,0.41484539012740285
14046,1336.379633,1336.384133,1,40091388,40091523,135,0.7158845652989609
14047,1336.387,1336.394867,1,40091610,40091846,236,0.8291644215512337
14048,1336.3962,1336.519467,1,40091886,40095584,3698,0.21667341943746812
14049,1336.521133,1336.552733,1,40095633,40096581,948,0.3521650228539201
14050,1336.5795,1336.600033,1,40097385,40098000,615,0.538504621020473
14051,1336.630633,1336.728567,1,40098918,40101857,2939,0.25213904950953575
14052,1336.736867,1336.763767,1,40102106,40102913,807,0.5141694052502509
14053,1336.768933,1336.781067,1,40103067,40103432,365,0.39679516189561226
14054,1336.793967,1336.804067,1,40103819,40104122,303,0.3166295915976384
14055,1336.8076,1336.815,1,40104228,40104450,222,0.5066191605798743
14056,1336.820567,1336.854733,1,40104617,40105641,1024,0.30867581896845353
14057,1336.8645,1336.878767,1,40105935,40106363,428,0.011169702790683769
14058,1336.880367,1336.909567,1,40106411,40107287,876,0.23407071833793344
14059,1336.912833,1336.926733,1,40107384,40107801,417,0.07385965421495833
14060,1336.9373,1336.9452,1,40108119,40108356,237,0.8398898494081525
14061,1336.950733,1336.969733,1,40108521,40109091,570,0.30428221891888013
14062,1336.971367,1337.0148,1,40109141,40110444,1303,0.12212853432557938
14063,1337.017367,1337.024933,1,40110521,40110747,226,0.11100402708278082
14064,1337.0265,1337.094967,1,40110795,40112849,2054,0.14638576059411393
14065,1337.096267,1337.127067,1,40112888,40113812,924,0.1862036397524458
14066,1337.129067,1337.136667,1,40113872,40114100,228,0.27616988461073044
14067,1337.1413,1337.1471,1,40114239,40114413,174,0.7238836118250466
14068,1337.152533,1337.158167,1,40114575,40114745,170,0.7872661985894616
14069,1337.163167,1337.2382,1,40114895,40117146,2251,0.1349081627212985
14070,1337.2451,1337.3016,1,40117353,40119048,1695,0.23574090632489192
14071,1337.303233,1337.308633,1,40119096,40119258,162,0.4290486846201763
14072,1337.311133,1337.3706,1,40119333,40121118,1785,0.12439739776947568
14073,1337.3719,1337.392167,1,40121157,40121765,608,0.11541802094165587
14074,1337.3932,1337.4228,1,40121796,40122684,888,0.15228679837584122
14075,1337.4288,1337.4473,1,40122864,40123419,555,0.3577403565845881
14076,1337.449167,1337.489133,1,40123475,40124673,1198,0.16911623577340595
14077,1337.495867,1337.502467,1,40124876,40125074,198,0.7201724770450619
14078,1337.505233,1337.550767,1,40125156,40126523,1367,0.14285003784948266
14079,1337.583633,1337.674233,1,40127508,40130226,2718,0.13876320043456072
14080,1337.675333,1337.724733,1,40130259,40131741,1482,0.25987328172922597
14081,1337.731367,1337.7634,1,40131941,40132902,961,0.22679638635674437
14082,1337.772767,1337.838933,1,40133183,40135167,1984,0.2331445799103141
14083,1337.8423,1337.892567,1,40135269,40136777,1508,0.41065087850980214
14084,1337.999567,1338.0038,1,40139987,40140114,127,0.7907101872777148
14085,1338.044633,1338.152067,1,40141338,40144562,3224,0.14856031934264102
14086,1338.157233,1338.2095,1,40144716,40146285,1569,0.2503643589254025
14087,1338.2108,1338.327733,1,40146324,40149831,3507,0.13189470443355675
14088,1338.331967,1338.381567,1,40149959,40151447,1488,0.32715911744835585
14089,1338.3826,1338.427667,1,40151478,40152830,1352,0.19417919611056758
14090,1338.436533,1338.460833,1,40153095,40153824,729,0.038372514442729024
14091,1338.473867,1338.479267,1,40154216,40154378,162,0.033544139012420364
14092,1338.492533,1338.5097,1,40154775,40155291,516,0.1978606930769985
14093,1338.516033,1338.526233,1,40155480,40155786,306,-0.11509774523324982
14094,1338.5404,1338.5438,1,40156212,40156314,102,0.886106463824389
14095,1338.554833,1338.559367,1,40156644,40156781,137,0.8204058952305556
14096,1338.560967,1338.606767,1,40156829,40158203,1374,0.14885045372239905
14097,1338.6108,1338.649767,1,40158324,40159493,1169,0.21102600579226322
14098,1338.669867,1338.675833,1,40160096,40160274,178,0.9150572125302661
14099,1338.677767,1338.771333,1,40160333,40163139,2806,0.05943921934943994
14100,1338.7782,1338.8429,1,40163346,40165287,1941,0.16636944941000334
14101,1338.844133,1338.895467,1,40165323,40166864,1541,0.1631177336586703
14102,1338.900167,1338.905967,1,40167005,40167179,174,0.9256891823463463
14103,1338.909633,1338.969267,1,40167288,40169078,1790,0.14623553968079678
14104,1338.973,1338.980867,1,40169190,40169426,236,0.47995778378627846
14105,1338.9835,1339.019033,1,40169505,40170570,1065,0.1260738163061178
14106,1339.0322,1339.036567,1,40170966,40171097,131,0.315571236314383
14107,1339.056133,1339.060367,1,40171683,40171811,128,0.552183967729542
14108,1339.0634,1339.074833,1,40171902,40172244,342,0.8088128926471742
14109,1339.076067,1339.100333,1,40172282,40173009,727,0.35146259406347685
14110,1339.115233,1339.121333,1,40173456,40173639,183,0.714690328843067
14111,1339.1306,1339.137067,1,40173918,40174112,194,0.7223346530944643
14112,1339.138667,1339.1674,1,40174160,40175022,862,0.12724019699564373
14113,1339.170067,1339.177267,1,40175102,40175318,216,0.6410151436073417
14114,1339.2052,1339.2253,1,40176156,40176759,603,0.18343006089708908
14115,1339.226333,1339.297867,1,40176789,40178936,2147,0.18570747864805534
14116,1339.317333,1339.3215,1,40179519,40179645,126,0.8462931553192505
14117,1339.332433,1339.377433,1,40179972,40181322,1350,0.14815816854447864
14118,1339.4032,1339.409433,1,40182096,40182282,186,0.8971577057593554
14119,1339.410733,1339.414833,1,40182321,40182444,123,0.6651919358050381
14120,1339.419333,1339.473867,1,40182579,40184216,1637,0.15881427070308848
14121,1339.489067,1339.497767,1,40184672,40184933,261,0.5249198227354204
14122,1339.5035,1339.517,1,40185105,40185510,405,0.9185726580642222
14123,1339.5202,1339.569033,1,40185606,40187070,1464,0.12244168619817701
14124,1339.574867,1339.635267,1,40187246,40189058,1812,0.041843424659065584
14125,1339.638567,1339.6429,1,40189157,40189287,130,0.6503205643941001
14126,1339.646633,1339.6529,1,40189398,40189587,189,0.3513464761478665
14127,1339.654433,1339.8155,1,40189632,40194465,4833,0.06310880352375713
14128,1339.8188,1339.933967,1,40194564,40198019,3455,0.14904600062348886
14129,1339.939767,1339.9664,1,40198193,40198992,799,0.1857749388024362
14130,1339.987567,1339.994133,1,40199627,40199823,196,0.441811542492136
14131,1340.0006,1340.005067,1,40200018,40200152,134,0.7749196354876111
14132,1340.007533,1340.023033,1,40200225,40200690,465,0.05153115064757711
14133,1340.024733,1340.036267,1,40200741,40201088,347,0.21122961274742
14134,1340.0642,1340.106167,1,40201926,40203185,1259,0.09836624714414458
14135,1340.107267,1340.3465,1,40203218,40210395,7177,0.10673578678939061
14136,1340.349067,1340.353233,1,40210472,40210596,124,0.6420136708084822
14137,1340.365467,1340.406567,1,40210964,40212197,1233,0.13865299533879577
14138,1340.422467,1340.455067,1,40212674,40213652,978,0.3111116978743122
14139,1340.4725,1340.4769,1,40214175,40214307,132,0.3549727267341988
14140,1340.484967,1340.491,1,40214549,40214730,181,0.9076168186046008
14141,1340.495967,1340.546733,1,40214879,40216401,1522,0.3822623760293072
14142,1340.581533,1340.657267,1,40217445,40219718,2273,0.31780530619833064
14143,1340.665267,1340.677933,1,40219958,40220337,379,0.19121181947959826
14144,1340.694133,1340.698367,1,40220823,40220951,128,0.8556202253016251
14145,1340.7016,1340.732033,1,40221048,40221960,912,0.04509540399371473
14146,1340.7574,1340.761333,1,40222722,40222839,117,0.6426359867184592
14147,1340.8314,1340.842667,1,40224942,40225280,338,0.7907142259232555
14148,1340.849533,1340.878567,1,40225485,40226357,872,0.47082899777006143
14149,1340.8871,1340.8928,1,40226613,40226784,171,0.8008594438378167
14150,1340.895133,1340.901467,1,40226853,40227044,191,0.5915249478062327
14151,1340.903567,1340.907867,1,40227107,40227236,129,0.9223865687708344
14152,1340.9335,1340.939933,1,40228005,40228197,192,0.494083741701086
14153,1340.943233,1340.977,1,40228296,40229310,1014,0.2938175331370574
14154,1340.982567,1341.0302,1,40229477,40230906,1429,0.5708432914721674
14155,1341.068233,1341.071633,1,40232046,40232148,102,0.9005331604211153
14156,1341.088967,1341.092,1,40232669,40232760,91,0.8016451859641267
14157,1341.128433,1341.134167,1,40233852,40234025,173,0.9125517860885045
14158,1341.135833,1341.145233,1,40234074,40234356,282,0.9520890588924271
14159,1341.1528,1341.205967,1,40234584,40236179,1595,0.327855399703113
14160,1341.2121,1341.220567,1,40236363,40236617,254,0.36182380227548605
14161,1341.222433,1341.3637,1,40236672,40240911,4239,0.3170313285336189
14162,1341.368367,1341.3724,1,40241051,40241172,121,0.7863219857109126
14163,1341.3746,1341.4068,1,40241238,40242204,966,0.3475804325735228
14164,1341.4256,1341.429467,1,40242768,40242884,116,0.6022147862514733
14165,1341.430933,1341.472833,1,40242927,40244184,1257,0.27181649949375564
14166,1341.492533,1341.545867,1,40244775,40246376,1601,0.16903203976403086
14167,1341.547067,1341.5523,1,40246412,40246569,157,0.74080926951026
14168,1341.561933,1341.565033,1,40246857,40246950,93,0.8405832957960097
14169,1341.566233,1341.647267,1,40246986,40249418,2432,0.11606618009459338
14170,1341.6517,1341.6747,1,40249551,40250241,690,0.14864116895944526
14171,1341.6758,1341.6789,1,40250274,40250367,93,0.7514188936886883
14172,1341.683467,1341.689633,1,40250504,40250688,184,0.5796631515510395
14173,1341.692667,1341.7025,1,40250780,40251075,295,0.6832404609190699
14174,1341.7054,1341.7362,1,40251162,40252086,924,0.10194328630814462
14175,1341.7688,1341.779767,1,40253064,40253393,329,0.5943894667656602
14176,1341.781667,1341.792333,1,40253450,40253769,319,0.7771776200731212
14177,1341.793633,1341.848333,1,40253808,40255449,1641,-0.03255065468426546
14178,1341.860667,1341.869833,1,40255820,40256094,274,0.6263197929056924
14179,1341.876067,1341.9104,1,40256282,40257312,1030,0.5578397882304931
14180,1341.966033,1341.970133,1,40258980,40259103,123,0.7239809532986154
14181,1341.982533,1342.0206,1,40259475,40260618,1143,0.16415887259579276
14182,1342.0219,1342.0259,1,40260657,40260777,120,0.7327114785205082
14183,1342.0328,1342.045267,1,40260984,40261358,374,-0.06367057714028654
14184,1342.0622,1342.066267,1,40261866,40261988,122,0.6027395161492155
14185,1342.078467,1342.129,1,40262354,40263870,1516,0.15901541553712398
14186,1342.1483,1342.1534,1,40264449,40264602,153,0.9450911401210028
14187,1342.1563,1342.198567,1,40264689,40265957,1268,0.12254098496416697
14188,1342.1997,1342.215367,1,40265991,40266461,470,0.3917414923669043
14189,1342.2273,1342.3048,1,40266819,40269144,2325,0.07915841839576968
14190,1342.310667,1342.3145,1,40269320,40269435,115,0.544574752370232
14191,1342.332567,1342.365,1,40269977,40270950,973,0.06941290556470768
14192,1342.383033,1342.393033,1,40271490,40271790,300,0.6620510244160138
14193,1342.394367,1342.4679,1,40271831,40274037,2206,0.19487196474717158
14194,1342.4723,1342.484767,1,40274169,40274543,374,0.5122826594881044
14195,1342.487267,1342.4924,1,40274618,40274772,154,0.8566584546607978
14196,1342.497067,1342.550733,1,40274912,40276521,1609,0.22453072970693327
14197,1342.6498,1342.653,1,40279494,40279590,96,0.32157889518804783
14198,1342.6554,1342.674433,1,40279662,40280232,570,0.3656221022661154
14199,1342.686333,1342.7109,1,40280589,40281327,738,0.44396622201770847
14200,1342.720033,1342.7237,1,40281600,40281711,111,0.6288118715730534
14201,1342.735367,1342.774133,1,40282061,40283223,1162,0.108627742797962
14202,1342.778033,1342.8184,1,40283340,40284552,1212,0.04927945753481179
14203,1342.819733,1342.823133,1,40284591,40284693,102,0.8896554042931769
14204,1342.8246,1342.831867,1,40284738,40284956,218,0.44045405425090767
14205,1342.838367,1342.8446,1,40285151,40285338,187,0.9013061129502207
14206,1342.852933,1342.893167,1,40285587,40286795,1208,0.11740657459020343
14207,1342.942467,1343.055733,1,40288274,40291671,3397,0.021856668218116614
14208,1343.0643,1343.073033,1,40291929,40292190,261,0.6082178617813163
14209,1343.0842,1343.090467,1,40292526,40292714,188,0.5722780622887951
14210,1343.095,1343.110967,1,40292850,40293329,479,0.34358349124876075
14211,1343.111967,1343.153267,1,40293359,40294598,1239,0.31723278377044983
14212,1343.162,1343.191233,1,40294860,40295736,876,0.07315733036261181
14213,1343.1927,1343.202533,1,40295781,40296075,294,0.13348712467470092
14214,1343.211167,1343.247033,1,40296335,40297410,1075,0.17760849896622394
14215,1343.250633,1343.257633,1,40297518,40297728,210,0.814910694231389
14216,1343.259067,1343.272433,1,40297772,40298172,400,0.5370888395351764
14217,1343.300133,1343.3168,1,40299003,40299504,501,0.7995405395807668
14218,1343.346633,1343.3644,1,40300398,40300932,534,0.9097089746764853
14219,1343.3667,1343.418533,1,40301001,40302555,1554,0.4936640733554217
14220,1343.420767,1343.437667,1,40302623,40303130,507,0.39545679670058537
14221,1343.444533,1343.448667,1,40303335,40303460,125,0.8542335055945005
14222,1343.4537,1343.465933,1,40303611,40303977,366,0.6467417975830894
14223,1343.467367,1343.800033,1,40304021,40314000,9979,0.1491049178778871
14224,1343.808133,1344.0247,1,40314243,40320741,6498,0.11635601237203487
14225,1344.063533,1344.109933,1,40321905,40323297,1392,0.18791952667338035
14226,1344.111033,1344.1223,1,40323330,40323669,339,0.11329207913518803
14227,1344.127533,1344.136067,1,40323825,40324082,257,0.04667075978093801
14228,1344.140067,1344.1863,1,40324202,40325589,1387,0.20242788529400949
14229,1344.187533,1344.206067,1,40325625,40326182,557,0.04789335543523084
14230,1344.207567,1344.422567,1,40326227,40332677,6450,0.05391677404163459
14231,1344.425967,1344.510267,1,40332779,40335308,2529,0.08622357497304702
14232,1344.524,1344.570633,1,40335720,40337118,1398,0.14586059704028745
14233,1344.5819,1344.619567,1,40337457,40338587,1130,0.22761094799541132
14234,1344.628133,1344.665167,1,40338843,40339955,1112,0.624855191096407
14235,1344.6679,1344.691033,1,40340037,40340730,693,0.4827688223015032
14236,1344.698433,1344.7088,1,40340952,40341264,312,0.8854383902352772
14237,1344.950867,1344.955,1,40348526,40348650,124,0.7281074518218196
14238,1345.174567,1345.178,1,40355237,40355340,103,0.7528977307475065
14239,1345.200233,1345.3246,1,40356006,40359738,3732,0.26197184861712014
14240,1345.327067,1345.3328,1,40359812,40359984,172,0.6327852562027776
14241,1345.336733,1345.416167,1,40360101,40362485,2384,0.42962582165165003
14242,1345.430333,1345.530533,1,40362909,40365915,3006,0.27471508517799104
14243,1345.537367,1345.5736,1,40366121,40367208,1087,0.33862096145224374
14244,1345.5754,1345.582,1,40367262,40367460,198,0.9337805712755601
14245,1345.597133,1345.651367,1,40367913,40369541,1628,0.18988602412445374
14246,1345.652433,1345.6572,1,40369572,40369716,144,0.35661151625380927
14247,1345.6582,1345.9268,1,40369746,40377804,8058,0.20210488995722317
14248,1345.9342,1345.9685,1,40378026,40379055,1029,0.46738309004096307
14249,1345.971267,1345.993233,1,40379138,40379796,658,0.2899452598043764
14250,1346.0023,1346.0163,1,40380069,40380489,420,0.6145992006736785
14251,1346.065267,1346.1047,1,40381958,40383141,1183,0.3258776216069672
14252,1346.106833,1346.1331,1,40383204,40383993,789,0.30229694626202097
14253,1346.136433,1346.191433,1,40384092,40385742,1650,0.23953363820051482
14254,1346.192533,1346.270367,1,40385775,40388111,2336,0.1790905952938461
14255,1346.274833,1346.301767,1,40388244,40389053,809,0.1517476761748059
14256,1346.346,1346.349,1,40390380,40390470,90,0.8840151840144109
14257,1346.3518,1346.3557,1,40390554,40390671,117,0.715164158020603
14258,1346.358067,1346.4025,1,40390742,40392075,1333,0.16644726319077593
14259,1346.410667,1346.4416,1,40392320,40393248,928,0.1900409022214218
14260,1346.443067,1346.4669,1,40393292,40394007,715,0.3052181165872178
14261,1346.468733,1346.4763,1,40394061,40394289,228,0.7539925885995634
14262,1346.5053,1346.519867,1,40395159,40395596,437,0.6480799160865702
14263,1346.522467,1346.5378,1,40395674,40396134,460,0.20206433917587555
14264,1346.538967,1346.543633,1,40396169,40396308,139,0.49387223149610593
14265,1346.548233,1346.551667,1,40396446,40396550,104,0.48254758400011516
14266,1346.568033,1346.591433,1,40397040,40397742,702,0.12551493588109294
14267,1346.603733,1346.6943,1,40398111,40400829,2718,0.3780267860652701
14268,1346.733367,1346.7381,1,40402001,40402143,142,0.7535710772857868
14269,1346.7418,1346.771033,1,40402254,40403130,876,0.23986549226496798
14270,1346.772333,1346.7974,1,40403169,40403922,753,0.5207372125244875
14271,1346.883867,1346.886867,1,40406516,40406606,90,0.9185393285715618
14272,1346.902067,1346.9097,1,40407062,40407291,229,0.7164802966859557
14273,1346.919867,1346.923667,1,40407596,40407710,114,0.7184766741690427
14274,1346.924733,1346.9637,1,40407741,40408911,1170,0.4652245750323581
14275,1346.965967,1347.012567,1,40408979,40410377,1398,0.23514552430609104
14276,1347.0143,1347.169367,1,40410429,40415081,4652,0.16624906483775612
14277,1347.172767,1347.369967,1,40415183,40421099,5916,0.20703247515065118
14278,1347.378733,1347.385033,1,40421361,40421550,189,-0.1466076192736446
14279,1347.3877,1347.3939,1,40421631,40421817,186,0.36947165023099415
14280,1347.399,1347.487833,1,40421970,40424634,2664,0.24671048469210016
14281,1347.489267,1347.669867,1,40424678,40430096,5418,0.24050480775650634
14282,1347.672467,1347.708767,1,40430174,40431263,1089,0.46031457478097604
14283,1347.714467,1347.719133,1,40431434,40431573,139,0.7136354753406959
14284,1347.729567,1347.733633,1,40431887,40432008,121,0.7568536225087987
14285,1347.738233,1347.874267,1,40432146,40436228,4082,0.24808065484065112
14286,1347.880167,1347.934867,1,40436405,40438046,1641,0.41177083585045754
14287,1347.9364,1347.9398,1,40438092,40438194,102,0.9574769350244593
14288,1347.944867,1347.949833,1,40438346,40438494,148,0.89730274816374
14289,1347.950867,1347.956133,1,40438526,40438683,157,0.9359874564712014
14290,1347.966,1348.146067,1,40438980,40444382,5402,0.1575713987516801
14291,1348.154167,1348.209267,1,40444625,40446278,1653,0.4610074214529062
14292,1348.211233,1348.278633,1,40446336,40448358,2022,0.21534076477815436
14293,1348.293733,1348.327967,1,40448811,40449839,1028,0.293273518959337
14294,1348.360533,1348.369333,1,40450815,40451079,264,0.5860592152069175
14295,1348.372,1348.433267,1,40451160,40452998,1838,0.288191462806661
14296,1348.4354,1348.457733,1,40453062,40453731,669,0.27119744730249434
14297,1348.460333,1348.504167,1,40453809,40455125,1316,0.608049285295333
14298,1348.506267,1348.551133,1,40455188,40456533,1345,0.4362163171816633
14299,1348.5586,1348.581467,1,40456758,40457444,686,0.4994317293121413
14300,1348.582833,1348.598333,1,40457484,40457949,465,0.4390156105793341
14301,1348.636067,1348.6395,1,40459082,40459185,103,0.5440645719837068
14302,1348.662933,1348.6697,1,40459887,40460091,204,0.17782707490239572
14303,1348.712033,1348.718767,1,40461360,40461563,203,0.7773918109669892
14304,1348.779367,1348.783867,1,40463381,40463516,135,0.5482984485776755
14305,1348.784867,1348.842433,1,40463546,40465272,1726,0.37968669907305175
14306,1348.8528,1348.8582,1,40465584,40465746,162,0.5088457848889236
14307,1348.862733,1348.888733,1,40465881,40466661,780,0.2554278945524008
14308,1348.896133,1348.909633,1,40466883,40467288,405,0.941391059555092
14309,1348.9127,1348.958833,1,40467381,40468764,1383,0.18080154744426408
14310,1348.9706,1349.0047,1,40469118,40470141,1023,0.1605877277980826
14311,1349.0164,1349.0279,1,40470492,40470837,345,0.09148275049861006
14312,1349.0333,1349.038667,1,40470999,40471160,161,0.7575041148176418
14313,1349.0516,1349.057367,1,40471548,40471721,173,0.6747356869995164
14314,1349.058733,1349.0645,1,40471761,40471935,174,0.8750883006336988
14315,1349.100667,1349.104033,1,40473020,40473120,100,0.9116907204388174
14316,1349.113333,1349.121733,1,40473399,40473651,252,0.6874346364783481
14317,1349.129067,1349.135567,1,40473872,40474067,195,0.2267240036984538
14318,1349.136667,1349.208167,1,40474100,40476245,2145,0.17038294443122448
14319,1349.219833,1349.234767,1,40476594,40477043,449,0.7203876639147815
14320,1349.2755,1349.360067,1,40478265,40480802,2537,0.33888565974748897
14321,1349.364767,1349.387233,1,40480943,40481616,673,0.3399749939843717
14322,1349.389067,1349.410667,1,40481672,40482320,648,0.13561332345038324
14323,1349.411667,1349.428567,1,40482350,40482857,507,0.30667760976835584
14324,1349.4309,1349.433967,1,40482927,40483019,92,0.9263636445945859
14325,1349.4547,1349.4621,1,40483641,40483863,222,0.7135449147950332
14326,1349.494533,1349.498,1,40484835,40484940,105,0.6794295116540392
14327,1349.4994,1349.5934,1,40484982,40487802,2820,0.3967186264885061
14328,1349.602267,1349.625333,1,40488068,40488759,691,0.25265742642525924
14329,1349.628,1349.6476,1,40488840,40489428,588,0.694873851724606
14330,1349.6808,1349.684867,1,40490424,40490546,122,0.9137207528754757
14331,1349.686533,1349.691333,1,40490595,40490739,144,0.8058039607299947
14332,1349.7047,1349.708267,1,40491141,40491248,107,0.6761695153126012
14333,1349.711433,1349.722967,1,40491342,40491689,347,0.9424603193898508
14334,1349.729833,1349.7614,1,40491894,40492842,948,0.1815525883131946
14335,1349.765467,1349.892067,1,40492964,40496762,3798,0.24211295909871514
14336,1349.894067,1350.112133,1,40496822,40503363,6541,0.19213668229549782
14337,1350.113533,1350.132267,1,40503405,40503968,563,0.05129497828310843
14338,1350.138433,1350.156967,1,40504152,40504709,557,0.2451212879820846
14339,1350.163333,1350.169867,1,40504899,40505096,197,0.352509038682135
14340,1350.174267,1350.178167,1,40505228,40505345,117,0.6951192080517271
14341,1350.1851,1350.254633,1,40505553,40507638,2085,0.11719747007660311
14342,1350.257633,1350.297767,1,40507728,40508933,1205,-0.0016532003777055045
14343,1350.304967,1350.3094,1,40509149,40509282,133,0.9095428924166951
14344,1350.3119,1350.3552,1,40509357,40510656,1299,0.19312095455876133
14345,1350.357967,1350.3623,1,40510739,40510869,130,0.8939184993550573
14346,1350.366133,1350.3833,1,40510983,40511499,516,0.8130177108017246
14347,1350.5391,1350.542633,1,40516173,40516278,105,0.7874880627028851
14348,1350.550833,1350.554233,1,40516524,40516626,102,0.7326315577144985
14349,1350.874033,1350.964767,1,40526220,40528943,2723,0.27421668008094374
14350,1350.965967,1350.984367,1,40528979,40529531,552,0.7345904986907943
14351,1350.9895,1351.021833,1,40529685,40530654,969,0.227983631705804
14352,1351.022933,1351.0487,1,40530687,40531461,774,0.18794659364869823
14353,1351.070067,1351.1007,1,40532102,40533021,919,0.23822307680094132
14354,1351.105333,1351.109367,1,40533159,40533281,122,0.6439908806407241
14355,1351.134167,1351.146,1,40534025,40534380,355,0.6642360620479719
14356,1351.1703,1351.173567,1,40535109,40535207,98,0.6642570183482128
14357,1351.185033,1351.189867,1,40535550,40535696,146,0.630693911496506
14358,1351.1918,1351.2062,1,40535754,40536186,432,0.7625175140338334
14359,1351.208633,1351.214033,1,40536258,40536420,162,0.5387915454266953
14360,1351.2151,1351.307767,1,40536453,40539233,2780,0.2409855505770282
14361,1351.311467,1351.317267,1,40539344,40539518,174,0.8591309607874026
14362,1351.318367,1351.3326,1,40539551,40539978,427,0.5705829709929222
14363,1351.349733,1351.419367,1,40540491,40542581,2090,0.20011001613431406
14364,1351.4299,1351.437767,1,40542897,40543133,236,0.7950841732977004
14365,1351.439167,1351.4439,1,40543175,40543317,142,0.9891568872799626
14366,1351.444967,1351.469067,1,40543349,40544072,723,0.5747218238802253
14367,1351.500967,1351.668267,1,40545029,40550048,5019,0.17952242754377684
14368,1351.678833,1351.684067,1,40550364,40550522,158,0.659269083673756
14369,1351.688533,1351.7018,1,40550655,40551054,399,0.2594080835120588
14370,1351.705233,1351.71,1,40551156,40551300,144,0.6118752934177532
14371,1351.712633,1351.719267,1,40551378,40551578,200,0.1056725025713061
14372,1351.728367,1351.743567,1,40551851,40552307,456,0.27549377697801464
14373,1351.772933,1351.7958,1,40553187,40553874,687,0.45530116357055
14374,1351.797267,1351.8269,1,40553918,40554807,889,0.16333273935729184
14375,1351.849067,1351.8769,1,40555472,40556307,835,0.01975417616013079
14376,1351.878067,1351.884433,1,40556342,40556532,190,0.816403373673717
14377,1351.886,1351.890133,1,40556580,40556703,123,0.8604565269285063
14378,1351.895133,1351.909767,1,40556853,40557293,440,0.5395698068861017
14379,1351.916333,1351.984667,1,40557489,40559540,2051,0.19030472664017556
14380,1351.992933,1351.9961,1,40559787,40559883,96,0.6256545006699614
14381,1352.002867,1352.076033,1,40560086,40562280,2194,0.25743487525986863
14382,1352.0828,1352.126733,1,40562484,40563801,1317,0.32179962522712585
14383,1352.1373,1352.186933,1,40564119,40565607,1488,0.40103471737903174
14384,1352.190633,1352.2401,1,40565718,40567203,1485,0.24418809401023892
14385,1352.251833,1352.262033,1,40567554,40567860,306,0.7854984145754583
14386,1352.264933,1352.288967,1,40567947,40568669,722,0.2298043962309691
14387,1352.2902,1352.315167,1,40568706,40569455,749,0.26792021556167667
14388,1352.326833,1352.377267,1,40569804,40571318,1514,0.19315723783949248
14389,1352.3865,1352.443,1,40571595,40573290,1695,0.31378710376598706
14390,1352.4443,1352.451067,1,40573329,40573532,203,0.7780187965117629
14391,1352.452133,1352.4559,1,40573563,40573677,114,0.7686894966047616
14392,1352.458533,1352.528667,1,40573755,40575860,2105,0.26212052020040805
14393,1352.535533,1352.5475,1,40576065,40576425,360,0.7946113571628756
14394,1352.549033,1352.6275,1,40576470,40578825,2355,0.1886274613463299
14395,1352.629033,1352.729867,1,40578870,40581896,3026,0.2887746248455777
14396,1352.744767,1352.984333,1,40582343,40589529,7186,0.1671825812512338
14397,1352.9856,1353.050267,1,40589568,40591508,1940,0.21505608450564548
14398,1353.052167,1353.0735,1,40591565,40592205,640,0.336392491523806
14399,1353.078767,1353.116233,1,40592363,40593486,1123,0.32589267626325363
14400,1353.131633,1353.194433,1,40593948,40595832,1884,0.14738326372657462
14401,1353.195567,1353.264233,1,40595867,40597926,2059,0.2749618924008606
14402,1353.272833,1353.362533,1,40598184,40600875,2691,0.20530913802059017
14403,1353.392967,1353.429633,1,40601789,40602888,1099,0.2634351555860438
14404,1353.474067,1353.484467,1,40604222,40604534,312,0.22783593978939554
14405,1353.497533,1353.5096,1,40604925,40605288,363,0.08433954245696483
14406,1353.518767,1353.538633,1,40605563,40606158,595,0.1920544151449875
14407,1353.552967,1353.605333,1,40606589,40608159,1570,0.14083099205750252
14408,1353.6067,1353.6402,1,40608201,40609206,1005,0.41471349890505
14409,1353.642,1353.650833,1,40609260,40609524,264,0.6875382091558823
14410,1353.661333,1353.7014,1,40609839,40611042,1203,0.2662451821173382
14411,1353.702567,1353.7632,1,40611077,40612896,1819,0.6840131851639254
14412,1353.767867,1353.783833,1,40613036,40613514,478,0.6678134028303625
14413,1353.7854,1353.815467,1,40613562,40614464,902,0.37997897225151556
14414,1353.823233,1353.826967,1,40614696,40614809,113,0.6622777415774127
14415,1353.829867,1353.840533,1,40614896,40615215,319,0.7868416785391814
14416,1353.8422,1353.936333,1,40615266,40618089,2823,0.3463460959064863
14417,1353.958,1353.963767,1,40618740,40618913,173,0.9175358035690709
14418,1353.9782,1353.992867,1,40619346,40619786,440,0.6127725930062062
14419,1353.996533,1353.999633,1,40619895,40619988,93,0.758598737532025
14420,1354.0218,1354.0509,1,40620654,40621527,873,0.3240286885316808
14421,1354.0622,1354.072133,1,40621866,40622163,297,0.855072860039792
14422,1354.0802,1354.0879,1,40622406,40622637,231,0.85962185256837
14423,1354.0925,1354.103167,1,40622775,40623095,320,0.7630927462500161
14424,1354.1123,1354.1541,1,40623369,40624623,1254,0.41781942390891613
14425,1354.158433,1354.1653,1,40624752,40624959,207,0.34768351262975666
14426,1354.1966,1354.225333,1,40625898,40626759,861,0.05683140823951745
14427,1354.239967,1354.331733,1,40627199,40629951,2752,0.2696847527761098
14428,1354.332733,1354.336467,1,40629981,40630094,113,0.5074072105299677
14429,1354.348433,1354.365633,1,40630452,40630968,516,-0.05928743028463231
14430,1354.3687,1354.391933,1,40631061,40631757,696,0.040011513168607946
14431,1354.393233,1354.3967,1,40631796,40631901,105,0.40704709983014065
14432,1354.399033,1354.411533,1,40631970,40632345,375,0.365192771849521
14433,1354.415367,1354.453367,1,40632461,40633601,1140,0.20475204354732277
14434,1354.454633,1354.5057,1,40633638,40635171,1533,0.35199553543082407
14435,1354.530133,1354.534633,1,40635903,40636038,135,0.412307610346507
14436,1354.541333,1354.648933,1,40636239,40639467,3228,0.1831985970268869
14437,1354.6731,1354.695567,1,40640193,40640867,674,0.55474758370448
14438,1354.696767,1354.723133,1,40640903,40641693,790,0.07852637121784763
14439,1354.731633,1354.748467,1,40641948,40642454,506,0.7654006908186746
14440,1354.764567,1354.767633,1,40642937,40643028,91,0.27671000268227863
14441,1354.790067,1354.8009,1,40643702,40644027,325,0.2026909658274914
14442,1354.807867,1354.821233,1,40644236,40644636,400,0.20007505586730176
14443,1354.8225,1354.8315,1,40644675,40644945,270,0.6023285969452875
14444,1354.832867,1354.836267,1,40644986,40645088,102,0.8096890343674918
14445,1354.837467,1354.856833,1,40645124,40645704,580,0.3666257003198886
14446,1354.858567,1354.8848,1,40645757,40646544,787,0.24318987003363296
14447,1354.888933,1354.910367,1,40646667,40647311,644,0.5870165948585807
14448,1354.920133,1354.957033,1,40647603,40648710,1107,0.34717533740722967
14449,1354.9806,1355.015433,1,40649418,40650462,1044,0.024852110787838885
14450,1355.0166,1355.029,1,40650498,40650870,372,0.5943859446611387
14451,1355.035933,1355.087367,1,40651077,40652621,1544,0.38003299624216125
14452,1355.088733,1355.113767,1,40652661,40653413,752,0.663826827768508
14453,1355.1154,1355.167233,1,40653462,40655016,1554,0.2698633766819811
14454,1355.176533,1355.2007,1,40655295,40656021,726,0.6408045049584372
14455,1355.208267,1355.279767,1,40656248,40658393,2145,0.24815634695100341
14456,1355.291667,1355.310867,1,40658750,40659326,576,0.368319162338752
14457,1355.3121,1355.355733,1,40659363,40660671,1308,0.25882854643305675
14458,1355.3675,1355.486967,1,40661025,40664609,3584,0.18016781715683225
14459,1355.489367,1355.587333,1,40664681,40667619,2938,0.1592791563761228
14460,1355.588567,1355.6102,1,40667657,40668306,649,0.2904623508753503
14461,1355.614667,1355.6216,1,40668440,40668648,208,0.5276334765167787
14462,1355.628667,1355.6564,1,40668860,40669692,832,0.7280860696681131
14463,1355.663967,1355.6729,1,40669919,40670187,268,0.666255664173201
14464,1355.680567,1355.696333,1,40670417,40670889,472,0.5940302415711441
14465,1355.697833,1355.7405,1,40670934,40672215,1281,0.2548535324152836
14466,1355.752467,1355.755533,1,40672574,40672665,91,0.6659788013430292
14467,1355.760067,1355.824833,1,40672802,40674744,1942,0.181875035402229
14468,1355.834567,1355.894567,1,40675037,40676837,1800,0.07936277384053293
14469,1355.896767,1355.9385,1,40676903,40678155,1252,0.27845870579878407
14470,1355.947267,1355.951233,1,40678418,40678536,118,0.06128499798134441
14471,1355.9561,1355.991367,1,40678683,40679741,1058,0.5753319732373501
14472,1356.0081,1356.0136,1,40680243,40680408,165,0.688903923404536
14473,1356.025033,1356.0364,1,40680750,40681092,342,0.10706739032401791
14474,1356.037767,1356.046367,1,40681133,40681391,258,0.8455723407225917
14475,1356.0866,1356.0907,1,40682598,40682721,123,0.8407647582948459
14476,1356.094133,1356.173167,1,40682823,40685195,2372,0.11332144581835824
14477,1356.1744,1356.204567,1,40685232,40686137,905,-0.007099169351502045
14478,1356.218867,1356.222467,1,40686566,40686674,108,0.7882608812911007
14479,1356.225033,1356.228533,1,40686750,40686855,105,0.864420891538185
14480,1356.234533,1356.243033,1,40687035,40687290,255,0.6325938106983704
14481,1356.245733,1356.2744,1,40687371,40688232,861,0.3728323528405185
14482,1356.2874,1356.296067,1,40688622,40688882,260,0.7418420024624223
14483,1356.302633,1356.3087,1,40689078,40689261,183,0.41386884989334616
14484,1356.330533,1356.336567,1,40689915,40690097,182,0.6466187665267863
14485,1356.353267,1356.357333,1,40690598,40690719,121,0.8679087841544598
14486,1356.367133,1356.422,1,40691013,40692660,1647,0.29223776999649426
14487,1356.4409,1356.463,1,40693227,40693890,663,0.649685950727226
14488,1356.4884,1356.508133,1,40694652,40695243,591,0.16404631553077242
14489,1356.513467,1356.525,1,40695404,40695750,346,0.8627918192023611
14490,1356.543567,1356.549767,1,40696307,40696493,186,0.8105072218804626
14491,1356.556333,1356.5729,1,40696689,40697187,498,0.8256243707132396
14492,1356.574133,1356.599367,1,40697223,40697981,758,0.37642106579820944
14493,1356.6012,1356.6272,1,40698036,40698816,780,0.32233393069016747
14494,1356.664467,1356.690133,1,40699934,40700703,769,0.6373104646591825
14495,1356.793867,1356.830933,1,40703816,40704927,1111,0.19792124258885307
14496,1356.8376,1356.8623,1,40705128,40705869,741,0.26423159384035155
14497,1356.8643,1356.877167,1,40705929,40706315,386,0.8254193747646037
14498,1356.923467,1356.935333,1,40707704,40708059,355,0.27084884275869103
14499,1356.9475,1356.954367,1,40708425,40708631,206,0.5587489531868884
14500,1356.971467,1357.009533,1,40709144,40710285,1141,0.4223122740827689
14501,1357.019267,1357.023767,1,40710578,40710713,135,0.7283304809609374
14502,1357.0351,1357.039533,1,40711053,40711185,132,0.3343144778808933
14503,1357.0839,1357.0923,1,40712517,40712769,252,0.7372836583522404
14504,1357.096667,1357.104233,1,40712900,40713126,226,0.7437655704787226
14505,1357.126233,1357.152567,1,40713786,40714577,791,0.352224351276746
14506,1357.178333,1357.1821,1,40715349,40715463,114,0.7425623930939619
14507,1357.2358,1357.240867,1,40717074,40717226,152,0.7195674574112957
14508,1357.259667,1357.262833,1,40717790,40717884,94,0.9301692074524646
14509,1357.659367,1357.662567,1,40729781,40729877,96,0.7838324211564979
14510,1357.665233,1357.670167,1,40729956,40730105,149,0.8842604363030793
14511,1357.8036,1357.813767,1,40734108,40734413,305,0.9364886130870832
14512,1357.825933,1357.878767,1,40734777,40736363,1586,0.4867509332655065
14513,1357.8804,1357.889733,1,40736412,40736691,279,0.7920382731072149
14514,1357.894133,1357.917033,1,40736823,40737510,687,0.5165155060334354
14515,1357.924267,1357.959367,1,40737728,40738781,1053,0.5238899482408687
14516,1357.9607,1357.9872,1,40738821,40739616,795,0.6565595365083141
14517,1357.991233,1358.0138,1,40739736,40740414,678,0.4637230990928798
14518,1358.019233,1358.0517,1,40740576,40741551,975,0.33632683170320804
14519,1358.056767,1358.060467,1,40741703,40741814,111,0.7461021453622696
14520,1358.063,1358.086633,1,40741890,40742598,708,0.47472614536561036
14521,1358.090067,1358.0979,1,40742702,40742937,235,0.6980526208508897
14522,1358.106933,1358.124933,1,40743207,40743747,540,0.7289886611935953
14523,1358.143067,1358.1609,1,40744292,40744827,535,0.6749007541769293
14524,1358.162333,1358.184933,1,40744869,40745547,678,0.5514419003494165
14525,1358.231567,1358.235167,1,40746947,40747055,108,0.8384887880446882
14526,1358.3746,1358.3903,1,40751238,40751709,471,0.9101298995470462
14527,1358.394567,1358.4121,1,40751837,40752363,526,0.21897981429478092
14528,1358.421767,1358.490933,1,40752653,40754727,2074,0.37652714713212865
14529,1358.505767,1358.529667,1,40755173,40755890,717,0.4761408210196542
14530,1358.545533,1358.5637,1,40756365,40756911,546,0.6085213171318644
14531,1358.567433,1358.588833,1,40757022,40757664,642,0.2302476302285154
14532,1358.6001,1358.641367,1,40758003,40759241,1238,0.523983079623873
14533,1358.6543,1358.668167,1,40759629,40760045,416,0.5310453129617242
14534,1358.669267,1358.7011,1,40760078,40761033,955,0.4995489504742425
14535,1358.712867,1358.759467,1,40761386,40762784,1398,0.6157525410335428
14536,1358.785533,1358.807333,1,40763565,40764219,654,0.7229921138535241
14537,1358.8135,1358.8168,1,40764405,40764504,99,0.7885983744694663
14538,1358.8178,1358.8765,1,40764534,40766295,1761,0.44247982274599096
14539,1358.8779,1359.0174,1,40766337,40770522,4185,0.15340993962464333
14540,1359.021167,1359.0447,1,40770635,40771341,706,0.062059911487762014
14541,1359.056833,1359.062433,1,40771704,40771872,168,0.7309857413817026
14542,1359.068967,1359.082567,1,40772069,40772477,408,0.8729721205848975
14543,1359.093067,1359.099133,1,40772792,40772973,181,0.8431426312142773
14544,1359.1004,1359.1067,1,40773012,40773201,189,0.7856753348705425
14545,1359.180467,1359.2679,1,40775414,40778037,2623,0.41089633596965114
14546,1359.269367,1359.366833,1,40778081,40781004,2923,0.6927044388839373
14547,1359.368133,1359.400033,1,40781043,40782000,957,0.7846105555250829
14548,1359.412733,1359.426133,1,40782381,40782783,402,0.8982182555200113
14549,1359.433067,1359.4837,1,40782992,40784511,1519,0.6355722785091932
14550,1359.4853,1359.506567,1,40784559,40785197,638,0.8853992876414246
14551,1359.5083,1359.546033,1,40785249,40786380,1131,0.5381320514326748
14552,1359.5472,1359.554133,1,40786416,40786623,207,0.8771046474363952
14553,1359.555533,1359.560367,1,40786665,40786811,146,0.9314356241318079
14554,1359.561567,1359.5805,1,40786847,40787415,568,0.4314958843692801
14555,1359.5882,1359.594267,1,40787646,40787828,182,0.4779712505315359
14556,1359.599067,1359.627667,1,40787972,40788830,858,0.5333526786128654
14557,1359.639033,1359.691833,1,40789170,40790754,1584,0.5001105728384339
14558,1359.6936,1359.747067,1,40790808,40792412,1604,0.2300825838389926
14559,1359.78,1359.884933,1,40793400,40796547,3147,0.25099038806427826
14560,1359.886133,1360.100767,1,40796583,40803023,6440,0.17544354515330263
14561,1360.1022,1360.194433,1,40803066,40805832,2766,0.08686175817180439
14562,1360.210767,1360.228567,1,40806323,40806857,534,0.1217706600002915
14563,1360.232533,1360.236167,1,40806975,40807085,110,0.9385076062571104
14564,1360.239767,1360.243433,1,40807193,40807302,109,0.9321415854886688
14565,1360.265533,1360.300933,1,40807965,40809027,1062,0.561607100187119
14566,1360.3935,1360.397267,1,40811805,40811918,113,0.8508750056643687
14567,1360.4469,1360.479833,1,40813407,40814394,987,0.5176038806970701
14568,1360.486433,1360.490933,1,40814592,40814727,135,0.869727683173035
14569,1360.502433,1360.5138,1,40815072,40815414,342,0.8075572343325333
14570,1360.5419,1360.545367,1,40816257,40816361,104,0.6801324514858533
14571,1360.583167,1360.5892,1,40817495,40817676,181,0.7403035042524349
14572,1360.762567,1360.7687,1,40822877,40823061,184,0.3897594459336466
14573,1360.887467,1360.891433,1,40826624,40826742,118,0.621956522642624
14574,1360.901333,1360.904367,1,40827039,40827131,92,0.9582700539582096
14575,1360.9251,1360.9294,1,40827753,40827882,129,0.7561129764606825
14576,1361.052467,1361.062,1,40831574,40831860,286,0.7309353807935617
14577,1361.1124,1361.116767,1,40833372,40833503,131,0.8148396870610625
14578,1361.3995,1361.403067,1,40841985,40842092,107,0.7908022367273938
14579,1361.409533,1361.443267,1,40842285,40843298,1013,0.8741364705648865
14580,1361.447633,1361.462267,1,40843428,40843868,440,0.6250890612243213
14581,1361.531967,1361.5387,1,40845959,40846161,202,0.6084764131332827
14582,1361.554733,1361.577967,1,40846641,40847339,698,0.6373819590283185
14583,1361.635567,1361.6393,1,40849067,40849179,112,0.6368899502139387
14584,1361.642467,1361.6665,1,40849274,40849995,721,0.5656019905183303
14585,1361.6724,1361.681633,1,40850172,40850448,276,0.6968552358821487
14586,1361.956733,1361.982767,1,40858701,40859483,782,0.06008329976280411
14587,1361.989067,1362.003467,1,40859672,40860104,432,0.8408826923235007
14588,1362.011,1362.056867,1,40860330,40861706,1376,0.24297196550609532
14589,1362.564167,1362.672567,1,40876925,40880177,3252,0.4026065977765153
14590,1362.675233,1362.699033,1,40880256,40880970,714,0.3857522487568166
14591,1362.735533,1362.741867,1,40882065,40882256,191,0.4417627967666293
14592,1363.0075,1363.0139,1,40890225,40890417,192,0.9084997546660679
14593,1363.0241,1363.0402,1,40890723,40891206,483,0.8904309451379351
14594,1363.510833,1363.514767,1,40905324,40905443,119,0.8426082658191191
14595,1363.5167,1363.520433,1,40905501,40905612,111,0.5882990629680684
14596,1363.526933,1363.531167,1,40905807,40905935,128,0.9125410709897017
14597,1363.563133,1363.594033,1,40906893,40907820,927,0.55142757547585
14598,1363.600733,1363.607567,1,40908021,40908227,206,0.7594078819598794
14599,1363.618167,1363.634567,1,40908545,40909037,492,0.3347694013999115
14600,1363.6404,1363.646967,1,40909212,40909409,197,0.8155523963569555
14601,1363.6613,1363.667033,1,40909839,40910010,171,0.9060044195599348
14602,1363.676033,1363.687233,1,40910280,40910616,336,0.7362676527415579
14603,1363.718033,1363.730933,1,40911540,40911927,387,0.0929700071961314
14604,1363.746867,1363.750733,1,40912406,40912521,115,0.7893422859070026
14605,1363.756533,1363.766833,1,40912695,40913004,309,0.54325416166869
14606,1363.827567,1363.831333,1,40914827,40914939,112,0.9331416523161251
14607,1363.847467,1363.855267,1,40915424,40915658,234,0.8626487551585399
14608,1363.860833,1363.872733,1,40915824,40916181,357,0.5873689447866164
14609,1363.884533,1363.897133,1,40916535,40916913,378,0.8186534324560225
14610,1363.951667,1363.954767,1,40918550,40918643,93,0.799641656905404
14611,1363.991467,1363.999667,1,40919744,40919990,246,0.8364492490096845
14612,1364.009767,1364.016967,1,40920293,40920509,216,0.6920649811948257
14613,1364.0186,1364.062,1,40920558,40921860,1302,0.31799994383482977
14614,1364.0631,1364.067,1,40921893,40922010,117,0.869672948061234
14615,1364.142133,1364.145333,1,40924263,40924359,96,0.8985327654220434
14616,1364.150167,1364.1789,1,40924505,40925367,862,0.3467216531370652
14617,1364.188733,1364.1998,1,40925661,40925994,333,0.54770706022878
14618,1364.207967,1364.223033,1,40926239,40926690,451,0.36291752567487034
14619,1364.224033,1364.241633,1,40926720,40927248,528,0.7060606323238258
14620,1364.2439,1364.291767,1,40927317,40928753,1436,0.4995810776989292
14621,1364.2975,1364.330533,1,40928925,40929915,990,0.36572166519180993
14622,1364.341567,1364.344567,1,40930247,40930337,90,0.8616664721503685
14623,1364.347567,1364.393,1,40930427,40931790,1363,0.5836516400960476
14624,1364.655833,1364.6626,1,40939674,40939878,204,0.23057555923826437
14625,1364.9369,1364.942333,1,40948107,40948269,162,0.5384714412044856
14626,1364.9467,1365.010033,1,40948401,40950300,1899,0.4242226213635172
14627,1365.023933,1365.027667,1,40950717,40950830,113,0.8659817130188145
14628,1365.0348,1365.0399,1,40951044,40951197,153,0.7806898905951704
14629,1365.044267,1365.095333,1,40951328,40952859,1531,0.34954770625786385
14630,1365.096733,1365.103733,1,40952901,40953111,210,0.7013505284894358
14631,1365.112133,1365.1211,1,40953363,40953633,270,0.675351376415804
14632,1365.143367,1365.149267,1,40954301,40954478,177,0.6312729369968246
14633,1365.165667,1365.192567,1,40954970,40955777,807,0.3092405648741998
14634,1365.216633,1365.231733,1,40956498,40956951,453,0.7782902395542186
14635,1365.239767,1365.243367,1,40957193,40957301,108,0.8620256864237824
14636,1365.3302,1365.3381,1,40959906,40960143,237,0.6626085296147496
14637,1365.3461,1365.3513,1,40960383,40960539,156,0.8405536659093258
14638,1365.352833,1365.3636,1,40960584,40960908,324,0.7490657330298219
14639,1365.368867,1365.373033,1,40961066,40961190,124,0.36543675674695136
14640,1365.3747,1365.3817,1,40961241,40961451,210,0.415909899409617
14641,1365.383167,1365.4455,1,40961495,40963365,1870,0.1230628985830368
14642,1365.466033,1365.7136,1,40963980,40971408,7428,0.15223248684364438
14643,1365.721067,1365.735133,1,40971632,40972053,421,0.09875752088869054
14644,1365.7476,1365.752067,1,40972428,40972562,134,0.3027032359971596
14645,1365.7606,1365.8081,1,40972818,40974243,1425,0.1455567406082517
14646,1365.829833,1365.838333,1,40974894,40975149,255,0.363093782126073
14647,1365.856267,1365.8665,1,40975688,40975995,307,0.7016410434984386
14648,1365.888567,1365.892833,1,40976657,40976784,127,0.6943621548337818
14649,1365.9064,1365.913833,1,40977192,40977414,222,0.8056084734903357
14650,1365.917533,1365.928667,1,40977525,40977860,335,0.6451722418895515
14651,1365.929867,1365.934667,1,40977896,40978040,144,0.9141125484073357
14652,1365.935733,1365.947267,1,40978071,40978418,347,0.5396494204627594
14653,1365.9541,1365.9581,1,40978623,40978743,120,-0.32856954916949777
14654,1365.9687,1365.9721,1,40979061,40979163,102,0.875872398832446
14655,1365.996867,1366.011433,1,40979906,40980342,436,0.725345965174187
14656,1366.663433,1366.672367,1,40999902,41000171,269,0.828813317636746
14657,1366.718,1366.7546,1,41001540,41002638,1098,0.5384321958976742
14658,1366.801167,1366.8369,1,41004035,41005107,1072,0.629359180768306
14659,1366.846833,1366.8687,1,41005404,41006061,657,0.5436039314245724
14660,1367.057933,1367.0662,1,41011737,41011986,249,0.8307371974840776
14661,1367.067367,1367.074433,1,41012021,41012232,211,0.5749241687175575
14662,1367.0898,1367.252967,1,41012694,41017589,4895,0.5335102877623913
14663,1367.2634,1367.268133,1,41017902,41018043,141,0.7838795581224222
14664,1367.2845,1367.290667,1,41018535,41018720,185,0.8657834039249466
14665,1367.318333,1367.326967,1,41019549,41019809,260,0.8651892702032521
14666,1367.501733,1367.5428,1,41025051,41026284,1233,0.2783069319437306
14667,1367.547,1367.580267,1,41026410,41027408,998,0.7632956638565409
14668,1367.586933,1367.6324,1,41027607,41028972,1365,0.26672108659375315
14669,1367.6509,1367.801233,1,41029527,41034036,4509,0.20868834896301966
14670,1367.808,1367.882033,1,41034240,41036460,2220,0.14053877800548395
14671,1367.897267,1367.926433,1,41036918,41037792,874,0.6866114505831741
14672,1367.979033,1368.392867,1,41039370,41051786,12416,0.15820550129964617
14673,1368.397333,1368.665067,1,41051919,41059952,8033,0.16021648882895934
14674,1368.666267,1368.7159,1,41059988,41061477,1489,0.225892290328836
14675,1368.717567,1368.735733,1,41061527,41062071,544,0.4237665388961095
14676,1368.749233,1368.767467,1,41062476,41063024,548,0.641411790088858
14677,1368.781433,1368.791433,1,41063442,41063742,300,0.40957374054149354
14678,1368.812733,1368.829833,1,41064381,41064894,513,0.2682009915764835
14679,1368.844067,1368.884533,1,41065322,41066535,1213,0.6552587651506019
14680,1368.897267,1368.949467,1,41066918,41068484,1566,0.16680657408229702
14681,1368.9509,1368.990767,1,41068527,41069723,1196,0.1611107705417993
14682,1368.992533,1369.0734,1,41069775,41072202,2427,0.1492101505509696
14683,1369.1348,1369.1384,1,41074044,41074152,108,0.8508902076834447
14684,1369.194267,1369.206033,1,41075828,41076180,352,0.5182694357379743
14685,1369.2129,1369.2241,1,41076387,41076723,336,0.8651142200948293
14686,1369.296367,1369.3022,1,41078891,41079066,175,0.26096566687891254
14687,1370.1881,1370.1923,1,41105643,41105769,126,0.8167726441998113
14688,1370.5235,1370.546733,1,41115705,41116401,696,0.6113583565460701
14689,1370.554567,1370.579433,1,41116637,41117382,745,0.5837452004187381
14690,1370.606867,1370.610467,1,41118206,41118314,108,0.8729164352448096
14691,1370.6168,1370.642633,1,41118504,41119278,774,0.735584585303577
14692,1370.6577,1370.694967,1,41119731,41120849,1118,0.24140939253436464
14693,1370.698333,1370.701933,1,41120949,41121057,108,0.7706572742098794
14694,1370.7606,1370.766267,1,41122818,41122988,170,0.7182714417475383
14695,1370.772967,1370.780733,1,41123189,41123421,232,0.8834093111850633
14696,1370.782367,1370.791033,1,41123471,41123730,259,0.7866316316728215
14697,1371.015933,1371.214567,1,41130477,41136437,5960,0.32128736808429004
14698,1371.215933,1371.261233,1,41136477,41137836,1359,0.30149986476453955
14699,1371.599233,1371.6038,1,41147976,41148114,138,0.8255277465248794
14700,1371.620933,1371.635367,1,41148627,41149061,434,0.7403171417031449
14701,1371.6427,1371.682133,1,41149281,41150463,1182,0.37094552705628225
14702,1371.689,1371.705067,1,41150670,41151152,482,0.7508236651129756
14703,1371.706367,1371.813133,1,41151191,41154393,3202,0.3897600469070786
14704,1371.8192,1371.848767,1,41154576,41155463,887,0.22991608110487496
14705,1371.852333,1371.9144,1,41155569,41157432,1863,0.19877096199616542
14706,1371.916267,1371.919433,1,41157488,41157582,94,-0.3964357134861462
14707,1371.929633,1371.9579,1,41157888,41158737,849,0.30676346911987695
14708,1371.959633,1371.986533,1,41158788,41159595,807,0.5994188577384656
14709,1371.995533,1372.000167,1,41159865,41160005,140,0.8020282150253152
14710,1372.069967,1372.097833,1,41162099,41162934,835,0.6550499222582484
14711,1372.105467,1372.312167,1,41163164,41169365,6201,0.3491119012960409
14712,1372.330467,1372.4648,1,41169914,41173944,4030,0.2567056880212479
14713,1372.4665,1372.483133,1,41173995,41174493,498,0.20924917026213233
14714,1372.484167,1372.763033,1,41174525,41182890,8365,0.12513771669793242
14715,1372.7709,1372.7801,1,41183127,41183403,276,0.09413712235805101
14716,1372.791433,1372.8005,1,41183742,41184015,273,0.25829213548981295
14717,1372.816233,1372.8223,1,41184486,41184669,183,0.5494842715000751
14718,1372.842933,1372.848733,1,41185287,41185461,174,0.0016314138345540987
14719,1372.860367,1372.876267,1,41185811,41186288,477,0.4594647174285556
14720,1372.928733,1372.9372,1,41187861,41188116,255,0.2734947887237314
14721,1372.9659,1372.9697,1,41188977,41189091,114,0.893042245914165
14722,1373.0247,1373.044467,1,41190741,41191334,593,0.5395026597206649
14723,1373.074133,1373.0846,1,41192223,41192538,315,0.1377666790384711
14724,1373.1509,1373.1557,1,41194527,41194671,144,0.7210814893431408
14725,1373.1985,1373.221833,1,41195955,41196654,699,0.7494963775651784
14726,1373.246733,1373.6518,1,41197401,41209554,12153,0.11799279413182065
14727,1373.674633,1373.687233,1,41210238,41210616,378,0.26024989912704216
14728,1373.690467,1373.695033,1,41210714,41210850,136,0.6940532673262294
14729,1373.697167,1373.717833,1,41210915,41211534,619,0.36710409058214755
14730,1373.753367,1373.7708,1,41212601,41213124,523,0.33771584606865185
14731,1373.777633,1373.780667,1,41213328,41213420,92,0.45586178289910817
14732,1373.785867,1373.797067,1,41213576,41213912,336,-0.1910051840818182
14733,1373.8064,1373.8655,1,41214192,41215965,1773,0.39936211755514095
14734,1373.867767,1373.879733,1,41216033,41216391,358,0.5219555045077742
14735,1373.887367,1373.9444,1,41216621,41218332,1711,0.37043341142595265
14736,1373.9454,1373.9958,1,41218362,41219874,1512,0.31478845180146736
14737,1374.0001,1374.0104,1,41220003,41220312,309,0.8365137593046738
14738,1374.020067,1374.0429,1,41220602,41221287,685,0.4535645777867755
14739,1374.0563,1374.0598,1,41221689,41221794,105,0.7486317896712095
14740,1374.0612,1374.0654,1,41221836,41221962,126,0.6792159165803653
14741,1374.078633,1374.083667,1,41222358,41222510,152,0.6673328232156517
14742,1374.088867,1374.1041,1,41222666,41223123,457,0.5722801305324235
14743,1374.2688,1374.377267,1,41228064,41231318,3254,0.2931676374940629
14744,1374.3783,1374.4133,1,41231349,41232399,1050,0.32459576044168365
14745,1374.417633,1374.430533,1,41232528,41232915,387,0.7830805406727158
14746,1374.574333,1374.580867,1,41237229,41237426,197,0.6811588402466184
14747,1374.585867,1374.59,1,41237576,41237700,124,0.8800870501684258
14748,1374.592933,1374.6598,1,41237787,41239794,2007,0.289061076080512
14749,1374.661433,1374.705533,1,41239842,41241165,1323,0.08691593748628254
14750,1374.710167,1374.7206,1,41241305,41241618,313,0.5340767666122155
14751,1374.731133,1374.7493,1,41241933,41242479,546,-0.010612477855710307
14752,1374.762,1374.7803,1,41242860,41243409,549,-0.006362143975646322
14753,1374.800233,1374.839967,1,41244006,41245199,1193,0.3878020762394486
14754,1374.848033,1374.853867,1,41245440,41245616,176,0.7338869206202507
14755,1374.859933,1374.864367,1,41245797,41245931,134,0.4797913273796414
14756,1374.946133,1374.949233,1,41248383,41248476,93,0.9388925302372934
14757,1374.981533,1375.090267,1,41249445,41252708,3263,0.25678510859737486
14758,1375.102433,1375.152167,1,41253072,41254565,1493,0.22286995895110429
14759,1375.153867,1375.5593,1,41254616,41266779,12163,0.09815432629017182
14760,1375.5616,1375.579133,1,41266848,41267373,525,0.093072413933989
14761,1375.583233,1375.596633,1,41267496,41267898,402,0.26311246562129537
14762,1375.600067,1375.607467,1,41268002,41268224,222,0.6870784988626244
14763,1375.621,1375.707333,1,41268630,41271219,2589,0.14757736910912578
14764,1375.72,1375.730733,1,41271600,41271921,321,0.7528874517116415
14765,1375.737633,1375.743633,1,41272128,41272308,180,0.8018399592090051
14766,1375.7778,1375.788133,1,41273334,41273643,309,0.5393185725871938
14767,1375.866167,1375.8741,1,41275985,41276223,238,0.4224163344844902
14768,1375.9833,1375.989033,1,41279499,41279670,171,0.7829090329517551
14769,1375.995633,1376.0,1,41279868,41280000,132,0.8064934060122269
14770,1376.004533,1376.009167,1,41280135,41280275,140,0.6861103591693127
14771,1376.0172,1376.0293,1,41280516,41280879,363,0.7786564661095963
14772,1376.045667,1376.0538,1,41281370,41281614,244,0.6796542944368099
14773,1376.0656,1376.096933,1,41281968,41282907,939,0.42416889382455886
14774,1376.0982,1376.1068,1,41282946,41283204,258,0.7364051555863226
14775,1376.117133,1376.1224,1,41283513,41283672,159,0.7972820909117915
14776,1376.1235,1376.135167,1,41283705,41284055,350,0.3735231346388659
14777,1376.1414,1376.160067,1,41284242,41284802,560,0.8805867821605434
14778,1376.1632,1376.1889,1,41284896,41285667,771,0.49392142369194947
14779,1376.193733,1376.2129,1,41285811,41286387,576,0.29045015525694595
14780,1376.215633,1376.2326,1,41286468,41286978,510,0.2618110916546273
14781,1376.2495,1376.253967,1,41287485,41287619,134,-0.03099159592315785
14782,1376.257733,1376.260867,1,41287731,41287826,95,-0.012485614504146711
14783,1376.263233,1376.271967,1,41287896,41288159,263,0.16045728708374138
14784,1376.276933,1376.2928,1,41288307,41288784,477,0.2876721178365354
14785,1376.293867,1376.355567,1,41288816,41290667,1851,0.30692705435646533
14786,1376.363833,1376.486267,1,41290914,41294588,3674,0.25031740862960494
14787,1376.487467,1376.513367,1,41294624,41295401,777,0.48542388915407053
14788,1376.5158,1376.5298,1,41295474,41295894,420,0.9095622575273702
14789,1376.684767,1376.692333,1,41300543,41300769,226,0.8163120864596886
14790,1376.712033,1376.8417,1,41301360,41305251,3891,0.40644551083913494
14791,1376.8459,1376.926867,1,41305377,41307806,2429,0.3564360557601128
14792,1376.931567,1377.058033,1,41307947,41311740,3793,0.20102713512578033
14793,1377.0611,1377.2307,1,41311833,41316921,5088,0.047425548394411245
14794,1377.231967,1377.2353,1,41316959,41317059,100,0.39262010421261223
14795,1377.2363,1377.3844,1,41317089,41321532,4443,0.08786533339938526
14796,1377.386633,1377.3976,1,41321598,41321928,330,0.33585932134404345
14797,1377.399533,1377.533933,1,41321985,41326017,4032,0.24758562079972957
14798,1377.537033,1377.567733,1,41326110,41327031,921,0.1662563185283266
14799,1377.569,1377.6218,1,41327070,41328654,1584,0.2757241514724667
14800,1377.6291,1377.633233,1,41328873,41328996,123,0.7682561598244909
14801,1377.637667,1377.828367,1,41329130,41334851,5721,0.20875467822148996
14802,1377.829567,1377.839967,1,41334887,41335199,312,0.6697856237452661
14803,1377.843433,1377.8662,1,41335302,41335986,684,0.21420765718314366
14804,1377.870067,1377.971667,1,41336102,41339150,3048,0.22066296434961372
14805,1377.976567,1378.0577,1,41339297,41341731,2434,0.23153353869059956
14806,1378.059133,1378.090633,1,41341773,41342718,945,0.14207964629456912
14807,1378.092833,1378.104033,1,41342784,41343120,336,0.12660719395091055
14808,1378.1078,1378.118767,1,41343234,41343563,329,0.18847618346883582
14809,1378.126033,1378.148167,1,41343780,41344445,665,0.5345445184394331
14810,1378.1558,1378.168967,1,41344674,41345069,395,0.3515188121748813
14811,1378.184433,1378.189067,1,41345532,41345672,140,0.7657001898097342
14812,1378.1911,1378.2311,1,41345733,41346933,1200,0.3699695715513025
14813,1378.232233,1378.3029,1,41346966,41349087,2121,0.17313022656945384
14814,1378.320533,1378.329933,1,41349615,41349897,282,0.9029801649840407
14815,1378.335733,1378.385833,1,41350071,41351574,1503,0.1361666484961163
14816,1378.392267,1378.395433,1,41351768,41351862,94,0.496124157348501
14817,1378.403867,1378.413233,1,41352116,41352396,280,0.6808543368572014
14818,1378.428233,1378.4316,1,41352846,41352948,102,0.7028550517802463
14819,1378.434033,1378.438967,1,41353020,41353169,149,0.9305226107079443
14820,1378.451467,1378.4755,1,41353544,41354265,721,0.5104391608665515
14821,1378.481133,1378.496733,1,41354433,41354901,468,0.44209178372092695
14822,1378.501267,1378.510667,1,41355038,41355320,282,0.5122842514530526
14823,1378.526633,1378.5625,1,41355798,41356875,1077,0.4933010789586003
14824,1378.567233,1378.6032,1,41357016,41358096,1080,0.2677487473693145
14825,1378.6089,1378.612967,1,41358267,41358389,122,0.4384385581009405
14826,1378.620433,1378.629233,1,41358612,41358876,264,0.24847297692300796
14827,1378.662167,1378.694967,1,41359865,41360849,984,0.7773471809600955
14828,1378.703067,1378.715333,1,41361092,41361459,367,0.2883353481257758
14829,1378.7467,1378.749933,1,41362401,41362497,96,0.7602437720086915
14830,1378.873233,1378.882167,1,41366196,41366465,269,0.9078795167114737
14831,1378.9627,1378.969533,1,41368881,41369085,204,0.7031525468104735
14832,1378.972133,1379.025233,1,41369163,41370756,1593,0.36191181709891823
14833,1379.0313,1379.034733,1,41370939,41371041,102,0.8456272545203272
14834,1379.0427,1379.0817,1,41371281,41372451,1170,0.4311972861127384
14835,1379.0877,1379.102533,1,41372631,41373075,444,0.6959025263679752
14836,1379.104667,1379.253033,1,41373140,41377590,4450,0.28469535595595963
14837,1379.259267,1379.513067,1,41377778,41385392,7614,0.04153937656385913
14838,1379.519067,1379.539633,1,41385572,41386188,616,0.4581126827926952
14839,1379.5592,1379.738533,1,41386776,41392155,5379,0.16159227344994784
14840,1379.7506,1379.754067,1,41392518,41392622,104,0.8258900902509196
14841,1379.773867,1379.7774,1,41393216,41393322,106,0.6643068279889501
14842,1379.8007,1379.8108,1,41394021,41394324,303,0.06945980896719697
14843,1379.920667,1379.947233,1,41397620,41398416,796,0.5062114423173992
14844,1379.948433,1379.955833,1,41398452,41398674,222,0.8019817324251219
14845,1379.9875,1379.991267,1,41399625,41399738,113,0.8632110113235167
14846,1380.001533,1380.008467,1,41400045,41400254,209,0.728318152272177
14847,1380.025967,1380.030467,1,41400779,41400914,135,0.8009663208436586
14848,1380.059867,1380.064567,1,41401796,41401937,141,0.5453928799912654
14849,1380.145133,1380.151633,1,41404353,41404548,195,0.29063748087141283
14850,1380.2035,1380.206533,1,41406105,41406195,90,0.8067155670547905
14851,1380.2508,1380.2607,1,41407524,41407821,297,0.679607182419475
14852,1380.478233,1380.481867,1,41414346,41414456,110,0.795916186171938
14853,1380.485667,1380.4901,1,41414570,41414703,133,0.7959734197276784
14854,1380.498933,1380.5237,1,41414967,41415711,744,0.810577304670227
14855,1380.615767,1380.620933,1,41418473,41418627,154,0.6653670057516438
14856,1380.702833,1380.7077,1,41421084,41421231,147,0.7849983910433715
14857,1380.753533,1380.7694,1,41422605,41423082,477,0.22787744240721503
14858,1380.7719,1380.888833,1,41423157,41426664,3507,0.5053675059953344
14859,1380.890367,1380.914767,1,41426711,41427443,732,0.3560045056631173
14860,1380.920433,1380.940333,1,41427612,41428209,597,0.2797794659521799
14861,1380.941833,1380.948633,1,41428254,41428458,204,0.8514564310107322
14862,1380.955133,1380.9795,1,41428653,41429385,732,0.5310877222650667
14863,1380.9825,1381.012133,1,41429475,41430363,888,0.3829328699290114
14864,1381.0141,1381.027533,1,41430423,41430825,402,0.18749147078653738
14865,1381.052767,1381.058633,1,41431583,41431758,175,0.2758002599586178
14866,1381.103733,1381.108133,1,41433111,41433243,132,0.3168357785910039
14867,1381.111133,1381.116267,1,41433333,41433488,155,0.7779564156292752
14868,1381.169733,1381.178067,1,41435091,41435342,251,0.4971883084850821
14869,1381.179667,1381.211,1,41435390,41436330,940,0.7706267755700309
14870,1381.226633,1381.2453,1,41436798,41437359,561,0.07037514092832145
14871,1381.247467,1381.279733,1,41437424,41438391,967,0.24792603759765744
14872,1381.319833,1381.333,1,41439594,41439990,396,0.2806535991191725
14873,1381.371367,1381.4243,1,41441141,41442729,1588,0.2571261343024154
14874,1381.4603,1381.465167,1,41443809,41443955,146,0.14847446476865586
14875,1381.4705,1381.508167,1,41444115,41445245,1130,0.14492861752156103
14876,1381.513167,1381.518767,1,41445395,41445563,168,0.8891268563190264
14877,1381.5357,1381.557033,1,41446071,41446710,639,0.47358959287086866
14878,1381.5635,1381.567367,1,41446905,41447021,116,0.8103470458314296
14879,1381.669967,1381.675333,1,41450099,41450259,160,0.8129608762455786
14880,1381.714133,1381.7383,1,41451423,41452149,726,0.217328839266565
14881,1381.843,1381.8474,1,41455290,41455422,132,0.7907517516358373
14882,1381.8757,1381.8894,1,41456271,41456682,411,0.8466789311286311
14883,1381.9105,1381.918367,1,41457315,41457551,236,0.9228509799171444
14884,1382.0429,1382.0459,1,41461287,41461377,90,0.9036362266003494
14885,1382.0509,1382.057667,1,41461527,41461730,203,0.8830171001237067
14886,1382.0606,1382.069433,1,41461818,41462082,264,0.8677773411590408
14887,1382.070467,1382.074267,1,41462114,41462228,114,0.772759904892723
14888,1382.075467,1382.131133,1,41462264,41463933,1669,0.4608907671174873
14889,1382.308,1382.319333,1,41469240,41469579,339,0.10667073719850034
14890,1382.325367,1382.347367,1,41469761,41470421,660,0.28292717423154456
14891,1382.349133,1382.485533,1,41470473,41474565,4092,0.2917329941242256
14892,1382.4869,1382.521933,1,41474607,41475657,1050,0.5526527483119758
14893,1382.5232,1382.553433,1,41475696,41476602,906,0.29816744152321434
14894,1382.5548,1382.572867,1,41476644,41477186,542,0.7750156127328546
14895,1382.634067,1382.637733,1,41479022,41479131,109,0.6114523187154295
14896,1382.6889,1382.699167,1,41480667,41480975,308,0.5975537152608421
14897,1382.703467,1382.8504,1,41481104,41485512,4408,0.23900582442248514
14898,1382.863733,1382.897167,1,41485911,41486915,1004,0.45708098638508526
14899,1382.901333,1382.958133,1,41487039,41488743,1704,0.25042113400859406
14900,1382.959933,1383.256133,1,41488797,41497683,8886,0.10411197827849071
14901,1383.2637,1383.2727,1,41497911,41498181,270,0.2738845841944416
14902,1383.280667,1383.321567,1,41498420,41499647,1227,0.1555625237332678
14903,1383.323433,1383.328333,1,41499702,41499849,147,0.3284280901057706
14904,1383.3897,1383.395933,1,41501691,41501877,186,0.5599227795589408
14905,1383.3988,1383.409867,1,41501964,41502296,332,0.5350888714845786
14906,1383.561967,1383.566867,1,41506859,41507006,147,0.7555168747111439
14907,1383.647433,1383.655633,1,41509422,41509668,246,0.5970470233780506
14908,1383.683967,1383.690033,1,41510519,41510700,181,0.42889519857493047
14909,1383.733767,1383.746767,1,41512013,41512403,390,0.5461640805093396
14910,1383.750867,1383.767133,1,41512526,41513013,487,0.8321639026872903
14911,1383.7756,1383.782267,1,41513268,41513468,200,0.9207755572536293
14912,1383.7886,1383.7932,1,41513658,41513796,138,0.7735624091327932
14913,1383.797267,1383.809667,1,41513918,41514290,372,0.7635365039355204
14914,1384.027933,1384.031833,1,41520837,41520954,117,0.8801356917618763
14915,1384.082333,1384.085833,1,41522469,41522574,105,0.7410482976293358
14916,1384.164867,1384.257667,1,41524946,41527730,2784,0.3341226853221468
14917,1384.2594,1384.266333,1,41527782,41527989,207,0.9134857341816564
14918,1384.269233,1384.325267,1,41528076,41529758,1682,0.2723939869725283
14919,1384.329467,1384.3599,1,41529884,41530797,913,0.19912276760507727
14920,1384.363333,1384.382467,1,41530899,41531474,575,0.6005752012018766
14921,1384.3913,1384.633767,1,41531739,41539013,7274,0.15177854338881555
14922,1384.641433,1384.6703,1,41539242,41540109,867,0.5347793468469055
14923,1384.671733,1384.6893,1,41540151,41540679,528,0.49567364411371895
14924,1384.8969,1384.9057,1,41546907,41547171,264,0.18668309613371117
14925,1385.180067,1385.185633,1,41555402,41555568,166,0.6976094872844207
14926,1385.187067,1385.191067,1,41555612,41555732,120,0.6817459835627188
14927,1385.1982,1385.204833,1,41555946,41556144,198,0.3816187200994972
14928,1385.242333,1385.250933,1,41557269,41557527,258,0.060681426657465475
14929,1385.255333,1385.260033,1,41557659,41557800,141,0.6307074474394275
14930,1385.263833,1385.298033,1,41557914,41558940,1026,0.5981720444554928
14931,1385.307967,1385.317833,1,41559239,41559534,295,0.3080082223040239
14932,1385.421433,1385.4322,1,41562642,41562966,324,0.8789576941742199
14933,1385.562233,1385.5687,1,41566866,41567061,195,0.6703439084663132
14934,1385.573667,1385.598233,1,41567210,41567946,736,-0.003212612079918734
14935,1385.6053,1385.609467,1,41568159,41568284,125,0.12403273695723638
14936,1385.6356,1385.639867,1,41569068,41569196,128,0.757905981723
14937,1385.662067,1385.784367,1,41569862,41573531,3669,0.41089773363513693
14938,1385.789967,1385.803167,1,41573699,41574095,396,0.5716862312448182
14939,1385.825933,1385.831333,1,41574777,41574939,162,0.8918860290870739
14940,1385.841367,1385.858567,1,41575241,41575757,516,0.8406423749042078
14941,1385.8599,1385.864,1,41575797,41575920,123,0.6863381410575359
14942,1386.1895,1386.1948,1,41585685,41585844,159,0.8267068443273035
14943,1386.196833,1386.2412,1,41585904,41587236,1332,0.29898244580936323
14944,1386.257933,1386.310633,1,41587737,41589318,1581,0.21486409683840146
14945,1386.312633,1386.338433,1,41589378,41590152,774,0.3731200957996074
14946,1386.3397,1386.343533,1,41590191,41590305,114,0.3892621567811911
14947,1386.351467,1386.368867,1,41590544,41591066,522,0.7517098611042294
14948,1386.7418,1386.752833,1,41602254,41602584,330,0.7184704896203478
14949,1386.786833,1386.9884,1,41603604,41609652,6048,0.2990105639432392
14950,1386.990433,1386.999733,1,41609712,41609991,279,0.36859997951236245
14951,1387.0016,1387.122633,1,41610048,41613678,3630,0.11291289526391626
14952,1387.125167,1387.2599,1,41613755,41617797,4042,0.1031959334240986
14953,1387.2616,1387.4135,1,41617848,41622405,4557,0.21501640769819494
14954,1387.4161,1387.438533,1,41622483,41623155,672,0.10716056984965552
14955,1387.440033,1387.4668,1,41623200,41624004,804,0.10494528051565086
14956,1387.468533,1387.498267,1,41624055,41624948,893,0.009280818531469238
14957,1387.5137,1387.5695,1,41625411,41627085,1674,0.1734003354280761
14958,1387.577533,1387.587833,1,41627325,41627634,309,0.489150469346125
14959,1387.743967,1387.750133,1,41632319,41632503,184,0.7969375122044149
14960,1387.799833,1387.803933,1,41633994,41634117,123,0.28327091273815663
14961,1387.814667,1387.819667,1,41634440,41634590,150,0.45191717218363164
14962,1387.839567,1387.843933,1,41635187,41635317,130,0.26722447331656335
14963,1387.875133,1387.878133,1,41636253,41636343,90,0.7668740007531574
14964,1387.885,1387.888667,1,41636550,41636660,110,0.8451233158314643
14965,1387.928633,1387.9324,1,41637858,41637972,114,0.47284178251250436
14966,1388.130933,1388.1351,1,41643927,41644053,126,0.9430364908647555
14967,1388.195333,1388.199167,1,41645859,41645975,116,0.9336405224480271
14968,1388.215267,1388.2237,1,41646458,41646711,253,0.8830804883696386
14969,1388.241967,1388.253167,1,41647259,41647595,336,0.5400495191343372
14970,1388.287233,1388.2903,1,41648616,41648709,93,0.6468945144915212
14971,1388.484,1388.4976,1,41654520,41654928,408,0.8118597651807872
14972,1388.4997,1388.503733,1,41654991,41655111,120,0.9526021036993048
14973,1388.8065,1388.81,1,41664195,41664300,105,0.8752600072212783
14974,1388.821533,1388.8319,1,41664645,41664957,312,0.8302865800720094
14975,1388.839033,1388.8527,1,41665170,41665581,411,0.6669383447048037
14976,1388.866333,1388.8738,1,41665989,41666214,225,0.8584543234923258
14977,1389.0465,1389.071467,1,41671395,41672144,749,0.4402387264939746
14978,1389.073467,1389.081767,1,41672204,41672453,249,0.3897769614357291
14979,1389.1001,1389.141367,1,41673003,41674241,1238,0.27588040971724914
14980,1389.149133,1389.152567,1,41674473,41674577,104,0.8366311787663799
14981,1389.166633,1389.170267,1,41674998,41675108,110,0.9247441897848938
14982,1389.175833,1389.247233,1,41675274,41677416,2142,0.4477663215630116
14983,1389.250467,1389.257567,1,41677514,41677727,213,0.6841888408412403
14984,1389.3272,1389.3332,1,41679816,41679996,180,0.7237203735618186
14985,1389.3487,1389.356233,1,41680461,41680686,225,0.5970686031779452
14986,1389.3578,1389.383133,1,41680734,41681493,759,0.6718767241702253
14987,1389.387533,1389.4118,1,41681625,41682354,729,0.3315143445862206
14988,1389.4845,1389.488133,1,41684535,41684643,108,0.8006081847836911
14989,1389.498933,1389.502067,1,41684967,41685062,95,0.7256243201311694
14990,1389.571167,1389.5886,1,41687135,41687658,523,0.7231204167767464
14991,1389.708667,1389.7584,1,41691260,41692752,1492,0.5104139639433137
14992,1389.761933,1389.782967,1,41692857,41693489,632,0.302418930119153
14993,1389.785733,1389.7894,1,41693571,41693682,111,0.9659220974465056
14994,1390.003333,1390.018433,1,41700099,41700552,453,0.7538562629391024
14995,1390.053933,1390.057067,1,41701617,41701712,95,0.7629829525436927
14996,1390.167433,1390.174433,1,41705022,41705232,210,0.8230085641186854
14997,1390.178433,1390.183233,1,41705352,41705496,144,0.893046806541444
14998,1390.214967,1390.227933,1,41706449,41706837,388,0.35615066010786317
14999,1390.230133,1390.2351,1,41706903,41707053,150,0.7108877870594993
15000,1390.2384,1390.244333,1,41707152,41707329,177,0.7366240973807864
15001,1390.2937,1390.2974,1,41708811,41708922,111,0.9566605817618697
15002,1390.303667,1390.316,1,41709110,41709480,370,0.8453616761018994
15003,1390.333733,1390.372567,1,41710011,41711177,1166,0.3693750178223673
15004,1390.373967,1390.377567,1,41711219,41711327,108,0.8915838235903685
15005,1390.571667,1390.5759,1,41717150,41717277,127,0.8918377626304882
15006,1390.645467,1390.650267,1,41719364,41719508,144,0.8094745062167177
15007,1390.6517,1390.661567,1,41719551,41719847,296,0.8624923380580141
15008,1390.669933,1390.689567,1,41720097,41720687,590,0.43742074227899047
15009,1391.1343,1391.149333,1,41734029,41734479,450,0.8523792126775176
15010,1391.155533,1391.158733,1,41734665,41734761,96,
15011,1391.210633,1391.218233,1,41736318,41736546,228,0.9221442080952901
15012,1391.225467,1391.237433,1,41736764,41737122,358,0.9056588275112523
15013,1391.507267,1391.511233,1,41745218,41745336,118,0.6941907590853835
15014,1391.5401,1391.550233,1,41746203,41746506,303,0.7572533375316637
15015,1391.555133,1391.566367,1,41746653,41746991,338,0.8235866767506748
15016,1391.567933,1391.572667,1,41747037,41747180,143,0.8774959237421058
15017,1391.587367,1391.590433,1,41747621,41747712,91,0.8803293874270945
15018,1391.6145,1391.619,1,41748435,41748570,135,0.4456369713167374
15019,1391.647333,1391.654333,1,41749419,41749629,210,0.6602263251618468
15020,1391.679033,1391.683633,1,41750370,41750508,138,0.2687690035264318
15021,1391.6936,1391.705733,1,41750808,41751171,363,0.37184668966520357
15022,1391.708,1391.7122,1,41751240,41751366,126,0.9579901246780964
15023,1391.7139,1391.7211,1,41751417,41751633,216,0.17346108660196566
15024,1391.7239,1391.760067,1,41751717,41752802,1085,0.13511059401735312
15025,1391.762133,1391.8198,1,41752863,41754594,1731,0.19966284222302164
15026,1391.821133,1391.869133,1,41754633,41756073,1440,0.21133712530276394
15027,1391.881033,1391.9124,1,41756430,41757372,942,0.526930025024754
15028,1391.925,1391.9371,1,41757750,41758113,363,0.4526274271634763
15029,1391.947433,1391.958033,1,41758422,41758740,318,-0.05217833571124246
15030,1392.395167,1392.421133,1,41771855,41772633,778,0.3562683872504592
15031,1392.4629,1392.4692,1,41773887,41774076,189,0.8979538295218459
15032,1392.475033,1392.4784,1,41774250,41774352,102,0.6989700500694026
15033,1392.479433,1392.484333,1,41774382,41774529,147,0.8796962721290266
15034,1392.489967,1392.511233,1,41774699,41775336,637,0.3298296586601449
15035,1392.5195,1392.525667,1,41775585,41775770,185,0.7559699234485865
15036,1392.5307,1392.536233,1,41775921,41776086,165,0.6409864191707182
15037,1392.6268,1392.639533,1,41778804,41779185,381,0.6065356033187
15038,1393.6369,1393.642567,1,41809107,41809277,170,0.7348071002947846
15039,1393.645267,1393.649967,1,41809358,41809499,141,0.7767327106280804
15040,1393.6556,1393.706667,1,41809668,41811200,1532,0.344819704266725
15041,1393.7082,1393.7514,1,41811246,41812542,1296,0.25421684260092214
15042,1393.7598,1393.824933,1,41812794,41814747,1953,0.40083652987049817
15043,1393.8295,1393.860833,1,41814885,41815824,939,0.47493740289721914
15044,1393.861967,1393.865367,1,41815859,41815961,102,0.9099572414424295
15045,1393.873567,1393.9182,1,41816207,41817546,1339,0.14086653814806224
15046,1393.9271,1393.930567,1,41817813,41817917,104,0.9494221541324354
15047,1393.931633,1393.937333,1,41817948,41818119,171,0.8759795240633006
15048,1393.9387,1393.972367,1,41818161,41819171,1010,0.22713322750385975
15049,1393.979833,1393.990333,1,41819394,41819709,315,0.7706990672959556
15050,1393.992,1394.0294,1,41819760,41820882,1122,0.5797974755798155
15051,1394.030533,1394.0482,1,41820915,41821446,531,0.34408067858375324
15052,1394.074333,1394.077633,1,41822229,41822328,99,0.9430207719501537
15053,1394.081567,1394.102967,1,41822447,41823089,642,0.807050711804438
15054,1394.123133,1394.1308,1,41823693,41823924,231,0.2754120941338352
15055,1394.131933,1394.164467,1,41823957,41824934,977,0.09124018003932004
15056,1394.1912,1394.198433,1,41825736,41825952,216,0.6982867064843001
15057,1394.2041,1394.216467,1,41826123,41826494,371,0.6643785425609156
15058,1394.2221,1394.2308,1,41826663,41826924,261,0.7508316901589048
15059,1394.535433,1394.5387,1,41836062,41836161,99,0.7541951531587634
15060,1394.5548,1394.558333,1,41836644,41836749,105,0.6864737423567188
15061,1394.5601,1394.566167,1,41836803,41836985,182,-0.061849470174414445
15062,1395.062367,1395.072333,1,41851871,41852169,298,0.6507586759293882
15063,1395.110667,1395.1143,1,41853320,41853429,109,0.7943636423230646
15064,1395.1159,1395.120967,1,41853477,41853629,152,0.7627113047963715
15065,1395.263067,1395.272367,1,41857892,41858171,279,0.7379414460560063
15066,1395.464233,1395.4868,1,41863926,41864604,678,0.8247695868225526
15067,1395.489167,1395.503633,1,41864675,41865108,433,0.46704224709063286
15068,1395.504667,1395.5235,1,41865140,41865705,565,0.3481593990985259
15069,1395.5255,1395.5693,1,41865765,41867079,1314,0.608186483829924
15070,1395.5777,1395.590433,1,41867331,41867712,381,0.7736128898004115
15071,1395.591633,1395.601433,1,41867748,41868042,294,0.6212395624900322
15072,1395.609433,1395.6504,1,41868282,41869512,1230,0.315213086219076
15073,1395.658033,1395.691367,1,41869740,41870741,1001,0.5032479653463279
15074,1395.701133,1395.712,1,41871033,41871360,327,0.9014067295884355
15075,1395.727167,1395.756733,1,41871815,41872701,886,0.48804216489714347
15076,1395.758033,1395.771567,1,41872740,41873147,407,0.38440432659685925
15077,1395.781133,1395.8234,1,41873433,41874702,1269,0.4717851119832594
15078,1395.8264,1395.8602,1,41874792,41875806,1014,0.23228051626045815
15079,1395.863367,1395.873867,1,41875901,41876216,315,0.3824100125838001
15080,1395.8785,1395.922633,1,41876355,41877678,1323,0.28351555614045787
15081,1395.9244,1395.929367,1,41877732,41877881,149,0.919206286149936
15082,1395.9308,1395.939333,1,41877924,41878179,255,0.6537299500182904
15083,1395.9416,1395.952533,1,41878248,41878575,327,0.881960309291301
15084,1395.955167,1395.966733,1,41878655,41879001,346,0.6813298628917869
15085,1395.968,1396.0116,1,41879040,41880348,1308,0.6174669370913549
15086,1396.0179,1396.032833,1,41880537,41880984,447,0.8191703836658649
15087,1396.040533,1396.047467,1,41881215,41881424,209,0.8622474614848251
15088,1396.0703,1396.089933,1,41882109,41882697,588,0.843745300803733
15089,1396.091233,1396.094833,1,41882736,41882844,108,0.8518672003827379
15090,1396.096533,1396.106333,1,41882895,41883189,294,0.6088547416182546
15091,1396.111033,1396.131967,1,41883330,41883959,629,0.7499420884006601
15092,1396.139,1396.153,1,41884170,41884590,420,0.7889898991958247
15093,1396.157367,1396.167933,1,41884721,41885037,316,0.8913523244549392
15094,1396.172433,1396.202867,1,41885172,41886086,914,0.20617677389118844
15095,1396.208667,1396.215333,1,41886260,41886459,199,0.829989158292001
15096,1396.2191,1396.2238,1,41886573,41886714,141,0.8997051589713596
15097,1396.231333,1396.2417,1,41886939,41887251,312,0.7460178131147972
15098,1396.246333,1396.2618,1,41887389,41887854,465,0.4825987605355972
15099,1396.271167,1396.280467,1,41888135,41888414,279,0.41988299538426055
15100,1396.507433,1396.510833,1,41895222,41895324,102,0.346380062934586
15101,1396.514633,1396.5677,1,41895438,41897031,1593,0.1323615311314919
15102,1396.5758,1396.6502,1,41897274,41899506,2232,0.14184675305660036
15103,1396.654833,1396.680233,1,41899644,41900406,762,0.3031152285192274
15104,1396.681467,1396.702767,1,41900444,41901083,639,0.27144558135454605
15105,1396.729967,1396.759767,1,41901899,41902793,894,0.5714365728439205
15106,1396.7667,1396.785367,1,41903001,41903561,560,0.7278136367131518
15107,1396.789933,1396.808233,1,41903697,41904246,549,0.8430607623739715
15108,1396.8115,1396.8558,1,41904345,41905674,1329,0.7178671278527253
15109,1396.857567,1396.901133,1,41905727,41907033,1306,0.30812724097800215
15110,1396.902567,1396.9183,1,41907077,41907549,472,0.5673770316985707
15111,1396.928033,1396.9368,1,41907840,41908104,264,0.5919567794437876
15112,1396.940367,1396.946133,1,41908211,41908383,172,0.9107572234444876
15113,1396.947433,1396.9521,1,41908422,41908563,141,0.826697268311587
15114,1396.953167,1396.958367,1,41908595,41908751,156,0.8588521301191832
15115,1396.962933,1396.9934,1,41908887,41909802,915,0.625262124985896
15116,1396.994467,1397.043533,1,41909834,41911305,1471,0.47174481443808886
15117,1397.0464,1397.0592,1,41911392,41911776,384,0.5057079028953049
15118,1397.061667,1397.1037,1,41911850,41913111,1261,0.349946395792963
15119,1397.105167,1397.114333,1,41913155,41913429,274,0.7844053125429208
15120,1397.116033,1397.127933,1,41913480,41913837,357,0.743553189289554
15121,1397.1362,1397.147167,1,41914086,41914415,329,0.759125496442824
15122,1397.1531,1397.1664,1,41914593,41914992,399,0.4170009328036885
15123,1397.174067,1397.227067,1,41915222,41916812,1590,0.5069845033039028
15124,1397.2365,1397.2502,1,41917095,41917506,411,0.4039651803742779
15125,1397.251233,1397.306767,1,41917536,41919203,1667,0.44170450909976616
15126,1397.314633,1397.385567,1,41919438,41921567,2129,0.297983098367992
15127,1397.4059,1397.4423,1,41922177,41923269,1092,0.4086418880254806
15128,1397.469467,1397.4828,1,41924084,41924484,400,0.5795455263371401
15129,1397.515267,1397.544967,1,41925458,41926349,891,0.41935394164434636
15130,1397.579133,1397.7043,1,41927373,41931129,3756,0.34955842649514407
15131,1397.707967,1397.742167,1,41931239,41932265,1026,0.16763786512348947
15132,1397.7433,1397.763,1,41932299,41932890,591,0.1892547514118085
15133,1397.7664,1397.806267,1,41932992,41934188,1196,0.15288759219844042
15134,1397.818033,1397.862367,1,41934540,41935871,1331,0.10974154066342803
15135,1397.87,1397.9107,1,41936100,41937321,1221,0.3499196082424413
15136,1397.919667,1398.012367,1,41937590,41940371,2781,0.1654023377193837
15137,1398.0162,1398.0292,1,41940486,41940876,390,0.5863545616967657
15138,1398.0628,1398.0756,1,41941884,41942268,384,0.46471106189324973
15139,1398.076867,1398.082033,1,41942306,41942460,154,0.43853253188984526
15140,1398.0897,1398.098133,1,41942691,41942943,252,0.7061214013399619
15141,1398.840133,1398.8447,1,41965203,41965341,138,0.33887435791395465
15142,1399.029067,1399.052567,1,41970872,41971577,705,0.5828920895323684
15143,1399.057333,1399.060533,1,41971719,41971815,96,0.7091899243202023
15144,1399.104967,1399.135167,1,41973149,41974055,906,0.6108711790011075
15145,1399.137,1399.140733,1,41974110,41974221,111,0.8440266692294599
15146,1399.144267,1399.150467,1,41974328,41974514,186,0.921748690819733
15147,1399.158433,1399.166967,1,41974752,41975009,257,0.7002597553238423
15148,1399.168,1399.171067,1,41975040,41975132,92,0.8589011408552198
15149,1399.173067,1399.176167,1,41975192,41975285,93,0.9569932974006702
15150,1399.177267,1399.1822,1,41975318,41975466,148,0.9516823595869771
15151,1399.1837,1399.194833,1,41975511,41975844,333,0.6775858712304083
15152,1399.196233,1399.202867,1,41975886,41976086,200,0.8969866316707528
15153,1399.263633,1399.268733,1,41977908,41978061,153,0.8431617949102618
15154,1399.275833,1399.306833,1,41978274,41979204,930,0.41934998988332634
15155,1399.379567,1399.390867,1,41981387,41981726,339,0.49675566435467916
15156,1399.620033,1399.636867,1,41988600,41989106,506,0.3965914588457592
15157,1399.6465,1399.660533,1,41989395,41989815,420,0.7991386871195277
15158,1399.665,1399.678,1,41989950,41990340,390,0.15641550345494645
15159,1399.685133,1399.7032,1,41990553,41991096,543,0.46675306555089946
15160,1399.721267,1399.734533,1,41991638,41992035,397,0.8369631454655242
15161,1399.7357,1399.741733,1,41992071,41992251,180,0.752347453591333
15162,1399.7664,1399.773367,1,41992992,41993201,209,0.5576190132800851
15163,1399.783733,1399.8054,1,41993511,41994162,651,0.4675469993977311
15164,1399.825633,1399.851833,1,41994768,41995554,786,0.7710583213797151
15165,1399.853433,1399.8605,1,41995602,41995815,213,0.7604304590468457
15166,1399.8728,1399.896767,1,41996184,41996903,719,0.5429613300529247
15167,1399.9182,1399.921533,1,41997546,41997645,99,0.8144102518643331
15168,1399.923867,1399.929233,1,41997716,41997876,160,0.9158073831640708
15169,1399.9375,1399.958433,1,41998125,41998752,627,0.47355679683566115
15170,1400.001167,1400.0139,1,42000035,42000417,382,0.5433454372106178
15171,1400.021733,1400.0296,1,42000651,42000888,237,0.6725656810312435
15172,1400.049467,1400.0548,1,42001484,42001644,160,0.8529581548922548
15173,1400.1055,1400.115267,1,42003165,42003458,293,0.8809608527333382
15174,1400.208133,1400.224233,1,42006243,42006726,483,0.30894819821433717
15175,1400.2307,1400.253167,1,42006921,42007595,674,0.5020880027864698
15176,1400.255667,1400.2655,1,42007670,42007965,295,0.6686952396870919
15177,1400.272933,1400.2789,1,42008187,42008367,180,0.3378132327338767
15178,1400.284667,1400.2911,1,42008540,42008733,193,0.2600782543106589
15179,1400.3258,1400.329933,1,42009774,42009897,123,0.7646439713811508
15180,1400.331133,1400.344567,1,42009933,42010337,404,0.5251522608127189
15181,1400.3662,1400.402267,1,42010986,42012068,1082,0.2682633559125866
15182,1400.446167,1400.4536,1,42013385,42013608,223,0.5005893018062166
15183,1400.4551,1400.469433,1,42013653,42014082,429,0.4821225893086029
15184,1400.493733,1400.497533,1,42014811,42014925,114,0.914162224173801
15185,1400.585033,1400.589733,1,42017550,42017691,141,0.8323578095472849
15186,1400.5914,1400.6109,1,42017742,42018327,585,0.8425260263078664
15187,1400.760167,1400.7753,1,42022805,42023259,454,0.7489562740367091
15188,1400.8146,1400.818667,1,42024438,42024560,122,0.4934946798002328
15189,1401.1306,1401.1738,1,42033918,42035214,1296,0.3577646861773982
15190,1401.179733,1401.187833,1,42035391,42035634,243,0.2798971824065261
15191,1401.1969,1401.2003,1,42035907,42036009,102,0.9286272600578787
15192,1401.2016,1401.217433,1,42036048,42036522,474,0.24297471483001554
15193,1401.230033,1401.3157,1,42036900,42039471,2571,0.15617292051779072
15194,1401.353567,1401.357333,1,42040607,42040719,112,0.9652983191599023
15195,1401.3589,1401.3886,1,42040767,42041658,891,0.2886151056292572
15196,1401.406,1401.4481,1,42042180,42043443,1263,0.6405299961386087
15197,1401.457667,1401.498867,1,42043730,42044966,1236,0.5425112151059079
15198,1401.507,1401.5244,1,42045210,42045732,522,0.26580416226445214
15199,1401.532367,1401.546367,1,42045971,42046391,420,0.2265273127563609
15200,1401.549533,1401.562167,1,42046485,42046865,380,0.3380616131604197
15201,1401.5729,1401.624233,1,42047187,42048726,1539,0.36419275479237273
15202,1401.633167,1401.666633,1,42048995,42049998,1003,0.3844674900582246
15203,1401.668633,1401.679433,1,42050058,42050382,324,0.3612939055451615
15204,1401.680533,1401.734933,1,42050415,42052047,1632,0.5947917557768986
15205,1401.7436,1401.7637,1,42052308,42052911,603,0.3611242405574558
15206,1401.7735,1401.788,1,42053205,42053640,435,0.794377611929915
15207,1401.789667,1401.8031,1,42053690,42054093,403,0.44211519753019035
15208,1401.8073,1401.839333,1,42054219,42055179,960,0.20842287248846483
15209,1401.840667,1401.844333,1,42055220,42055329,109,0.8660373016226527
15210,1401.8456,1401.849467,1,42055368,42055484,116,0.8050699400882704
15211,1401.8505,1401.854467,1,42055515,42055634,119,0.14644624261140968
15212,1401.861533,1401.865533,1,42055845,42055965,120,0.7975122055724699
15213,1401.876167,1401.879433,1,42056285,42056382,97,0.8262688899347516
15214,1401.8851,1401.892833,1,42056553,42056784,231,0.7485662198725038
15215,1401.897,1401.913933,1,42056910,42057417,507,0.28369705966329295
15216,1401.926133,1401.930233,1,42057783,42057906,123,0.2880855523925604
15217,1401.952367,1401.9978,1,42058571,42059934,1363,0.15000897335371519
15218,1402.0063,1402.010967,1,42060189,42060329,140,0.4937173229110969
15219,1402.015167,1402.0908,1,42060455,42062724,2269,0.2673833326422683
15220,1402.093067,1402.129667,1,42062792,42063890,1098,0.7161760197470047
15221,1402.1402,1402.143333,1,42064206,42064299,93,0.9003232981955467
15222,1402.144733,1402.1675,1,42064341,42065025,684,-0.0871597059502195
15223,1402.175833,1402.184667,1,42065274,42065540,266,-0.034700591897617775
15224,1402.1859,1402.189367,1,42065577,42065681,104,0.0030378592652058113
15225,1402.197533,1402.205167,1,42065925,42066155,230,-0.038002816835432086
15226,1402.206467,1402.239667,1,42066194,42067190,996,0.07535829612211785
15227,1402.252033,1402.269467,1,42067560,42068084,524,0.5265406622572032
15228,1402.339167,1402.3447,1,42070175,42070341,166,0.7125288945657762
15229,1402.3549,1402.361533,1,42070647,42070845,198,0.8826054576735396
15230,1402.396433,1402.418267,1,42071892,42072548,656,0.5364861330623286
15231,1402.4478,1402.454,1,42073434,42073620,186,0.638359670624778
15232,1402.483,1402.488033,1,42074490,42074640,150,0.8001736170987876
15233,1402.500533,1402.509633,1,42075015,42075288,273,0.8240663955927509
15234,1402.708033,1402.7235,1,42081240,42081705,465,0.5697108462335513
15235,1402.745767,1402.7865,1,42082373,42083595,1222,0.4171457405622182
15236,1402.787633,1402.836733,1,42083628,42085101,1473,0.10427648734520452
15237,1402.840133,1402.876967,1,42085203,42086309,1106,0.20635512081990767
15238,1402.8951,1402.912767,1,42086853,42087383,530,0.15852066266914522
15239,1402.914,1402.9179,1,42087420,42087537,117,0.5459944747267235
15240,1402.9286,1402.941667,1,42087858,42088250,392,0.27139604661031447
15241,1402.965733,1402.9869,1,42088971,42089607,636,0.23049089216391044
15242,1402.991433,1402.997033,1,42089742,42089910,168,0.6097917826555047
15243,1403.007567,1403.039233,1,42090227,42091176,949,0.4252619547808169
15244,1403.0697,1403.072967,1,42092091,42092189,98,0.6891757279726779
15245,1403.137067,1403.155,1,42094112,42094650,538,0.43498144400330196
15246,1403.249033,1403.2524,1,42097470,42097572,102,0.8634814062055103
15247,1403.283867,1403.302867,1,42098516,42099086,570,0.7313194324114402
15248,1403.303967,1403.3472,1,42099119,42100416,1297,0.41093076571866344
15249,1403.355567,1403.370567,1,42100667,42101117,450,0.35552161804488475
15250,1403.4254,1403.446333,1,42102762,42103389,627,0.24626921241784921
15251,1403.450667,1403.4633,1,42103520,42103899,379,0.2623371013684236
15252,1403.4644,1403.467667,1,42103932,42104030,98,0.9548805744605874
15253,1403.486033,1403.510667,1,42104580,42105320,740,0.2812663651073218
15254,1403.511867,1403.5312,1,42105356,42105936,580,0.23379322045465165
15255,1403.5464,1403.5652,1,42106392,42106956,564,0.48847163586763875
15256,1403.569333,1403.576767,1,42107079,42107303,224,0.9125233694323367
15257,1403.5901,1403.5985,1,42107703,42107955,252,0.7587879127413617
15258,1403.602267,1403.612133,1,42108068,42108363,295,0.26060866984480513
15259,1403.6168,1403.6373,1,42108504,42109119,615,0.42939023482074695
15260,1403.6474,1403.6528,1,42109422,42109584,162,0.4080782083223849
15261,1403.6547,1403.686733,1,42109641,42110601,960,0.382477271108486
15262,1403.688067,1403.694733,1,42110642,42110841,199,0.8167794507327147
15263,1403.698833,1403.728833,1,42110964,42111864,900,0.2619040388551994
15264,1403.730533,1403.739767,1,42111915,42112193,278,0.31305112200283997
15265,1403.741233,1403.744433,1,42112236,42112332,96,0.7915635411726056
15266,1403.748733,1403.757333,1,42112461,42112719,258,0.7154451013650649
15267,1403.7584,1403.873167,1,42112752,42116195,3443,0.08521903952046404
15268,1403.876033,1403.9685,1,42116280,42119055,2775,0.3230652170044445
15269,1403.990433,1404.019567,1,42119712,42120587,875,0.5260150544031273
15270,1404.024967,1404.0339,1,42120749,42121017,268,0.6157139126416583
15271,1404.036233,1404.050667,1,42121086,42121520,434,0.347688138844229
15272,1404.0523,1404.076133,1,42121569,42122283,714,0.3328013194673136
15273,1404.087333,1404.0974,1,42122619,42122922,303,0.7887881865501823
15274,1404.101067,1404.147033,1,42123032,42124410,1378,0.46341076972474954
15275,1404.149033,1404.159333,1,42124470,42124779,309,0.541131779915236
15276,1404.161,1404.174567,1,42124830,42125237,407,0.2468243018376614
15277,1404.1829,1404.2013,1,42125487,42126039,552,0.5752215924913386
15278,1404.2048,1404.2248,1,42126144,42126744,600,0.5591618630684788
15279,1404.230467,1404.2397,1,42126914,42127191,277,0.5816834671313277
15280,1404.244367,1404.249733,1,42127331,42127491,160,0.49852360160828274
15281,1404.251233,1404.3071,1,42127536,42129213,1677,0.27605901975592423
15282,1404.314833,1404.329733,1,42129444,42129891,447,0.18199256467784602
15283,1404.335533,1404.346533,1,42130065,42130395,330,0.1404102613070693
15284,1404.3554,1404.416633,1,42130662,42132498,1836,0.21850909989955758
15285,1404.430667,1404.4438,1,42132920,42133314,394,0.6004604786182822
15286,1404.4449,1404.449767,1,42133347,42133493,146,0.6605943820566668
15287,1404.458467,1404.462567,1,42133754,42133877,123,0.4276438164493504
15288,1404.4744,1404.480667,1,42134232,42134420,188,0.26776221808831396
15289,1404.566767,1404.5796,1,42137003,42137388,385,0.07658097786229758
15290,1404.580967,1404.592833,1,42137429,42137784,355,0.3390526921344663
15291,1404.604433,1404.625,1,42138132,42138750,618,0.14225972257076694
15292,1404.6281,1404.647633,1,42138843,42139428,585,0.4308900739518742
15293,1404.651433,1404.6869,1,42139542,42140607,1065,0.24928982859343451
15294,1404.699433,1404.834567,1,42140982,42145037,4055,0.33884707736166825
15295,1404.837333,1404.851767,1,42145119,42145553,434,0.1291542731539191
15296,1404.853033,1404.8693,1,42145590,42146079,489,0.10484115872507387
15297,1404.871767,1404.8814,1,42146153,42146442,289,0.68672140715754
15298,1404.884633,1404.8915,1,42146538,42146745,207,0.7900484131823328
15299,1404.893267,1404.905367,1,42146798,42147161,363,0.8003851610930249
15300,1404.907167,1404.9103,1,42147215,42147309,94,0.6930117029205456
15301,1404.911433,1404.930167,1,42147342,42147905,563,0.7064597437701382
15302,1404.949767,1404.9609,1,42148493,42148827,334,0.3126127812138506
15303,1404.976367,1404.9833,1,42149291,42149499,208,0.6514927286359689
15304,1405.1572,1405.179467,1,42154716,42155384,668,0.09838532650355648
15305,1405.184067,1405.1953,1,42155522,42155859,337,0.20591083170800964
15306,1405.2863,1405.300267,1,42158589,42159008,419,0.2994992506108115
15307,1405.301667,1405.307667,1,42159050,42159230,180,0.7999760361671621
15308,1405.317767,1405.332633,1,42159533,42159978,445,0.7375099407869627
15309,1405.334,1405.355267,1,42160020,42160658,638,0.35847957123681645
15310,1405.356867,1405.380233,1,42160706,42161406,700,0.45596101434516556
15311,1405.3844,1405.3921,1,42161532,42161763,231,0.8730512308283555
15312,1405.393167,1405.3992,1,42161795,42161976,181,0.9455896466641933
15313,1405.6005,1405.658267,1,42168015,42169748,1733,0.4943201076575152
15314,1405.659967,1405.6763,1,42169799,42170289,490,0.4288555965007282
15315,1405.677767,1405.695533,1,42170333,42170865,532,0.5246237991711643
15316,1405.699133,1405.714033,1,42170973,42171420,447,0.5654575941367662
15317,1405.716167,1405.7235,1,42171485,42171705,220,0.5640634516307544
15318,1405.7712,1405.775233,1,42173136,42173256,120,0.82114530753157
15319,1405.8064,1405.854967,1,42174192,42175649,1457,0.3203465720668143
15320,1405.868067,1405.8807,1,42176042,42176421,379,0.6419112106683279
15321,1405.881833,1405.8991,1,42176454,42176973,519,0.5939544271285369
15322,1405.906033,1405.9367,1,42177180,42178101,921,0.1501416632924564
15323,1405.9551,1405.989433,1,42178653,42179682,1029,0.12881085598840683
15324,1406.000033,1406.0058,1,42180000,42180174,174,0.44925047959087205
15325,1406.006933,1406.027767,1,42180207,42180833,626,0.450166967556494
15326,1406.0732,1406.077,1,42182196,42182310,114,0.7902170026969814
15327,1406.108167,1406.119433,1,42183245,42183582,337,0.8514924147014453
15328,1406.304967,1406.325,1,42189149,42189750,601,0.16930560282296755
15329,1406.328167,1406.336667,1,42189845,42190100,255,0.884702664925913
15330,1406.338333,1406.355233,1,42190149,42190656,507,0.7881442197049106
15331,1406.378,1406.414033,1,42191340,42192420,1080,0.5917050562601717
15332,1406.4157,1406.441167,1,42192471,42193235,764,0.4887737438446578
15333,1406.442267,1406.448967,1,42193268,42193469,201,0.7668762609287003
15334,1406.462833,1406.468267,1,42193884,42194048,164,0.9250222209814247
15335,1406.481,1406.4878,1,42194430,42194634,204,0.7681735513603165
15336,1406.5031,1406.508567,1,42195093,42195257,164,0.779959630941446
15337,1406.510833,1406.515867,1,42195324,42195476,152,0.8294687392096073
15338,1406.522233,1406.536467,1,42195666,42196094,428,0.7161044655549313
15339,1406.541367,1406.546533,1,42196241,42196395,154,0.7759875108593332
15340,1406.5481,1406.565767,1,42196443,42196973,530,0.5165247031317336
15341,1406.5687,1406.585233,1,42197061,42197556,495,0.514201151245934
15342,1406.5965,1406.651,1,42197895,42199530,1635,0.16924222494610822
15343,1406.655533,1406.662,1,42199665,42199860,195,0.2662818321325608
15344,1406.730667,1406.747333,1,42201920,42202419,499,0.4147925814106013
15345,1406.750167,1406.757133,1,42202505,42202713,208,0.867422383782529
15346,1406.879867,1406.895333,1,42206396,42206859,463,0.4640233025222856
15347,1406.9214,1406.9248,1,42207642,42207744,102,0.8322721007679293
15348,1407.1922,1407.197033,1,42215766,42215910,144,0.9010688474862533
15349,1407.212567,1407.222233,1,42216377,42216666,289,0.7059159785180412
15350,1407.225767,1407.230767,1,42216773,42216923,150,-0.13114296421585195
15351,1407.2646,1407.284967,1,42217938,42218549,611,0.7923064229262599
15352,1407.291367,1407.305267,1,42218741,42219158,417,0.1010497430862383
15353,1407.966367,1407.969933,1,42238991,42239097,106,0.891174236548924
15354,1407.972433,1407.977833,1,42239172,42239334,162,0.14625132499011417
15355,1407.985167,1407.991967,1,42239555,42239759,204,0.6375718545995479
15356,1408.013333,1408.018,1,42240399,42240540,141,0.9700661815244239
15357,1408.082033,1408.0867,1,42242460,42242601,141,-0.10744649317921628
15358,1408.0897,1408.115,1,42242691,42243450,759,0.5496637049604228
15359,1408.491233,1408.506367,1,42254736,42255191,455,0.8379648495728217
15360,1408.523667,1408.537433,1,42255710,42256122,412,0.9503559829662032
15361,1408.544467,1408.563933,1,42256334,42256917,583,0.6712850114858028
15362,1408.571367,1408.582467,1,42257141,42257474,333,0.8396182975359764
15363,1408.603867,1408.609367,1,42258116,42258281,165,0.9035944663603743
15364,1408.617167,1408.6786,1,42258515,42260358,1843,0.3670406583805053
15365,1408.690133,1408.764067,1,42260703,42262922,2219,0.052532853755566225
15366,1408.774833,1408.792733,1,42263244,42263781,537,0.4089279403906053
15367,1408.801733,1408.8114,1,42264051,42264342,291,0.10840268506845786
15368,1408.812433,1408.913267,1,42264372,42267398,3026,0.284942900371665
15369,1408.940333,1408.961233,1,42268209,42268836,627,0.43266087719778296
15370,1408.974667,1408.985333,1,42269240,42269559,319,0.4768939392086769
15371,1408.999467,1409.015833,1,42269984,42270474,490,0.1287044253061664
15372,1409.0169,1409.034367,1,42270507,42271031,524,0.4004993645098269
15373,1409.0639,1409.0912,1,42271917,42272736,819,0.33308936435963926
15374,1409.096233,1409.1106,1,42272886,42273318,432,0.4778836565033441
15375,1409.124567,1409.127567,1,42273737,42273827,90,0.9237624073508006
15376,1409.132433,1409.1482,1,42273972,42274446,474,0.7788470714245151
15377,1409.154033,1409.160867,1,42274620,42274826,206,0.5609042468811116
15378,1409.1668,1409.192467,1,42275004,42275774,770,0.6654406641952973
15379,1409.201633,1409.249133,1,42276048,42277473,1425,0.5492500621126992
15380,1409.2589,1409.2632,1,42277767,42277896,129,0.6409805574990268
15381,1409.2685,1409.272267,1,42278055,42278168,113,0.6507021543913725
15382,1409.273333,1409.2966,1,42278199,42278898,699,0.5256843281867477
15383,1409.307433,1409.317267,1,42279222,42279518,296,0.6096383053444895
15384,1409.3278,1409.3374,1,42279834,42280122,288,0.47707227105380134
15385,1409.343,1409.348367,1,42280290,42280451,161,0.913151375955365
15386,1409.3573,1409.361333,1,42280719,42280839,120,0.8997871571270666
15387,1409.367233,1409.374467,1,42281016,42281234,218,0.297416895256584
15388,1409.3858,1409.392,1,42281574,42281760,186,0.8542500694361304
15389,1409.398733,1409.413267,1,42281961,42282398,437,0.5301832414362976
15390,1409.4231,1409.445733,1,42282693,42283371,678,0.38382002097976087
15391,1409.452033,1409.4774,1,42283560,42284322,762,0.22642550798925093
15392,1409.484667,1409.497467,1,42284540,42284924,384,0.4051693753405018
15393,1409.521833,1409.525167,1,42285654,42285755,101,0.5499662859712151
15394,1409.5493,1409.5641,1,42286479,42286923,444,0.35555078404597723
15395,1409.569433,1409.579667,1,42287082,42287390,308,0.6913600916431752
15396,1409.5816,1409.584733,1,42287448,42287541,93,0.8062379095969304
15397,1409.5923,1409.5989,1,42287769,42287967,198,0.4136424173298857
15398,1409.604367,1409.612133,1,42288131,42288363,232,0.8178285650703829
15399,1409.624733,1409.651667,1,42288741,42289550,809,0.24648376552003812
15400,1409.653767,1409.668233,1,42289613,42290046,433,0.351356237365815
15401,1409.674467,1409.721967,1,42290234,42291659,1425,0.6086058289461719
15402,1409.725067,1409.746867,1,42291752,42292406,654,0.14977122491765898
15403,1409.751367,1409.756267,1,42292541,42292688,147,0.0952216019791135
15404,1409.757367,1409.7654,1,42292721,42292962,241,0.4523904711966721
15405,1409.773267,1409.779433,1,42293198,42293382,184,0.7444294542220259
15406,1409.789233,1409.8036,1,42293676,42294108,432,0.8838219517954321
15407,1409.8051,1409.814833,1,42294153,42294444,291,0.6598432897566292
15408,1409.817367,1409.838667,1,42294521,42295160,639,0.22283346748244948
15409,1409.844167,1409.856467,1,42295325,42295694,369,-0.11518603955650432
15410,1409.8788,1409.885933,1,42296364,42296577,213,0.8091345053632226
15411,1409.887767,1409.911567,1,42296633,42297347,714,0.591218184043405
15412,1409.916767,1409.944467,1,42297503,42298334,831,0.17338819558286084
15413,1409.947667,1409.962867,1,42298430,42298886,456,0.024747296961963903
15414,1409.969233,1409.975733,1,42299076,42299271,195,0.3326162875739247
15415,1409.977333,1409.988833,1,42299319,42299664,345,0.7390499275260651
15416,1409.991033,1410.093567,1,42299730,42302807,3077,0.2163380886042314
15417,1410.0951,1410.107767,1,42302853,42303233,380,0.23887739684796186
15418,1410.113933,1410.1844,1,42303417,42305532,2115,0.32188973293695045
15419,1410.187933,1410.246133,1,42305637,42307383,1746,0.20995619268177163
15420,1410.266367,1410.270433,1,42307991,42308112,121,0.8823845242291275
15421,1410.2789,1410.2981,1,42308367,42308943,576,0.6721050183484739
15422,1410.306333,1410.336233,1,42309189,42310086,897,0.26977208079230536
15423,1410.337967,1410.359,1,42310139,42310770,631,0.6226252403459409
15424,1410.4052,1410.4086,1,42312156,42312258,102,0.6851057818101798
15425,1410.413333,1410.419467,1,42312399,42312584,185,0.8401778424638402
15426,1410.4274,1410.437633,1,42312822,42313128,306,0.6559353996439414
15427,1410.4387,1410.4422,1,42313161,42313266,105,0.9212639263163866
15428,1410.467,1410.4781,1,42314010,42314343,333,0.4563791554002001
15429,1410.500067,1410.504533,1,42315002,42315135,133,0.7881811410871173
15430,1410.6204,1410.632767,1,42318612,42318983,371,0.3967276043681818
15431,1410.651233,1410.675267,1,42319536,42320258,722,0.44505952970748086
15432,1410.6799,1410.695467,1,42320397,42320864,467,0.6933989908327758
15433,1410.6969,1410.7399,1,42320907,42322197,1290,0.1653745031799355
15434,1410.783633,1410.8104,1,42323508,42324312,804,0.31465807617772473
15435,1410.8493,1410.881,1,42325479,42326430,951,0.29735704697264714
15436,1410.9238,1410.986133,1,42327714,42329583,1869,0.23910815261220558
15437,1410.994367,1411.0009,1,42329831,42330027,196,0.7559871587107574
15438,1411.230867,1411.247167,1,42336926,42337415,489,0.4370674773515426
15439,1411.248233,1411.252333,1,42337446,42337569,123,0.835393805694298
15440,1411.254733,1411.2678,1,42337641,42338034,393,0.7091852185280437
15441,1411.277933,1411.283067,1,42338337,42338492,155,0.3384266246314529
15442,1411.284433,1411.300667,1,42338532,42339020,488,-0.001336494433836903
15443,1411.301933,1411.351467,1,42339057,42340544,1487,0.030678106411090842
15444,1411.354467,1411.3598,1,42340634,42340794,160,-0.027132789427811402
15445,1411.3982,1411.406367,1,42341946,42342191,245,0.834388553389927
15446,1411.407833,1411.411867,1,42342234,42342356,122,0.8704963659198649
15447,1411.430433,1411.4339,1,42342912,42343017,105,0.788504052125708
15448,1411.435533,1411.472533,1,42343065,42344175,1110,0.14303838624472184
15449,1411.491667,1411.4954,1,42344750,42344862,112,0.564799610212124
15450,1411.5196,1411.524567,1,42345588,42345737,149,0.8632146258606221
15451,1411.5259,1411.545667,1,42345777,42346370,593,0.48635907552377183
15452,1411.556733,1411.565767,1,42346701,42346973,272,0.601736658964053
15453,1411.581967,1411.5938,1,42347459,42347814,355,0.6617504558614832
15454,1411.6071,1411.6163,1,42348213,42348489,276,0.5201173438948564
15455,1411.948267,1411.952533,1,42358448,42358575,127,0.5690773373840061
15456,1411.981,1411.985267,1,42359430,42359558,128,0.623321771178445
15457,1411.987767,1411.998233,1,42359633,42359946,313,0.7829581519739383
15458,1412.874167,1412.8784,1,42386225,42386352,127,0.5396313046163408
15459,1412.8797,1412.884,1,42386391,42386520,129,0.5225071737303169
15460,1412.921633,1412.926267,1,42387648,42387788,140,0.8901402587853708
15461,1413.0115,1413.015367,1,42390345,42390461,116,0.8760233633241937
15462,1413.025267,1413.031467,1,42390758,42390944,186,0.8739222695237813
15463,1413.0347,1413.048567,1,42391041,42391457,416,0.8815916549912971
15464,1413.1183,1413.128367,1,42393549,42393851,302,0.46212905223392226
15465,1413.202833,1413.212567,1,42396084,42396377,293,0.7964155025288113
15466,1413.335933,1413.3421,1,42400077,42400263,186,0.5192782079446425
15467,1413.773767,1413.784467,1,42413213,42413534,321,0.5703056123617218
15468,1413.799833,1413.8148,1,42413994,42414444,450,0.45388997960488103
15469,1413.827767,1413.8943,1,42414833,42416829,1996,0.32923811757307075
15470,1413.9074,1413.9247,1,42417222,42417741,519,0.2620777684403096
15471,1413.933133,1413.948467,1,42417993,42418454,461,0.15861110229914535
15472,1413.954033,1413.968233,1,42418620,42419046,426,0.14713676040440826
15473,1413.9859,1414.035767,1,42419577,42421073,1496,0.2315752718013279
15474,1414.036767,1414.047033,1,42421103,42421410,307,0.9113676143214197
15475,1414.0583,1414.0825,1,42421749,42422475,726,0.5519911842770705
15476,1414.086833,1414.103733,1,42422604,42423111,507,0.45483939907242454
15477,1414.131733,1414.153733,1,42423951,42424611,660,0.2806113086447128
15478,1414.169567,1414.1741,1,42425087,42425223,136,0.3989853042823775
15479,1414.191933,1414.199033,1,42425757,42425970,213,0.4339885748658286
15480,1414.203233,1414.208867,1,42426096,42426266,170,0.8209042584363964
15481,1414.216833,1414.236833,1,42426504,42427104,600,0.4013030964132427
15482,1414.240467,1414.250733,1,42427214,42427521,307,0.41772486721054225
15483,1414.261867,1414.267933,1,42427856,42428037,181,0.6591236015026378
15484,1414.275533,1414.288067,1,42428265,42428642,377,0.165859740043378
15485,1414.2916,1414.303833,1,42428748,42429114,366,0.29809391528859625
15486,1414.311833,1414.339433,1,42429354,42430182,828,0.35918371471492005
15487,1414.340533,1414.343733,1,42430215,42430311,96,0.3594256226857518
15488,1414.354467,1414.359967,1,42430634,42430799,165,0.7971606712087455
15489,1414.397133,1414.424067,1,42431913,42432722,809,0.28575255342991784
15490,1414.4395,1414.4785,1,42433185,42434355,1170,0.2154945202779752
15491,1414.479533,1414.487233,1,42434385,42434616,231,0.8721310067520394
15492,1414.491433,1414.502933,1,42434742,42435087,345,0.717233017280356
15493,1414.5043,1414.5291,1,42435129,42435873,744,0.752826169024952
15494,1414.541167,1414.593367,1,42436235,42437801,1566,0.4548517685079787
15495,1414.6021,1414.655067,1,42438063,42439652,1589,0.22868082694485778
15496,1414.658833,1414.674733,1,42439764,42440241,477,0.5714087827899774
15497,1414.6758,1414.686167,1,42440274,42440585,311,0.4943475970619476
15498,1414.690533,1414.725167,1,42440715,42441755,1040,0.26350675954762703
15499,1414.7271,1414.7431,1,42441813,42442293,480,0.1601492752855113
15500,1414.751467,1414.754633,1,42442544,42442638,94,0.8889427305096093
15501,1414.7617,1414.7672,1,42442851,42443016,165,0.8500463269425602
15502,1414.770333,1414.778067,1,42443109,42443342,233,0.7830800186820488
15503,1414.798,1414.801867,1,42443940,42444056,116,0.8587255226657698
15504,1414.806,1414.8326,1,42444180,42444978,798,0.23915330833001514
15505,1414.861633,1414.8667,1,42445848,42446001,153,0.9025629761451527
15506,1414.8723,1414.893733,1,42446169,42446811,642,0.8941994154284993
15507,1414.898367,1414.933667,1,42446951,42448010,1059,0.3220244656172714
15508,1414.938033,1414.942633,1,42448140,42448278,138,0.8330943374585871
15509,1414.9536,1414.972767,1,42448608,42449183,575,0.3896698316183528
15510,1414.9738,1415.003833,1,42449214,42450114,900,0.830067385189168
15511,1415.005567,1415.037033,1,42450167,42451110,943,0.19674850466898944
15512,1415.038033,1415.047533,1,42451140,42451425,285,0.1122423516952379
15513,1415.0766,1415.118667,1,42452298,42453560,1262,0.6673664148545817
15514,1415.1237,1415.157567,1,42453711,42454727,1016,0.20577956747442475
15515,1415.163067,1415.169067,1,42454892,42455072,180,0.15937295067947121
15516,1415.176133,1415.1868,1,42455283,42455604,321,0.39349469810983373
15517,1415.216,1415.241867,1,42456480,42457256,776,0.5737935377483685
15518,1415.2435,1415.254067,1,42457305,42457622,317,0.6604220511854041
15519,1415.2777,1415.298633,1,42458331,42458958,627,0.3576128439870869
15520,1415.301767,1415.306,1,42459053,42459180,127,0.6883179280926367
15521,1415.401733,1415.407133,1,42462051,42462213,162,0.8480809541860542
15522,1415.413767,1415.418733,1,42462413,42462561,148,0.23604976547472623
15523,1415.461267,1415.474167,1,42463838,42464225,387,0.3735765398075284
15524,1415.564033,1415.569233,1,42466920,42467076,156,0.6315936147326046
15525,1415.570333,1415.580567,1,42467109,42467417,308,0.6191040576363046
15526,1415.5846,1415.5943,1,42467538,42467829,291,0.46195387438436264
15527,1415.615367,1415.6269,1,42468461,42468807,346,0.3484279576746176
15528,1415.7557,1415.780033,1,42472671,42473400,729,0.4975051324861342
15529,1415.790067,1415.8051,1,42473702,42474153,451,0.23237633429487078
15530,1415.813167,1415.853067,1,42474395,42475592,1197,0.4625306905433346
15531,1415.8588,1415.896367,1,42475764,42476891,1127,0.29174043209898276
15532,1415.899467,1415.905933,1,42476984,42477177,193,0.8501482293016396
15533,1415.907,1415.915433,1,42477210,42477462,252,0.3726628968242782
15534,1415.9497,1415.952933,1,42478491,42478587,96,0.7585155373073342
15535,1415.968067,1416.000167,1,42479042,42480005,963,0.2099298728661915
15536,1416.009233,1416.025633,1,42480276,42480768,492,0.2689293606155129
15537,1416.0293,1416.052833,1,42480879,42481584,705,-0.11081082682421559
15538,1416.055267,1416.064667,1,42481658,42481940,282,0.16423651651300072
15539,1416.0706,1416.076433,1,42482118,42482292,174,0.39562457168503495
15540,1416.134833,1416.1537,1,42484044,42484611,567,0.5261767592791139
15541,1416.159333,1416.163167,1,42484779,42484895,116,0.8093616020007836
15542,1416.1798,1416.1988,1,42485394,42485964,570,0.7525578054764561
15543,1416.299833,1416.306867,1,42488994,42489206,212,0.7901465698661375
15544,1416.3219,1416.369933,1,42489657,42491097,1440,0.1490946653497504
15545,1416.392467,1416.4031,1,42491774,42492093,319,0.26472275929193423
15546,1416.411,1416.471133,1,42492330,42494133,1803,0.22889684696686
15547,1416.472667,1416.4868,1,42494180,42494604,424,0.449683600980523
15548,1416.500367,1416.561333,1,42495011,42496839,1828,0.2677190011661935
15549,1416.566167,1416.612733,1,42496985,42498381,1396,0.2435915510752888
15550,1416.6264,1416.631833,1,42498792,42498954,162,0.7008042174825839
15551,1416.639033,1416.646967,1,42499170,42499409,239,0.88945800210458
15552,1416.648,1416.6542,1,42499440,42499626,186,0.8625693837174524
15553,1416.6594,1416.664567,1,42499782,42499937,155,0.8595922164743258
15554,1416.665667,1416.671067,1,42499970,42500132,162,0.3009550545306405
15555,1416.675267,1416.7048,1,42500258,42501144,886,0.20897717221391485
15556,1416.707367,1416.7362,1,42501221,42502086,865,0.11820517385404593
15557,1416.737667,1416.7577,1,42502130,42502731,601,0.5308764795716172
15558,1416.766333,1416.8106,1,42502989,42504318,1329,0.09076436222557362
15559,1416.822967,1416.850567,1,42504689,42505517,828,0.46905888183952565
15560,1416.853467,1416.884033,1,42505604,42506520,916,0.34271044734715556
15561,1416.914967,1416.9197,1,42507449,42507591,142,0.08953322511768669
15562,1416.922633,1416.932933,1,42507678,42507987,309,0.2853426534965832
15563,1416.9392,1416.9515,1,42508176,42508545,369,0.396712642179821
15564,1416.965,1416.978967,1,42508950,42509369,419,0.28267696435280076
15565,1416.980067,1417.0099,1,42509402,42510297,895,0.5176730422039352
15566,1417.019,1417.023133,1,42510570,42510693,123,0.5703083600432708
15567,1417.0496,1417.066167,1,42511488,42511985,497,0.15431230010172997
15568,1417.075067,1417.152,1,42512252,42514560,2308,0.3711851586850275
15569,1417.156333,1417.162733,1,42514689,42514881,192,0.8077379265807558
15570,1417.1657,1417.175033,1,42514971,42515250,279,0.5490074028695593
15571,1417.179667,1417.190167,1,42515390,42515705,315,0.839844189051399
15572,1417.2069,1417.226633,1,42516207,42516798,591,0.3141374316921037
15573,1417.229767,1417.2334,1,42516893,42517002,109,0.9131801360728112
15574,1417.251667,1417.257333,1,42517550,42517719,169,0.9149826036142926
15575,1417.5017,1417.567467,1,42525051,42527024,1973,0.08542009612550026
15576,1417.586767,1417.597767,1,42527603,42527933,330,0.3076275995296345
15577,1417.6038,1417.6659,1,42528114,42529977,1863,0.060891052503186056
15578,1417.667467,1417.6877,1,42530024,42530631,607,0.44051227063470005
15579,1417.694533,1417.7012,1,42530835,42531036,201,0.7364413447061121
15580,1417.715533,1417.719567,1,42531465,42531587,122,0.46960401246345557
15581,1417.724367,1417.739933,1,42531731,42532197,466,0.18030903552720307
15582,1417.777967,1417.795267,1,42533339,42533858,519,0.3423206142258533
15583,1417.798,1417.8011,1,42533940,42534033,93,0.7564070813009356
15584,1417.8528,1417.898333,1,42535584,42536949,1365,0.021131629329624417
15585,1417.908833,1417.9213,1,42537264,42537639,375,-0.08171457715409404
15586,1417.9581,1417.962567,1,42538743,42538877,134,0.4290435647492683
15587,1417.988267,1417.9948,1,42539648,42539844,196,0.47332572338550866
15588,1417.9997,1418.0049,1,42539991,42540147,156,0.5536237527392528
15589,1418.028933,1418.037867,1,42540867,42541136,269,0.45216679588499015
15590,1418.097433,1418.104933,1,42542922,42543147,225,0.42618945826384547
15591,1418.155867,1418.159267,1,42544676,42544778,102,0.32583908786618415
15592,1418.209467,1418.220233,1,42546284,42546606,322,0.27158162249875745
15593,1418.489233,1418.492467,1,42554676,42554774,98,0.6674569701495847
15594,1418.617667,1418.622667,1,42558530,42558680,150,0.7327700439716249
15595,1418.625533,1418.653167,1,42558765,42559595,830,0.3840702060506616
15596,1418.683533,1418.696267,1,42560505,42560888,383,0.6678919062649691
15597,1418.7388,1418.807533,1,42562164,42564225,2061,0.26861553998236803
15598,1418.809867,1418.8187,1,42564296,42564561,265,0.6587678241622588
15599,1418.8235,1418.830033,1,42564705,42564900,195,0.9167359196489936
15600,1418.836267,1418.853,1,42565088,42565590,502,0.2052388909115766
15601,1418.867233,1418.9136,1,42566016,42567408,1392,0.261471211588521
15602,1418.9308,1418.967867,1,42567924,42569036,1112,0.1108639669066842
15603,1418.9835,1418.996167,1,42569505,42569885,380,0.3122365254610017
15604,1419.039667,1419.046867,1,42571190,42571406,216,0.8266345648085957
15605,1419.064733,1419.123967,1,42571941,42573719,1778,0.2022435383443862
15606,1419.1523,1419.171133,1,42574569,42575133,564,0.2987687649118765
15607,1419.180067,1419.195333,1,42575402,42575859,457,0.769133049369079
15608,1419.671267,1419.709433,1,42590138,42591282,1144,0.32717340371168835
15609,1419.737033,1419.752633,1,42592110,42592578,468,0.7919397583734195
15610,1419.767633,1419.775067,1,42593028,42593252,224,0.8736882112593317
15611,1419.808333,1419.811333,1,42594249,42594339,90,0.882811721619995
15612,1419.812633,1419.8164,1,42594378,42594492,114,0.44636350033254973
15613,1419.846633,1419.9092,1,42595398,42597276,1878,0.358451009164852
15614,1419.924033,1419.940867,1,42597720,42598226,506,0.21750737304994275
15615,1419.972967,1420.0148,1,42599189,42600444,1255,0.23370626688107846
15616,1420.041467,1420.059233,1,42601244,42601776,532,0.4882840612923624
15617,1420.7193,1420.723567,1,42621579,42621707,128,0.850710692327939
15618,1421.180267,1421.249533,1,42635408,42637485,2077,0.26754108225843126
15619,1421.2626,1421.278533,1,42637878,42638355,477,0.39519319849749834
15620,1421.288867,1421.2965,1,42638666,42638895,229,0.14118501161442015
15621,1421.3038,1421.3201,1,42639114,42639603,489,0.46238985707278535
15622,1421.3272,1421.3871,1,42639816,42641613,1797,0.13631870924990896
15623,1421.3881,1421.441833,1,42641643,42643254,1611,0.3043049113269752
15624,1421.444967,1421.472733,1,42643349,42644181,832,0.8997505781426067
15625,1421.474133,1421.495433,1,42644223,42644862,639,0.20771438446736545
15626,1421.496667,1421.616433,1,42644900,42648492,3592,0.2849359996370768
15627,1421.6206,1421.687667,1,42648618,42650630,2012,0.3751599385646958
15628,1421.689133,1421.694133,1,42650673,42650823,150,0.5031800902678595
15629,1421.6963,1421.719267,1,42650889,42651578,689,0.17638686016469127
15630,1421.720333,1421.734933,1,42651609,42652047,438,0.3055280769520185
15631,1421.7398,1421.764833,1,42652194,42652944,750,0.38093348079153794
15632,1421.766633,1421.8018,1,42652998,42654054,1056,0.8075903205646463
15633,1421.8276,1421.848467,1,42654828,42655454,626,0.4754174963577616
15634,1421.856233,1421.860233,1,42655686,42655806,120,0.5266126602864213
15635,1421.879833,1421.8849,1,42656394,42656547,153,0.7922120802139226
15636,1422.194,1422.2031,1,42665820,42666093,273,0.6569617330390417
15637,1422.231433,1422.2349,1,42666942,42667047,105,0.7326082078151015
15638,1422.242767,1422.246133,1,42667283,42667383,100,0.8794074263475465
15639,1422.247667,1422.268933,1,42667430,42668067,637,0.3358159688824418
15640,1422.299833,1422.337,1,42668994,42670110,1116,0.2989765647006766
15641,1422.339667,1422.396733,1,42670190,42671901,1711,0.2774963581840109
15642,1422.397833,1422.432067,1,42671934,42672962,1028,0.6377395262103598
15643,1422.441433,1422.454133,1,42673242,42673623,381,0.8331932051396083
15644,1422.483167,1422.499533,1,42674495,42674985,490,0.46956901230463577
15645,1422.504533,1422.5138,1,42675135,42675414,279,0.5142966481597958
15646,1422.523333,1422.5588,1,42675699,42676764,1065,0.28665648822644335
15647,1422.559867,1422.574367,1,42676796,42677231,435,0.596684266633826
15648,1422.593333,1422.596367,1,42677799,42677891,92,0.9094826832600984
15649,1422.7192,1422.753533,1,42681576,42682605,1029,0.40812192574961687
15650,1422.754633,1422.7609,1,42682638,42682827,189,0.8662476506168918
15651,1422.762567,1422.771167,1,42682877,42683135,258,0.8571170219884414
15652,1422.772233,1422.775333,1,42683166,42683259,93,0.6158516214334637
15653,1422.780933,1422.7878,1,42683427,42683634,207,0.7622532865417722
15654,1422.812933,1422.8344,1,42684387,42685032,645,0.6406397479215857
15655,1422.8653,1422.869533,1,42685959,42686085,126,0.8557095034308645
15656,1422.904833,1422.925367,1,42687144,42687761,617,0.599341325330197
15657,1422.940467,1422.946967,1,42688214,42688409,195,0.8769656174663196
15658,1422.951,1422.9712,1,42688530,42689136,606,0.7150439924826463
15659,1422.9752,1422.9985,1,42689256,42689955,699,0.2394750016499753
15660,1423.0005,1423.0102,1,42690015,42690306,291,0.3134484415087499
15661,1423.0204,1423.032467,1,42690612,42690974,362,0.3118584641581639
15662,1423.0432,1423.090633,1,42691296,42692718,1422,0.2610279924144014
15663,1423.0981,1423.103233,1,42692943,42693096,153,0.8343402696206073
15664,1423.105967,1423.111567,1,42693179,42693347,168,0.7705874169316284
15665,1423.112767,1423.1251,1,42693383,42693753,370,0.3553256957354838
15666,1423.133867,1423.151633,1,42694016,42694548,532,0.18884088684188094
15667,1423.164533,1423.235867,1,42694935,42697076,2141,0.32773682165678175
15668,1423.248267,1423.306533,1,42697448,42699195,1747,0.41952685233914233
15669,1423.3619,1423.471333,1,42700857,42704139,3282,0.08893602075388729
15670,1423.472633,1423.483533,1,42704178,42704505,327,0.3887178245395725
15671,1423.484533,1423.494733,1,42704535,42704841,306,0.3216005090753966
15672,1423.4983,1423.501933,1,42704949,42705057,108,0.8946998676146977
15673,1423.538533,1423.5527,1,42706155,42706581,426,0.2565839974028061
15674,1423.5578,1423.568767,1,42706734,42707063,329,0.49912646443903325
15675,1423.605667,1423.664367,1,42708170,42709931,1761,0.17798364092364022
15676,1423.700433,1423.725633,1,42711012,42711768,756,0.42834921547747784
15677,1423.744467,1423.76,1,42712334,42712800,466,0.5951234206909576
15678,1423.7795,1423.783367,1,42713385,42713501,116,0.8969096249583638
15679,1424.201867,1424.206133,1,42726056,42726183,127,0.7384331505651279
15680,1424.219167,1424.223533,1,42726575,42726705,130,0.6963767831260508
15681,1424.2366,1424.2408,1,42727098,42727224,126,0.8186684521201862
15682,1424.259733,1424.2643,1,42727791,42727929,138,0.449284101341739
15683,1424.3218,1424.324967,1,42729654,42729749,95,-0.36779754660642483
15684,1424.480833,1424.4948,1,42734424,42734844,420,0.43279531379202574
15685,1424.499067,1424.547067,1,42734972,42736412,1440,0.3147352630024419
15686,1424.5501,1424.5591,1,42736503,42736773,270,0.17612647064634002
15687,1424.575367,1424.6111,1,42737261,42738333,1072,0.3540180634643897
15688,1424.6121,1424.6261,1,42738363,42738783,420,0.6204835219528402
15689,1424.636,1424.641367,1,42739080,42739241,161,0.3185732266459873
15690,1424.659867,1424.663633,1,42739796,42739908,112,0.30943239186093
15691,1424.668,1424.671533,1,42740040,42740145,105,0.23643523857729648
15692,1424.679367,1424.685433,1,42740381,42740562,181,0.7091699792886798
15693,1424.717033,1424.737033,1,42741510,42742110,600,0.46979757766988306
15694,1424.740533,1424.753233,1,42742215,42742596,381,0.5286505654977305
15695,1424.914467,1424.919567,1,42747434,42747587,153,0.009594569071460593
15696,1425.012233,1425.030833,1,42750366,42750924,558,0.48561089963572174
15697,1425.0482,1425.0648,1,42751446,42751944,498,0.5714441001979796
15698,1425.090267,1425.095033,1,42752708,42752850,142,0.8578989547125192
15699,1425.109967,1425.1133,1,42753299,42753399,100,0.7689347126334748
15700,1425.1168,1425.142433,1,42753504,42754272,768,0.2505787755103101
15701,1425.1436,1425.163567,1,42754308,42754907,599,0.46919622931619215
15702,1425.171367,1425.176133,1,42755141,42755283,142,0.7570920769680112
15703,1425.182333,1425.205833,1,42755469,42756174,705,0.5874166168373309
15704,1425.214267,1425.217367,1,42756428,42756521,93,0.8620229120680817
15705,1425.223633,1425.239467,1,42756708,42757184,476,0.18097545431059414
15706,1425.2458,1425.251167,1,42757374,42757535,161,0.4949904404731465
15707,1425.264467,1425.276933,1,42757934,42758307,373,0.1390422000949235
15708,1425.3108,1425.359267,1,42759324,42760778,1454,0.18475432412998644
15709,1425.3662,1425.371967,1,42760986,42761159,173,0.6640378663000481
15710,1425.381133,1425.385033,1,42761433,42761550,117,0.7018883534585104
15711,1425.4191,1425.446633,1,42762573,42763398,825,0.08957450573099406
15712,1425.455533,1425.478033,1,42763665,42764340,675,0.3075497910029836
15713,1425.479667,1425.552,1,42764390,42766560,2170,0.2017144838913847
15714,1425.553633,1425.560167,1,42766608,42766805,197,0.8544223043399342
15715,1425.5676,1425.583067,1,42767028,42767492,464,0.5736450023689235
15716,1425.6187,1425.631667,1,42768561,42768950,389,0.6887408824159048
15717,1425.6908,1425.693933,1,42770724,42770817,93,0.6854811301513585
15718,1425.7096,1425.7188,1,42771288,42771564,276,0.43829885448430905
15719,1425.724933,1425.729067,1,42771747,42771872,125,0.8704617714646298
15720,1425.781967,1425.830533,1,42773459,42774915,1456,0.18958446785162056
15721,1425.8623,1425.891033,1,42775869,42776730,861,0.4884413530874079
15722,1425.904033,1425.909433,1,42777120,42777282,162,0.3091641823704196
15723,1425.923267,1425.9327,1,42777698,42777981,283,0.18497596244569112
15724,1426.018033,1426.033733,1,42780540,42781011,471,0.18806235753857026
15725,1426.043333,1426.0502,1,42781299,42781506,207,0.5522433976750477
15726,1426.483667,1426.504433,1,42794510,42795132,622,0.1628399009258503
15727,1426.5219,1426.530267,1,42795657,42795908,251,0.5164032636754242
15728,1426.531833,1426.562233,1,42795954,42796866,912,0.42751241202220847
15729,1426.567633,1426.580533,1,42797028,42797415,387,0.7211605382420077
15730,1426.5954,1426.6198,1,42797862,42798594,732,0.5134621193210333
15731,1426.621133,1426.660333,1,42798633,42799809,1176,0.4854395747237796
15732,1426.676333,1426.680033,1,42800289,42800400,111,0.7975749860962044
15733,1426.684667,1426.688267,1,42800540,42800648,108,0.7520645992828598
15734,1426.691667,1426.697867,1,42800750,42800936,186,0.38342363821434877
15735,1426.907267,1426.914267,1,42807218,42807428,210,0.5235170703638949
15736,1427.199033,1427.2164,1,42815970,42816492,522,0.3666326902082518
15737,1427.2182,1427.2314,1,42816546,42816942,396,0.9040533402877494
15738,1427.276433,1427.2864,1,42818292,42818592,300,0.756042222712372
15739,1427.299233,1427.3036,1,42818976,42819108,132,-0.04891465912847554
15740,1427.350367,1427.3554,1,42820511,42820662,151,0.6777532576493082
15741,1427.3631,1427.368167,1,42820893,42821045,152,0.5711803919153396
15742,1427.397733,1427.4082,1,42821931,42822246,315,0.3233177997736575
15743,1427.412933,1427.4181,1,42822387,42822543,156,0.3130511236538485
15744,1427.758633,1427.7639,1,42832758,42832917,159,0.7881556274109932
15745,1427.7699,1427.774167,1,42833097,42833225,128,0.9342242315087128
15746,1427.8043,1427.8107,1,42834129,42834321,192,0.3706071234891672
15747,1427.823933,1427.835467,1,42834717,42835064,347,0.27277974003725924
15748,1427.838533,1427.864667,1,42835155,42835940,785,0.11844545118358311
15749,1427.867133,1427.870467,1,42836013,42836114,101,0.2997215727061114
15750,1427.8719,1427.925067,1,42836157,42837752,1595,0.16740896455666618
15751,1427.931133,1427.985433,1,42837933,42839562,1629,0.2591614788818555
15752,1427.999067,1428.012833,1,42839972,42840384,412,0.2808710779179703
15753,1428.080867,1428.083867,1,42842426,42842516,90,0.460171464562749
15754,1428.085867,1428.0983,1,42842576,42842949,373,0.7722558330665166
15755,1428.134267,1428.144133,1,42844028,42844323,295,0.38881097261874903
15756,1428.499833,1428.505233,1,42854994,42855156,162,0.5319097831318231
15757,1428.513167,1428.517467,1,42855395,42855524,129,0.1485468482319201
15758,1428.590867,1428.597733,1,42857726,42857931,205,0.8651598569759484
15759,1428.600033,1428.603267,1,42858000,42858098,98,0.7863557387006835
15760,1428.621433,1428.626667,1,42858642,42858800,158,0.9352079027177305
15761,1428.6341,1428.691033,1,42859023,42860730,1707,0.30532504158481
15762,1428.719267,1428.748833,1,42861578,42862464,886,0.3105594658627191
15763,1428.754767,1428.7739,1,42862643,42863217,574,0.2275784915874339
15764,1429.335667,1429.342267,1,42880070,42880268,198,0.36148117309771166
15765,1429.343933,1429.3536,1,42880317,42880608,291,0.4446406867234063
15766,1429.7973,1429.815633,1,42893919,42894468,549,0.6880759074656735
15767,1429.818533,1429.838967,1,42894555,42895169,614,0.3854751228963901
15768,1429.846333,1429.8772,1,42895389,42896316,927,0.38414245920125256
15769,1430.588033,1430.599,1,42917640,42917970,330,0.32770143576177907
15770,1430.6062,1430.6199,1,42918186,42918597,411,0.5436803844673708
15771,1430.627933,1430.638833,1,42918837,42919164,327,0.687573074220247
15772,1430.662633,1430.671867,1,42919878,42920156,278,0.8133336641652791
15773,1430.802433,1430.813367,1,42924072,42924401,329,0.6514142424820869
15774,1430.8267,1430.846733,1,42924801,42925401,600,0.11366856559588125
15775,1430.847933,1430.895333,1,42925437,42926859,1422,0.046921272973803475
15776,1430.9232,1430.926867,1,42927696,42927806,110,0.7450288069621867
15777,1430.929933,1430.9558,1,42927897,42928674,777,0.35983692858665217
15778,1430.963633,1430.971867,1,42928908,42929156,248,0.6727485259752165
15779,1430.977567,1430.999233,1,42929327,42929976,649,0.25333897802599303
15780,1431.084767,1431.0884,1,42932543,42932652,109,0.6118777713179748
15781,1431.103233,1431.1069,1,42933096,42933207,111,0.8614495865155961
15782,1431.161067,1431.1659,1,42934832,42934977,145,0.4190636580441257
15783,1431.432833,1431.4362,1,42942984,42943086,102,0.4738103062579434
15784,1431.485133,1431.488333,1,42944553,42944649,96,0.8030749034500649
15785,1431.6241,1431.640067,1,42948723,42949202,479,0.2884384734923012
15786,1431.661533,1431.666867,1,42949845,42950006,161,0.6498194935629733
15787,1431.6828,1431.7063,1,42950484,42951189,705,0.32422873943942215
15788,1431.707467,1431.721733,1,42951224,42951651,427,0.4198914592065901
15789,1431.732667,1431.739633,1,42951980,42952188,208,0.16848137042105696
15790,1431.7536,1431.800167,1,42952608,42954005,1397,0.16918737935853553
15791,1431.813433,1431.818233,1,42954402,42954546,144,0.688057678618062
15792,1431.822067,1431.8354,1,42954662,42955062,400,0.4041148019211377
15793,1431.8416,1431.990967,1,42955248,42959729,4481,0.19392142994950334
15794,1431.992567,1431.996133,1,42959777,42959883,106,0.10473444792429337
15795,1432.001567,1432.033567,1,42960047,42961007,960,0.11321430757306394
15796,1432.0386,1432.054567,1,42961158,42961637,479,0.501433107271901
15797,1432.056433,1432.1069,1,42961692,42963207,1515,0.4281777322996086
15798,1432.111533,1432.1156,1,42963345,42963468,123,0.8401956494016954
15799,1432.1236,1432.152333,1,42963708,42964569,861,0.26928963717525656
15800,1432.154967,1432.166067,1,42964649,42964982,333,0.7162497573466808
15801,1432.184933,1432.208333,1,42965547,42966249,702,0.16647705098917237
15802,1432.211033,1432.245633,1,42966330,42967368,1038,0.7860614858032563
15803,1432.251233,1432.3022,1,42967536,42969066,1530,0.34046718875558
15804,1432.322067,1432.376167,1,42969662,42971285,1623,0.2703634941294457
15805,1432.3785,1432.423667,1,42971355,42972710,1355,0.27252822386041065
15806,1432.426567,1432.4374,1,42972797,42973122,325,0.23956587395278287
15807,1432.4496,1432.472933,1,42973488,42974187,699,0.09953743588733001
15808,1432.4864,1432.532,1,42974592,42975960,1368,0.26570378142669
15809,1432.547733,1432.588133,1,42976431,42977643,1212,0.20183027284205907
15810,1432.6637,1432.669433,1,42979911,42980082,171,0.636958043481551
15811,1432.6709,1432.684767,1,42980127,42980543,416,0.7649307765627309
15812,1432.689433,1432.693167,1,42980682,42980795,113,0.8710373208844593
15813,1432.702333,1432.705933,1,42981069,42981177,108,0.9090424848868237
15814,1432.9809,1432.985833,1,42989427,42989574,147,0.889016141821369
15815,1433.0455,1433.064433,1,42991365,42991932,567,0.5775362761247532
15816,1433.065433,1433.0949,1,42991962,42992847,885,0.8237122726721784
15817,1433.109067,1433.116667,1,42993272,42993500,228,0.7428478633510237
15818,1433.1298,1433.1532,1,42993894,42994596,702,0.6879702942799483
15819,1433.161633,1433.2066,1,42994848,42996198,1350,0.6011963794110663
15820,1433.210333,1433.2146,1,42996309,42996438,129,0.6271631766331857
15821,1433.216433,1433.250567,1,42996492,42997517,1025,0.6580088638436032
15822,1433.284,1433.287367,1,42998520,42998621,101,0.6306707140604771
15823,1433.2896,1433.3005,1,42998688,42999015,327,0.47942923536966986
15824,1433.304267,1433.307867,1,42999128,42999236,108,0.9237903085670998
15825,1433.3276,1433.331467,1,42999828,42999944,116,0.7061609514995661
15826,1433.3345,1433.341833,1,43000035,43000254,219,0.9197220890839408
15827,1433.3654,1433.3942,1,43000962,43001826,864,0.3258190002670288
15828,1433.395333,1433.400933,1,43001859,43002027,168,0.8199820790766369
15829,1433.433067,1433.443433,1,43002992,43003302,310,0.7676568763285146
15830,1433.454333,1433.474667,1,43003629,43004240,611,0.4273338433186064
15831,1433.475733,1433.493267,1,43004271,43004798,527,0.8630240049558914
15832,1433.506433,1433.5261,1,43005192,43005783,591,0.6051552159626926
15833,1433.536167,1433.5419,1,43006085,43006257,172,0.6824564884184025
15834,1433.543033,1433.547667,1,43006290,43006430,140,0.9179733618579003
15835,1433.5492,1433.564533,1,43006476,43006935,459,0.7038042738685156
15836,1433.603,1433.6279,1,43008090,43008837,747,0.43445450328960317
15837,1433.6298,1433.634033,1,43008894,43009020,126,0.8837146572670209
15838,1433.659167,1433.719133,1,43009775,43011573,1798,0.547678197664283
15839,1434.602133,1434.606233,1,43038063,43038186,123,0.9185723364812277
15840,1434.621467,1434.681133,1,43038644,43040433,1789,0.21860767888384966
15841,1434.686167,1434.700267,1,43040585,43041008,423,0.5841420147399787
15842,1434.713833,1434.752,1,43041414,43042560,1146,0.13954743048131438
15843,1434.762,1434.841933,1,43042860,43045257,2397,0.2484153850428235
15844,1434.848567,1434.8524,1,43045457,43045572,115,0.8186245076025384
15845,1434.859067,1434.865933,1,43045772,43045977,205,0.4639180883739209
15846,1434.8754,1434.8847,1,43046262,43046541,279,0.8889304311330412
15847,1434.889,1434.922,1,43046670,43047660,990,0.02690842065685988
15848,1435.014867,1435.0189,1,43050446,43050567,121,0.6342021673993596
15849,1435.0294,1435.047767,1,43050882,43051433,551,0.2799343563778646
15850,1435.0698,1435.075067,1,43052094,43052252,158,0.7429697500103579
15851,1435.079833,1435.112,1,43052394,43053360,966,0.11682772975941678
15852,1435.202733,1435.210533,1,43056081,43056315,234,0.14774297460731778
15853,1435.703733,1435.727967,1,43071111,43071839,728,0.37270235832362253
15854,1435.7378,1435.771833,1,43072134,43073154,1020,0.3782591909966404
15855,1435.817067,1435.821567,1,43074512,43074647,135,0.8403625398206147
15856,1435.837567,1435.8409,1,43075127,43075227,100,0.7803203343098043
15857,1435.891067,1435.897167,1,43076732,43076915,183,0.7302708243581049
15858,1435.997533,1436.001667,1,43079925,43080050,125,0.4418841102273397
15859,1436.056967,1436.0622,1,43081709,43081866,157,0.60222363615792
15860,1436.0677,1436.078333,1,43082031,43082349,318,0.33941076251089325
15861,1436.091867,1436.098467,1,43082756,43082954,198,0.659602276914186
15862,1436.1022,1436.106033,1,43083066,43083180,114,0.8730006920320302
15863,1436.107367,1436.146867,1,43083221,43084406,1185,0.5437057412158267
15864,1436.1495,1436.1863,1,43084485,43085589,1104,0.0981123212438883
15865,1436.199867,1436.208,1,43085996,43086240,244,0.5770111081180712
15866,1436.225367,1436.229733,1,43086761,43086891,130,0.8047092409867384
15867,1436.2383,1436.258767,1,43087149,43087763,614,0.0029680049322438657
15868,1436.278533,1436.307,1,43088355,43089210,855,0.040511323523566276
15869,1436.308067,1436.315267,1,43089242,43089458,216,0.4753515848182986
15870,1436.3163,1436.3284,1,43089489,43089852,363,0.5241196556452856
15871,1436.4288,1436.439633,1,43092864,43093188,324,0.6189482707846851
15872,1436.4782,1436.481333,1,43094346,43094439,93,0.9305871955698817
15873,1436.566933,1436.5713,1,43097007,43097139,132,0.8178666460074583
15874,1436.573367,1436.577533,1,43097201,43097325,124,0.8339317305954008
15875,1436.5787,1436.5834,1,43097361,43097502,141,0.5504321348960147
15876,1436.587133,1436.592067,1,43097613,43097762,149,0.4486433430229001
15877,1436.6003,1436.604133,1,43098009,43098123,114,0.9071490684374599
15878,1436.6941,1436.731067,1,43100823,43101932,1109,0.5069855027546518
15879,1436.7572,1436.7658,1,43102716,43102974,258,0.8580727887702373
15880,1436.766833,1436.773133,1,43103004,43103193,189,0.8362561196243407
15881,1437.262467,1437.272533,1,43117874,43118175,301,0.8971764792859886
15882,1437.391367,1437.399267,1,43121741,43121978,237,0.7574685788728887
15883,1437.406667,1437.4183,1,43122200,43122549,349,0.3686965183875954
15884,1437.422067,1437.432933,1,43122662,43122987,325,0.886706900601721
15885,1437.4343,1437.442967,1,43123029,43123289,260,0.6543464782814564
15886,1437.444067,1437.462633,1,43123322,43123878,556,0.828404320293219
15887,1437.4791,1437.4977,1,43124373,43124931,558,0.24451904161513816
15888,1437.5042,1437.5098,1,43125126,43125294,168,0.9114912527436003
15889,1437.520567,1437.529267,1,43125617,43125878,261,0.33113326071568483
15890,1437.535667,1437.544533,1,43126070,43126335,265,0.908205866413991
15891,1437.560533,1437.564233,1,43126815,43126926,111,0.9387014506870619
15892,1437.6415,1437.6447,1,43129245,43129341,96,0.3288962259823462
15893,1437.6458,1437.653833,1,43129374,43129614,240,0.5168878513241231
15894,1437.6558,1437.676033,1,43129674,43130280,606,0.6929799155386012
15895,1437.680933,1437.6851,1,43130427,43130553,126,0.4306950751141164
15896,1437.688567,1437.742967,1,43130657,43132289,1632,0.24830869048963633
15897,1437.745767,1437.778967,1,43132373,43133369,996,0.5726346218223389
15898,1437.784433,1437.788667,1,43133532,43133660,128,0.8405329045449309
15899,1437.794367,1437.812233,1,43133831,43134366,535,0.12317673613152617
15900,1437.8249,1437.8306,1,43134747,43134918,171,0.6840281463209089
15901,1438.1994,1438.2031,1,43145982,43146093,111,0.8892713823726827
15902,1438.3023,1438.3083,1,43149069,43149249,180,0.8391878833765202
15903,1438.311433,1438.3283,1,43149342,43149849,507,0.9023749061152985
15904,1438.333967,1438.3716,1,43150019,43151148,1129,0.1309817337813436
15905,1438.374667,1438.388633,1,43151240,43151658,418,0.4877144333958949
15906,1438.415333,1438.4208,1,43152459,43152624,165,0.8908763231219711
15907,1438.428933,1438.436133,1,43152867,43153083,216,0.483472721608401
15908,1438.456033,1438.497867,1,43153680,43154936,1256,0.2989066165787131
15909,1438.532867,1438.539067,1,43155986,43156172,186,0.416003225856256
15910,1438.541033,1438.575833,1,43156230,43157274,1044,0.3471605341240454
15911,1438.578533,1438.6149,1,43157355,43158447,1092,0.3081098663046695
15912,1438.617933,1438.631933,1,43158537,43158957,420,0.6654000178535534
15913,1438.757333,1438.763567,1,43162719,43162907,188,0.714030396918041
15914,1438.7713,1438.775033,1,43163139,43163250,111,0.8675818164623563
15915,1439.036633,1439.061233,1,43171098,43171836,738,0.36363804220709967
15916,1439.066767,1439.0989,1,43172003,43172967,964,0.34304455168528986
15917,1439.1134,1439.119467,1,43173402,43173584,182,0.820765959052823
15918,1439.171433,1439.2625,1,43175142,43177875,2733,0.2947163722727516
15919,1439.279333,1439.284633,1,43178379,43178538,159,0.6597394728432973
15920,1439.2859,1439.2957,1,43178577,43178871,294,0.8303801001926774
15921,1439.3003,1439.3203,1,43179009,43179609,600,0.7328485165182728
15922,1439.325333,1439.3367,1,43179759,43180101,342,0.21381915588383987
15923,1439.3382,1439.3499,1,43180146,43180497,351,0.34011382988225675
15924,1439.352467,1439.3558,1,43180574,43180674,100,0.6807244317676535
15925,1439.362833,1439.3838,1,43180884,43181514,630,0.18841214145272436
15926,1439.606933,1439.6654,1,43188207,43189962,1755,0.7134335166446305
15927,1439.666567,1439.669933,1,43189997,43190097,100,0.974091618580818
15928,1439.735467,1439.747667,1,43192064,43192430,366,0.6524669216093429
15929,1439.7572,1439.7617,1,43192716,43192851,135,0.8793667967633654
15930,1439.762833,1439.7702,1,43192884,43193106,222,0.7191543293675072
15931,1439.774967,1439.781033,1,43193249,43193430,181,0.7413326837850824
15932,1439.809167,1439.827633,1,43194275,43194828,553,0.7230650736482361
15933,1439.865467,1439.8711,1,43195964,43196133,169,0.7169721296366212
15934,1439.877933,1439.899567,1,43196337,43196987,650,0.7102073471124833
15935,1439.9103,1439.913867,1,43197309,43197416,107,0.9014944763179972
15936,1439.938433,1439.977233,1,43198152,43199316,1164,0.38125407164119945
15937,1439.997033,1440.001967,1,43199910,43200059,149,0.7868606075337388
15938,1440.004567,1440.0271,1,43200137,43200813,676,0.3255249155708109
15939,1440.053233,1440.0593,1,43201596,43201779,183,0.5382734040243338
15940,1440.060567,1440.064067,1,43201817,43201922,105,0.9354300256335383
15941,1440.071167,1440.106933,1,43202135,43203207,1072,0.327295143386891
15942,1440.109933,1440.123333,1,43203297,43203699,402,0.39553979487938046
15943,1440.1309,1440.1666,1,43203927,43204998,1071,0.4043571012646527
15944,1440.168733,1440.1724,1,43205061,43205172,111,0.6032105657902558
15945,1440.2209,1440.243933,1,43206627,43207317,690,0.5223034824985787
15946,1440.2462,1440.270767,1,43207386,43208123,737,0.4943617487390269
15947,1440.272133,1440.279133,1,43208163,43208373,210,0.6973092082252201
15948,1440.2862,1440.2951,1,43208586,43208853,267,0.4448335356861293
15949,1440.300833,1440.321233,1,43209024,43209636,612,0.6199555185169023
15950,1440.3255,1440.360667,1,43209765,43210820,1055,0.41558531676153754
15951,1440.367933,1440.380133,1,43211037,43211403,366,0.3185585269572349
15952,1440.382667,1440.394367,1,43211480,43211831,351,0.6535989790907049
15953,1440.396333,1440.404633,1,43211889,43212138,249,0.7345294705272013
15954,1440.407233,1440.4236,1,43212216,43212708,492,0.6138964847552122
15955,1440.4361,1440.4611,1,43213083,43213833,750,0.5684528759188414
15956,1440.470133,1440.508567,1,43214103,43215257,1154,0.48291002387488896
15957,1440.526033,1440.530333,1,43215780,43215909,129,0.8866738017024213
15958,1440.575167,1440.5854,1,43217255,43217562,307,0.8525363965004616
15959,1440.586633,1440.595667,1,43217598,43217870,272,0.6953495983989441
15960,1440.612933,1440.6197,1,43218387,43218591,204,0.8577036316374143
15961,1440.6289,1440.650833,1,43218867,43219524,657,0.8100534764439739
15962,1440.653033,1440.658633,1,43219590,43219758,168,0.6188829301044022
15963,1440.671367,1440.678033,1,43220141,43220340,199,0.8459063335697125
15964,1440.6814,1440.708167,1,43220442,43221245,803,0.8017689469894226
15965,1440.719267,1440.7231,1,43221578,43221693,115,0.8700892619530746
15966,1440.7755,1440.786367,1,43223265,43223591,326,0.2572183746416073
15967,1440.898967,1440.913,1,43226969,43227390,421,0.6223692081790414
15968,1440.9239,1440.927533,1,43227717,43227825,108,0.6442460371550439
15969,1440.948567,1440.955767,1,43228457,43228673,216,0.42802459843840257
15970,1440.9778,1441.001867,1,43229334,43230056,722,0.5013791871581694
15971,1441.015267,1441.0249,1,43230458,43230747,289,0.4252420060198237
15972,1441.028867,1441.0592,1,43230866,43231776,910,0.38776454447147973
15973,1441.073233,1441.101067,1,43232196,43233032,836,0.058922210963804
15974,1441.1148,1441.117867,1,43233444,43233536,92,0.7896475984529182
15975,1441.119467,1441.1267,1,43233584,43233801,217,0.6736575221551727
15976,1441.127767,1441.1352,1,43233833,43234056,223,0.4670275093672112
15977,1441.154067,1441.157967,1,43234622,43234739,117,0.8080031320353279
15978,1441.1621,1441.203367,1,43234863,43236101,1238,0.5018548075677332
15979,1441.2096,1441.215467,1,43236288,43236464,176,0.8667710112876564
15980,1441.216533,1441.235633,1,43236495,43237068,573,0.703045919990185
15981,1441.236933,1441.250533,1,43237107,43237515,408,0.38040660799328113
15982,1441.2635,1441.2974,1,43237905,43238922,1017,0.7528889307878164
15983,1441.301767,1441.307533,1,43239053,43239225,172,0.9393903794199586
15984,1441.3648,1441.391367,1,43240944,43241741,797,0.646733786779811
15985,1441.3929,1441.421733,1,43241787,43242651,864,0.7163291750726839
15986,1441.4381,1441.442767,1,43243143,43243283,140,0.6172767276139257
15987,1441.492767,1441.495767,1,43244783,43244873,90,0.287020537102808
15988,1441.559933,1441.567833,1,43246797,43247034,237,0.7744829424135422
15989,1441.569267,1441.574533,1,43247078,43247235,157,0.7494408891713382
15990,1441.576967,1441.584967,1,43247309,43247549,240,0.8110037017956434
15991,1441.5866,1441.596067,1,43247598,43247882,284,0.8216476065902512
15992,1441.6099,1441.614933,1,43248297,43248447,150,0.8734829569152359
15993,1441.6237,1441.632333,1,43248711,43248969,258,0.8466934402777093
15994,1441.638633,1441.660333,1,43249158,43249809,651,0.6771794792702983
15995,1441.667133,1441.673233,1,43250013,43250196,183,0.860506254096589
15996,1441.687067,1441.691333,1,43250612,43250739,127,0.7449392032554129
15997,1441.717333,1441.748967,1,43251519,43252469,950,0.13578217695137224
15998,1441.7517,1441.757633,1,43252551,43252728,177,0.3809189543072324
15999,1441.7587,1441.762167,1,43252761,43252865,104,0.35949002055322365
16000,1441.763567,1441.7687,1,43252907,43253061,154,0.4753579724266487
16001,1441.7698,1441.7739,1,43253094,43253217,123,0.24353944820038764
16002,1441.775967,1441.788367,1,43253279,43253651,372,0.2696676980999112
16003,1441.803667,1441.808433,1,43254110,43254252,142,0.7828617372745327
16004,1441.8471,1441.8539,1,43255413,43255617,204,0.79609002670069
16005,1441.862967,1441.905067,1,43255889,43257152,1263,0.7108698296199559
16006,1441.907633,1441.912967,1,43257228,43257389,161,0.5350055583801372
16007,1441.914133,1441.921633,1,43257423,43257648,225,0.8120302997082882
16008,1441.9258,1441.957567,1,43257774,43258727,953,0.5624580462806877
16009,1441.966533,1441.980167,1,43258995,43259405,410,0.3805023081092644
16010,1442.055467,1442.0741,1,43261664,43262223,559,0.36486830215018773
16011,1442.110967,1442.120767,1,43263329,43263623,294,0.7247868153554771
16012,1442.126167,1442.1457,1,43263785,43264371,586,0.36051037487738347
16013,1442.1593,1442.166733,1,43264779,43265001,222,0.5940705229400898
16014,1442.179267,1442.207433,1,43265378,43266222,844,0.596761206733784
16015,1442.210167,1442.232733,1,43266305,43266981,676,0.6361183603522
16016,1442.250667,1442.254433,1,43267520,43267632,112,0.8408021934213687
16017,1442.258367,1442.266067,1,43267751,43267982,231,0.7343934666847188
16018,1442.267067,1442.274133,1,43268012,43268223,211,0.862674159760432
16019,1442.2943,1442.330233,1,43268829,43269906,1077,0.3976894144107058
16020,1442.333467,1442.3504,1,43270004,43270512,508,0.31458612686105014
16021,1442.3645,1442.3718,1,43270935,43271154,219,0.7238298197683158
16022,1442.3772,1442.402533,1,43271316,43272075,759,0.5713055020852583
16023,1442.405567,1442.408867,1,43272167,43272266,99,0.7763647478637954
16024,1442.4623,1442.4974,1,43273869,43274922,1053,0.3827391449970179
16025,1442.5003,1442.509033,1,43275009,43275270,261,0.46127565211916005
16026,1442.512233,1442.524667,1,43275366,43275740,374,0.7405005254643707
16027,1442.572533,1442.575633,1,43277175,43277268,93,0.5575727760973667
16028,1442.603133,1442.617167,1,43278093,43278515,422,0.8508017921758831
16029,1442.665667,1442.670733,1,43279970,43280121,151,0.8667593972553101
16030,1442.678367,1442.6908,1,43280351,43280724,373,0.8525158199173198
16031,1442.7086,1442.711767,1,43281258,43281353,95,0.8862823106336675
16032,1442.713067,1442.7195,1,43281392,43281585,193,0.5560175164533941
16033,1442.754233,1442.780767,1,43282626,43283423,797,0.5581980875239336
16034,1442.790633,1442.794667,1,43283718,43283840,122,0.6569990633682473
16035,1442.812733,1442.849467,1,43284381,43285484,1103,0.7510383244718574
16036,1442.8747,1442.8805,1,43286241,43286415,174,0.693804512206943
16037,1442.898233,1442.9128,1,43286946,43287384,438,0.7541907324478249
16038,1442.954333,1442.960667,1,43288629,43288820,191,0.8856116813550993
16039,1442.990933,1443.001067,1,43289727,43290032,305,0.767148549066852
16040,1443.046233,1443.051467,1,43291386,43291544,158,0.5934798917667283
16041,1443.2913,1443.294867,1,43298739,43298846,107,0.3165124721142733
16042,1443.478667,1443.484267,1,43304360,43304528,168,0.32593152967498285
16043,1443.530933,1443.5597,1,43305927,43306791,864,0.20445151221600733
16044,1443.5787,1443.6153,1,43307361,43308459,1098,0.3095735193675214
16045,1443.622933,1443.6709,1,43308687,43310127,1440,0.4303817324176164
16046,1443.673733,1443.6841,1,43310211,43310523,312,0.7663191082088038
16047,1443.691867,1443.7145,1,43310756,43311435,679,0.23516261143442888
16048,1443.716033,1443.721333,1,43311480,43311639,159,0.39292213799325065
16049,1443.7296,1443.733167,1,43311888,43311995,107,0.7663781039072102
16050,1443.751,1443.759367,1,43312530,43312781,251,0.7980634162409714
16051,1443.760933,1443.7666,1,43312827,43312998,171,0.7999925553316212
16052,1443.771133,1443.777867,1,43313133,43313336,203,0.30622028514350536
16053,1443.813933,1443.825967,1,43314417,43314779,362,0.2522647037515558
16054,1443.830567,1443.851867,1,43314917,43315556,639,0.5376670869442967
16055,1443.8984,1443.901633,1,43316952,43317048,96,0.8314465422417818
16056,1443.908333,1443.9163,1,43317249,43317489,240,0.8854126659417433
16057,1443.917767,1443.948433,1,43317533,43318452,919,0.5882475476501359
16058,1443.950633,1443.989133,1,43318518,43319673,1155,0.015027824592739502
16059,1443.990367,1444.0,1,43319711,43320000,289,0.1958137286711053
16060,1444.003267,1444.007267,1,43320098,43320218,120,0.5132695823728382
16061,1444.0207,1444.024767,1,43320621,43320743,122,0.10801111949645723
16062,1444.026067,1444.071367,1,43320782,43322141,1359,0.09790275596888019
16063,1444.079033,1444.101667,1,43322370,43323050,680,0.25235854792888074
16064,1444.103433,1444.109067,1,43323102,43323272,170,0.39103646128280733
16065,1444.1141,1444.126133,1,43323423,43323783,360,0.19446474553037177
16066,1444.241367,1444.245,1,43327241,43327350,109,0.8789309078748826
16067,1444.492433,1444.509267,1,43334772,43335278,506,0.3902311651535511
16068,1444.520033,1444.5428,1,43335600,43336284,684,0.1489632310366835
16069,1444.548367,1444.5554,1,43336451,43336662,211,0.48038742182428235
16070,1444.570667,1444.5838,1,43337120,43337514,394,0.6590516901297874
16071,1444.5849,1444.618867,1,43337547,43338566,1019,0.5835533798174575
16072,1444.6259,1444.6307,1,43338777,43338921,144,0.8150561877036115
16073,1444.6359,1444.6537,1,43339077,43339611,534,0.3554842783953497
16074,1444.669633,1444.6752,1,43340088,43340256,168,0.7503661947748183
16075,1444.6842,1444.689367,1,43340526,43340681,155,0.8556797606532539
16076,1444.693933,1444.702333,1,43340817,43341069,252,0.7650345616200637
16077,1444.703767,1444.735433,1,43341113,43342062,949,0.6319214513816789
16078,1444.743067,1444.746433,1,43342292,43342392,100,0.8828622589760479
16079,1444.748867,1444.764133,1,43342466,43342923,457,0.492039302998565
16080,1444.7657,1444.778533,1,43342971,43343355,384,0.46966819241573154
16081,1444.949667,1444.9672,1,43348490,43349016,526,0.41439143422655045
16082,1444.975933,1444.9817,1,43349277,43349451,174,0.7368143753637661
16083,1444.983333,1444.997133,1,43349499,43349913,414,0.6552574772874769
16084,1445.000533,1445.0097,1,43350015,43350291,276,0.8405035589582773
16085,1445.044433,1445.054833,1,43351332,43351644,312,0.6529864026180496
16086,1445.0671,1445.082767,1,43352013,43352483,470,0.3541143742321531
16087,1445.092433,1445.0965,1,43352772,43352895,123,0.6994139529515015
16088,1445.109067,1445.118867,1,43353272,43353566,294,0.7337025797402154
16089,1445.1217,1445.125,1,43353651,43353750,99,0.6833949036121291
16090,1445.130433,1445.1392,1,43353912,43354176,264,0.6780435601807131
16091,1445.150867,1445.1606,1,43354526,43354818,292,0.9220927795308271
16092,1445.182567,1445.197433,1,43355477,43355922,445,0.519177592121563
16093,1445.220633,1445.2247,1,43356618,43356741,123,0.7571557296808027
16094,1445.232367,1445.239867,1,43356971,43357196,225,0.8168575531252406
16095,1445.2513,1445.297933,1,43357539,43358937,1398,0.6462846967953967
16096,1445.302167,1445.335233,1,43359065,43360056,991,0.4843627358415171
16097,1445.340233,1445.378767,1,43360206,43361363,1157,0.6440120818855873
16098,1445.388133,1445.3999,1,43361643,43361997,354,0.3893671745341253
16099,1445.424533,1445.428333,1,43362735,43362849,114,0.8557140554762134
16100,1445.437133,1445.441933,1,43363113,43363257,144,0.8994473743373489
16101,1445.443467,1445.447267,1,43363304,43363418,114,0.4577282068127082
16102,1445.4681,1445.485167,1,43364043,43364555,512,0.636891668428108
16103,1445.569967,1445.5739,1,43367099,43367217,118,0.9038597469186055
16104,1445.620267,1445.624333,1,43368608,43368729,121,0.5117484261536593
16105,1446.578833,1446.586467,1,43397364,43397594,230,0.5449031091521569
16106,1446.598533,1446.604533,1,43397955,43398135,180,0.8148735600586777
16107,1446.611767,1446.638867,1,43398353,43399166,813,0.2841182166639485
16108,1446.658967,1446.6759,1,43399769,43400277,508,0.6288702666823124
16109,1446.676933,1446.701333,1,43400307,43401039,732,0.6367277906664178
16110,1446.705433,1446.733933,1,43401162,43402017,855,0.27917878221784626
16111,1446.735367,1446.747333,1,43402061,43402419,358,0.37588127259490045
16112,1446.760067,1446.7655,1,43402802,43402965,163,0.4753402926346656
16113,1446.7676,1446.924667,1,43403028,43407740,4712,0.3050789181876035
16114,1446.9262,1446.973,1,43407786,43409190,1404,0.3474828643528673
16115,1446.988,1447.008367,1,43409640,43410251,611,0.7012599646501783
16116,1447.01,1447.102533,1,43410300,43413075,2775,0.43405895752902046
16117,1447.107067,1447.145367,1,43413212,43414361,1149,0.7194627177429133
16118,1447.148067,1447.196767,1,43414442,43415903,1461,0.6636627110749043
16119,1447.198167,1447.202333,1,43415945,43416069,124,0.7670264657741059
16120,1447.204167,1447.211333,1,43416125,43416339,214,0.7503798049278622
16121,1447.217367,1447.235333,1,43416521,43417059,538,0.4408373862091808
16122,1447.236533,1447.255333,1,43417095,43417659,564,0.5430569082296114
16123,1447.277133,1447.309067,1,43418313,43419272,959,0.3573205044336002
16124,1447.3261,1447.329367,1,43419783,43419881,98,0.8466727171846781
16125,1447.331733,1447.3625,1,43419951,43420875,924,0.7267750892787617
16126,1447.363833,1447.368,1,43420914,43421040,126,0.8456158667580229
16127,1447.371633,1447.390633,1,43421148,43421718,570,0.09783985243834792
16128,1447.4025,1447.490667,1,43422075,43424720,2645,0.31948685702069796
16129,1447.494833,1447.509,1,43424844,43425270,426,0.428283565713641
16130,1447.511633,1447.5254,1,43425348,43425762,414,0.4511825268036896
16131,1447.529,1447.5936,1,43425870,43427808,1938,0.30380354754621236
16132,1447.605667,1447.626467,1,43428170,43428794,624,0.3611885830931353
16133,1447.885667,1447.934667,1,43436570,43438040,1470,0.40724739059471315
16134,1447.943633,1447.946767,1,43438308,43438403,95,0.9279381716768732
16135,1447.9483,1447.956133,1,43438449,43438683,234,0.6116381482367101
16136,1447.9637,1447.975733,1,43438911,43439271,360,0.8196977989605079
16137,1447.976833,1447.987133,1,43439304,43439613,309,0.26862710295169634
16138,1447.998467,1448.0078,1,43439954,43440234,280,0.5614734609856262
16139,1448.044267,1448.064067,1,43441328,43441922,594,0.23716960913064294
16140,1448.0731,1448.087567,1,43442193,43442627,434,0.7679985204499934
16141,1448.093267,1448.110533,1,43442798,43443315,517,0.77483967513587
16142,1448.125433,1448.1313,1,43443762,43443939,177,0.7400642345682624
16143,1448.132733,1448.1475,1,43443981,43444425,444,0.39006639384567476
16144,1448.343967,1448.3601,1,43450319,43450803,484,0.6742588992858004
16145,1448.367733,1448.382633,1,43451031,43451478,447,0.6002171985510527
16146,1448.3883,1448.392867,1,43451649,43451786,137,0.8897682961261795
16147,1448.421833,1448.429667,1,43452654,43452890,236,0.7620245942650721
16148,1448.861933,1448.865933,1,43465857,43465977,120,0.590982747706709
16149,1448.8798,1448.8853,1,43466394,43466559,165,0.582138833436213
16150,1449.222533,1449.241067,1,43476675,43477232,557,0.8703713632789036
16151,1449.242367,1449.246233,1,43477271,43477386,115,0.8407605293879716
16152,1449.252767,1449.257967,1,43477583,43477739,156,0.20870842455762653
16153,1449.401433,1449.443,1,43482042,43483290,1248,0.24090920150188885
16154,1449.470867,1449.498233,1,43484126,43484946,820,0.34457975290964077
16155,1449.499467,1449.526433,1,43484984,43485792,808,-0.09201780704594396
16156,1449.531367,1449.538267,1,43485941,43486148,207,0.7944473968704505
16157,1449.5717,1449.613167,1,43487151,43488395,1244,0.2816374307227382
16158,1449.616467,1449.631667,1,43488494,43488950,456,0.1832287771468177
16159,1449.637033,1449.657033,1,43489110,43489710,600,0.052025856160275566
16160,1449.6998,1449.727,1,43490994,43491810,816,0.0036243498710288344
16161,1449.728,1449.7326,1,43491840,43491978,138,0.5254863207131538
16162,1449.733933,1449.737233,1,43492017,43492116,99,0.1935359957524141
16163,1449.7436,1449.779867,1,43492308,43493396,1088,0.3372195639499657
16164,1449.785333,1449.8213,1,43493559,43494639,1080,0.29676699934887985
16165,1449.822567,1449.831667,1,43494677,43494950,273,0.4222098875980508
16166,1449.832933,1449.8513,1,43494987,43495539,552,0.14728942567167871
16167,1449.855067,1449.858167,1,43495652,43495745,93,0.9085482246030525
16168,1449.8604,1449.870567,1,43495812,43496117,305,0.4568315771557168
16169,1449.882333,1449.887333,1,43496469,43496619,150,-0.2866045855676663
16170,1449.9073,1449.924333,1,43497219,43497729,510,0.2492914086858651
16171,1449.9509,1449.9689,1,43498527,43499067,540,0.07782983110502349
16172,1449.9746,1449.978667,1,43499238,43499360,122,0.6900335924016779
16173,1450.025633,1450.075567,1,43500768,43502267,1499,0.185433350562652
16174,1450.0855,1450.0915,1,43502565,43502745,180,0.06544569564935501
16175,1450.104033,1450.1317,1,43503120,43503951,831,0.12331534082387707
16176,1450.136067,1450.143867,1,43504082,43504316,234,0.6480669451674358
16177,1450.1458,1450.151133,1,43504374,43504533,159,0.8930815942451277
16178,1450.703333,1450.728167,1,43521099,43521845,746,0.04644311858058647
16179,1450.729567,1450.7486,1,43521887,43522458,571,0.7480675521283673
16180,1450.749833,1450.757633,1,43522494,43522728,234,0.5424169958899023
16181,1450.774367,1450.7817,1,43523231,43523451,220,0.778068246533561
16182,1450.823833,1450.870967,1,43524714,43526129,1415,0.30249690220772324
16183,1450.8862,1450.8896,1,43526586,43526688,102,0.8881227104401356
16184,1450.9129,1450.984,1,43527387,43529520,2133,0.19483224380133068
16185,1450.994533,1451.0034,1,43529835,43530102,267,0.822249524260041
16186,1451.010433,1451.027667,1,43530312,43530830,518,0.11833989903318856
16187,1451.067133,1451.084567,1,43532013,43532537,524,0.436572593864255
16188,1451.1701,1451.176533,1,43535103,43535295,192,0.20269945102826423
16189,1451.851467,1451.8555,1,43555544,43555665,121,0.16059778711833886
16190,1452.285933,1452.292733,1,43568577,43568781,204,0.06972422545999735
16191,1452.321167,1452.331233,1,43569635,43569936,301,0.5490666075158612
16192,1452.433667,1452.4524,1,43573010,43573572,562,0.46994424754598
16193,1452.4587,1452.4687,1,43573761,43574061,300,0.7711175264960836
16194,1452.474233,1452.4868,1,43574226,43574604,378,0.8836787925175964
16195,1452.488133,1452.492833,1,43574643,43574784,141,0.7616377642240112
16196,1452.4941,1452.498767,1,43574823,43574963,140,0.7956351327857175
16197,1452.499867,1452.5061,1,43574996,43575183,187,0.7651327109760584
16198,1452.511167,1452.516267,1,43575335,43575488,153,0.8316050509375533
16199,1452.517467,1452.521733,1,43575524,43575651,127,0.8929292723395514
16200,1452.525333,1452.5563,1,43575759,43576689,930,0.5634562265595069
16201,1452.558033,1452.5687,1,43576740,43577061,321,0.6183504482711539
16202,1452.569967,1452.5782,1,43577099,43577346,247,0.7840693793516357
16203,1452.604167,1452.611267,1,43578125,43578338,213,0.8338421425434662
16204,1452.6237,1452.656433,1,43578711,43579692,981,0.6246352269055633
16205,1452.6598,1452.662967,1,43579794,43579889,95,0.7514146829669546
16206,1452.686167,1452.689867,1,43580585,43580696,111,0.8603935916249884
16207,1452.792333,1452.798567,1,43583769,43583957,188,0.7637527195525113
16208,1452.810533,1452.813933,1,43584315,43584417,102,0.9325903078199276
16209,1452.963233,1452.973567,1,43588896,43589207,311,0.6047595566967281
16210,1452.998833,1453.0063,1,43589964,43590189,225,0.7262914782986327
16211,1453.086433,1453.0901,1,43592592,43592703,111,0.548889047833328
16212,1453.778233,1453.8119,1,43613346,43614357,1011,0.36913740356456626
16213,1453.816967,1453.828833,1,43614509,43614864,355,0.7550318588229269
16214,1453.839133,1453.868967,1,43615173,43616069,896,0.3884455544371724
16215,1453.8762,1453.889667,1,43616286,43616690,404,0.18777055407109405
16216,1453.923833,1453.9406,1,43617714,43618218,504,0.1527380555791901
16217,1453.947333,1453.9663,1,43618419,43618989,570,0.19771869320102886
16218,1453.98,1454.004067,1,43619400,43620122,722,0.1309252497978019
16219,1454.012433,1454.0219,1,43620372,43620657,285,0.3311922472182692
16220,1454.025733,1454.0693,1,43620771,43622079,1308,0.1841560269672944
16221,1454.097933,1454.111467,1,43622937,43623344,407,0.4347793803122466
16222,1454.112533,1454.1328,1,43623375,43623984,609,0.824066885454092
16223,1454.139233,1454.161367,1,43624176,43624841,665,0.4767156900910015
16224,1454.175033,1454.185133,1,43625250,43625553,303,-0.044521345190867784
16225,1454.186533,1454.201233,1,43625595,43626036,441,0.0701993754983349
16226,1454.2026,1454.208167,1,43626078,43626245,167,0.889497151211998
16227,1454.216567,1454.235967,1,43626497,43627079,582,0.23118561240350796
16228,1454.354267,1454.376567,1,43630628,43631297,669,0.1605402450967237
16229,1454.403733,1454.4115,1,43632111,43632345,234,0.7517858477016401
16230,1454.415933,1454.424733,1,43632477,43632741,264,0.746846650483873
16231,1454.426067,1454.431733,1,43632782,43632951,169,0.8317477054210091
16232,1454.432733,1454.4495,1,43632981,43633485,504,0.634322119488574
16233,1454.4508,1454.4555,1,43633524,43633665,141,0.24456522588072152
16234,1454.458633,1454.482533,1,43633758,43634475,717,0.19484800316813433
16235,1454.4897,1454.4942,1,43634691,43634826,135,0.9164882915555517
16236,1454.510767,1454.557733,1,43635323,43636731,1408,0.4187928221140175
16237,1454.559667,1454.5889,1,43636790,43637667,877,0.37406197640290717
16238,1454.6096,1454.618233,1,43638288,43638546,258,0.8003532587673967
16239,1454.620633,1454.627067,1,43638618,43638812,194,0.8143057931919897
16240,1454.628067,1454.6761,1,43638842,43640283,1441,0.4934040578861186
16241,1454.684733,1454.709,1,43640541,43641270,729,0.22382122114128736
16242,1454.713633,1454.7322,1,43641408,43641966,558,0.37672291060545426
16243,1454.748833,1454.758967,1,43642464,43642769,305,0.5512632854549363
16244,1454.760767,1454.807967,1,43642823,43644239,1416,0.6593865333187839
16245,1454.811767,1454.815,1,43644353,43644450,97,0.8559256623028338
16246,1454.8235,1454.850033,1,43644705,43645500,795,0.4349391589706495
16247,1454.904567,1454.918033,1,43647137,43647540,403,-0.010967163879121661
16248,1454.922533,1454.957333,1,43647675,43648719,1044,0.2976545658692185
16249,1454.963267,1454.9893,1,43648898,43649679,781,0.13237296027506987
16250,1455.087467,1455.109267,1,43652624,43653278,654,0.6478681190811593
16251,1455.137333,1455.142,1,43654119,43654260,141,0.7792831780024109
16252,1455.377233,1455.405633,1,43661316,43662168,852,0.532117174955723
16253,1455.409367,1455.426367,1,43662281,43662791,510,0.5746314873892944
16254,1455.435167,1455.4448,1,43663055,43663344,289,0.2982100136329839
16255,1455.446967,1455.4504,1,43663409,43663512,103,0.5221790175248255
16256,1455.456733,1455.460433,1,43663701,43663812,111,0.6503348807932862
16257,1455.497867,1455.502867,1,43664936,43665086,150,0.5706250340929631
16258,1455.548733,1455.563267,1,43666461,43666898,437,0.5105818218484395
16259,1455.572167,1455.577367,1,43667165,43667321,156,0.31497668496002607
16260,1455.579567,1455.590167,1,43667387,43667705,318,0.7760789939818011
16261,1455.641867,1455.656167,1,43669256,43669685,429,0.7345688580449776
16262,1455.7273,1455.732767,1,43671819,43671983,164,0.743530607289689
16263,1455.808567,1455.826267,1,43674257,43674788,531,0.5673614541738131
16264,1455.828633,1455.862233,1,43674858,43675866,1008,0.7193516163049994
16265,1455.8681,1455.8843,1,43676043,43676529,486,0.5181586585513116
16266,1455.891667,1455.8963,1,43676750,43676889,139,0.6946634040968833
16267,1455.933167,1455.974,1,43677995,43679220,1225,-0.0013516060715423595
16268,1456.013133,1456.016733,1,43680393,43680501,108,0.91289382744699
16269,1456.045233,1456.050433,1,43681356,43681512,156,0.6057027361780795
16270,1456.054267,1456.065933,1,43681628,43681977,349,0.3818986563652962
16271,1456.290533,1456.320967,1,43688715,43689629,914,0.5006398519865354
16272,1456.322267,1456.3261,1,43689668,43689783,115,0.8748494612927641
16273,1456.3339,1456.3466,1,43690017,43690398,381,0.6895838901038103
16274,1456.3545,1456.3716,1,43690635,43691148,513,0.4276313346568641
16275,1456.374,1456.379167,1,43691220,43691375,155,0.9252346834788802
16276,1456.380267,1456.3874,1,43691408,43691622,214,0.44799060337195873
16277,1456.398933,1456.403067,1,43691967,43692092,125,0.8940559554727243
16278,1456.419833,1456.429133,1,43692594,43692873,279,0.8396053321142903
16279,1456.431833,1456.471467,1,43692954,43694144,1190,0.29646439377688594
16280,1456.4725,1456.4765,1,43694175,43694295,120,0.747283716651821
16281,1457.419733,1457.488567,1,43722591,43724657,2066,-0.1416549819104281
16282,1457.489733,1457.494333,1,43724691,43724829,138,0.16292734859976057
16283,1457.495533,1457.5146,1,43724865,43725438,573,-0.054266638591137985
16284,1457.528733,1457.5575,1,43725861,43726725,864,0.28361791432193556
16285,1457.5885,1457.7183,1,43727655,43731549,3894,0.12081564680312894
16286,1457.7204,1457.733167,1,43731612,43731995,383,0.16533728961235578
16287,1457.736067,1457.752433,1,43732082,43732572,490,0.1402764293614242
16288,1457.785633,1457.849433,1,43733568,43735482,1914,0.1783192012457655
16289,1457.884633,1457.891367,1,43736538,43736741,203,0.6624503277572144
16290,1457.8926,1457.9128,1,43736778,43737384,606,0.3118328565873271
16291,1457.951467,1457.975533,1,43738544,43739265,721,0.33386981885841854
16292,1457.9768,1457.980167,1,43739304,43739405,101,0.8844201455335486
16293,1458.0055,1458.0188,1,43740165,43740564,399,0.32485728391161567
16294,1458.0266,1458.033567,1,43740798,43741007,209,0.7086298869267531
16295,1458.0379,1458.0439,1,43741137,43741317,180,0.6210488446131075
16296,1458.055333,1458.072133,1,43741659,43742163,504,0.3038519674730552
16297,1458.0754,1458.0924,1,43742262,43742772,510,0.17815581015359633
16298,1458.101167,1458.105933,1,43743035,43743177,142,-0.09855295127145333
16299,1458.111667,1458.1324,1,43743350,43743972,622,0.10653449825001363
16300,1458.133467,1458.138233,1,43744004,43744146,142,0.7262699950828962
16301,1458.148533,1458.151733,1,43744455,43744551,96,0.15217314246700284
16302,1458.850333,1458.8622,1,43765509,43765866,357,0.7808276420461872
16303,1459.189433,1459.197367,1,43775682,43775921,239,0.6109493522061251
16304,1459.217233,1459.226333,1,43776516,43776789,273,0.2951740772638292
16305,1459.372033,1459.386333,1,43781160,43781589,429,0.23677653947599753
16306,1459.4531,1459.472233,1,43783593,43784166,573,0.23177954485601207
16307,1459.525833,1459.5399,1,43785774,43786197,423,0.23465200864282118
16308,1459.5411,1459.544467,1,43786233,43786334,101,0.7501135202322977
16309,1459.598967,1459.615633,1,43787969,43788468,499,0.29606965194584184
16310,1459.648767,1459.712633,1,43789463,43791378,1915,0.3396007312456761
16311,1459.717967,1459.7257,1,43791539,43791771,232,0.3476690020308021
16312,1459.730133,1459.735733,1,43791903,43792071,168,0.5429023503014487
16313,1459.751867,1459.7581,1,43792556,43792743,187,0.657215437257526
16314,1459.767133,1459.779133,1,43793013,43793373,360,0.011368467789445436
16315,1459.7969,1459.8019,1,43793907,43794057,150,0.4013245613505998
16316,1459.8563,1459.863867,1,43795689,43795916,227,0.42983747242237924
16317,1459.885167,1459.901267,1,43796555,43797038,483,0.19097739021253854
16318,1459.961267,1459.964733,1,43798838,43798941,103,0.9258072529119641
16319,1460.003933,1460.007567,1,43800117,43800227,110,0.6933021680936777
16320,1460.139267,1460.145133,1,43804178,43804353,175,0.09418182278018329
16321,1460.4846,1460.490433,1,43814538,43814712,174,0.018600812613481565
16322,1460.814033,1460.8181,1,43824420,43824543,123,0.3519157880266555
16323,1461.1611,1461.165533,1,43834833,43834965,132,0.4523398013480903
16324,1461.167267,1461.2351,1,43835018,43837053,2035,0.37513858866849126
16325,1461.237333,1461.266933,1,43837119,43838007,888,0.7810852271708624
16326,1461.271767,1461.274767,1,43838153,43838243,90,0.8419783731737889
16327,1461.276067,1461.279467,1,43838282,43838384,102,0.8974613992279811
16328,1461.288767,1461.294567,1,43838663,43838837,174,0.8305409778365537
16329,1461.313467,1461.317033,1,43839404,43839510,106,0.7854455806809735
16330,1461.327333,1461.360967,1,43839819,43840829,1010,0.5369276344140183
16331,1461.363667,1461.370667,1,43840910,43841120,210,0.8764849896241671
16332,1461.384867,1461.403667,1,43841546,43842110,564,0.5160084898287425
16333,1461.4148,1461.422333,1,43842444,43842669,225,0.5505641095740639
16334,1461.440667,1461.446733,1,43843220,43843401,181,0.5314362978715531
16335,1461.455133,1461.472067,1,43843653,43844162,509,0.707844966538378
16336,1461.475867,1461.4825,1,43844276,43844475,199,0.45442762444227064
16337,1461.487367,1461.5886,1,43844621,43847658,3037,0.3498389238390305
16338,1461.5924,1461.6144,1,43847772,43848432,660,0.4558818817008953
16339,1461.618833,1461.623367,1,43848564,43848701,137,0.9215990461956024
16340,1461.6323,1461.6534,1,43848969,43849602,633,0.4080719394087743
16341,1461.654533,1461.657533,1,43849635,43849725,90,0.8728484390816416
16342,1461.710933,1461.719367,1,43851327,43851581,254,0.9077834320474056
16343,1461.7378,1461.8526,1,43852134,43855578,3444,0.21401963289085585
16344,1461.864633,1461.8921,1,43855938,43856763,825,0.18635028265725706
16345,1461.923467,1461.995867,1,43857704,43859876,2172,0.1192164545587861
16346,1461.996867,1462.040867,1,43859906,43861226,1320,0.21199540043448514
16347,1462.0426,1462.070067,1,43861278,43862102,824,0.2969158001342004
16348,1462.113733,1462.1173,1,43863411,43863519,108,0.8167735923849464
16349,1462.118767,1462.136333,1,43863563,43864089,526,0.7619426331413298
16350,1462.140367,1462.1577,1,43864211,43864731,520,0.4100898007912859
16351,1462.1978,1462.2008,1,43865934,43866024,90,0.7113895005094509
16352,1462.211867,1462.2168,1,43866356,43866504,148,0.05152179959630086
16353,1462.2201,1462.232667,1,43866603,43866980,377,0.19999594590733388
16354,1462.238633,1462.2423,1,43867158,43867269,111,0.7791223704212002
16355,1462.247867,1462.259667,1,43867436,43867790,354,0.7253206525308801
16356,1462.510667,1462.5173,1,43875320,43875519,199,0.6009508940419979
16357,1462.563733,1462.595867,1,43876911,43877876,965,0.36639145371295195
16358,1462.5996,1462.6046,1,43877988,43878138,150,0.9272852680546657
16359,1462.6096,1462.66,1,43878288,43879800,1512,0.41440663896708263
16360,1462.666833,1462.683633,1,43880004,43880508,504,0.30008980402105756
16361,1462.684933,1462.716867,1,43880547,43881506,959,0.39772283384316015
16362,1462.722033,1462.728467,1,43881660,43881854,194,0.6812145573348646
16363,1462.736367,1462.758033,1,43882091,43882740,649,0.5547627693814379
16364,1463.1556,1463.164,1,43894668,43894920,252,0.3810669727829206
16365,1463.2035,1463.2071,1,43896105,43896213,108,0.38017203074969125
16366,1463.3192,1463.339633,1,43899576,43900188,612,0.25437904254241384
16367,1463.501267,1463.550033,1,43905038,43906500,1462,0.1591495414058815
16368,1463.553967,1463.5627,1,43906619,43906881,262,0.32129969615423426
16369,1463.5709,1463.594267,1,43907127,43907828,701,0.19356130047548079
16370,1463.602333,1463.6165,1,43908069,43908495,426,0.6081323543445473
16371,1463.617967,1463.629133,1,43908539,43908873,334,0.34121275172309384
16372,1463.630633,1463.6514,1,43908918,43909542,624,0.20414153574770375
16373,1463.660833,1463.665567,1,43909824,43909967,143,0.602004545662109
16374,1463.684733,1463.689033,1,43910541,43910670,129,0.6496367625613355
16375,1463.694067,1463.726133,1,43910822,43911783,961,0.24013034776562062
16376,1463.7332,1463.7375,1,43911996,43912125,129,0.8592297559721767
16377,1463.745133,1463.749067,1,43912353,43912472,119,0.13012298828879146
16378,1463.751033,1463.781567,1,43912530,43913447,917,0.20961181969681772
16379,1463.7906,1463.800967,1,43913718,43914029,311,0.7934571491500508
16380,1463.807,1463.848933,1,43914210,43915467,1257,0.20366116135217305
16381,1463.866633,1463.881567,1,43915998,43916447,449,0.1087800656174921
16382,1463.8827,1463.9105,1,43916481,43917315,834,0.4296569405181061
16383,1463.925233,1463.954567,1,43917756,43918637,881,0.29131313654708413
16384,1463.959767,1463.966833,1,43918793,43919004,211,0.5880455840166585
16385,1463.969033,1463.9728,1,43919070,43919184,114,0.7560996811528704
16386,1463.999533,1464.037367,1,43919985,43921121,1136,0.13315625889842017
16387,1464.055533,1464.061833,1,43921665,43921854,189,0.8662603796793482
16388,1464.075967,1464.0894,1,43922279,43922682,403,0.7698697093000655
16389,1464.098067,1464.101133,1,43922942,43923033,91,0.7608912591402129
16390,1464.108133,1464.120267,1,43923243,43923608,365,0.7074449612792126
16391,1464.128867,1464.1322,1,43923866,43923966,100,0.828730234070455
16392,1464.156733,1464.214067,1,43924701,43926422,1721,0.2906734923127064
16393,1464.215933,1464.237733,1,43926477,43927131,654,0.8192721872588322
16394,1464.2409,1464.3337,1,43927227,43930011,2784,0.19493555101044932
16395,1464.338533,1464.386833,1,43930155,43931604,1449,0.12987379248526318
16396,1464.3935,1464.4339,1,43931805,43933017,1212,0.01717056613239108
16397,1464.458133,1464.498967,1,43933743,43934969,1226,0.2438239983327917
16398,1464.504467,1464.521033,1,43935134,43935630,496,0.32561927418726333
16399,1464.522733,1464.555433,1,43935681,43936662,981,0.2110878602757218
16400,1464.560733,1464.602633,1,43936821,43938078,1257,0.24318335470803637
16401,1464.621067,1464.6645,1,43938632,43939935,1303,0.13978397149162422
16402,1464.666767,1464.7104,1,43940003,43941312,1309,0.12961364261925493
16403,1464.7115,1464.7158,1,43941345,43941474,129,0.5741018658307331
16404,1464.718733,1464.724033,1,43941561,43941720,159,0.8833494264450795
16405,1464.7346,1464.7423,1,43942038,43942269,231,0.9065196161431024
16406,1464.777267,1464.780567,1,43943318,43943417,99,0.9427018710949592
16407,1464.781733,1464.784733,1,43943451,43943541,90,0.8859903383596842
16408,1464.805033,1465.034333,1,43944150,43951029,6879,0.21923823098257386
16409,1465.041533,1465.0449,1,43951245,43951347,102,0.5232245331184613
16410,1465.050433,1465.338533,1,43951512,43960155,8643,0.18005037629387968
16411,1465.3502,1465.3746,1,43960506,43961238,732,0.15323486742975456
16412,1465.382567,1465.439267,1,43961477,43963178,1701,0.08665590968591554
16413,1465.4586,1465.468867,1,43963758,43964066,308,0.7164195764264152
16414,1465.4723,1465.758667,1,43964169,43972760,8591,0.09191757041700849
16415,1465.762467,1465.824567,1,43972874,43974737,1863,0.23297314917295225
16416,1465.827433,1465.921967,1,43974822,43977659,2837,0.10609768911248182
16417,1465.958967,1465.962133,1,43978769,43978863,94,0.9714602483773109
16418,1465.9647,1466.019433,1,43978941,43980582,1641,0.24782082601196903
16419,1466.024267,1466.0847,1,43980728,43982541,1813,0.09262968044958472
16420,1466.093633,1466.100733,1,43982808,43983021,213,0.653105585282112
16421,1466.105133,1466.2504,1,43983153,43987512,4359,0.11745504840873475
16422,1466.301133,1466.305533,1,43989033,43989165,132,0.6465909306091329
16423,1466.3066,1466.319,1,43989198,43989570,372,0.4533886464591282
16424,1466.336167,1466.341967,1,43990085,43990259,174,0.9122427894573304
16425,1466.354267,1466.380833,1,43990628,43991424,796,0.27106497530475604
16426,1466.382033,1466.411433,1,43991460,43992342,882,0.35592048752311123
16427,1466.413833,1466.481833,1,43992414,43994454,2040,0.0941135713243523
16428,1466.485433,1466.5312,1,43994562,43995936,1374,0.16309674034467653
16429,1466.616333,1466.619833,1,43998489,43998594,105,0.7442786635756145
16430,1466.624667,1466.763033,1,43998740,44002890,4150,0.25758675113994167
16431,1466.7738,1466.778633,1,44003214,44003358,144,0.8334729504476713
16432,1466.782567,1466.789367,1,44003477,44003681,204,0.5328349329401423
16433,1466.790367,1466.833067,1,44003711,44004992,1281,0.17625368483521398
16434,1466.839233,1466.952267,1,44005176,44008568,3392,0.2253054098569958
16435,1466.9548,1467.006667,1,44008644,44010200,1556,0.3535394152885929
16436,1467.0103,1467.0977,1,44010309,44012931,2622,0.04260816193605445
16437,1467.138233,1467.1431,1,44014146,44014293,147,0.0014448165658038808
16438,1467.1632,1467.213767,1,44014896,44016413,1517,0.3245474258717006
16439,1467.218633,1467.2344,1,44016558,44017032,474,0.29257167665079925
16440,1467.238267,1467.245633,1,44017148,44017368,220,0.44463357660401465
16441,1467.247467,1467.264867,1,44017424,44017946,522,0.1349776230216937
16442,1467.276167,1467.340033,1,44018285,44020200,1915,0.16633925107331657
16443,1467.343533,1467.347767,1,44020305,44020433,128,0.5297617137082918
16444,1467.368067,1467.373767,1,44021042,44021213,171,0.5136668862380056
16445,1467.385733,1467.446933,1,44021571,44023407,1836,0.28939245834785715
16446,1467.4521,1467.565867,1,44023563,44026976,3413,0.08222678035028778
16447,1467.579767,1467.6077,1,44027393,44028231,838,0.36450034940211445
16448,1467.616367,1467.650967,1,44028491,44029529,1038,0.1773237842929371
16449,1467.658833,1467.663133,1,44029764,44029893,129,0.7418289985951372
16450,1467.757867,1467.764667,1,44032736,44032940,204,0.9061639712845998
16451,1467.765833,1467.783367,1,44032974,44033501,527,0.39306481902377277
16452,1467.945567,1467.952633,1,44038367,44038578,211,0.5073740208457451
16453,1467.967967,1467.973,1,44039039,44039190,151,0.83532955902641
16454,1468.020667,1468.023933,1,44040620,44040717,97,0.49059662650020697
16455,1468.0405,1468.047933,1,44041215,44041437,222,0.8827388648136631
16456,1468.0697,1468.074033,1,44042091,44042220,129,0.8933587764801834
16457,1468.076633,1468.1186,1,44042298,44043558,1260,0.3506045676402764
16458,1468.121067,1468.136167,1,44043632,44044085,453,0.9157621460718115
16459,1468.138433,1468.193567,1,44044152,44045807,1655,0.27627061391312
16460,1468.371733,1468.375433,1,44051151,44051262,111,0.8808300232896952
16461,1468.3816,1468.4038,1,44051448,44052114,666,0.8500761112577484
16462,1468.419933,1468.424067,1,44052597,44052722,125,0.6528942636583558
16463,1468.4266,1468.434033,1,44052798,44053020,222,0.5206309079202502
16464,1468.509533,1468.519433,1,44055285,44055582,297,0.827931285295517
16465,1468.530067,1468.537233,1,44055902,44056116,214,0.7285063650863476
16466,1468.543967,1468.548167,1,44056319,44056445,126,0.7941967027387826
16467,1468.586267,1468.590767,1,44057588,44057723,135,0.5818613727157382
16468,1468.6579,1468.6626,1,44059737,44059878,141,0.8910550854666616
16469,1468.6638,1468.674833,1,44059914,44060244,330,0.7515380564651843
16470,1468.675833,1468.680133,1,44060274,44060403,129,0.8088304437624325
16471,1468.6823,1468.732333,1,44060469,44061969,1500,0.36756293766594184
16472,1468.7334,1468.756767,1,44062002,44062703,701,0.5679806862731592
16473,1468.8785,1468.931667,1,44066355,44067950,1595,0.2823107336475751
16474,1468.935033,1468.9458,1,44068050,44068374,324,0.8644480366240798
16475,1468.952567,1468.987067,1,44068577,44069612,1035,0.6630053245922549
16476,1468.988667,1468.999333,1,44069660,44069979,319,0.9049650541369332
16477,1469.000633,1469.0148,1,44070018,44070444,426,0.8164012430503507
16478,1469.021067,1469.042733,1,44070632,44071281,649,0.615044835731594
16479,1469.046433,1469.052733,1,44071392,44071581,189,0.7069075010630647
16480,1469.0547,1469.063333,1,44071641,44071899,258,0.8976382564339774
16481,1469.0823,1469.091433,1,44072469,44072742,273,0.7773611698915887
16482,1469.1771,1469.181767,1,44075313,44075453,140,0.9071889932830453
16483,1469.182967,1469.254867,1,44075489,44077646,2157,0.31245598179887146
16484,1469.2559,1469.262133,1,44077677,44077863,186,0.791453325505038
16485,1469.2671,1469.294333,1,44078013,44078829,816,0.4443667008208704
16486,1469.296767,1469.3154,1,44078903,44079462,559,0.782305840863273
16487,1469.483567,1469.488267,1,44084507,44084648,141,0.9009043677368215
16488,1469.4953,1469.6068,1,44084859,44088204,3345,0.30913161141029216
16489,1469.6111,1469.618533,1,44088333,44088555,222,0.9187791999791861
16490,1469.619833,1469.717467,1,44088594,44091524,2930,0.3403705116804976
16491,1469.729467,1469.7602,1,44091884,44092806,922,0.25798708263703907
16492,1469.762267,1469.779433,1,44092868,44093382,514,0.708962651311627
16493,1469.785933,1469.828133,1,44093577,44094843,1266,0.6678233979129125
16494,1469.8612,1469.8661,1,44095836,44095983,147,0.7213369581801777
16495,1469.912233,1469.9923,1,44097366,44099769,2403,0.42049803392564655
16496,1469.9967,1470.020267,1,44099901,44100608,707,0.7137895378273922
16497,1470.0256,1470.047433,1,44100768,44101422,654,0.5674171109749885
16498,1470.181,1470.189967,1,44105430,44105699,269,0.6528512562835764
16499,1470.1921,1470.309567,1,44105763,44109287,3524,0.3186307367657005
16500,1470.320467,1470.362967,1,44109614,44110889,1275,0.20411101486754538
16501,1470.374367,1470.41,1,44111231,44112300,1069,0.28879555324353273
16502,1470.411167,1470.5173,1,44112335,44115519,3184,0.22739615646620118
16503,1470.520267,1470.5301,1,44115608,44115903,295,0.49808492734874
16504,1470.5369,1470.5814,1,44116107,44117442,1335,0.4847914323113008
16505,1470.604333,1470.608767,1,44118129,44118263,134,0.7787434188256095
16506,1470.6131,1470.618767,1,44118393,44118563,170,0.7432760456519347
16507,1470.620133,1470.643067,1,44118603,44119292,689,0.6217126325844731
16508,1470.644633,1470.661167,1,44119338,44119835,497,0.32010169082052836
16509,1470.6755,1470.681167,1,44120265,44120435,170,0.6738446030099687
16510,1470.686533,1470.713933,1,44120595,44121417,822,0.1809638288469197
16511,1470.7152,1470.7202,1,44121456,44121606,150,0.7167332042912206
16512,1470.7574,1470.833667,1,44122722,44125010,2288,0.2525589754334754
16513,1470.839233,1470.8994,1,44125176,44126982,1806,0.08646519987844165
16514,1470.9083,1470.916933,1,44127249,44127507,258,0.44294837355174566
16515,1470.928933,1470.9926,1,44127867,44129778,1911,0.31067914580447725
16516,1470.9956,1471.012933,1,44129868,44130387,519,0.34501838216968217
16517,1471.022033,1471.031733,1,44130660,44130951,291,0.6949627745982195
16518,1471.037067,1471.094367,1,44131112,44132831,1719,0.2293851034200801
16519,1471.097367,1471.1331,1,44132921,44133993,1072,0.3711959342853645
16520,1471.147567,1471.156467,1,44134427,44134694,267,0.2888673764830865
16521,1471.169667,1471.1763,1,44135090,44135289,199,0.7110765120297702
16522,1471.199833,1471.204867,1,44135994,44136146,152,0.8436283861905811
16523,1471.214367,1471.235733,1,44136431,44137071,640,0.6924118950686009
16524,1471.2396,1471.2502,1,44137188,44137506,318,0.5874098221869862
16525,1471.253733,1471.289633,1,44137611,44138688,1077,0.36026360739796914
16526,1471.290733,1471.345033,1,44138721,44140350,1629,0.23125276246730625
16527,1471.346067,1471.360567,1,44140382,44140817,435,0.4720021971955226
16528,1471.401567,1471.4059,1,44142047,44142177,130,0.8622132307162176
16529,1471.423367,1471.4328,1,44142701,44142984,283,0.7311487614522962
16530,1471.437933,1471.4786,1,44143137,44144358,1221,0.25778236598059934
16531,1471.479633,1471.483867,1,44144388,44144516,128,0.5025364251269829
16532,1471.4851,1471.6183,1,44144553,44148549,3996,0.04785795056615345
16533,1471.6213,1471.644,1,44148639,44149320,681,0.3034036844077946
16534,1471.647467,1471.6702,1,44149424,44150106,682,0.2388870903387593
16535,1471.6787,1471.696867,1,44150361,44150906,545,0.767102413151966
16536,1471.757367,1471.766567,1,44152721,44152997,276,0.5621062367497774
16537,1471.7721,1471.8548,1,44153163,44155644,2481,0.20600775436478316
16538,1471.869967,1471.9307,1,44156099,44157921,1822,0.2081598536224076
16539,1471.933367,1471.944767,1,44158001,44158343,342,0.39770028159610915
16540,1471.9572,1471.983033,1,44158716,44159490,774,0.2119264209733722
16541,1471.992067,1472.004933,1,44159762,44160147,385,0.5172713183579903
16542,1472.0101,1472.013733,1,44160303,44160411,108,0.7851114676288645
16543,1472.021167,1472.0402,1,44160635,44161206,571,0.8048533561840227
16544,1472.047533,1472.056033,1,44161425,44161680,255,0.8105172196897681
16545,1472.110867,1472.120467,1,44163326,44163614,288,0.8115581143832747
16546,1472.281933,1472.2966,1,44168457,44168898,441,0.7184320344482219
16547,1472.301533,1472.535167,1,44169045,44176055,7010,0.3298519960332348
16548,1472.537067,1472.5586,1,44176112,44176758,646,0.22472933655347466
16549,1472.561533,1472.599933,1,44176845,44177997,1152,0.4478937281284074
16550,1472.614033,1472.63,1,44178420,44178900,480,0.22984724571447449
16551,1472.633433,1472.706267,1,44179002,44181188,2186,0.35630102460410135
16552,1472.709033,1472.714367,1,44181270,44181431,161,0.9681757622217583
16553,1472.715667,1472.7558,1,44181470,44182674,1204,0.1587516565211175
16554,1472.771867,1472.7794,1,44183156,44183382,226,0.5423107415183495
16555,1472.8449,1472.8481,1,44185347,44185443,96,0.7884144043554946
16556,1472.857833,1472.914233,1,44185734,44187426,1692,0.4517274693298219
16557,1472.9214,1472.951467,1,44187642,44188544,902,0.3053973628931895
16558,1472.975967,1472.982767,1,44189279,44189483,204,0.5470793771580439
16559,1472.988833,1472.992867,1,44189664,44189786,122,0.5917113797259814
16560,1473.022233,1473.0347,1,44190666,44191041,375,0.8066966216672469
16561,1473.043667,1473.047833,1,44191310,44191434,124,0.4106859370765102
16562,1473.269467,1473.2725,1,44198084,44198175,91,0.8862013271302027
16563,1473.536067,1473.539467,1,44206082,44206184,102,0.7534022344365009
16564,1473.547967,1473.569733,1,44206439,44207091,652,0.3615787422088141
16565,1473.576767,1473.593033,1,44207303,44207790,487,0.3865774054650601
16566,1474.0249,1474.028,1,44220747,44220840,93,0.7968414348073173
16567,1474.244267,1474.2575,1,44227328,44227725,397,0.8427601549462781
16568,1474.277967,1474.3253,1,44228339,44229759,1420,0.4713071864935136
16569,1474.3263,1474.350633,1,44229789,44230518,729,0.17221702169587033
16570,1474.364567,1474.3699,1,44230937,44231097,160,0.5308311593106566
16571,1474.3741,1474.4282,1,44231223,44232846,1623,0.2536431717612426
16572,1474.430733,1474.462233,1,44232921,44233866,945,0.327370797790306
16573,1474.480033,1474.524533,1,44234400,44235735,1335,0.22956844405233404
16574,1474.526667,1474.581333,1,44235800,44237439,1639,0.38853152616273073
16575,1474.585633,1474.588733,1,44237568,44237661,93,0.9112434677813019
16576,1474.605567,1474.612167,1,44238167,44238365,198,0.8314498886819344
16577,1474.632833,1474.661867,1,44238984,44239856,872,0.17510605741204105
16578,1474.663533,1474.6738,1,44239905,44240214,309,0.44593292415908936
16579,1474.675433,1474.687233,1,44240262,44240616,354,0.3901176782647147
16580,1474.689267,1474.903667,1,44240678,44247110,6432,0.24719962509508517
16581,1474.937767,1474.9416,1,44248133,44248248,115,0.8947062459215469
16582,1474.9432,1474.947367,1,44248296,44248421,125,0.8607483139218309
16583,1474.955333,1475.007,1,44248659,44250210,1551,0.14244162164571564
16584,1475.0172,1475.041067,1,44250516,44251232,716,0.1571729230581396
16585,1475.042267,1475.0454,1,44251268,44251362,94,0.9295416421140537
16586,1475.0575,1475.068133,1,44251725,44252043,318,0.8698108249229085
16587,1475.082533,1475.1095,1,44252475,44253285,810,0.30362856868456833
16588,1475.110733,1475.115467,1,44253321,44253464,143,0.8486873897222488
16589,1475.117,1475.120967,1,44253510,44253629,119,0.9470256426561049
16590,1475.155433,1475.159067,1,44254662,44254772,110,0.7442690498727961
16591,1475.161967,1475.1673,1,44254859,44255019,160,0.7482107548296628
16592,1475.1748,1475.191033,1,44255244,44255730,486,0.6587321638631154
16593,1475.196267,1475.2008,1,44255888,44256024,136,0.8040287902327978
16594,1475.217433,1475.221467,1,44256522,44256644,122,0.7384477867707346
16595,1475.2374,1475.2428,1,44257122,44257284,162,0.6824712112921945
16596,1475.255233,1475.278933,1,44257656,44258367,711,0.4516294976945483
16597,1475.3495,1475.3533,1,44260485,44260599,114,0.7956519167688026
16598,1475.360667,1475.368933,1,44260820,44261067,247,0.5275282955655197
16599,1475.3703,1475.3772,1,44261109,44261316,207,0.8413071241639836
16600,1475.398033,1475.406267,1,44261940,44262188,248,0.886505221364464
16601,1475.4494,1475.461633,1,44263482,44263848,366,0.828522316485272
16602,1475.464767,1475.471467,1,44263943,44264144,201,0.7111047604309096
16603,1475.475567,1475.482933,1,44264267,44264487,220,0.8851165316279066
16604,1475.551067,1475.554467,1,44266532,44266634,102,0.6386735288163546
16605,1475.559533,1475.5671,1,44266785,44267013,228,0.5479981584171781
16606,1475.57,1475.583333,1,44267100,44267499,399,0.5587306601284571
16607,1475.694133,1475.7087,1,44270823,44271261,438,0.4742175413608798
16608,1475.709867,1475.749067,1,44271296,44272472,1176,0.09940689913070583
16609,1475.773567,1475.829533,1,44273207,44274885,1678,0.19678770300683748
16610,1475.854733,1475.8818,1,44275641,44276454,813,0.49379587182074336
16611,1475.907267,1475.932567,1,44277218,44277977,759,0.7704968508858421
16612,1475.983767,1475.9879,1,44279513,44279637,124,0.7786601464870971
16613,1475.989733,1476.004533,1,44279691,44280135,444,0.8187922054225376
16614,1476.0087,1476.0878,1,44280261,44282634,2373,0.2705446721096581
16615,1476.093667,1476.1018,1,44282810,44283054,244,0.4538503643526777
16616,1476.104633,1476.1162,1,44283138,44283486,348,0.6005518114345518
16617,1476.119333,1476.1952,1,44283579,44285856,2277,0.30379777817904974
16618,1476.1966,1476.241,1,44285898,44287230,1332,0.43172404849748774
16619,1476.2495,1476.2623,1,44287485,44287869,384,0.47975880994386016
16620,1476.264167,1476.2856,1,44287925,44288568,643,0.21623941163003985
16621,1476.2879,1476.291533,1,44288637,44288745,108,0.8094006375072043
16622,1476.295467,1476.3144,1,44288864,44289432,568,0.371858088758295
16623,1476.324933,1476.334767,1,44289747,44290043,296,0.886269305547971
16624,1476.364567,1476.367733,1,44290937,44291031,94,0.9091693783361653
16625,1476.608467,1476.671767,1,44298254,44300153,1899,0.31211914154284953
16626,1476.687767,1476.699033,1,44300633,44300970,337,0.40765855471206275
16627,1476.714767,1476.7193,1,44301443,44301579,136,0.14181860221231382
16628,1476.7328,1476.764267,1,44301984,44302928,944,0.4461938114448145
16629,1476.766133,1476.775667,1,44302983,44303270,287,0.8453021226816427
16630,1476.7776,1476.799133,1,44303328,44303973,645,0.22645765098777948
16631,1476.9584,1476.9634,1,44308752,44308902,150,0.6568540543081616
16632,1477.0143,1477.064633,1,44310429,44311938,1509,0.33907149031558526
16633,1477.0658,1477.074767,1,44311974,44312243,269,0.7330893025879972
16634,1477.0758,1477.085233,1,44312274,44312556,282,0.7350340687621391
16635,1477.089267,1477.124333,1,44312678,44313729,1051,0.3077688535410788
16636,1477.125633,1477.128867,1,44313768,44313866,98,0.9565740648738578
16637,1477.129967,1477.1439,1,44313899,44314317,418,0.24298308790793588
16638,1477.147967,1477.224233,1,44314439,44316726,2287,0.3309370516103647
16639,1477.2353,1477.239633,1,44317059,44317188,129,0.735493036758183
16640,1477.370067,1477.376033,1,44321102,44321280,178,0.7380103844305023
16641,1477.3838,1477.429667,1,44321514,44322890,1376,0.5527171668919927
16642,1477.431833,1477.4356,1,44322954,44323068,114,0.8027193989695657
16643,1477.438,1477.443633,1,44323140,44323308,168,0.5542102151590027
16644,1477.460267,1477.5258,1,44323808,44325774,1966,0.26868667694729137
16645,1477.528,1477.534267,1,44325840,44326028,188,0.6507428583021686
16646,1477.550233,1477.5562,1,44326506,44326686,180,0.3433070724983492
16647,1477.5695,1477.581067,1,44327085,44327432,347,0.336200467741421
16648,1477.591733,1477.5984,1,44327751,44327952,201,0.8594074972547188
16649,1477.615733,1477.6209,1,44328471,44328627,156,0.866324014847949
16650,1477.646,1477.650033,1,44329380,44329500,120,0.7877098024193422
16651,1477.668467,1477.7378,1,44330054,44332134,2080,0.4007206257717813
16652,1477.749633,1477.767867,1,44332488,44333036,548,0.48736041180443274
16653,1477.770167,1477.794533,1,44333105,44333835,730,0.6418515909833045
16654,1477.819767,1477.876767,1,44334593,44336303,1710,0.2763703678468654
16655,1477.8784,1477.896967,1,44336352,44336909,557,0.7575869281169674
16656,1477.907267,1477.911767,1,44337218,44337353,135,0.7551206856411039
16657,1477.927033,1477.9795,1,44337810,44339385,1575,0.25008796390479554
16658,1477.982633,1477.9868,1,44339478,44339604,126,0.8867936630617953
16659,1477.988033,1477.994333,1,44339640,44339829,189,0.7935078741876953
16660,1478.004633,1478.0163,1,44340138,44340489,351,0.7626203917957581
16661,1478.032967,1478.036267,1,44340989,44341088,99,0.8733815143165916
16662,1478.3391,1478.348267,1,44350173,44350448,275,0.9112863421462585
16663,1478.364133,1478.482167,1,44350923,44354465,3542,0.41719982494174346
16664,1478.485733,1478.490467,1,44354571,44354714,143,0.8095565873228844
16665,1478.4971,1478.517233,1,44354913,44355516,603,0.2996697013371393
16666,1478.519233,1478.5388,1,44355576,44356164,588,0.5180055191417691
16667,1478.541,1478.604033,1,44356230,44358120,1890,0.36212005613327636
16668,1478.6333,1478.637633,1,44358999,44359128,129,0.9454006476128405
16669,1478.817067,1478.9391,1,44364512,44368173,3661,0.3160904058810891
16670,1478.9456,1479.000333,1,44368368,44370009,1641,0.12101141303678972
16671,1479.0027,1479.045333,1,44370081,44371359,1278,0.383829451787003
16672,1479.055467,1479.080767,1,44371664,44372423,759,0.6449899268464374
16673,1479.159767,1479.163467,1,44374793,44374904,111,0.46697934599952234
16674,1479.306067,1479.309567,1,44379182,44379287,105,0.5092554658513848
16675,1479.358933,1479.363333,1,44380767,44380899,132,0.1272139655509301
16676,1479.771767,1479.776533,1,44393153,44393295,142,0.6921788460229984
16677,1479.780367,1479.799067,1,44393411,44393972,561,0.7160225319318956
16678,1479.8005,1479.9028,1,44394015,44397084,3069,0.3439866092666797
16679,1479.911233,1479.934967,1,44397336,44398049,713,0.4664965865795391
16680,1479.9402,1479.961667,1,44398206,44398850,644,0.09644362966463088
16681,1479.9631,1479.9782,1,44398893,44399346,453,0.34067724955702855
16682,1479.983067,1480.0106,1,44399492,44400318,826,-0.02210392559407602
16683,1480.013933,1480.020167,1,44400417,44400605,188,0.5543509502513152
16684,1480.021833,1480.0526,1,44400654,44401578,924,0.1495883507084012
16685,1480.102867,1480.1079,1,44403086,44403237,151,0.7650754396116691
16686,1480.148033,1480.211533,1,44404440,44406345,1905,0.10571956449820319
16687,1480.213,1480.216933,1,44406390,44406507,117,0.671854470444448
16688,1480.447433,1480.4924,1,44413422,44414772,1350,0.20480262107758923
16689,1480.495133,1480.5161,1,44414853,44415483,630,0.15406691042518642
16690,1480.528667,1480.544133,1,44415860,44416323,463,0.3252289379250865
16691,1480.550467,1480.559733,1,44416514,44416791,277,0.35221948343324944
16692,1480.5666,1480.583667,1,44416998,44417510,512,0.2873178460870183
16693,1480.603333,1480.635067,1,44418099,44419052,953,0.17651013139319774
16694,1480.636633,1480.658,1,44419098,44419740,642,0.09444858479776451
16695,1480.687767,1480.7047,1,44420633,44421141,508,0.2967441429896169
16696,1480.7119,1480.718467,1,44421357,44421554,197,0.7829013174895473
16697,1480.722367,1480.734533,1,44421671,44422035,364,0.8331670247778145
16698,1480.7486,1480.754467,1,44422458,44422634,176,0.6912844885841514
16699,1480.852533,1480.858333,1,44425575,44425749,174,0.9060050729517394
16700,1480.868333,1480.962567,1,44426049,44428877,2828,0.3170353716958946
16701,1480.965867,1481.005533,1,44428976,44430165,1189,0.22408656592871717
16702,1481.012433,1481.028033,1,44430372,44430840,468,0.32502129905497074
16703,1481.061133,1481.0831,1,44431833,44432493,660,0.2041440082337703
16704,1481.085333,1481.116133,1,44432559,44433483,924,0.3498140693563356
16705,1481.120633,1481.1358,1,44433618,44434074,456,0.5266751801801008
16706,1481.138033,1481.141667,1,44434140,44434250,110,0.9115949528544607
16707,1481.1445,1481.1554,1,44434335,44434662,327,0.30707027509704143
16708,1481.235867,1481.377467,1,44437076,44441324,4248,0.1970265204776725
16709,1481.394133,1481.397267,1,44441823,44441918,95,0.5649607108785089
16710,1481.399233,1481.4103,1,44441976,44442309,333,0.8157104042567507
16711,1481.504467,1481.6337,1,44445134,44449011,3877,0.43876356335918504
16712,1481.6372,1481.700767,1,44449116,44451023,1907,0.26812751971152143
16713,1481.717867,1481.735333,1,44451536,44452059,523,0.6148183697172662
16714,1481.752967,1481.758967,1,44452589,44452769,180,0.5880225289915219
16715,1481.7719,1481.780767,1,44453157,44453423,266,0.5021855570760069
16716,1481.783867,1481.876733,1,44453516,44456301,2785,0.24668384298572762
16717,1481.884733,1481.8881,1,44456541,44456643,102,0.8472616582815171
16718,1481.8911,1481.899067,1,44456733,44456972,239,0.7613137940326287
16719,1481.932467,1481.986967,1,44457974,44459609,1635,0.08331581499394819
16720,1481.994567,1481.998867,1,44459837,44459966,129,0.7429356936225211
16721,1482.012733,1482.1132,1,44460381,44463396,3015,0.1466133869266061
16722,1482.130267,1482.1432,1,44463908,44464296,388,0.5650484632920083
16723,1482.1497,1482.179933,1,44464491,44465397,906,0.1166453308480558
16724,1482.181933,1482.1895,1,44465457,44465685,228,0.48152679644677576
16725,1482.205933,1482.213267,1,44466177,44466398,221,0.9052292380298511
16726,1482.226767,1482.293833,1,44466803,44468814,2011,0.2085031219500207
16727,1482.305667,1482.3691,1,44469170,44471073,1903,0.13283044735577215
16728,1482.371433,1482.375567,1,44471142,44471267,125,0.723202896844586
16729,1482.3783,1482.421033,1,44471349,44472630,1281,0.22019035982663826
16730,1482.422233,1482.426633,1,44472666,44472798,132,0.8496189997059431
16731,1482.436733,1482.4415,1,44473101,44473245,144,0.8242750730597264
16732,1482.447533,1482.4623,1,44473425,44473869,444,0.8167226587647426
16733,1482.463367,1482.494667,1,44473901,44474840,939,0.4469676623588159
16734,1482.500633,1482.505933,1,44475018,44475177,159,0.8137520979344458
16735,1482.517067,1482.520533,1,44475512,44475615,103,0.2381817470757005
16736,1482.539333,1482.546133,1,44476179,44476383,204,0.8096840043439679
16737,1482.553633,1482.559967,1,44476608,44476799,191,0.7613854435144545
16738,1482.562167,1482.618467,1,44476865,44478554,1689,0.24813242599385607
16739,1482.6253,1482.634867,1,44478759,44479046,287,0.7364509743323734
16740,1482.652767,1482.6566,1,44479583,44479698,115,0.8456396723871528
16741,1482.6628,1482.6949,1,44479884,44480847,963,0.15129571004693476
16742,1482.6996,1482.794033,1,44480988,44483820,2832,0.10962833998761674
16743,1482.805733,1482.813233,1,44484171,44484396,225,0.8449152971182492
16744,1482.853133,1482.8578,1,44485593,44485734,141,0.9004740180875683
16745,1482.8593,1482.875433,1,44485779,44486262,483,0.2760353311652556
16746,1483.1645,1483.1828,1,44494935,44495484,549,0.17759771367395819
16747,1483.222333,1483.229067,1,44496669,44496872,203,0.8821680954398327
16748,1483.252333,1483.339467,1,44497569,44500184,2615,0.410555980710849
16749,1483.341367,1483.364,1,44500241,44500920,679,-0.09062905695916008
16750,1483.365033,1483.3748,1,44500950,44501244,294,-0.08100776428278242
16751,1483.376833,1483.4396,1,44501304,44503188,1884,0.45955260318667784
16752,1483.441167,1483.503733,1,44503235,44505111,1876,0.6100553839574819
16753,1483.543667,1483.5546,1,44506310,44506638,328,0.5362939004530225
16754,1483.555833,1483.651067,1,44506674,44509532,2858,0.17429914455068987
16755,1483.652667,1483.6597,1,44509580,44509791,211,0.35943930030522175
16756,1483.6607,1483.713967,1,44509821,44511419,1598,0.12975336163374257
16757,1483.7171,1483.7446,1,44511513,44512338,825,0.33726644820404883
16758,1483.747433,1483.757833,1,44512422,44512734,312,0.3872829456050537
16759,1483.763033,1483.767,1,44512890,44513010,120,0.92159155657095
16760,1483.781567,1483.8039,1,44513447,44514117,670,0.2788277968214161
16761,1483.830967,1483.8365,1,44514929,44515095,166,0.9031687919374003
16762,1483.839633,1483.848933,1,44515188,44515467,279,0.8651221484793894
16763,1483.851367,1483.8691,1,44515541,44516073,532,0.4174070147924486
16764,1483.8752,1483.892567,1,44516256,44516777,521,0.13851018333197912
16765,1483.912133,1484.053567,1,44517363,44521607,4244,0.32139028786895396
16766,1484.0547,1484.071767,1,44521641,44522153,512,0.3995344278351092
16767,1484.0838,1484.156333,1,44522514,44524689,2175,0.14688555404114856
16768,1484.161067,1484.1659,1,44524832,44524977,145,-0.31876774362320826
16769,1484.169633,1484.1967,1,44525088,44525901,813,0.7235170011512853
16770,1484.2076,1484.212667,1,44526228,44526380,152,0.8248069507516692
16771,1484.214467,1484.2191,1,44526434,44526573,139,0.9305576127023386
16772,1484.289667,1484.295267,1,44528690,44528858,168,0.1571688383011661
16773,1484.378067,1484.3974,1,44531342,44531922,580,0.8575066583888399
16774,1484.399267,1484.5157,1,44531978,44535471,3493,0.29041775357884475
16775,1484.5177,1484.533,1,44535531,44535990,459,0.5398781224203706
16776,1484.535567,1484.542067,1,44536067,44536262,195,0.5840807146059716
16777,1484.5494,1484.554567,1,44536482,44536637,155,0.8880457634920514
16778,1484.5648,1484.618133,1,44536944,44538543,1599,0.10841068267800086
16779,1484.6214,1484.627767,1,44538642,44538833,191,0.7531378663858544
16780,1484.6333,1484.656733,1,44538999,44539701,702,0.49592745589501463
16781,1484.820733,1484.873967,1,44544621,44546219,1598,0.3584198363461335
16782,1484.875467,1484.905433,1,44546264,44547162,898,0.4598631292845205
16783,1484.908167,1484.990967,1,44547245,44549729,2484,0.4219049568875019
16784,1484.995567,1485.000267,1,44549867,44550008,141,0.673858308741663
16785,1485.032267,1485.035833,1,44550968,44551074,106,0.17728266633534054
16786,1485.044967,1485.050767,1,44551349,44551523,174,0.25571207656229966
16787,1485.0951,1485.0997,1,44552853,44552991,138,0.8249862314594265
16788,1485.131767,1485.2756,1,44553953,44558268,4315,0.2549779548571246
16789,1485.277467,1485.299233,1,44558324,44558976,652,0.14312411911145131
16790,1485.305167,1485.317567,1,44559155,44559527,372,-0.10017629355236846
16791,1485.319,1485.355233,1,44559570,44560656,1086,0.10308910413138751
16792,1485.3574,1485.374667,1,44560722,44561240,518,0.8862853797695139
16793,1485.436833,1485.441033,1,44563104,44563230,126,0.9104087973853293
16794,1485.473333,1485.5379,1,44564199,44566137,1938,0.3838081394993653
16795,1485.5389,1485.5421,1,44566167,44566263,96,0.8416357433025596
16796,1485.554333,1485.591467,1,44566629,44567744,1115,0.3257979740744461
16797,1485.5964,1485.641367,1,44567892,44569241,1349,0.27873711646886756
16798,1485.6477,1485.6697,1,44569431,44570091,660,0.46650488812337326
16799,1485.709967,1485.713933,1,44571299,44571417,118,0.3220355997060606
16800,1485.7239,1485.727967,1,44571717,44571839,122,0.4423718805866055
16801,1485.730867,1485.739667,1,44571926,44572190,264,0.652305561221659
16802,1485.741433,1485.7448,1,44572242,44572344,102,0.4905872129915196
16803,1485.7467,1485.7537,1,44572401,44572611,210,0.40639525119001063
16804,1485.754867,1485.7873,1,44572646,44573619,973,0.5022115724473869
16805,1485.790333,1485.799167,1,44573709,44573975,266,0.48583459324866246
16806,1485.801133,1485.8152,1,44574033,44574456,423,0.6777394637509554
16807,1485.8165,1485.8219,1,44574495,44574657,162,0.7036658171008279
16808,1485.827333,1485.830533,1,44574819,44574915,96,0.76616754923778
16809,1485.835767,1485.843933,1,44575073,44575317,244,0.819426535992701
16810,1485.8516,1485.983067,1,44575548,44579492,3944,0.32020481691567787
16811,1485.9874,1486.032033,1,44579622,44580960,1338,0.1597535768033187
16812,1486.039467,1486.058867,1,44581184,44581766,582,0.2115531765292111
16813,1486.060267,1486.0681,1,44581808,44582043,235,0.4782314242821183
16814,1486.111433,1486.203267,1,44583342,44586098,2756,0.1091546609491106
16815,1486.2066,1486.217333,1,44586198,44586519,321,0.09259145305209196
16816,1486.2254,1486.271033,1,44586762,44588130,1368,0.15921456487318833
16817,1486.292367,1486.298767,1,44588771,44588963,192,0.6468092936920903
16818,1486.3036,1486.306833,1,44589108,44589204,96,0.803038384557269
16819,1486.310367,1486.3299,1,44589311,44589897,586,0.3304319825270418
16820,1486.347033,1486.351533,1,44590410,44590545,135,0.48543179961963356
16821,1486.374533,1486.3915,1,44591235,44591745,510,0.13564088036648947
16822,1486.392833,1486.612867,1,44591784,44598386,6602,0.1738678950709636
16823,1486.617733,1486.664867,1,44598531,44599946,1415,0.10146745497870693
16824,1486.6765,1486.6839,1,44600295,44600517,222,0.11762515822482825
16825,1486.686067,1486.726867,1,44600582,44601806,1224,0.0896728049446402
16826,1486.732167,1486.74,1,44601965,44602200,235,0.9284084551938077
16827,1486.7742,1486.782,1,44603226,44603460,234,0.7119691408638704
16828,1486.784333,1486.7899,1,44603529,44603697,168,0.8518391893737981
16829,1486.7953,1486.815667,1,44603859,44604470,611,0.2247054611505069
16830,1486.818733,1486.8486,1,44604561,44605458,897,0.4094256883085065
16831,1486.8501,1486.8544,1,44605503,44605632,129,0.7236169479816843
16832,1486.8559,1486.864467,1,44605677,44605934,257,0.5232355885971658
16833,1486.874767,1486.889933,1,44606243,44606697,454,0.017820715070973516
16834,1486.8964,1486.904033,1,44606892,44607120,228,-0.004752204665390472
16835,1486.907633,1486.933367,1,44607228,44608001,773,0.023907191962218088
16836,1486.934467,1486.954233,1,44608034,44608626,592,0.4816008489319701
16837,1486.956,1486.971567,1,44608680,44609147,467,0.45546429806469674
16838,1486.983733,1487.068833,1,44609511,44612064,2553,0.16027321937064237
16839,1487.070667,1487.0772,1,44612120,44612316,196,0.36302900945595806
16840,1487.0836,1487.098167,1,44612508,44612945,437,0.4147432914557643
16841,1487.117133,1487.137933,1,44613513,44614137,624,0.5190361099566526
16842,1487.140267,1487.158067,1,44614208,44614742,534,0.5641022669097924
16843,1487.160067,1487.176767,1,44614802,44615303,501,0.6928350158340146
16844,1487.299433,1487.305933,1,44618982,44619177,195,0.4573976892148217
16845,1487.313233,1487.325667,1,44619396,44619770,374,0.12353732307965563
16846,1487.351233,1487.357467,1,44620536,44620724,188,0.8600787776002965
16847,1487.358467,1487.367333,1,44620754,44621019,265,0.9062638617060691
16848,1487.536333,1487.544533,1,44626089,44626335,246,0.9196575736591431
16849,1487.546,1487.549333,1,44626380,44626479,99,0.8897531101080676
16850,1487.568267,1487.6094,1,44627048,44628282,1234,0.37206309456522174
16851,1487.613967,1487.6811,1,44628419,44630433,2014,0.29205543905170356
16852,1487.688433,1487.694733,1,44630652,44630841,189,0.6920746286231675
16853,1487.6972,1487.703,1,44630916,44631090,174,0.7959544134459549
16854,1487.710967,1487.768333,1,44631329,44633049,1720,0.29733956958700486
16855,1487.789367,1487.7927,1,44633681,44633781,100,0.9069633164096688
16856,1487.8155,1487.8197,1,44634465,44634591,126,0.6697946825755828
16857,1487.826567,1487.870333,1,44634797,44636109,1312,0.2864839840441032
16858,1487.8899,1487.903867,1,44636697,44637116,419,0.700392530493429
16859,1487.908533,1487.911867,1,44637255,44637356,101,0.9342156016871116
16860,1487.916233,1487.9197,1,44637486,44637591,105,0.8776999777746805
16861,1487.924533,1487.995,1,44637735,44639850,2115,0.2438808406414872
16862,1488.003967,1488.0469,1,44640119,44641407,1288,0.20052573572724253
16863,1488.0479,1488.0711,1,44641437,44642133,696,-0.08843956463526297
16864,1488.073367,1488.094767,1,44642201,44642843,642,0.1511611537814911
16865,1488.105067,1488.1094,1,44643152,44643282,130,0.845737668790462
16866,1488.1202,1488.1343,1,44643606,44644029,423,0.3636011033309598
16867,1488.137967,1488.1549,1,44644139,44644647,508,0.09121299981365145
16868,1488.1671,1488.174267,1,44645013,44645228,215,0.3953809519478715
16869,1488.177,1488.201367,1,44645310,44646041,731,0.1309627040693566
16870,1488.211867,1488.225,1,44646356,44646750,394,0.958289582277921
16871,1488.244333,1488.2509,1,44647329,44647527,198,0.7076507746410254
16872,1488.3817,1488.385533,1,44651451,44651565,114,0.8342428486320717
16873,1488.391333,1488.403433,1,44651739,44652102,363,0.8769975206748268
16874,1488.4295,1488.504167,1,44652885,44655125,2240,0.2092956131595881
16875,1488.5059,1488.516867,1,44655177,44655506,329,0.6154815657832048
16876,1488.519267,1488.545633,1,44655578,44656368,790,0.12306122388440914
16877,1488.548133,1488.554567,1,44656443,44656637,194,0.5591376897651685
16878,1488.5558,1488.6032,1,44656674,44658096,1422,0.18317284190795646
16879,1488.609067,1488.616567,1,44658272,44658497,225,0.04725359259120902
16880,1488.619433,1488.636833,1,44658582,44659104,522,0.465754911348529
16881,1488.6464,1488.675033,1,44659392,44660250,858,0.20410214828547235
16882,1488.6944,1488.701067,1,44660832,44661032,200,0.46768544254063976
16883,1488.711567,1488.730133,1,44661347,44661903,556,0.23085581578747325
16884,1488.7515,1488.7611,1,44662545,44662833,288,0.270258320832056
16885,1488.787167,1488.8021,1,44663615,44664063,448,0.6319914495863134
16886,1488.803367,1488.812467,1,44664101,44664374,273,0.6073765602799074
16887,1488.864733,1488.973267,1,44665941,44669198,3257,0.2018513692045197
16888,1488.977233,1488.9818,1,44669316,44669454,138,0.857243620391828
16889,1488.9851,1489.009733,1,44669553,44670291,738,0.08020680846691429
16890,1489.019367,1489.022933,1,44670581,44670687,106,0.6041378626409186
16891,1489.0427,1489.047533,1,44671281,44671425,144,0.8774856140941927
16892,1489.054833,1489.094367,1,44671644,44672831,1187,0.15859226449217195
16893,1489.136067,1489.140833,1,44674082,44674224,142,0.8444883006680843
16894,1489.142,1489.146767,1,44674260,44674403,143,0.7766007631060765
16895,1489.150433,1489.1556,1,44674512,44674668,156,0.8889795253110656
16896,1489.1569,1489.2133,1,44674707,44676399,1692,0.3510175754635999
16897,1489.218767,1489.223633,1,44676563,44676708,145,0.8997068378520182
16898,1489.2259,1489.237767,1,44676777,44677133,356,0.4916096418585281
16899,1489.248067,1489.2517,1,44677442,44677551,109,0.670205262206055
16900,1489.274733,1489.2869,1,44678241,44678607,366,0.5627473928975517
16901,1489.304467,1489.3081,1,44679134,44679243,109,0.6141357427280103
16902,1489.315867,1489.361,1,44679476,44680830,1354,0.16018803597645417
16903,1489.364533,1489.381533,1,44680935,44681445,510,0.09564911658094347
16904,1489.389633,1489.3992,1,44681688,44681976,288,0.3312874724966951
16905,1489.406833,1489.443,1,44682204,44683290,1086,0.5528374621187966
16906,1489.7923,1489.796167,1,44693769,44693885,116,0.9159887523076975
16907,1489.797667,1489.801267,1,44693930,44694038,108,0.8853173704063628
16908,1489.8329,1489.8376,1,44694987,44695128,141,0.7471135267951574
16909,1489.867833,1489.954267,1,44696034,44698628,2594,0.1386861424458271
16910,1489.957967,1490.045133,1,44698739,44701353,2614,0.127362052749715
16911,1490.062933,1490.067767,1,44701887,44702033,146,0.7248463691463982
16912,1490.366867,1490.3723,1,44711006,44711169,163,0.6548367571143997
16913,1490.373833,1490.377133,1,44711214,44711313,99,0.7864708717083609
16914,1490.399567,1490.404167,1,44711987,44712125,138,0.9021763342134422
16915,1490.415433,1490.4558,1,44712462,44713674,1212,0.3561604436971725
16916,1490.4574,1490.494633,1,44713722,44714838,1116,0.5371545851705299
16917,1490.4958,1490.5001,1,44714874,44715003,129,0.6938558154898715
16918,1490.503433,1490.532033,1,44715102,44715960,858,0.7198144604571985
16919,1490.533767,1490.572267,1,44716013,44717168,1155,0.41759613913217325
16920,1490.5864,1490.706367,1,44717592,44721191,3599,0.34113669978772254
16921,1490.7078,1490.7165,1,44721234,44721495,261,0.19322017947012063
16922,1490.7185,1490.736767,1,44721555,44722103,548,-0.009309768357541305
16923,1490.744133,1490.780567,1,44722323,44723417,1094,0.5465921229777656
16924,1490.790333,1490.830567,1,44723709,44724917,1208,0.33827976136554133
16925,1490.8319,1490.8359,1,44724957,44725077,120,0.6931499428627661
16926,1490.843367,1490.8609,1,44725301,44725827,526,0.5948175805039374
16927,1490.870267,1490.882433,1,44726108,44726472,364,0.8626908356235565
16928,1490.888367,1490.9058,1,44726651,44727174,523,0.5235700377723675
16929,1490.909167,1490.930867,1,44727275,44727926,651,0.31054875921648306
16930,1490.9339,1490.939067,1,44728017,44728172,155,0.8373361268230672
16931,1490.941767,1490.9478,1,44728253,44728434,181,0.8532269408694995
16932,1490.967567,1490.983667,1,44729027,44729510,483,0.5134193958703741
16933,1491.007833,1491.076867,1,44730234,44732306,2072,0.29305614162513816
16934,1491.0779,1491.0816,1,44732337,44732448,111,0.9134824870687493
16935,1491.092333,1491.103733,1,44732769,44733111,342,0.6664588583308825
16936,1491.105167,1491.136333,1,44733155,44734089,934,0.12760358073466344
16937,1491.147733,1491.3318,1,44734431,44739954,5523,0.0990270176438644
16938,1491.345533,1491.3577,1,44740365,44740731,366,0.25501047641855523
16939,1491.363733,1491.3678,1,44740911,44741034,123,0.7227730494673051
16940,1491.379,1491.383267,1,44741370,44741498,128,0.8183967185695542
16941,1491.384267,1491.4033,1,44741528,44742099,571,0.5868754227249565
16942,1491.4097,1491.4338,1,44742291,44743014,723,0.09019797611123798
16943,1491.4419,1491.454,1,44743257,44743620,363,0.44445056252793924
16944,1491.455033,1491.4583,1,44743650,44743749,99,0.8232189115208258
16945,1491.464133,1491.472633,1,44743923,44744178,255,0.5198067361341825
16946,1491.4905,1491.5017,1,44744715,44745051,336,0.32569272684751344
16947,1491.562567,1491.565733,1,44746877,44746971,94,0.6436759375226649
16948,1491.6628,1491.675367,1,44749884,44750261,377,0.7309490340237385
16949,1491.687067,1491.714933,1,44750612,44751447,835,0.43740370366015713
16950,1491.722067,1491.735333,1,44751662,44752059,397,0.08770836373979386
16951,1491.827,1491.841833,1,44754810,44755254,444,0.8548176066563731
16952,1491.845167,1491.8592,1,44755355,44755776,421,0.6752955886379461
16953,1491.8603,1491.864933,1,44755809,44755947,138,0.9362389340599712
16954,1491.8662,1491.870667,1,44755986,44756120,134,0.7492934084742524
16955,1491.8843,1491.920133,1,44756529,44757603,1074,0.506722517562401
16956,1491.960067,1491.963267,1,44758802,44758898,96,0.8057563357480799
16957,1491.9685,1492.002267,1,44759055,44760068,1013,0.5425606492170486
16958,1492.020333,1492.0322,1,44760609,44760966,357,0.7018639190780296
16959,1492.0822,1492.087867,1,44762466,44762636,170,0.198010010277516
16960,1492.1362,1492.155,1,44764086,44764650,564,0.5677277103219104
16961,1492.1565,1492.167,1,44764695,44765010,315,0.61546160514029
16962,1492.267,1492.283867,1,44768010,44768516,506,0.1253582025104793
16963,1492.317333,1492.321433,1,44769519,44769642,123,0.664933978112064
16964,1492.323667,1492.339367,1,44769710,44770181,471,0.8052431755876933
16965,1492.344133,1492.3478,1,44770323,44770434,111,0.906361444563972
16966,1492.367367,1492.385933,1,44771021,44771577,556,0.25543644374749086
16967,1492.415233,1492.421567,1,44772456,44772647,191,0.5919022313312241
16968,1492.422667,1492.4258,1,44772680,44772774,94,0.8835414367313471
16969,1492.497467,1492.512067,1,44774924,44775362,438,0.42318702112737794
16970,1492.516267,1492.5276,1,44775488,44775828,340,0.8050607559172581
16971,1492.532733,1492.54,1,44775981,44776200,219,0.3494404740971416
16972,1492.605067,1492.608633,1,44778152,44778258,106,0.5202952519350234
16973,1492.633833,1492.638133,1,44779014,44779143,129,0.5670742805620331
16974,1492.926567,1492.9319,1,44787797,44787957,160,0.5417531508787318
16975,1493.1056,1493.112567,1,44793168,44793377,209,0.7271934779262529
16976,1493.570633,1493.581033,1,44807118,44807430,312,0.7795346181067697
16977,1493.583967,1493.5914,1,44807519,44807742,223,0.8289100203316777
16978,1493.5946,1493.602133,1,44807838,44808063,225,0.78824676555083
16979,1493.604233,1493.614967,1,44808126,44808449,323,0.43603385759806185
16980,1493.6171,1493.6232,1,44808513,44808696,183,0.8159299949472593
16981,1493.627167,1493.640733,1,44808815,44809221,406,0.4763458217834108
16982,1493.65,1493.6599,1,44809500,44809797,297,-0.10556887423562673
16983,1493.663967,1493.678767,1,44809919,44810363,444,0.40577474125670515
16984,1493.680767,1493.689267,1,44810423,44810678,255,0.2933610779538697
16985,1493.690467,1493.6947,1,44810714,44810841,127,0.8582883343188655
16986,1493.696633,1493.714867,1,44810898,44811446,548,0.8750944150929707
16987,1493.715967,1493.726267,1,44811479,44811788,309,0.9300693976157092
16988,1493.730033,1493.741133,1,44811900,44812233,333,0.899886509960324
16989,1494.255067,1494.261633,1,44827652,44827848,196,0.8747608426280343
16990,1494.2744,1494.2828,1,44828232,44828484,252,0.6806085148719773
16991,1494.292067,1494.295533,1,44828762,44828865,103,0.8490038221692481
16992,1494.314167,1494.3248,1,44829425,44829744,319,0.754467918210883
16993,1494.3258,1494.3522,1,44829774,44830566,792,0.1415112711677658
16994,1494.353333,1494.356633,1,44830599,44830698,99,0.8460992724563511
16995,1494.360967,1494.3855,1,44830829,44831565,736,0.41590519641142465
16996,1494.392567,1494.4025,1,44831777,44832075,298,0.4728990376804018
16997,1494.411467,1494.446533,1,44832344,44833395,1051,0.13708041861973885
16998,1494.454667,1494.462167,1,44833640,44833865,225,0.849478130630365
16999,1494.468067,1494.487567,1,44834042,44834627,585,0.18074195324286108
17000,1494.490967,1494.4942,1,44834729,44834826,97,0.8412511782454376
17001,1494.497233,1494.512033,1,44834916,44835360,444,0.7559049625417085
17002,1494.527033,1494.534433,1,44835810,44836032,222,0.7891462783459308
17003,1494.601033,1494.6158,1,44838030,44838474,444,0.6914043037588264
17004,1494.6168,1494.668133,1,44838504,44840043,1539,0.2396772786407969
17005,1494.6697,1494.678833,1,44840091,44840364,273,0.6593500624813425
17006,1494.6858,1494.692667,1,44840574,44840780,206,0.8686729161991132
17007,1494.709533,1494.7576,1,44841285,44842728,1443,0.3080287742194948
17008,1494.759933,1494.766567,1,44842797,44842997,200,0.6388391679699782
17009,1494.769067,1494.777767,1,44843072,44843333,261,0.913201661935278
17010,1494.796133,1494.8184,1,44843883,44844552,669,0.8723773013532168
17011,1495.117567,1495.1809,1,44853527,44855427,1900,0.27010171064484667
17012,1495.182233,1495.189267,1,44855466,44855678,212,0.8764151471980894
17013,1495.220767,1495.223967,1,44856623,44856719,96,0.8845734796826697
17014,1495.2252,1495.228533,1,44856756,44856855,99,0.8942711570566734
17015,1495.533167,1495.5595,1,44865995,44866785,790,0.8382766832645663
17016,1495.560633,1495.624633,1,44866818,44868738,1920,0.4921617420330169
17017,1495.626567,1495.6336,1,44868797,44869008,211,0.4163062696988892
17018,1495.635033,1495.653267,1,44869050,44869598,548,0.21915222609029172
17019,1495.6572,1495.6848,1,44869716,44870544,828,0.1461864830816021
17020,1495.6927,1495.7066,1,44870781,44871198,417,0.09732457148251838
17021,1495.707867,1495.7458,1,44871236,44872374,1138,0.11973298841447175
17022,1495.7468,1495.750767,1,44872404,44872523,119,0.9053012222791115
17023,1495.7533,1495.768833,1,44872599,44873064,465,0.9186083655103953
17024,1495.9812,1495.9845,1,44879436,44879535,99,0.9030365658854137
17025,1496.243,1496.246067,1,44887290,44887382,92,0.9393962292647663
17026,1496.248267,1496.391467,1,44887448,44891744,4296,0.528152906195574
17027,1496.3931,1496.415967,1,44891793,44892479,686,0.8701298931970854
17028,1496.505233,1496.5113,1,44895156,44895339,183,0.5359060359960536
17029,1496.521533,1496.5421,1,44895645,44896263,618,0.26742836873455217
17030,1496.6512,1496.6554,1,44899536,44899662,126,0.5812740577956835
17031,1496.7189,1496.723767,1,44901567,44901713,146,0.9230306223087588
17032,1496.781367,1496.790233,1,44903441,44903706,265,0.8460394960223996
17033,1496.7998,1496.8644,1,44903994,44905932,1938,0.13520927990402412
17034,1496.865433,1496.9877,1,44905962,44909631,3669,0.252361601483988
17035,1496.993433,1497.0238,1,44909802,44910714,912,0.42077599372656665
17036,1497.189533,1497.195267,1,44915685,44915858,173,0.9505532953506383
17037,1497.1975,1497.204833,1,44915925,44916144,219,0.9411525304051903
17038,1497.213267,1497.218733,1,44916398,44916561,163,0.8724146538350184
17039,1497.220033,1497.225833,1,44916600,44916774,174,0.9116046362177824
17040,1497.231767,1497.326467,1,44916953,44919794,2841,0.397938640690379
17041,1497.733167,1497.753267,1,44931995,44932598,603,0.27190074803064757
17042,1497.758,1497.761633,1,44932740,44932848,108,0.4991647115840907
17043,1497.823267,1497.827933,1,44934698,44934837,139,0.7016512943275317
17044,1497.889233,1497.893533,1,44936676,44936805,129,0.8423957949229992
17045,1497.895133,1497.8986,1,44936853,44936958,105,0.8685043522037599
17046,1497.902867,1497.920433,1,44937086,44937612,526,0.5231676892081504
17047,1497.929433,1497.937467,1,44937882,44938124,242,0.8127722085387221
17048,1497.939533,1497.947967,1,44938185,44938439,254,0.860321995715297
17049,1497.9494,1497.958567,1,44938482,44938757,275,0.42648790665946945
17050,1497.960167,1497.9644,1,44938805,44938932,127,0.8906472235214447
17051,1498.089933,1498.094667,1,44942697,44942840,143,0.004470817396062516
17052,1498.126967,1498.133767,1,44943809,44944013,204,0.4788005233328846
17053,1498.1532,1498.160133,1,44944596,44944803,207,0.6436960607892158
17054,1498.170467,1498.174733,1,44945114,44945241,127,0.855457538009574
17055,1498.201633,1498.209667,1,44946048,44946290,242,0.6363736444994722
17056,1498.2202,1498.225833,1,44946606,44946774,168,0.8157941357737171
17057,1498.242233,1498.2558,1,44947266,44947674,408,0.8519639081924264
17058,1498.262833,1498.275833,1,44947884,44948274,390,0.7751947228675385
17059,1498.444733,1498.487933,1,44953341,44954637,1296,0.7199743751052646
17060,1498.6471,1498.6501,1,44959413,44959503,90,0.8897551642856651
17061,1498.651633,1498.6563,1,44959548,44959689,141,0.8760046041261562
17062,1498.6669,1498.7246,1,44960007,44961738,1731,0.38343540671147686
17063,1498.733933,1498.745333,1,44962017,44962359,342,0.270518205531643
17064,1498.748067,1498.819533,1,44962442,44964585,2143,0.2575076498260433
17065,1498.845133,1498.8529,1,44965353,44965587,234,0.7931703367557966
17066,1498.917067,1498.921133,1,44967512,44967633,121,0.9327043509807234
17067,1498.928733,1499.052867,1,44967861,44971586,3725,0.36268590192499767
17068,1499.059133,1499.103167,1,44971773,44973095,1322,0.12741744934667473
17069,1499.135333,1499.1706,1,44974059,44975118,1059,0.1949880507881804
17070,1499.1778,1499.183267,1,44975334,44975498,164,0.5939401196016235
17071,1499.1881,1499.191867,1,44975643,44975756,113,0.8335767475029127
17072,1499.1981,1499.242633,1,44975943,44977278,1335,0.2136068375877266
17073,1499.2438,1499.250733,1,44977314,44977521,207,0.6551684208158398
17074,1499.2751,1499.286833,1,44978253,44978604,351,0.7746723884477116
17075,1499.301633,1499.330467,1,44979048,44979914,866,0.27098908559913304
17076,1499.332433,1499.441867,1,44979972,44983256,3284,0.22974479696469044
17077,1499.452233,1499.460767,1,44983566,44983823,257,0.8479056677843757
17078,1499.680267,1499.6966,1,44990408,44990898,490,0.8988578617626616
17079,1499.6981,1499.7014,1,44990943,44991042,99,0.9097446074735548
17080,1499.706133,1499.7529,1,44991183,44992587,1404,0.30960612790494196
17081,1499.774667,1499.783067,1,44993240,44993492,252,0.8439834107257652
17082,1499.7849,1499.795933,1,44993547,44993877,330,0.2758087984207747
17083,1499.804533,1499.847633,1,44994135,44995428,1293,0.24891456118653593
17084,1499.8529,1499.876733,1,44995587,44996301,714,0.3554110500028479
17085,1499.879633,1499.8835,1,44996388,44996505,117,0.8473436544121087
17086,1499.8858,1499.895067,1,44996574,44996852,278,0.906317503025371
17087,1499.910933,1499.931633,1,44997327,44997948,621,0.919926264202209
17088,1499.996667,1500.0014,1,44999900,45000042,142,0.8517958326697891
17089,1500.002967,1500.010167,1,45000089,45000305,216,0.8081577576912267
17090,1500.011167,1500.072067,1,45000335,45002162,1827,0.37014006670035515
17091,1500.0802,1500.103233,1,45002406,45003096,690,0.25942258202342633
17092,1500.113933,1500.124067,1,45003417,45003722,305,0.7549667213156774
17093,1500.131533,1500.144867,1,45003945,45004346,401,0.7626355406554609
17094,1500.146833,1500.1612,1,45004404,45004836,432,0.8795848837577638
17095,1500.346267,1500.350433,1,45010388,45010512,124,0.7909619230122346
17096,1500.3581,1500.371167,1,45010743,45011135,392,0.8849726541450627
17097,1500.3728,1500.456567,1,45011184,45013697,2513,0.3950113821415514
17098,1500.463833,1500.4691,1,45013914,45014073,159,0.7625549048651948
17099,1500.4774,1500.5746,1,45014322,45017238,2916,0.16512214338057576
17100,1500.576233,1500.585467,1,45017286,45017564,278,0.9179144885221379
17101,1500.591867,1500.596467,1,45017756,45017894,138,0.7667420167765109
17102,1500.602267,1500.6321,1,45018068,45018963,895,0.29947203446710213
17103,1500.637567,1500.696533,1,45019127,45020895,1768,0.5525279891928512
17104,1500.6977,1500.708833,1,45020931,45021264,333,0.31768164624975653
17105,1500.710133,1500.723367,1,45021303,45021701,398,0.31302953468718303
17106,1500.725367,1500.769267,1,45021761,45023078,1317,0.31623941775634057
17107,1500.771467,1500.810033,1,45023144,45024300,1156,0.3858075895782443
17108,1500.8143,1500.8192,1,45024429,45024576,147,0.6167039339274513
17109,1500.8599,1500.867167,1,45025797,45026015,218,0.5110464650684453
17110,1500.868467,1500.911233,1,45026054,45027336,1282,0.038161912944543255
17111,1500.952567,1500.969567,1,45028577,45029087,510,0.6541849116815533
17112,1500.9707,1501.0145,1,45029121,45030435,1314,0.27116653207948366
17113,1501.0326,1501.035767,1,45030978,45031073,95,0.9318438020814355
17114,1501.057367,1501.081333,1,45031721,45032439,718,0.34279108283118054
17115,1501.161167,1501.2679,1,45034835,45038037,3202,0.2893219787823565
17116,1501.2743,1501.343867,1,45038229,45040316,2087,0.18657080604665546
17117,1501.3538,1501.4946,1,45040614,45044838,4224,0.23324886276217044
17118,1501.498667,1501.5051,1,45044960,45045153,193,0.9015761972151388
17119,1501.510467,1501.5366,1,45045314,45046098,784,0.4555753241780124
17120,1501.540433,1501.549867,1,45046212,45046496,284,0.3188585376429038
17121,1501.5883,1501.594467,1,45047649,45047834,185,0.566439029713869
17122,1501.595633,1501.6009,1,45047868,45048027,159,0.8677083587037746
17123,1501.607167,1501.6408,1,45048215,45049224,1009,0.21712162774449267
17124,1501.6646,1501.676967,1,45049938,45050309,371,0.7891132072057163
17125,1501.678133,1501.6823,1,45050343,45050469,126,0.8152300072710238
17126,1501.6887,1501.693733,1,45050661,45050811,150,0.8560362449807818
17127,1501.696767,1501.7476,1,45050903,45052428,1525,0.18685667493565666
17128,1501.763633,1501.777667,1,45052908,45053330,422,0.5278815441778154
17129,1501.792633,1501.826367,1,45053778,45054791,1013,0.6302891043015065
17130,1501.834633,1501.8825,1,45055038,45056475,1437,0.17740858531172646
17131,1501.892767,1501.942233,1,45056783,45058266,1483,0.12549201118255435
17132,1501.944567,1501.959633,1,45058337,45058788,451,0.523286749896153
17133,1501.968033,1502.004933,1,45059040,45060147,1107,0.569304698876787
17134,1502.009233,1502.0151,1,45060276,45060453,177,0.773192872020405
17135,1502.212167,1502.216933,1,45066365,45066507,142,0.8671674664279309
17136,1502.2422,1502.246433,1,45067266,45067392,126,0.6126671922110871
17137,1502.251833,1502.268033,1,45067554,45068040,486,0.7509997458336457
17138,1502.270533,1502.3432,1,45068115,45070296,2181,0.2508446360283476
17139,1502.3485,1502.354433,1,45070455,45070632,177,0.8396584684741801
17140,1502.357167,1502.378333,1,45070715,45071349,634,0.4033778796369342
17141,1502.3821,1502.386833,1,45071463,45071604,141,0.9581280666690006
17142,1502.390433,1502.3947,1,45071712,45071841,129,0.9439283889846914
17143,1502.522467,1502.546667,1,45075674,45076400,726,0.6213928537426285
17144,1502.549167,1502.604567,1,45076475,45078137,1662,0.25446141948076834
17145,1502.605567,1502.623767,1,45078167,45078713,546,0.21459188683162891
17146,1502.714567,1502.730667,1,45081437,45081920,483,0.7986505068911787
17147,1502.738233,1502.8011,1,45082146,45084033,1887,0.16382934498085464
17148,1502.803233,1502.821667,1,45084096,45084650,554,0.4936572246246123
17149,1502.9175,1502.920567,1,45087525,45087617,92,0.6642443224393034
17150,1502.940367,1503.043167,1,45088211,45091295,3084,0.2732517457982328
17151,1503.049033,1503.0906,1,45091470,45092718,1248,0.15509123649478557
17152,1503.094133,1503.100767,1,45092823,45093023,200,0.4361325895723208
17153,1503.1023,1503.135667,1,45093069,45094070,1001,0.2260356950984296
17154,1503.139233,1503.2767,1,45094176,45098301,4125,0.3263404029521944
17155,1503.282767,1503.287333,1,45098483,45098619,136,0.8823148107228838
17156,1503.3034,1503.344633,1,45099102,45100338,1236,0.21198730136087743
17157,1503.3463,1503.3687,1,45100389,45101061,672,0.25969453366436296
17158,1503.3756,1503.39,1,45101268,45101700,432,0.15740605845067795
17159,1503.4084,1503.411733,1,45102252,45102351,99,0.6298835004345298
17160,1503.413633,1503.428467,1,45102408,45102854,446,0.9230387288760055
17161,1503.4321,1503.5124,1,45102963,45105372,2409,0.2456937361927418
17162,1503.517167,1503.555867,1,45105515,45106676,1161,0.6079615225204369
17163,1503.5664,1503.574467,1,45106992,45107234,242,0.7816200393028436
17164,1503.575633,1503.7078,1,45107268,45111234,3966,0.2914627695046934
17165,1503.7091,1503.7664,1,45111273,45112992,1719,0.23559500200977168
17166,1503.7687,1503.780667,1,45113061,45113420,359,0.7049314167476852
17167,1503.783667,1503.820967,1,45113510,45114629,1119,0.6389260412640251
17168,1503.8613,1503.8848,1,45115839,45116544,705,0.5372106807516915
17169,1503.961933,1503.971967,1,45118857,45119159,302,0.685675964095006
17170,1504.028233,1504.041233,1,45120846,45121236,390,0.8768796279614428
17171,1504.050533,1504.098933,1,45121515,45122967,1452,0.20161127406271862
17172,1504.102667,1504.147967,1,45123080,45124439,1359,0.18724914188152472
17173,1504.149567,1504.154933,1,45124487,45124647,160,0.3257526515750781
17174,1504.3393,1504.3424,1,45130179,45130272,93,0.9459935832553659
17175,1504.363533,1504.421167,1,45130905,45132635,1730,0.2932613470046252
17176,1504.4324,1504.506633,1,45132972,45135198,2226,0.3710274665505292
17177,1504.572733,1504.586467,1,45137181,45137594,413,0.8040704146795637
17178,1504.620933,1504.637533,1,45138627,45139125,498,0.6277978954465104
17179,1504.645467,1504.693267,1,45139364,45140798,1434,0.45147820572066627
17180,1504.6968,1504.744533,1,45140904,45142335,1431,0.23529219538270824
17181,1504.747967,1504.898567,1,45142439,45146957,4518,0.23731748117087476
17182,1504.899967,1504.938033,1,45146999,45148140,1141,0.18060776394711983
17183,1504.949633,1504.960867,1,45148488,45148826,338,0.8477648244043096
17184,1504.976467,1504.984467,1,45149294,45149534,240,0.8064057786566893
17185,1504.9861,1505.012733,1,45149583,45150381,798,0.5918678681343561
17186,1505.0138,1505.023333,1,45150414,45150699,285,0.5882234985261993
17187,1505.0691,1505.104433,1,45152073,45153132,1059,0.328152969112937
17188,1505.1427,1505.330233,1,45154281,45159906,5625,0.4047295487609169
17189,1505.331333,1505.342767,1,45159939,45160283,344,0.7343301173212254
17190,1505.350033,1505.382033,1,45160500,45161460,960,0.3036917226239182
17191,1505.383167,1505.416567,1,45161495,45162497,1002,0.2322290284156603
17192,1505.417833,1505.4211,1,45162534,45162633,99,0.798598018235929
17193,1505.4232,1505.440433,1,45162696,45163212,516,0.7818855251036078
17194,1505.441833,1505.470333,1,45163254,45164109,855,0.2323623104190123
17195,1505.4889,1505.493,1,45164667,45164790,123,0.8967626958734889
17196,1505.495533,1505.5051,1,45164865,45165153,288,0.6602335663553552
17197,1505.5104,1505.5146,1,45165312,45165438,126,0.8879907161158396
17198,1505.815,1506.345533,1,45174450,45190365,15915,0.6824129289124845
17199,1506.352233,1506.357567,1,45190566,45190727,161,0.6651714224913323
17200,1506.371367,1506.375167,1,45191141,45191255,114,0.8571791034451278
17201,1506.407733,1506.4176,1,45192231,45192528,297,0.855247074797097
17202,1506.463633,1506.469133,1,45193908,45194073,165,0.8003897626911409
17203,1506.470533,1506.475267,1,45194115,45194258,143,0.8713114507789371
17204,1506.480367,1506.495567,1,45194411,45194867,456,0.7503181059626618
17205,1506.501567,1506.5152,1,45195047,45195456,409,0.1976431515996487
17206,1506.575067,1506.579533,1,45197252,45197385,133,0.22016265259645384
17207,1506.592167,1506.5982,1,45197765,45197946,181,0.901757814403305
17208,1506.599233,1506.6135,1,45197976,45198405,429,0.7291401311780897
17209,1506.618167,1506.624367,1,45198545,45198731,186,0.8711161204406334
17210,1506.657767,1506.662167,1,45199733,45199865,132,0.5041234875719524
17211,1506.666367,1506.6858,1,45199991,45200574,583,0.3517051684525053
17212,1506.6936,1506.7294,1,45200808,45201882,1074,0.35456503339001616
17213,1506.785833,1506.858767,1,45203574,45205763,2189,0.4889708379645546
17214,1506.8674,1506.888433,1,45206022,45206652,630,0.38554127028224394
17215,1506.897833,1506.911833,1,45206934,45207354,420,0.6002216751724412
17216,1506.914167,1506.9826,1,45207425,45209478,2053,0.1805210921387795
17217,1506.984,1506.991933,1,45209520,45209757,237,0.8232763558542548
17218,1507.000067,1507.034033,1,45210002,45211020,1018,0.1468558844270251
17219,1507.0506,1507.0794,1,45211518,45212382,864,0.07343958362946162
17220,1507.0819,1507.086533,1,45212457,45212595,138,0.8429526632227172
17221,1507.090933,1507.4172,1,45212727,45222516,9789,0.06519196654781177
17222,1507.419567,1507.424367,1,45222587,45222731,144,0.834219252904309
17223,1507.425367,1507.430367,1,45222761,45222911,150,0.6057834325225535
17224,1507.432333,1507.694733,1,45222969,45230841,7872,0.2917147333022769
17225,1507.6962,1507.736567,1,45230886,45232097,1211,0.26221149492430756
17226,1507.737567,1507.746267,1,45232127,45232388,261,0.5889476238226817
17227,1507.7552,1507.8149,1,45232656,45234447,1791,0.31980303256710946
17228,1507.833133,1507.8896,1,45234993,45236688,1695,0.2694170686045227
17229,1507.892933,1507.973667,1,45236787,45239210,2423,0.23039036680140967
17230,1507.977033,1507.9981,1,45239310,45239943,633,0.24634486425506452
17231,1508.0143,1508.024533,1,45240429,45240735,306,0.5411912223675628
17232,1508.028567,1508.032467,1,45240857,45240974,117,0.866853757435586
17233,1508.034567,1508.037567,1,45241037,45241127,90,0.937478569265866
17234,1508.043833,1508.054833,1,45241314,45241644,330,0.8370916601186318
17235,1508.330167,1508.348767,1,45249905,45250463,558,0.638899532433536
17236,1508.349833,1508.393633,1,45250494,45251808,1314,0.17165717459871088
17237,1508.394933,1508.403233,1,45251847,45252096,249,0.7092759313867126
17238,1508.435067,1508.4394,1,45253052,45253182,130,0.810314798214938
17239,1508.461867,1508.466667,1,45253856,45254000,144,0.9469313108600653
17240,1508.738367,1508.816333,1,45262151,45264489,2338,0.19720370673037496
17241,1508.8195,1508.864967,1,45264585,45265949,1364,0.1369302583601252
17242,1508.8729,1508.8804,1,45266187,45266412,225,0.8770076594703736
17243,1508.8864,1508.919367,1,45266592,45267581,989,0.2641807024683415
17244,1509.084467,1509.201233,1,45272534,45276036,3502,0.31362196800748665
17245,1509.208167,1509.2141,1,45276245,45276423,178,0.8473085705252738
17246,1509.2208,1509.252167,1,45276624,45277565,941,0.4422230585808409
17247,1509.269867,1509.277267,1,45278096,45278318,222,0.9199964971743941
17248,1509.2875,1509.3272,1,45278625,45279816,1191,0.21301605830517642
17249,1509.3332,1509.371467,1,45279996,45281144,1148,0.10447457801839988
17250,1509.3952,1509.4419,1,45281856,45283257,1401,0.3718329651260591
17251,1509.4629,1509.467567,1,45283887,45284027,140,0.9640794639334487
17252,1509.469633,1509.472633,1,45284088,45284178,90,0.9634776905043713
17253,1509.478167,1509.5977,1,45284345,45287931,3586,0.31319769467860725
17254,1509.862067,1509.9419,1,45295862,45298257,2395,0.26327572023838625
17255,1509.9453,1509.9502,1,45298359,45298506,147,0.8274103718360397
17256,1509.9548,1509.958733,1,45298644,45298761,117,0.8708341077481175
17257,1509.971333,1509.9864,1,45299139,45299592,453,0.4450910440556869
17258,1509.991233,1509.9979,1,45299736,45299937,201,0.7845739925076903
17259,1510.2147,1510.2934,1,45306441,45308802,2361,0.3186810140656264
17260,1510.294467,1510.299233,1,45308834,45308976,142,0.9590049789051968
17261,1510.300767,1510.3148,1,45309023,45309444,421,0.831497563681362
17262,1510.9472,1510.9514,1,45328416,45328542,126,0.8744342511616832
17263,1511.2512,1511.2543,1,45337536,45337629,93,0.5643784451195214
17264,1511.533033,1511.539667,1,45345990,45346190,200,0.7945729394339508
17265,1511.711867,1511.730633,1,45351356,45351918,562,0.1780793382286461
17266,1511.751567,1511.7561,1,45352547,45352683,136,0.9005860411844756
17267,1511.776333,1511.7821,1,45353289,45353463,174,0.9543411308361849
17268,1511.790967,1511.821433,1,45353729,45354642,913,0.3041571529941942
17269,1511.8232,1511.869133,1,45354696,45356073,1377,0.3703146967069884
17270,1511.870167,1512.3014,1,45356105,45369042,12937,0.6305146231381292
17271,1512.551067,1512.556867,1,45376532,45376706,174,0.9413951003354951
17272,1512.638733,1512.656367,1,45379161,45379691,530,0.6353522571941781
17273,1512.7204,1512.723467,1,45381612,45381704,92,0.8349220844031052
17274,1512.745467,1512.749,1,45382364,45382470,106,0.6158319245356008
17275,1512.808033,1512.813933,1,45384240,45384417,177,0.8378534841424436
17276,1512.822733,1512.827467,1,45384681,45384824,143,0.976474262905714
17277,1512.8323,1512.842767,1,45384969,45385283,314,0.6854658065572578
17278,1512.843967,1512.847967,1,45385319,45385439,120,0.9713753558650534
17279,1512.864033,1512.889233,1,45385920,45386676,756,0.6736241417445901
17280,1512.8944,1512.904033,1,45386832,45387120,288,0.7968136018111226
17281,1512.914167,1512.9184,1,45387425,45387552,127,0.8939468927587634
17282,1513.0587,1513.0632,1,45391761,45391896,135,0.5972022642854629
17283,1513.0667,1513.0829,1,45392001,45392487,486,0.21490216766746026
17284,1513.1369,1513.144167,1,45394107,45394325,218,0.5290815223533633
17285,1513.231033,1513.236067,1,45396930,45397082,152,0.49135549172146903
17286,1513.285067,1513.2884,1,45398552,45398652,100,0.7987272151350333
17287,1513.4556,1513.466167,1,45403668,45403985,317,0.777923569870763
17288,1513.472367,1513.477267,1,45404171,45404318,147,0.6629255912487891
17289,1513.5104,1513.582933,1,45405312,45407487,2175,0.4726449152045922
17290,1513.584967,1513.636867,1,45407549,45409106,1557,0.3061870584314632
17291,1513.639167,1513.662467,1,45409175,45409874,699,0.7161463234583779
17292,1513.663967,1513.6902,1,45409919,45410706,787,0.8376994424326423
17293,1513.7003,1513.705567,1,45411009,45411167,158,0.930578376376855
17294,1513.720933,1513.727067,1,45411627,45411812,185,0.8843069697520463
17295,1513.732,1513.7453,1,45411960,45412359,399,0.8030952492796465
17296,1513.996067,1514.0014,1,45419882,45420042,160,0.7523097129509732
17297,1514.005,1514.0164,1,45420150,45420492,342,0.8645069616727589
17298,1514.022067,1514.076767,1,45420662,45422303,1641,0.22350738691976796
17299,1514.080767,1514.092833,1,45422423,45422784,361,0.3084208798448729
17300,1514.093967,1514.1001,1,45422819,45423003,184,0.838673078425284
17301,1514.127267,1514.147633,1,45423818,45424428,610,0.19129194690025386
17302,1514.381933,1514.386933,1,45431457,45431607,150,0.10495210693620385
17303,1515.856133,1515.8764,1,45475683,45476292,609,0.2643687659696712
17304,1515.903267,1515.9073,1,45477098,45477219,121,0.04420198837984107
17305,1515.948133,1515.954533,1,45478443,45478635,192,0.4896698109801094
17306,1515.9984,1516.008,1,45479952,45480240,288,0.5537058859662511
17307,1516.334833,1516.3422,1,45490044,45490266,222,0.7838401777528359
17308,1516.3736,1516.472967,1,45491208,45494189,2981,0.18434860738381612
17309,1516.4742,1516.508867,1,45494226,45495266,1040,0.08696384105743214
17310,1516.520067,1516.5319,1,45495602,45495957,355,0.13295172437139813
17311,1516.541867,1516.5653,1,45496256,45496959,703,0.2904319276509386
17312,1516.569033,1516.574967,1,45497070,45497249,179,0.8489842859491435
17313,1516.576867,1516.587733,1,45497306,45497631,325,0.879435982781177
17314,1516.603133,1516.607267,1,45498093,45498218,125,0.7686239674344642
17315,1516.687033,1516.698933,1,45500610,45500967,357,0.7990780741471951
17316,1516.7002,1516.704567,1,45501006,45501137,131,0.8475070439742189
17317,1516.708167,1516.803433,1,45501245,45504102,2857,0.33373129745775826
17318,1516.808067,1516.814833,1,45504242,45504444,202,0.7913358888788395
17319,1516.815967,1516.8195,1,45504479,45504585,106,0.8271717838256438
17320,1516.823133,1516.849133,1,45504693,45505473,780,0.23578126222470547
17321,1516.861,1516.867733,1,45505830,45506031,201,0.3696693145230902
17322,1516.880933,1516.8976,1,45506427,45506928,501,0.6720396986437618
17323,1517.271767,1517.275567,1,45518153,45518267,114,0.7056277908318455
17324,1517.359433,1517.3822,1,45520782,45521466,684,0.8368095962737115
17325,1517.39,1517.402433,1,45521700,45522072,372,0.2848120769518725
17326,1517.403567,1517.466033,1,45522107,45523980,1873,0.38068476933976053
17327,1517.470133,1517.5054,1,45524103,45525162,1059,0.2764120229309583
17328,1517.511733,1517.6151,1,45525351,45528453,3102,0.31048222767467426
17329,1517.665033,1517.730667,1,45529950,45531920,1970,0.39670173623659766
17330,1517.7569,1517.7651,1,45532707,45532953,246,0.6599866056984818
17331,1517.766167,1517.796467,1,45532985,45533894,909,0.4823947297452446
17332,1517.7991,1517.841367,1,45533973,45535241,1268,0.121694919729364
17333,1517.852567,1518.139967,1,45535577,45544199,8622,-0.018680651999537893
17334,1518.141,1518.227167,1,45544230,45546815,2585,0.1211150938576731
17335,1518.233767,1518.245867,1,45547013,45547376,363,0.520583878315623
17336,1518.386733,1518.390267,1,45551601,45551708,107,0.5546180805275628
17337,1518.4213,1518.4346,1,45552639,45553038,399,0.1720314170674165
17338,1518.471733,1518.475533,1,45554151,45554265,114,0.7820988319388811
17339,1518.4773,1518.4907,1,45554319,45554721,402,0.7795550111096089
17340,1518.659767,1518.698233,1,45559793,45560946,1153,0.6717943389531045
17341,1518.700733,1518.730767,1,45561021,45561923,902,0.21981190172017734
17342,1518.790733,1518.857,1,45563721,45565710,1989,0.37408696901315963
17343,1518.858567,1518.8628,1,45565757,45565884,127,0.923907103404665
17344,1518.875333,1518.884433,1,45566259,45566532,273,0.49404419578488795
17345,1518.8899,1518.8935,1,45566697,45566805,108,0.7039924574458452
17346,1518.908567,1518.912333,1,45567257,45567369,112,0.6524987366975895
17347,1518.956433,1518.9832,1,45568692,45569496,804,0.6965471068378826
17348,1518.9852,1518.989867,1,45569556,45569696,140,0.6228599221951798
17349,1519.009,1519.0221,1,45570270,45570663,393,0.6942189699051957
17350,1519.027267,1519.033367,1,45570818,45571001,183,0.13218426155667176
17351,1519.0388,1519.043433,1,45571164,45571302,138,0.5112283248195775
17352,1519.312333,1519.319567,1,45579369,45579587,218,0.924982783947739
17353,1519.326767,1519.339433,1,45579803,45580182,379,0.9124041165924214
17354,1519.3494,1519.5277,1,45580482,45585831,5349,0.246800823337477
17355,1519.531367,1519.762167,1,45585941,45592865,6924,0.10479227966767267
17356,1519.784567,1519.7884,1,45593537,45593652,115,0.8937833305072579
17357,1519.803567,1519.809533,1,45594107,45594285,178,0.6818459364662061
17358,1519.813233,1519.8164,1,45594396,45594492,96,0.6290167015446584
17359,1519.9494,1519.9535,1,45598482,45598605,123,0.7838135478471702
17360,1519.955067,1519.959,1,45598652,45598770,118,0.8882836889029302
17361,1519.973833,1519.978667,1,45599214,45599360,146,0.8158114725118156
17362,1519.999333,1520.0132,1,45599979,45600396,417,0.8497272538668935
17363,1520.0902,1520.105933,1,45602706,45603177,471,0.8438154264857372
17364,1520.106967,1520.165133,1,45603209,45604953,1744,0.23096658049029872
17365,1520.167367,1520.1712,1,45605021,45605136,115,0.9299014642836162
17366,1520.175867,1520.255733,1,45605276,45607671,2395,0.3725618271386832
17367,1520.2604,1520.265667,1,45607812,45607970,158,0.9621693102827574
17368,1520.2777,1520.2846,1,45608331,45608538,207,0.8903432199360604
17369,1520.306,1520.310067,1,45609180,45609302,122,0.7828637361851944
17370,1520.445367,1520.475767,1,45613361,45614273,912,0.6914865960581252
17371,1520.487933,1520.493,1,45614637,45614790,153,0.8448666895351168
17372,1520.531333,1520.610933,1,45615939,45618327,2388,0.2912075376799124
17373,1520.660933,1520.685767,1,45619827,45620573,746,0.6600942864936175
17374,1520.687967,1520.705833,1,45620639,45621174,535,0.8563270528565531
17375,1520.7088,1520.736767,1,45621264,45622103,839,0.6028628250045126
17376,1520.750067,1520.811533,1,45622502,45624345,1843,0.44231809514443565
17377,1520.8275,1520.833367,1,45624825,45625001,176,0.8721149873102201
17378,1520.844933,1520.8485,1,45625347,45625455,108,0.9144266110347606
17379,1520.880367,1520.9843,1,45626411,45629529,3118,0.3508902328668107
17380,1520.9875,1521.0078,1,45629625,45630234,609,0.3363517076387519
17381,1521.0173,1521.021967,1,45630519,45630659,140,0.927875405242221
17382,1521.024767,1521.043733,1,45630743,45631311,568,0.38194214981545477
17383,1521.0627,1521.0667,1,45631881,45632001,120,0.7048102961120567
17384,1521.073533,1521.138233,1,45632205,45634146,1941,0.336848097246629
17385,1521.139567,1521.1574,1,45634187,45634722,535,0.8760339054240324
17386,1521.176667,1521.182933,1,45635300,45635487,187,0.8774872710736832
17387,1521.194067,1521.300933,1,45635822,45639027,3205,0.32855112536973946
17388,1521.4879,1521.491867,1,45644637,45644756,119,0.8650301262724536
17389,1521.4931,1521.536967,1,45644793,45646109,1316,0.43640435498819174
17390,1521.538167,1521.6489,1,45646145,45649467,3322,0.3096515384473265
17391,1521.650967,1521.7078,1,45649529,45651234,1705,0.20118764957299598
17392,1521.731,1521.737333,1,45651930,45652119,189,0.7409753339493287
17393,1521.739667,1521.762267,1,45652190,45652868,678,0.4711345516115402
17394,1521.763467,1521.792233,1,45652904,45653766,862,0.18140106699391723
17395,1521.795333,1521.805533,1,45653859,45654165,306,0.89987933074906
17396,1521.8092,1521.818433,1,45654276,45654552,276,0.8639747660650045
17397,1521.821367,1521.9391,1,45654641,45658173,3532,0.16732982043039793
17398,1521.9402,1522.529333,1,45658206,45675879,17673,0.14262328281524733
17399,1522.5384,1522.5738,1,45676152,45677214,1062,0.6577065118161105
17400,1522.581733,1522.740133,1,45677451,45682203,4752,0.4478820984834688
17401,1522.742533,1522.745567,1,45682275,45682367,92,0.884955120102776
17402,1522.750467,1522.764367,1,45682514,45682931,417,0.7304738057047673
17403,1522.7686,1522.7889,1,45683058,45683667,609,0.7555960233395026
17404,1522.839867,1522.857,1,45685196,45685710,514,0.8169663146015133
17405,1522.862967,1522.879633,1,45685889,45686388,499,0.6777526160347676
17406,1522.948467,1522.966467,1,45688454,45688994,540,0.8564221086388445
17407,1522.973233,1523.026033,1,45689196,45690780,1584,0.3628080986959279
17408,1523.0338,1523.0493,1,45691014,45691479,465,0.06872026757077276
17409,1523.0528,1523.1372,1,45691584,45694116,2532,0.1296097673025095
17410,1523.149733,1523.1797,1,45694491,45695391,900,0.08789140963086785
17411,1523.184533,1523.191567,1,45695535,45695747,212,0.874445384372073
17412,1523.2412,1523.3599,1,45697236,45700797,3561,0.3889474141895632
17413,1523.4082,1523.440167,1,45702246,45703205,959,0.1361462701388598
17414,1523.446267,1523.456133,1,45703388,45703683,295,0.8597161233642524
17415,1523.4587,1523.4627,1,45703761,45703881,120,-0.35854845389858264
17416,1523.466,1523.594233,1,45703980,45707826,3846,0.2830057348232047
17417,1523.6006,1523.6441,1,45708018,45709323,1305,0.17908011385261172
17418,1523.647767,1523.7758,1,45709433,45713274,3841,0.16964576444122165
17419,1523.787133,1523.7979,1,45713613,45713937,324,0.7969488403664323
17420,1523.801733,1523.842567,1,45714051,45715277,1226,0.27883285593093365
17421,1523.850467,1523.868133,1,45715514,45716043,529,0.3124920468558418
17422,1523.886067,1523.930833,1,45716582,45717924,1342,0.35030847001565246
17423,1523.938567,1523.9668,1,45718157,45719004,847,0.45457589423018374
17424,1523.970633,1523.993833,1,45719118,45719814,696,0.3257289083263852
17425,1523.995067,1524.1895,1,45719852,45725685,5833,0.35084528199233433
17426,1524.198567,1524.3009,1,45725957,45729027,3070,0.25891459568091574
17427,1524.305067,1524.309933,1,45729152,45729297,145,0.8896246465583062
17428,1524.320867,1524.3876,1,45729626,45731628,2002,0.12689392297313487
17429,1524.4165,1524.4438,1,45732495,45733314,819,0.4273782030595986
17430,1524.462267,1524.4675,1,45733868,45734025,157,0.5667188555658641
17431,1524.487367,1524.5061,1,45734621,45735183,562,0.02000488354673884
17432,1524.5104,1524.516433,1,45735312,45735492,180,0.909380022792455
17433,1524.524333,1524.561567,1,45735729,45736847,1118,0.3494877590472519
17434,1524.5786,1524.602967,1,45737358,45738089,731,0.27706678358150927
17435,1524.604167,1524.625567,1,45738125,45738767,642,0.27042933221275817
17436,1524.628167,1524.636933,1,45738845,45739107,262,0.011594277219664424
17437,1524.6411,1524.647033,1,45739233,45739410,177,0.44273603673243656
17438,1524.675,1524.6821,1,45740250,45740463,213,0.7575266766216467
17439,1524.683467,1524.711467,1,45740504,45741344,840,0.28247490543363885
17440,1524.713,1524.765067,1,45741390,45742952,1562,0.11884822174560983
17441,1524.766867,1524.7777,1,45743006,45743331,325,0.14436661605063475
17442,1524.781233,1524.817133,1,45743436,45744513,1077,0.18692234384298614
17443,1524.8508,1524.946567,1,45745524,45748397,2873,0.2658334818040506
17444,1524.949067,1524.958367,1,45748472,45748751,279,0.15152938485968706
17445,1524.980267,1524.983367,1,45749408,45749501,93,0.8544147361992263
17446,1524.988233,1524.993233,1,45749646,45749796,150,0.11030494084294645
17447,1524.998133,1525.004933,1,45749943,45750147,204,0.7431103559704109
17448,1525.005933,1525.009433,1,45750177,45750282,105,0.4205165363926445
17449,1525.036033,1525.043667,1,45751080,45751310,230,0.19228702930284902
17450,1525.061133,1525.067067,1,45751833,45752012,179,0.9258810616894332
17451,1525.075533,1525.080467,1,45752265,45752414,149,0.8940482700247292
17452,1525.082433,1525.112467,1,45752472,45753374,902,0.5423397022230829
17453,1525.115467,1525.124067,1,45753464,45753722,258,0.5411249268379389
17454,1525.133167,1525.1614,1,45753995,45754842,847,0.11799836351148875
17455,1525.163067,1525.2066,1,45754892,45756198,1306,0.41747305838640764
17456,1525.2086,1525.2209,1,45756258,45756627,369,0.48505414909416267
17457,1525.224133,1525.264533,1,45756723,45757935,1212,0.17022892423469144
17458,1525.311767,1525.317033,1,45759353,45759510,157,0.5346243497327849
17459,1525.326133,1525.334267,1,45759783,45760028,245,0.8711586076768484
17460,1525.3358,1525.354,1,45760074,45760620,546,0.3602482632843674
17461,1525.358567,1525.366033,1,45760757,45760980,223,0.7931833907239085
17462,1525.3674,1525.374233,1,45761022,45761226,204,0.0004345205108204403
17463,1525.434433,1525.845267,1,45763032,45775358,12326,0.35242314909891376
17464,1525.926633,1525.945733,1,45777798,45778371,573,0.8546010521167543
17465,1525.999333,1526.0029,1,45779979,45780087,108,0.5934914370591514
17466,1526.029233,1526.08,1,45780876,45782400,1524,0.4190368062461848
17467,1526.092633,1526.103167,1,45782778,45783095,317,0.9486788316680571
17468,1526.104167,1526.114533,1,45783125,45783435,310,0.8655392003531078
17469,1526.120767,1526.149467,1,45783623,45784484,861,0.27101098908742777
17470,1526.150933,1526.191967,1,45784527,45785759,1232,0.31156495688962854
17471,1526.201067,1526.2052,1,45786032,45786156,124,0.3972299089729541
17472,1526.222067,1526.2662,1,45786662,45787986,1324,0.3760185377636088
17473,1526.2991,1526.302367,1,45788973,45789071,98,0.8403567706097501
17474,1526.309833,1526.356333,1,45789294,45790689,1395,0.6347805680448895
17475,1526.357333,1526.391667,1,45790719,45791750,1031,0.2345261446222402
17476,1526.408967,1526.414833,1,45792269,45792444,175,0.7354028108772172
17477,1526.431833,1526.437067,1,45792954,45793112,158,0.9590694683969547
17478,1526.441667,1526.519,1,45793250,45795570,2320,0.4139766023382643
17479,1526.5262,1526.530967,1,45795786,45795929,143,0.8899025161002143
17480,1527.032367,1527.057867,1,45810971,45811736,765,0.35047725630475973
17481,1527.067367,1527.070733,1,45812021,45812121,100,0.9571407062436826
17482,1527.0735,1527.077333,1,45812205,45812319,114,0.9060513944754731
17483,1527.0828,1527.1294,1,45812484,45813882,1398,0.3837066874366528
17484,1527.1418,1527.1454,1,45814254,45814362,108,0.7369056915806735
17485,1527.151133,1527.1614,1,45814533,45814842,309,0.6738891606707594
17486,1527.1702,1527.1777,1,45815106,45815331,225,0.7933064748014305
17487,1527.199367,1527.220533,1,45815981,45816615,634,0.4958754674873492
17488,1527.2271,1527.234333,1,45816813,45817029,216,0.11339913749670727
17489,1527.3073,1527.313767,1,45819219,45819413,194,0.9346014395615369
17490,1527.442033,1527.452367,1,45823260,45823571,311,0.7951962197915395
17491,1527.462267,1527.473133,1,45823868,45824193,325,-0.07552854208655162
17492,1527.578733,1527.583933,1,45827361,45827517,156,0.31381488457818857
17493,1528.104167,1528.107167,1,45843125,45843215,90,0.8553798369180325
17494,1528.108567,1528.111967,1,45843257,45843359,102,-0.23456920422159183
17495,1528.163967,1528.182367,1,45844919,45845471,552,0.1158893303104062
17496,1528.257867,1528.2623,1,45847736,45847869,133,0.046611201805821005
17497,1528.328067,1528.3311,1,45849842,45849933,91,0.8247481408886298
17498,1528.3396,1528.349867,1,45850188,45850496,308,-0.13144272061189805
17499,1528.355967,1528.3603,1,45850679,45850809,130,0.3954395254965939
17500,1528.4195,1528.544633,1,45852585,45856338,3753,0.3498800299559508
17501,1528.547633,1528.574367,1,45856428,45857231,803,0.2519482303078472
17502,1528.5767,1528.6333,1,45857301,45858999,1698,0.16894958070315635
17503,1528.6484,1528.657067,1,45859452,45859712,260,0.7815964923788936
17504,1528.663167,1528.695,1,45859895,45860850,955,0.22794486577955264
17505,1528.7203,1528.7241,1,45861609,45861723,114,0.9020589851301276
17506,1528.7268,1528.7529,1,45861804,45862587,783,0.31953603427812294
17507,1528.7549,1528.758467,1,45862647,45862754,107,0.13057444807537677
17508,1528.775133,1528.7782,1,45863253,45863346,93,0.6505854959785651
17509,1529.037767,1529.0412,1,45871133,45871236,103,0.2067845932088875
17510,1529.122367,1529.3387,1,45873671,45880161,6490,0.4086231523881075
17511,1529.3413,1529.3511,1,45880239,45880533,294,0.9114188528580288
17512,1529.3556,1529.360967,1,45880668,45880829,161,0.8199860091062774
17513,1529.363533,1529.3787,1,45880905,45881361,456,0.6767279579829945
17514,1529.3881,1529.449367,1,45881643,45883481,1838,0.32986864558365825
17515,1529.465433,1529.4796,1,45883962,45884388,426,0.4250416420519895
17516,1529.506133,1529.519,1,45885183,45885570,387,0.8001385789262762
17517,1529.523767,1529.527,1,45885713,45885810,97,0.9334501851709393
17518,1529.532233,1529.5476,1,45885966,45886428,462,0.8770151038928788
17519,1529.579267,1529.673533,1,45887378,45890205,2827,0.3360402239768573
17520,1529.674633,1529.678233,1,45890238,45890346,108,0.7041246479941458
17521,1529.894567,1530.126433,1,45896837,45903792,6955,0.2566862527410977
17522,1530.143967,1530.146967,1,45904319,45904409,90,0.9010555004251768
17523,1530.154233,1530.227267,1,45904626,45906818,2192,0.26138315764429404
17524,1530.228933,1530.268233,1,45906867,45908046,1179,0.29003148523433114
17525,1530.288367,1530.294533,1,45908651,45908835,184,0.9263729751260624
17526,1530.3019,1530.338467,1,45909057,45910154,1097,0.196944546590215
17527,1530.361,1530.369767,1,45910830,45911093,263,0.5827484439726599
17528,1530.371967,1530.392767,1,45911159,45911783,624,0.21774430456888022
17529,1530.394933,1530.413867,1,45911847,45912416,569,0.8428619688382991
17530,1530.436567,1530.439767,1,45913097,45913193,96,0.9413164851702684
17531,1530.4408,1530.4495,1,45913224,45913485,261,0.7812329392278097
17532,1530.4682,1530.561367,1,45914046,45916841,2795,0.2858376456893096
17533,1530.565067,1530.578867,1,45916952,45917366,414,0.7096406824651169
17534,1530.580033,1530.631767,1,45917400,45918953,1553,0.38914491881445523
17535,1530.633733,1530.637133,1,45919011,45919113,102,0.8634397192344603
17536,1530.6447,1530.6532,1,45919341,45919596,255,0.7692500558435115
17537,1530.657967,1530.6728,1,45919739,45920184,445,0.8712532331692578
17538,1530.778133,1530.7858,1,45923343,45923574,231,0.8550880491926656
17539,1530.8541,1530.9445,1,45925623,45928335,2712,0.2907957880282348
17540,1530.9456,1530.963567,1,45928368,45928907,539,0.6018894276335315
17541,1530.964567,1530.9873,1,45928937,45929619,682,0.40954229846830914
17542,1530.989933,1531.009233,1,45929697,45930276,579,0.8310453622248066
17543,1531.033867,1531.0403,1,45931016,45931209,193,0.9285400228116935
17544,1531.0525,1531.0558,1,45931575,45931674,99,0.8867943072276264
17545,1531.115233,1531.211967,1,45933456,45936359,2903,0.2482654274043398
17546,1531.216733,1531.244,1,45936501,45937320,819,0.4151588447838035
17547,1531.252933,1531.258167,1,45937587,45937745,158,0.8578932233383524
17548,1531.259767,1531.270833,1,45937793,45938124,331,0.8129234899550806
17549,1531.370333,1531.387567,1,45941109,45941627,518,0.1820593258512262
17550,1531.410767,1531.415867,1,45942323,45942476,153,0.6576151763344986
17551,1531.418633,1531.433833,1,45942558,45943014,456,0.17634973164371678
17552,1531.439233,1531.449633,1,45943176,45943488,312,0.8013155277042754
17553,1531.451833,1531.544633,1,45943554,45946338,2784,0.2634535886591995
17554,1531.5512,1531.585067,1,45946536,45947552,1016,0.469231839696293
17555,1531.5879,1531.6316,1,45947637,45948948,1311,0.42517459881091985
17556,1531.633533,1531.667867,1,45949005,45950036,1031,0.27359529308638597
17557,1531.668933,1531.693367,1,45950067,45950801,734,0.12915858243614553
17558,1531.694367,1531.7524,1,45950831,45952572,1741,0.29312576346939256
17559,1531.754067,1531.903033,1,45952622,45957090,4468,0.16500498990669657
17560,1531.9047,1531.9134,1,45957141,45957402,261,0.4976369374698057
17561,1531.9176,1531.9678,1,45957528,45959034,1506,0.24806327784425158
17562,1531.9936,1532.082667,1,45959808,45962480,2672,0.3969289609471066
17563,1532.085433,1532.127633,1,45962562,45963828,1266,0.5655440932835627
17564,1532.129267,1532.146533,1,45963878,45964395,517,0.7363806374970217
17565,1532.160767,1532.2337,1,45964823,45967011,2188,0.2040825279184552
17566,1532.249667,1532.2585,1,45967490,45967755,265,0.5495101364863803
17567,1532.260133,1532.276933,1,45967803,45968307,504,0.310950840225753
17568,1532.2797,1532.2838,1,45968391,45968514,123,0.7112959377139222
17569,1532.3249,1532.331033,1,45969747,45969930,183,0.8550345033726393
17570,1532.337567,1532.383567,1,45970127,45971507,1380,0.3849624545003003
17571,1532.395633,1532.419433,1,45971868,45972582,714,0.1278902402388621
17572,1532.456133,1532.460167,1,45973683,45973805,122,0.7817628120903084
17573,1532.461467,1532.621,1,45973844,45978630,4786,0.2728279176867094
17574,1532.624933,1532.7692,1,45978747,45983076,4329,0.1511418031957752
17575,1532.7759,1532.785533,1,45983277,45983565,288,0.6088410777257719
17576,1532.7886,1532.791833,1,45983658,45983754,96,0.9613701369174998
17577,1532.793133,1532.827467,1,45983793,45984824,1031,0.2743211092029766
17578,1532.8314,1532.874667,1,45984942,45986240,1298,0.32687212116002357
17579,1532.878133,1532.9264,1,45986343,45987792,1449,0.3567796814359508
17580,1532.933833,1532.946733,1,45988014,45988401,387,0.7591907220324985
17581,1532.953833,1533.124,1,45988614,45993720,5106,0.22595201262390582
17582,1533.125633,1533.179667,1,45993768,45995390,1622,0.49665221710526963
17583,1533.1813,1533.186567,1,45995439,45995597,158,0.7970721220983333
17584,1533.189933,1533.1936,1,45995697,45995808,111,0.8316633608197462
17585,1533.196367,1533.286033,1,45995891,45998580,2689,0.14060643347415755
17586,1533.293167,1533.327833,1,45998795,45999834,1039,0.17841020781328742
17587,1533.361467,1533.366367,1,46000844,46000991,147,0.7658292679453206
17588,1533.369,1533.411667,1,46001070,46002350,1280,0.15896012151954414
17589,1533.413667,1533.4617,1,46002410,46003851,1441,0.14311486719634045
17590,1533.4852,1533.4925,1,46004556,46004775,219,0.8631936073939056
17591,1533.499867,1533.532267,1,46004996,46005968,972,0.5945148151934442
17592,1533.5334,1533.539533,1,46006002,46006185,183,0.8456435721357377
17593,1533.5852,1533.591133,1,46007556,46007733,177,-0.00745134230740219
17594,1533.614267,1533.6212,1,46008428,46008636,208,0.7425755805276211
17595,1533.624967,1533.701267,1,46008749,46011038,2289,0.3544969329921887
17596,1533.7421,1533.792567,1,46012263,46013777,1514,0.4280756205318745
17597,1533.8414,1533.870567,1,46015242,46016117,875,0.7426870317591721
17598,1533.871767,1533.880467,1,46016153,46016414,261,0.9561331050647918
17599,1533.907467,1533.910767,1,46017224,46017323,99,0.873398434499179
17600,1533.927567,1533.931033,1,46017827,46017930,103,0.8151583501805799
17601,1533.939733,1533.945533,1,46018191,46018365,174,0.7581342217714886
17602,1533.970867,1534.015367,1,46019126,46020461,1335,0.5565752148556417
17603,1534.025833,1534.036167,1,46020774,46021085,311,0.7670635418764774
17604,1534.0491,1534.056867,1,46021473,46021706,233,0.9514497582207192
17605,1534.3379,1534.382667,1,46030137,46031480,1343,0.9144511550358193
17606,1534.399133,1534.419067,1,46031973,46032572,599,0.9739776548644578
17607,1534.4228,1534.436167,1,46032684,46033085,401,0.9216444285649766
17608,1534.443533,1534.4578,1,46033305,46033734,429,0.8628052049124869
17609,1534.459533,1534.479867,1,46033785,46034396,611,0.9521710064490302
17610,1534.482167,1534.521733,1,46034465,46035651,1186,0.8472078255616926
17611,1534.525933,1534.531633,1,46035777,46035948,171,0.8527612508778629
17612,1534.5333,1534.560367,1,46035999,46036811,812,0.2727388285718161
17613,1534.564367,1534.603467,1,46036931,46038104,1173,0.567445230206806
17614,1534.605067,1534.611267,1,46038152,46038338,186,0.9347815861782531
17615,1534.6209,1534.6408,1,46038627,46039224,597,0.8564369908025785
17616,1534.649533,1534.663767,1,46039485,46039913,428,0.7698164042083971
17617,1534.668433,1534.6984,1,46040052,46040952,900,0.6002520373374087
17618,1534.706,1534.757767,1,46041180,46042733,1553,0.6384419411796011
17619,1534.765767,1534.7785,1,46042973,46043355,382,0.714617337168034
17620,1534.786767,1534.8138,1,46043603,46044414,811,0.3099618872170196
17621,1534.821833,1534.830367,1,46044654,46044911,257,0.6897125258712397
17622,1534.831533,1534.8349,1,46044945,46045047,102,0.8151111462876112
17623,1534.886,1534.893567,1,46046580,46046807,227,0.8990169664757663
17624,1534.896867,1534.9012,1,46046906,46047036,130,0.14030922235817336
17625,1534.917133,1534.921033,1,46047513,46047630,117,0.27895704522185377
17626,1534.948033,1534.953833,1,46048440,46048614,174,0.05491052797355909
17627,1534.966833,1534.993533,1,46049004,46049805,801,0.40529939780430924
17628,1534.9954,1535.0232,1,46049862,46050696,834,0.6624476614161368
17629,1535.0732,1535.2193,1,46052196,46056579,4383,0.2650591718242281
17630,1535.226067,1535.237233,1,46056782,46057116,334,0.8408427372307404
17631,1535.2384,1535.259633,1,46057152,46057788,636,0.07654060251349021
17632,1535.2724,1535.320033,1,46058172,46059600,1428,0.2269590079991641
17633,1535.321633,1535.362233,1,46059648,46060866,1218,0.1933271249967323
17634,1535.3923,1535.397067,1,46061769,46061912,143,0.7146242048342083
17635,1535.406567,1535.4319,1,46062197,46062957,760,0.26599128449498244
17636,1535.434867,1535.450467,1,46063046,46063514,468,0.8869004591567852
17637,1535.469767,1535.4767,1,46064093,46064301,208,0.757756809034524
17638,1535.530833,1535.5544,1,46065924,46066632,708,0.8279086217437605
17639,1535.563567,1535.616567,1,46066907,46068497,1590,0.20030701389279212
17640,1535.626267,1535.6295,1,46068788,46068885,97,0.8992170337371761
17641,1535.652567,1535.658467,1,46069577,46069754,177,0.8507702541675489
17642,1536.1685,1536.199367,1,46085055,46085981,926,0.20827959826786754
17643,1536.203333,1536.289367,1,46086099,46088681,2582,0.2603944198457426
17644,1536.2906,1536.304267,1,46088718,46089128,410,0.8243613346169394
17645,1536.321067,1536.3552,1,46089632,46090656,1024,0.31815546131221084
17646,1536.358867,1536.4493,1,46090766,46093479,2713,0.1916271649419775
17647,1536.450733,1536.4785,1,46093521,46094355,834,0.31290393118089543
17648,1536.4816,1536.5094,1,46094448,46095282,834,0.26407758213374655
17649,1536.5111,1536.540167,1,46095333,46096205,872,0.014086834761046595
17650,1536.5444,1536.5752,1,46096332,46097256,924,0.44199887038214997
17651,1536.579033,1536.628033,1,46097370,46098840,1470,0.10938940841955125
17652,1536.951667,1536.9688,1,46108550,46109064,514,0.17470639527153464
17653,1537.135233,1537.138867,1,46114056,46114166,110,0.6475438762061254
17654,1537.160467,1537.168767,1,46114814,46115063,249,0.24669742193854446
17655,1537.191433,1537.1958,1,46115742,46115874,132,0.6821736955127597
17656,1537.201533,1537.2132,1,46116045,46116396,351,0.0959564558687168
17657,1538.3368,1538.347667,1,46150104,46150430,326,0.4625366466104766
17658,1538.3506,1538.359733,1,46150518,46150791,273,0.3858368547662563
17659,1538.3698,1538.377133,1,46151094,46151313,219,0.04977758249463668
17660,1538.3858,1538.426833,1,46151574,46152804,1230,0.20604340884088226
17661,1538.439533,1538.450433,1,46153185,46153512,327,0.21803241980878618
17662,1538.471067,1538.514933,1,46154132,46155447,1315,0.0661040386381265
17663,1538.521,1538.541767,1,46155630,46156253,623,0.6754951512225144
17664,1538.5557,1538.5662,1,46156671,46156986,315,0.7991598536366643
17665,1538.571767,1538.5784,1,46157153,46157352,199,0.7298168432202663
17666,1538.588433,1538.6007,1,46157652,46158021,369,0.58109728539071
17667,1538.761333,1538.766667,1,46162839,46163000,161,0.9229232071992493
17668,1538.767667,1538.787367,1,46163030,46163621,591,0.8569562605708931
17669,1538.788533,1538.867333,1,46163655,46166019,2364,0.4077085967031697
17670,1538.873967,1538.881967,1,46166219,46166459,240,0.564820974171728
17671,1538.885067,1538.9036,1,46166552,46167108,556,0.6590313308503682
17672,1538.907867,1538.997133,1,46167236,46169913,2677,0.11188635742325562
17673,1539.007967,1539.0116,1,46170239,46170348,109,0.8476942812678749
17674,1539.0205,1539.056133,1,46170615,46171683,1068,0.10370175447659628
17675,1539.068533,1539.080733,1,46172055,46172421,366,0.7542682896571501
17676,1539.085333,1539.0911,1,46172559,46172733,174,0.7477947533740888
17677,1539.092133,1539.096833,1,46172763,46172904,141,0.6665464107037931
17678,1539.098567,1539.140033,1,46172957,46174200,1243,0.32475828005131435
17679,1539.337833,1539.342667,1,46180134,46180280,146,0.9581499781193898
17680,1539.454133,1539.466733,1,46183623,46184001,378,0.6874282269106285
17681,1539.4689,1539.529767,1,46184067,46185893,1826,0.36458820094880945
17682,1539.533467,1539.5378,1,46186004,46186134,130,0.8982364599824088
17683,1539.538867,1539.557633,1,46186166,46186728,562,0.6990720122892299
17684,1539.5633,1539.576867,1,46186899,46187306,407,0.4089752171161206
17685,1539.577967,1539.5814,1,46187339,46187442,103,0.8985673214861349
17686,1539.586867,1539.601733,1,46187606,46188051,445,0.7345393118337581
17687,1539.606933,1539.6112,1,46188207,46188336,129,0.8859800405946966
17688,1540.0542,1540.139633,1,46201626,46204188,2562,0.37957851442274365
17689,1540.153367,1540.164333,1,46204601,46204929,328,0.42088534062110405
17690,1540.169067,1540.177233,1,46205072,46205316,244,0.621636372080705
17691,1540.1973,1540.207833,1,46205919,46206234,315,0.7703754879358226
17692,1540.2097,1540.2174,1,46206291,46206522,231,0.6929098395450818
17693,1540.249533,1540.416367,1,46207485,46212491,5006,0.4345814451819537
17694,1540.4195,1540.4542,1,46212585,46213626,1041,0.28869982904535574
17695,1540.4552,1540.4662,1,46213656,46213986,330,0.484966383064158
17696,1540.468267,1540.490333,1,46214048,46214709,661,0.15477319117787572
17697,1540.4944,1540.511067,1,46214832,46215332,500,0.9572890798341923
17698,1540.666233,1540.671067,1,46219986,46220132,146,0.9210280980816571
17699,1540.6724,1540.6927,1,46220172,46220781,609,0.8076024219808786
17700,1540.693967,1540.781167,1,46220819,46223435,2616,0.2839080630117342
17701,1540.782433,1540.855,1,46223472,46225650,2178,0.24501701170376125
17702,1540.856467,1540.952367,1,46225694,46228571,2877,0.17235147460998265
17703,1540.964567,1540.9732,1,46228937,46229196,259,0.36185787792646473
17704,1540.982233,1541.004567,1,46229466,46230137,671,0.8374361097318026
17705,1541.0059,1541.052967,1,46230177,46231589,1412,0.15860084761013374
17706,1541.055,1541.058867,1,46231650,46231766,116,0.7844888909142789
17707,1541.083467,1541.088733,1,46232504,46232661,157,0.7453234538592005
17708,1541.0964,1541.102467,1,46232892,46233074,182,0.8410650890732796
17709,1541.104133,1541.131433,1,46233123,46233942,819,0.6217445344546613
17710,1541.145767,1541.152267,1,46234373,46234568,195,0.8312598332486002
17711,1541.153867,1541.157967,1,46234616,46234739,123,0.5569970313908112
17712,1541.179433,1541.1826,1,46235382,46235478,96,0.7886051632040438
17713,1541.190067,1541.2054,1,46235702,46236162,460,0.38921922174356943
17714,1541.225433,1541.695133,1,46236762,46250853,14091,0.5851191815745699
17715,1541.699867,1541.8436,1,46250996,46255308,4312,0.6586484094689128
17716,1541.8446,1541.849667,1,46255338,46255490,152,0.9315365724288199
17717,1541.890467,1542.0379,1,46256714,46261137,4423,0.49591659773599495
17718,1542.047,1542.094067,1,46261410,46262822,1412,0.4083983884400383
17719,1542.105933,1542.109833,1,46263177,46263294,117,0.7935460783802417
17720,1542.120333,1542.171233,1,46263609,46265136,1527,0.3491767190158282
17721,1542.172567,1542.184333,1,46265177,46265529,352,0.5702841442857518
17722,1542.201733,1542.2377,1,46266051,46267131,1080,0.7311035228242114
17723,1542.248967,1542.264833,1,46267469,46267944,475,0.7931285156680691
17724,1542.285633,1542.292533,1,46268568,46268775,207,0.8545539800017289
17725,1542.2944,1542.388567,1,46268832,46271657,2825,0.26514026428120113
17726,1542.394233,1542.403233,1,46271826,46272096,270,0.22992762429046293
17727,1542.4133,1542.421733,1,46272399,46272651,252,0.31836344517347503
17728,1542.425933,1542.431467,1,46272777,46272944,167,0.647120156998488
17729,1542.5384,1542.550567,1,46276152,46276517,365,0.6380810621649692
17730,1542.5612,1542.5775,1,46276836,46277325,489,0.46765460772528716
17731,1542.578767,1542.5842,1,46277363,46277526,163,0.2700933255323404
17732,1542.594133,1542.605067,1,46277823,46278152,329,0.20251683668875342
17733,1542.622567,1542.626033,1,46278677,46278780,103,0.9091334350059012
17734,1542.627967,1542.664667,1,46278839,46279940,1101,0.3155644644259105
17735,1542.666533,1542.6718,1,46279995,46280154,159,0.6054710026833118
17736,1542.700233,1542.705467,1,46281006,46281164,158,0.1028754294618736
17737,1542.716333,1542.720833,1,46281489,46281624,135,0.7338791963589407
17738,1542.7449,1542.751267,1,46282347,46282538,191,0.8843895323805141
17739,1543.208233,1543.213867,1,46296246,46296416,170,0.9139790733914738
17740,1543.216033,1543.221467,1,46296480,46296644,164,0.8346651095127684
17741,1543.2269,1543.232633,1,46296807,46296978,171,0.718913258274254
17742,1543.256033,1543.260867,1,46297680,46297826,146,0.7494180016277502
17743,1543.2828,1543.287,1,46298484,46298610,126,0.17573594289193342
17744,1543.290567,1543.294033,1,46298717,46298820,103,0.9011764415337196
17745,1543.474467,1543.563033,1,46304234,46306890,2656,0.47247778668404133
17746,1543.564933,1543.575433,1,46306947,46307262,315,0.7526783015232203
17747,1543.583867,1543.5875,1,46307516,46307625,109,0.8718096534293824
17748,1543.588633,1543.603267,1,46307658,46308098,440,0.8236436779305624
17749,1543.6096,1543.6289,1,46308288,46308867,579,0.27131618605560964
17750,1543.63,1543.6692,1,46308900,46310076,1176,0.25746440988789154
17751,1543.679533,1543.6856,1,46310385,46310568,183,0.7724607751242264
17752,1543.902033,1544.0287,1,46317060,46320861,3801,0.39238253349556257
17753,1544.055933,1544.0809,1,46321677,46322427,750,0.4501931446412797
17754,1544.082633,1544.0862,1,46322478,46322586,108,0.8835970965637776
17755,1544.0898,1544.099333,1,46322694,46322979,285,0.7239005052570131
17756,1544.1065,1544.122067,1,46323195,46323662,467,0.7859860890011447
17757,1544.1385,1544.153233,1,46324155,46324596,441,0.8154718497695254
17758,1544.154733,1544.1719,1,46324641,46325157,516,0.8784547679076141
17759,1544.183733,1544.245067,1,46325511,46327352,1841,0.3914922752847416
17760,1544.2677,1544.273933,1,46328031,46328217,186,0.5880797940636052
17761,1544.277333,1544.322133,1,46328319,46329663,1344,0.23588133291336447
17762,1544.353133,1544.361567,1,46330593,46330847,254,0.26314543090803955
17763,1544.370633,1544.376233,1,46331118,46331286,168,0.46944742110959947
17764,1544.398133,1544.4045,1,46331943,46332135,192,0.37151224028215163
17765,1544.406067,1544.416767,1,46332182,46332503,321,0.32141311748021273
17766,1544.417933,1544.443167,1,46332537,46333295,758,0.3898847858827257
17767,1544.444733,1544.493267,1,46333341,46334798,1457,0.37138359655630654
17768,1544.4983,1544.5054,1,46334949,46335162,213,0.4636383016149603
17769,1544.513867,1544.5384,1,46335416,46336152,736,0.34083429723260134
17770,1544.5422,1544.6229,1,46336266,46338687,2421,0.21454352008547153
17771,1544.624467,1544.636133,1,46338734,46339083,349,0.8377680115934696
17772,1544.640967,1544.765667,1,46339229,46342970,3741,0.29175090618171895
17773,1544.770167,1544.926433,1,46343105,46347792,4687,0.22324878244465252
17774,1544.930967,1544.966767,1,46347929,46349003,1074,0.3433516828873284
17775,1544.9703,1544.976433,1,46349109,46349292,183,0.8788258678199886
17776,1544.977667,1545.016933,1,46349330,46350507,1177,0.4248363736671933
17777,1545.0667,1545.074067,1,46352001,46352222,221,0.7826181017858487
17778,1545.088033,1545.0956,1,46352640,46352868,228,0.04897610276634555
17779,1545.118933,1545.1292,1,46353567,46353876,309,0.8284613135273702
17780,1545.2706,1545.280467,1,46358118,46358414,296,0.6012738853516927
17781,1545.2916,1545.304633,1,46358748,46359138,390,0.7320440650203538
17782,1545.305833,1545.3208,1,46359174,46359624,450,0.3414092641637703
17783,1545.3223,1545.339,1,46359669,46360170,501,0.6697524522170034
17784,1545.340033,1545.3639,1,46360200,46360917,717,0.30738713050524236
17785,1545.4218,1545.441333,1,46362654,46363239,585,0.39557704966566726
17786,1545.443267,1545.463467,1,46363298,46363904,606,0.46152799307574327
17787,1545.4664,1545.471333,1,46363992,46364139,147,0.8216782431217694
17788,1545.475567,1545.485333,1,46364267,46364559,292,0.3038732249531132
17789,1545.489467,1545.4995,1,46364684,46364985,301,0.9571783013523198
17790,1545.5317,1545.535733,1,46365951,46366071,120,0.7672635219964429
17791,1545.537167,1545.6843,1,46366115,46370529,4414,0.4250181901869711
17792,1545.693767,1545.698967,1,46370813,46370969,156,0.8451855508659805
17793,1545.705,1545.7366,1,46371150,46372098,948,0.34004808182352836
17794,1545.753133,1545.805367,1,46372593,46374161,1568,0.4227723294966241
17795,1545.8114,1545.8163,1,46374342,46374489,147,0.5583459022168499
17796,1545.818567,1545.913633,1,46374557,46377408,2851,0.06779843183594164
17797,1545.925267,1545.959133,1,46377758,46378773,1015,0.22739711630285261
17798,1545.9616,1545.9962,1,46378848,46379886,1038,0.6231755719404686
17799,1546.021433,1546.029,1,46380642,46380870,228,0.40854365481828936
17800,1546.032767,1546.135833,1,46380983,46384074,3091,0.2503835196968542
17801,1546.1629,1546.167633,1,46384887,46385028,141,0.8776009812452765
17802,1546.168667,1546.174,1,46385060,46385220,160,0.8891204688011259
17803,1546.599967,1546.610633,1,46397999,46398318,319,0.7944045403733203
17804,1546.6179,1546.6234,1,46398537,46398702,165,0.9284700365983592
17805,1546.6353,1546.6813,1,46399059,46400439,1380,0.3427327973495102
17806,1546.6902,1546.7525,1,46400706,46402575,1869,0.26693725302912413
17807,1546.755967,1546.786733,1,46402679,46403601,922,0.3824492404111139
17808,1546.811,1546.815733,1,46404330,46404471,141,0.7693348403789454
17809,1546.819233,1546.823867,1,46404576,46404716,140,0.8731774577428989
17810,1546.8502,1546.8632,1,46405506,46405896,390,0.8927755915111246
17811,1546.999767,1547.002767,1,46409993,46410083,90,0.8967767906163053
17812,1547.243667,1547.2505,1,46417310,46417515,205,0.8910382729366167
17813,1547.280667,1547.316233,1,46418420,46419486,1066,0.31831898302209394
17814,1547.333533,1547.337633,1,46420005,46420128,123,0.9217378745493516
17815,1547.357767,1547.367267,1,46420733,46421018,285,0.9699127739887617
17816,1547.898467,1548.015767,1,46436954,46440473,3519,0.3252711986839426
17817,1548.032333,1548.044633,1,46440969,46441338,369,0.4177769490313044
17818,1548.046867,1548.057333,1,46441406,46441719,313,0.10786175749131167
17819,1548.076233,1548.08,1,46442286,46442400,114,0.8046606915393961
17820,1548.101367,1548.1108,1,46443041,46443324,283,0.8628924174414915
17821,1548.150467,1548.1583,1,46444514,46444749,235,0.4083994708766799
17822,1548.1802,1548.3022,1,46445406,46449066,3660,0.28928626781158295
17823,1548.3044,1548.327567,1,46449132,46449827,695,0.7466874869453584
17824,1548.3295,1548.3646,1,46449885,46450938,1053,0.3054092972621916
17825,1548.3684,1548.398333,1,46451052,46451949,897,0.2685260924845166
17826,1548.399933,1548.403933,1,46451997,46452117,120,0.7764933552659782
17827,1548.408333,1548.4152,1,46452249,46452456,207,0.7408478389716872
17828,1548.419133,1548.445233,1,46452573,46453356,783,0.061269087484195725
17829,1548.448033,1548.4729,1,46453440,46454187,747,0.8117596988355757
17830,1548.479467,1548.4877,1,46454384,46454631,247,0.30818249611668447
17831,1548.571133,1548.597533,1,46457133,46457925,792,0.5230758177870719
17832,1548.757,1548.875933,1,46462710,46466277,3567,0.10257684476760996
17833,1548.883567,1549.0046,1,46466507,46470138,3631,0.4647285578034579
17834,1549.005467,1549.017833,1,46470164,46470534,370,0.8842704168865719
17835,1549.019033,1549.032833,1,46470570,46470984,414,0.9712880524107348
17836,1549.0445,1549.047867,1,46471335,46471436,101,0.9113529580947043
17837,1549.048967,1549.052567,1,46471469,46471577,108,0.9333196399353763
17838,1549.061867,1549.065267,1,46471856,46471958,102,0.9702413685058957
17839,1549.0727,1549.385,1,46472181,46481550,9369,0.5900704676389873
17840,1549.3872,1549.4095,1,46481616,46482285,669,0.9080070227240725
17841,1549.4106,1549.452233,1,46482318,46483566,1248,0.8387818773945674
17842,1549.4533,1549.460833,1,46483599,46483824,225,0.9659068935361458
17843,1549.463633,1549.490333,1,46483908,46484709,801,0.9236789993574372
17844,1549.4951,1549.6112,1,46484853,46488336,3483,0.4989269219734265
17845,1549.616567,1549.6521,1,46488497,46489563,1066,0.12968696388041748
17846,1549.656267,1549.7298,1,46489688,46491894,2206,0.5977419853603457
17847,1549.734633,1549.747,1,46492038,46492410,372,0.32541280379778653
17848,1549.7538,1549.768767,1,46492614,46493063,449,0.7603213371909501
17849,1549.780233,1549.785933,1,46493406,46493577,171,0.8226988652479112
17850,1549.823033,1549.827133,1,46494690,46494813,123,0.7834956762156607
17851,1549.902367,1549.9122,1,46497071,46497366,295,0.9123406086313536
17852,1549.9151,1549.920467,1,46497453,46497614,161,0.9771487283875666
17853,1549.9461,1549.951067,1,46498383,46498532,149,0.8677923079621198
17854,1549.965767,1550.0176,1,46498973,46500528,1555,0.35355513068719
17855,1550.020833,1550.0363,1,46500624,46501089,465,0.7342915450712806
17856,1550.038467,1550.0437,1,46501154,46501311,157,0.8518084349629269
17857,1550.046467,1550.059133,1,46501394,46501773,379,0.829643721267068
17858,1550.066967,1550.0871,1,46502009,46502613,604,0.7913168370937351
17859,1550.1489,1550.152633,1,46504467,46504578,111,0.9375456871151335
17860,1550.1706,1550.1931,1,46505118,46505793,675,0.8564841440371398
17861,1550.207667,1550.255167,1,46506230,46507655,1425,0.3193983336789268
17862,1550.262167,1550.268933,1,46507865,46508067,202,0.8840353610443152
17863,1550.270767,1550.290467,1,46508123,46508714,591,0.5953908006628416
17864,1550.361433,1550.368,1,46510842,46511040,198,0.9476720859613522
17865,1550.429633,1550.4408,1,46512888,46513224,336,0.8826624996974475
17866,1550.4435,1550.4486,1,46513305,46513458,153,0.8953659878251995
17867,1550.4646,1550.5278,1,46513938,46515834,1896,0.23666407738167286
17868,1550.557667,1550.665133,1,46516730,46519953,3223,0.14125219039880202
17869,1550.672167,1550.733267,1,46520165,46521998,1833,0.24285816953758935
17870,1550.7351,1550.7646,1,46522053,46522938,885,0.24771992992526237
17871,1550.7682,1550.779267,1,46523046,46523378,332,0.6332703678974078
17872,1550.7843,1550.829133,1,46523529,46524873,1344,0.16442533476931281
17873,1550.834833,1550.840567,1,46525044,46525217,173,-0.147510130774256
17874,1550.8421,1550.871433,1,46525263,46526142,879,0.2573663527518074
17875,1550.8737,1550.888133,1,46526211,46526643,432,0.6093210265147395
17876,1550.889767,1551.1063,1,46526693,46533189,6496,0.31414474641340334
17877,1551.137367,1551.155367,1,46534121,46534661,540,0.8390298802407188
17878,1551.167967,1551.175867,1,46535039,46535276,237,0.4429480706711372
17879,1551.189533,1551.196867,1,46535685,46535906,221,0.7356946954179016
17880,1551.209833,1551.217467,1,46536294,46536524,230,0.9393065559256364
17881,1551.227467,1551.236867,1,46536824,46537106,282,0.7218701652313764
17882,1551.2555,1551.2617,1,46537665,46537851,186,0.7453239791214942
17883,1551.266633,1551.271233,1,46537998,46538136,138,0.6162643367097689
17884,1551.3147,1551.378167,1,46539441,46541345,1904,0.19714908127320846
17885,1551.385,1551.403367,1,46541550,46542101,551,0.4792833754223302
17886,1551.4116,1551.439467,1,46542348,46543184,836,0.18492810335061236
17887,1551.444167,1551.447333,1,46543325,46543419,94,0.9489651272317903
17888,1551.4521,1551.4956,1,46543563,46544868,1305,0.3565423072862674
17889,1551.5051,1551.509033,1,46545153,46545270,117,0.707338169643231
17890,1551.510967,1551.559,1,46545329,46546770,1441,0.23845509015958027
17891,1551.569467,1551.572833,1,46547084,46547184,100,0.819941187129601
17892,1551.5853,1551.610033,1,46547559,46548300,741,0.18281558284703436
17893,1551.620033,1551.626133,1,46548600,46548783,183,0.5574590154508695
17894,1551.642467,1551.680433,1,46549274,46550412,1138,0.20682385799811753
17895,1551.6847,1551.689933,1,46550541,46550697,156,0.6854106558367402
17896,1551.718167,1551.723867,1,46551545,46551716,171,0.6423366911045917
17897,1551.7252,1551.742233,1,46551756,46552266,510,0.3944727999003969
17898,1551.750467,1551.755933,1,46552514,46552677,163,0.9103679901130854
17899,1551.757067,1551.760367,1,46552712,46552811,99,0.9568645206718006
17900,1551.771567,1551.776533,1,46553147,46553295,148,0.8671545982241007
17901,1551.8457,1551.851433,1,46555371,46555542,171,0.5924223416986798
17902,1551.880733,1551.914567,1,46556421,46557437,1016,0.5029973568112984
17903,1551.917233,1551.9241,1,46557516,46557723,207,0.28431018869667934
17904,1551.9292,1551.932333,1,46557876,46557969,93,0.9419233484312208
17905,1551.934633,1551.977067,1,46558038,46559312,1274,0.2972597432036664
17906,1551.994367,1552.0012,1,46559831,46560036,205,0.6303905836985481
17907,1552.0192,1552.0328,1,46560576,46560984,408,0.26436200426645506
17908,1552.0345,1552.061033,1,46561035,46561830,795,0.22692891074062357
17909,1552.063833,1552.071367,1,46561914,46562141,227,0.8848839728422886
17910,1552.082067,1552.103533,1,46562462,46563105,643,0.15180612792089448
17911,1552.108533,1552.1544,1,46563255,46564632,1377,0.26610715504223603
17912,1552.176433,1552.181167,1,46565292,46565435,143,0.9411157951250243
17913,1552.189267,1552.1932,1,46565678,46565796,118,0.6694128956484551
17914,1552.289,1552.295433,1,46568670,46568862,192,0.421787187465615
17915,1552.340333,1552.351933,1,46570209,46570557,348,0.4125003821910457
17916,1552.363267,1552.367633,1,46570898,46571028,130,0.5736270553776202
17917,1552.396333,1552.413967,1,46571889,46572419,530,0.14966860227967377
17918,1552.693833,1552.697633,1,46580814,46580928,114,0.7081177106613131
17919,1552.699,1552.7094,1,46580970,46581282,312,0.744799465902573
17920,1552.844433,1552.876233,1,46585332,46586286,954,0.6427745370005674
17921,1552.911733,1552.9206,1,46587351,46587618,267,0.9237344259385492
17922,1552.926933,1552.935633,1,46587807,46588068,261,0.7554409495893907
17923,1552.951167,1552.9637,1,46588535,46588911,376,0.8716600798353404
17924,1552.967467,1552.9912,1,46589024,46589736,712,0.9499043093470378
17925,1553.0045,1553.0248,1,46590135,46590744,609,0.03263212642218657
17926,1553.0291,1553.043533,1,46590873,46591305,432,0.25987377862132793
17927,1553.061767,1553.089333,1,46591853,46592679,826,0.023447246760126807
17928,1553.1082,1553.121733,1,46593246,46593651,405,0.8718562252052664
17929,1553.129033,1553.1328,1,46593870,46593984,114,0.7034653548992804
17930,1553.147433,1553.1584,1,46594422,46594752,330,0.691873127317879
17931,1553.161933,1553.172467,1,46594857,46595174,317,0.41803981914213173
17932,1553.174433,1553.179567,1,46595232,46595387,155,0.3525953077964078
17933,1553.182533,1553.202767,1,46595475,46596083,608,0.8434934220310061
17934,1553.204333,1553.217467,1,46596129,46596524,395,0.7352930160386244
17935,1553.2244,1553.2401,1,46596732,46597203,471,0.4043904197750777
17936,1553.246267,1553.250367,1,46597388,46597511,123,0.9538881335204903
17937,1553.253467,1553.2822,1,46597604,46598466,862,0.7672917139702927
17938,1553.295333,1553.326,1,46598859,46599780,921,0.46441371806581955
17939,1553.327033,1553.3313,1,46599810,46599939,129,0.0441004152744482
17940,1553.332367,1553.346033,1,46599971,46600380,409,0.7409843814092888
17941,1553.3942,1553.3973,1,46601826,46601919,93,-0.04981526512516562
17942,1553.3991,1553.432233,1,46601973,46602966,993,0.7997406214761286
17943,1553.433667,1553.461267,1,46603010,46603838,828,0.39330657626779936
17944,1553.550667,1553.6146,1,46606520,46608438,1918,0.5959582092415382
17945,1553.6222,1553.6295,1,46608666,46608885,219,0.8706553424979029
17946,1553.631433,1553.637067,1,46608942,46609112,170,0.6568858789578946
17947,1553.647033,1553.654767,1,46609410,46609643,233,0.9396407103275639
17948,1553.665533,1553.708233,1,46609965,46611246,1281,0.41679081187600076
17949,1553.713067,1553.7377,1,46611392,46612131,739,0.5501731956009621
17950,1553.7554,1553.7944,1,46612662,46613832,1170,0.4360108328443278
17951,1553.849433,1553.854067,1,46615482,46615622,140,0.7107248815955367
17952,1553.8571,1553.8673,1,46615713,46616019,306,-0.05235253844905931
17953,1553.879667,1553.899367,1,46616390,46616981,591,0.5965088104711704
17954,1553.9117,1553.937933,1,46617351,46618137,786,0.7018151669291441
17955,1553.940767,1553.943833,1,46618223,46618314,91,0.2526775527587844
17956,1553.944933,1553.9577,1,46618347,46618731,384,0.6896796999433339
17957,1553.9589,1553.982667,1,46618767,46619480,713,0.525803485056574
17958,1553.988333,1553.995733,1,46619649,46619871,222,0.7598594662652577
17959,1553.997133,1554.010433,1,46619913,46620312,399,0.609269095990364
17960,1554.012933,1554.0208,1,46620387,46620624,237,0.777987593203227
17961,1554.045833,1554.053467,1,46621374,46621604,230,0.8900080812425936
17962,1554.055567,1554.078567,1,46621667,46622357,690,0.5004385822773892
17963,1554.087367,1554.129233,1,46622621,46623876,1255,0.5797009982666125
17964,1554.1308,1554.1399,1,46623924,46624197,273,0.6129170133653878
17965,1554.1444,1554.1711,1,46624332,46625133,801,0.7212770529878877
17966,1554.172667,1554.193867,1,46625180,46625816,636,0.6611221039815838
17967,1554.213833,1554.231167,1,46626414,46626935,521,0.39331590424992763
17968,1554.278233,1554.2824,1,46628346,46628472,126,0.44773626904532116
17969,1556.165,1556.172267,1,46684950,46685168,218,0.8991099974904087
17970,1556.1894,1556.1941,1,46685682,46685823,141,0.8206127762937645
17971,1556.195267,1556.2087,1,46685858,46686261,403,0.5088783379552588
17972,1556.2165,1556.256433,1,46686495,46687692,1197,0.1695135876160396
17973,1556.262867,1556.276367,1,46687886,46688291,405,0.6758063479545344
17974,1556.285233,1556.288233,1,46688556,46688646,90,0.8467121381647852
17975,1556.290133,1556.3963,1,46688703,46691889,3186,0.3184757410234313
17976,1556.3974,1556.445133,1,46691922,46693353,1431,0.6372862290971778
17977,1556.449633,1556.4915,1,46693488,46694745,1257,0.23191847405913654
17978,1556.518467,1556.538367,1,46695554,46696151,597,0.2046559603021043
17979,1556.555067,1556.579833,1,46696652,46697394,742,0.7649469658600256
17980,1556.5849,1556.6749,1,46697547,46700247,2700,0.8509013153939611
17981,1556.676033,1556.974567,1,46700280,46709237,8957,0.37875947639904395
17982,1556.975967,1556.9822,1,46709279,46709466,187,0.881437525249901
17983,1556.9912,1556.994967,1,46709736,46709849,113,0.8440950529091359
17984,1556.996267,1557.0383,1,46709888,46711149,1261,0.8235449192407456
17985,1557.039633,1557.116767,1,46711188,46713503,2315,0.626185345912217
17986,1557.1325,1557.141367,1,46713975,46714241,266,0.5926763200918815
17987,1557.171733,1557.1759,1,46715151,46715277,126,0.8102578834717792
17988,1557.184467,1557.2071,1,46715534,46716213,679,0.23914644879547395
17989,1557.209533,1557.2941,1,46716285,46718823,2538,0.6328974257018068
17990,1557.3152,1557.3305,1,46719456,46719915,459,0.7033032396002996
17991,1557.332367,1557.339033,1,46719971,46720170,199,0.9404665170112829
17992,1557.3634,1557.372467,1,46720902,46721174,272,0.7029875809300077
17993,1557.376533,1557.379867,1,46721295,46721396,101,0.9620064935720292
17994,1557.386233,1557.430867,1,46721586,46722926,1340,0.6264267602877311
17995,1557.458533,1557.6118,1,46723755,46728354,4599,0.6450859871526797
17996,1557.6128,1557.686533,1,46728384,46730595,2211,0.7132748670561275
17997,1557.695033,1557.719033,1,46730850,46731570,720,0.8483676571756485
17998,1557.7336,1557.807167,1,46732008,46734215,2207,0.7456164134480643
17999,1557.8093,1557.822467,1,46734279,46734674,395,0.6699204640867121
18000,1557.9319,1557.9956,1,46737957,46739868,1911,0.35436368487677306
18001,1558.012067,1558.0247,1,46740362,46740741,379,0.329472778963774
18002,1558.0613,1558.0679,1,46741839,46742037,198,0.8522203074899086
18003,1558.1967,1558.199967,1,46745901,46745999,98,0.7452104008973317
18004,1558.2074,1558.262133,1,46746222,46747863,1641,0.8528157467311853
18005,1558.264833,1558.2726,1,46747944,46748178,234,0.7633992129100643
18006,1558.495667,1558.4997,1,46754870,46754991,121,0.7935333270565987
18007,1558.508967,1558.556133,1,46755269,46756683,1414,0.7454929900584728
18008,1558.558167,1558.664833,1,46756745,46759944,3199,0.5200095364629722
18009,1558.670233,1558.675133,1,46760106,46760253,147,0.7735672614614753
18010,1558.718467,1558.723333,1,46761554,46761699,145,0.7545866803655535
18011,1558.8549,1558.859367,1,46765647,46765781,134,0.4778677303310694
18012,1559.3256,1559.330467,1,46779768,46779914,146,0.9798283350800485
18013,1559.4945,1559.5052,1,46784835,46785156,321,0.5629656149578839
18014,1559.511767,1559.518367,1,46785353,46785551,198,0.3544895713617398
18015,1559.519833,1559.5274,1,46785594,46785822,228,0.8120993749857018
18016,1559.531133,1559.535267,1,46785933,46786058,125,0.9432037974254157
18017,1559.5563,1559.560833,1,46786689,46786824,135,0.6273152142421655
18018,1559.675633,1559.679633,1,46790268,46790388,120,-0.3575482429428929
18019,1559.687933,1559.6921,1,46790637,46790763,126,0.8548634978746157
18020,1559.699867,1559.729933,1,46790996,46791897,901,0.8355219839913652
18021,1559.9554,1559.9998,1,46798662,46799994,1332,0.5817942607847693
18022,1560.001933,1560.055,1,46800057,46801650,1593,0.42076527767240696
18023,1560.0813,1560.087333,1,46802439,46802619,180,0.7748219298862709
18024,1560.567133,1560.5705,1,46817013,46817115,102,0.6378750230279137
18025,1561.183467,1561.188067,1,46835504,46835642,138,0.825530391349414
18026,1561.232667,1561.2953,1,46836980,46838859,1879,0.21526913707793877
18027,1561.4818,1561.489167,1,46844454,46844675,221,0.7975615601488008
18028,1561.490433,1561.515867,1,46844712,46845476,764,0.6132569847235073
18029,1561.523733,1561.545967,1,46845711,46846379,668,0.25040544292641753
18030,1561.552933,1561.5605,1,46846587,46846815,228,0.8586619099734456
18031,1561.566867,1561.589,1,46847006,46847670,664,0.5804905341334848
18032,1561.592167,1561.5967,1,46847765,46847901,136,0.84433588728485
18033,1561.605967,1561.610933,1,46848179,46848327,148,0.8730065170427058
18034,1561.617767,1561.628667,1,46848533,46848860,327,0.44675761430529154
18035,1561.631933,1561.6394,1,46848957,46849182,225,0.6992615954988533
18036,1561.6463,1561.659333,1,46849389,46849779,390,0.6915021549991126
18037,1561.6627,1561.6659,1,46849881,46849977,96,0.8465615408938886
18038,1561.6902,1561.694467,1,46850706,46850834,128,0.821953323771592
18039,1561.696733,1561.7951,1,46850901,46853853,2952,0.4157019822469592
18040,1561.798267,1562.0284,1,46853948,46860852,6904,0.5784207378039529
18041,1562.112067,1562.118567,1,46863362,46863557,195,0.6640387497785708
18042,1563.027833,1563.040167,1,46890834,46891205,371,0.35222518125447805
18043,1563.0431,1563.058767,1,46891293,46891763,470,0.7521797141018735
18044,1563.06,1563.079333,1,46891800,46892379,579,0.7875481238544836
18045,1563.100133,1563.1152,1,46893003,46893456,453,0.7340571765957824
18046,1563.1402,1563.148967,1,46894206,46894469,263,0.8485656412099933
18047,1563.150033,1563.159267,1,46894500,46894778,278,0.935346397877983
18048,1563.188267,1563.217767,1,46895648,46896533,885,0.7760523208319156
18049,1563.251533,1563.302,1,46897545,46899060,1515,0.8342822766282364
18050,1563.367767,1563.4087,1,46901033,46902261,1228,0.7628392985056867
18051,1563.41,1563.419767,1,46902300,46902593,293,0.9323531821863819
18052,1563.459767,1563.464833,1,46903793,46903944,151,0.7860602073767752
18053,1563.477933,1563.481,1,46904337,46904430,93,0.7296881741217454
18054,1563.497533,1563.502233,1,46904925,46905066,141,0.7911580014735583
18055,1563.503233,1563.518133,1,46905096,46905543,447,0.6281482469129529
18056,1563.5195,1563.562567,1,46905585,46906877,1292,0.6599689723568414
18057,1563.565733,1563.572767,1,46906971,46907183,212,0.8757205111654972
18058,1563.5738,1563.591733,1,46907214,46907751,537,0.7963092535013704
18059,1563.593333,1563.604733,1,46907799,46908141,342,0.846606531771049
18060,1563.6065,1563.6095,1,46908195,46908285,90,0.905317127117166
18061,1563.623,1563.629167,1,46908690,46908875,185,-0.11152407130603918
18062,1563.6303,1563.662867,1,46908909,46909886,977,0.3551865387219745
18063,1563.6651,1563.673933,1,46909953,46910217,264,0.18660508537777476
18064,1563.676633,1563.682767,1,46910298,46910483,185,0.4239784074764701
18065,1563.693133,1563.704433,1,46910793,46911132,339,-0.0883134977443424
18066,1563.736167,1563.755933,1,46912085,46912677,592,0.33825517917817016
18067,1563.808133,1563.819067,1,46914243,46914572,329,0.7924272759562039
18068,1563.831533,1563.839267,1,46914945,46915178,233,0.6815000650678747
18069,1563.8627,1563.866167,1,46915881,46915985,104,0.6595018524580482
18070,1563.885167,1563.8884,1,46916555,46916652,97,0.8985746438248658
18071,1563.89,1563.9041,1,46916700,46917123,423,0.34987902866273773
18072,1563.9288,1563.932967,1,46917864,46917989,125,0.9687126835275292
18073,1564.017867,1564.0222,1,46920536,46920666,130,0.9107737778910981
18074,1564.031567,1564.0461,1,46920947,46921383,436,0.85586300773242
18075,1564.0727,1564.0759,1,46922181,46922277,96,0.8392892564750563
18076,1564.077267,1564.0807,1,46922318,46922421,103,0.918005856508642
18077,1564.083067,1564.104067,1,46922492,46923122,630,0.920824440169091
18078,1564.123633,1564.127633,1,46923708,46923828,120,0.6926289475129213
18079,1564.658667,1564.686933,1,46939760,46940607,847,0.476108729022033
18080,1564.742,1564.745233,1,46942260,46942356,96,0.7725982905579055
18081,1564.754467,1564.757533,1,46942634,46942725,91,0.8386208448402726
18082,1564.759933,1564.768833,1,46942797,46943064,267,0.3449006164688917
18083,1564.7719,1564.775133,1,46943157,46943253,96,0.8231073245455724
18084,1564.779333,1564.7825,1,46943379,46943475,96,0.8599155479137035
18085,1564.784233,1564.7905,1,46943526,46943715,189,0.38770895780345943
18086,1564.791533,1564.8091,1,46943745,46944273,528,0.7107403287178998
18087,1564.810133,1564.841367,1,46944303,46945241,938,0.6164029594621915
18088,1564.858433,1564.865133,1,46945752,46945953,201,0.7687234202912517
18089,1564.896267,1564.9047,1,46946888,46947141,253,0.874766248834347
18090,1564.9062,1564.9117,1,46947186,46947351,165,0.9236704970189631
18091,1564.9127,1564.960267,1,46947381,46948808,1427,0.3070726589480715
18092,1565.687,1565.695367,1,46970610,46970861,251,0.8170481635195784
18093,1565.698067,1565.702,1,46970942,46971060,118,0.8293171724879349
18094,1565.7173,1565.724033,1,46971519,46971720,201,0.8939751942677253
18095,1565.818267,1565.822833,1,46974548,46974684,136,0.8604160382134985
18096,1565.8279,1565.845333,1,46974837,46975359,522,0.3779203680139141
18097,1565.872667,1565.876733,1,46976180,46976301,121,0.5608199076427751
18098,1565.879333,1565.886833,1,46976379,46976604,225,0.8176172555570089
18099,1565.923933,1565.927133,1,46977717,46977813,96,0.9703246916106164
18100,1565.957633,1565.962333,1,46978728,46978869,141,0.6186927643985869
18101,1566.0454,1566.0505,1,46981362,46981515,153,0.7599164018849476
18102,1566.0623,1566.065467,1,46981869,46981964,95,0.704841558374457
18103,1566.1163,1566.127167,1,46983489,46983815,326,0.161486248060663
18104,1566.176633,1566.1815,1,46985298,46985445,147,0.07412993227023007
18105,1566.190667,1566.206267,1,46985720,46986188,468,0.3300456392190864
18106,1566.2312,1566.235567,1,46986936,46987067,131,0.6834310671983175
18107,1566.352633,1566.356833,1,46990578,46990704,126,0.5384033308644626
18108,1566.418333,1566.423667,1,46992549,46992710,161,0.4821943231737693
18109,1566.8742,1566.8916,1,47006226,47006748,522,0.7209463477083086
18110,1567.0151,1567.086467,1,47010453,47012594,2141,0.179764774877593
18111,1567.087533,1567.103167,1,47012625,47013095,470,0.18685490725351278
18112,1567.1256,1567.129367,1,47013768,47013881,113,0.312762029531797
18113,1567.159867,1567.235567,1,47014796,47017067,2271,0.1983259457898084
18114,1567.2367,1567.268833,1,47017101,47018064,963,0.2604431749124551
18115,1567.3208,1567.3595,1,47019624,47020785,1161,0.41513150837683765
18116,1567.3626,1567.4073,1,47020878,47022219,1341,0.3041294614010643
18117,1567.480733,1567.4842,1,47024421,47024526,105,0.8910742615551129
18118,1567.4891,1567.5817,1,47024673,47027451,2778,0.23404459909271064
18119,1567.582967,1567.6116,1,47027489,47028348,859,0.06564661533042031
18120,1567.655933,1567.6955,1,47029677,47030865,1188,0.2872411994355179
18121,1567.701367,1567.707033,1,47031041,47031210,169,0.8334289125970104
18122,1567.7129,1567.7275,1,47031387,47031825,438,0.26642889211035836
18123,1567.7286,1567.746367,1,47031858,47032391,533,0.44126361538806924
18124,1567.747367,1567.7666,1,47032421,47032998,577,0.49681188118919406
18125,1567.767733,1567.7846,1,47033031,47033538,507,0.638059948370873
18126,1567.789167,1567.7983,1,47033675,47033949,274,0.38273571241860294
18127,1567.807667,1567.8518,1,47034230,47035554,1324,0.43129845646557785
18128,1567.863367,1567.921533,1,47035901,47037645,1744,0.25750377587728773
18129,1567.9249,1567.9651,1,47037747,47038953,1206,0.4588945510489898
18130,1567.9678,1567.977,1,47039034,47039310,276,0.09582778945239583
18131,1567.982333,1567.991367,1,47039469,47039741,272,0.9258182144492423
18132,1568.074833,1568.080967,1,47042244,47042429,185,0.793384937333591
18133,1568.7849,1568.8389,1,47063547,47065167,1620,0.12795476717144752
18134,1568.8484,1568.960733,1,47065452,47068821,3369,0.2399569176647919
18135,1568.9624,1568.998467,1,47068872,47069954,1082,0.43882241981740205
18136,1569.005833,1569.021467,1,47070174,47070644,470,-0.10492255306892273
18137,1569.0227,1569.087,1,47070681,47072610,1929,-0.1591463484911274
18138,1569.092533,1569.161533,1,47072775,47074845,2070,0.13983978377924874
18139,1569.168967,1569.182767,1,47075069,47075483,414,0.31342670783344234
18140,1569.184033,1569.202767,1,47075520,47076083,563,0.6505487475909638
18141,1569.207467,1569.236533,1,47076224,47077095,871,0.25382075789783
18142,1569.237733,1569.242667,1,47077131,47077280,149,0.7220541117460464
18143,1569.245967,1569.259667,1,47077379,47077790,411,0.37327573681363174
18144,1569.538,1569.551133,1,47086140,47086533,393,0.012807631883564024
18145,1569.552533,1569.568067,1,47086575,47087042,467,0.17512301268658503
18146,1569.573933,1569.651,1,47087217,47089530,2313,0.16243140470746548
18147,1569.658067,1569.661533,1,47089742,47089845,103,0.9349997789133092
18148,1569.6653,1569.691767,1,47089959,47090753,794,0.33467887926889034
18149,1569.7008,1569.703867,1,47091024,47091116,92,0.7938380277084114
18150,1569.7093,1569.729533,1,47091279,47091885,606,0.8535675044283582
18151,1569.730533,1569.735133,1,47091915,47092053,138,0.8455626986610123
18152,1569.7374,1569.743467,1,47092122,47092304,182,0.7581481162912532
18153,1569.748,1569.8353,1,47092440,47095059,2619,0.5488282973981446
18154,1569.837733,1569.852233,1,47095131,47095566,435,0.6422808716351416
18155,1569.8538,1569.8844,1,47095614,47096532,918,0.6513170849883629
18156,1569.885467,1570.1062,1,47096564,47103186,6622,0.16908115107653804
18157,1570.114,1570.266267,1,47103420,47107988,4568,0.672815526732755
18158,1570.307767,1570.313433,1,47109233,47109402,169,0.8470269099044269
18159,1570.315633,1570.453933,1,47109468,47113617,4149,0.7707144293461498
18160,1570.577967,1570.595033,1,47117339,47117850,511,0.2820889108780337
18161,1570.600833,1570.6765,1,47118024,47120295,2271,0.8285451913819246
18162,1570.680733,1570.688667,1,47120421,47120660,239,0.8838795094287644
18163,1570.694667,1570.717367,1,47120840,47121521,681,0.5979693424301423
18164,1570.7187,1570.729467,1,47121561,47121884,323,0.6487600981052162
18165,1570.731267,1570.746467,1,47121938,47122394,456,0.8756091418798264
18166,1570.747533,1570.7562,1,47122425,47122686,261,0.7942513790288475
18167,1570.784733,1570.787833,1,47123541,47123634,93,0.902290889945633
18168,1570.794667,1570.798567,1,47123840,47123957,117,0.8724960407830084
18169,1570.8077,1570.814333,1,47124231,47124429,198,0.8379550057091771
18170,1570.816133,1570.8359,1,47124483,47125077,594,0.8876516646339889
18171,1570.8376,1570.8481,1,47125128,47125443,315,0.7652714497706739
18172,1570.8524,1570.859533,1,47125572,47125785,213,0.5408758310715112
18173,1570.8607,1570.875133,1,47125821,47126253,432,0.8526112127762178
18174,1570.8763,1570.889267,1,47126289,47126678,389,0.6399398340929106
18175,1570.8905,1570.950967,1,47126715,47128529,1814,0.5475309825688943
18176,1570.9524,1570.962633,1,47128572,47128878,306,0.7866132644221459
18177,1570.963667,1570.994033,1,47128910,47129820,910,0.16754749591260484
18178,1570.998733,1571.0031,1,47129961,47130093,132,0.7640801239060577
18179,1571.0394,1571.042633,1,47131182,47131278,96,0.8772407653640675
18180,1572.3297,1572.388967,1,47169891,47171669,1778,0.31475300027969827
18181,1572.536667,1572.5404,1,47176100,47176212,112,0.8707043759860374
18182,1572.567133,1572.572533,1,47177013,47177175,162,0.7755126593362386
18183,1572.585767,1572.5897,1,47177573,47177691,118,0.7048043174053675
18184,1572.595533,1572.606333,1,47177865,47178189,324,0.5649849994086585
18185,1572.610033,1572.622133,1,47178300,47178663,363,0.2546330801245538
18186,1572.6292,1572.6326,1,47178876,47178978,102,0.7451797105038378
18187,1572.636533,1572.654767,1,47179095,47179643,548,0.4247054739687778
18188,1572.668533,1572.7403,1,47180055,47182209,2154,0.4643765768441556
18189,1572.839067,1572.842067,1,47185172,47185262,90,0.8152352174667736
18190,1572.858533,1572.8631,1,47185755,47185893,138,0.7179123915766098
18191,1573.681867,1573.8239,1,47210456,47214717,4261,0.41835412424277807
18192,1573.828167,1573.9187,1,47214845,47217561,2716,0.631608940086986
18193,1573.9203,1573.9263,1,47217609,47217789,180,0.9031627332410288
18194,1573.965533,1573.968967,1,47218965,47219069,104,0.8692867442229383
18195,1573.9904,1573.997733,1,47219712,47219931,219,0.7283717686235983
18196,1573.999267,1574.073967,1,47219978,47222219,2241,0.8130536367849471
18197,1574.0753,1574.088567,1,47222259,47222657,398,0.8568122063455816
18198,1574.098467,1574.105667,1,47222954,47223170,216,0.8481934450886369
18199,1574.112433,1574.117233,1,47223372,47223516,144,0.6327331422134564
18200,1574.121433,1574.124633,1,47223642,47223738,96,0.6191750413529855
18201,1574.520767,1574.540133,1,47235623,47236203,580,0.38597234809954756
18202,1574.5673,1574.6623,1,47237019,47239869,2850,0.5354500127705943
18203,1574.690167,1574.708533,1,47240705,47241255,550,0.6049130238034722
18204,1574.7109,1574.7681,1,47241327,47243043,1716,0.7419046714454238
18205,1575.017133,1575.031567,1,47250513,47250947,434,0.5720526181749783
18206,1575.0427,1575.074467,1,47251281,47252234,953,0.6346616457883473
18207,1575.076833,1575.099533,1,47252304,47252985,681,0.4449565717453566
18208,1575.100633,1575.1394,1,47253018,47254182,1164,0.5208013892076531
18209,1575.158133,1575.1907,1,47254743,47255721,978,0.519657825490677
18210,1575.2093,1575.2224,1,47256279,47256672,393,0.6841862931954641
18211,1575.226,1575.2303,1,47256780,47256909,129,0.8468650995384247
18212,1575.255,1575.263167,1,47257650,47257895,245,0.8351522730963684
18213,1575.2928,1575.297867,1,47258784,47258936,152,0.8535600672291664
18214,1575.310467,1575.314533,1,47259314,47259435,121,0.7837191577004747
18215,1575.331667,1575.337333,1,47259950,47260119,169,0.903078864625214
18216,1575.341533,1575.347467,1,47260245,47260424,179,0.9012272547157258
18217,1575.4886,1575.513667,1,47264658,47265410,752,0.49984639076827353
18218,1575.515267,1575.988067,1,47265458,47279642,14184,0.5347761735120427
18219,1575.995867,1576.000167,1,47279876,47280005,129,0.8776626116767144
18220,1576.009367,1576.013867,1,47280281,47280416,135,-0.37478223773166164
18221,1576.022,1576.026233,1,47280660,47280786,126,0.9248391930140549
18222,1576.0276,1576.031,1,47280828,47280930,102,0.8957824397199224
18223,1576.062367,1576.067967,1,47281871,47282039,168,0.8761059497168884
18224,1576.2875,1576.294867,1,47288625,47288846,221,0.25608425393803175
18225,1576.3249,1576.332333,1,47289747,47289969,222,0.07493935232430551
18226,1576.6943,1576.7069,1,47300829,47301207,378,0.6476933528044821
18227,1576.942767,1577.114867,1,47308283,47313446,5163,0.22117956937073785
18228,1577.115867,1577.196233,1,47313476,47315886,2410,0.2624440103249624
18229,1577.204667,1577.208867,1,47316140,47316266,126,0.7470919480037366
18230,1577.2099,1577.242467,1,47316297,47317274,977,0.30290820376849853
18231,1577.243833,1577.279433,1,47317314,47318382,1068,0.25667087823090123
18232,1577.2805,1577.2896,1,47318415,47318688,273,0.662417088395857
18233,1577.290667,1577.298133,1,47318720,47318943,223,0.6621058608537549
18234,1577.2994,1577.303567,1,47318982,47319107,125,0.3726966211409267
18235,1577.313067,1577.318033,1,47319392,47319540,148,0.7242037300556924
18236,1577.321167,1577.407067,1,47319635,47322212,2577,0.18196671582818683
18237,1577.4183,1577.423567,1,47322549,47322707,158,0.7297403366114988
18238,1577.4321,1577.450133,1,47322963,47323503,540,0.5682181952045852
18239,1577.457467,1577.535067,1,47323724,47326052,2328,0.2365222243381741
18240,1577.539333,1577.548467,1,47326179,47326454,275,0.853635690474923
18241,1577.5503,1577.562533,1,47326509,47326875,366,0.45491231386741454
18242,1577.567133,1577.621833,1,47327013,47328654,1641,0.5031142437728076
18243,1577.623567,1577.654167,1,47328707,47329625,918,0.31372144185164996
18244,1577.661467,1577.6856,1,47329844,47330568,724,0.3495384760431416
18245,1577.6893,1577.7286,1,47330679,47331858,1179,0.20599949724726885
18246,1577.731567,1577.743133,1,47331947,47332293,346,0.43973603251093507
18247,1577.757233,1577.768067,1,47332716,47333042,326,0.37395723680880816
18248,1577.769167,1577.791433,1,47333075,47333742,667,0.5353494060749706
18249,1577.7956,1577.833733,1,47333868,47335011,1143,0.18439337389537666
18250,1577.837733,1577.840933,1,47335131,47335227,96,-0.08972127596197799
18251,1577.899367,1577.9147,1,47336981,47337441,460,0.744351174030284
18252,1577.918267,1577.932867,1,47337548,47337986,438,0.8972116532781564
18253,1577.9446,1577.982067,1,47338338,47339462,1124,0.19577459313987597
18254,1578.014733,1578.0182,1,47340441,47340546,105,0.7938062177105955
18255,1578.0255,1578.0298,1,47340765,47340894,129,0.9180703523756015
18256,1578.0346,1578.0383,1,47341038,47341149,111,0.866919649290614
18257,1578.062333,1578.071467,1,47341869,47342144,275,0.24004729763611674
18258,1578.072633,1578.092,1,47342178,47342760,582,0.6983092512746671
18259,1578.1033,1578.1341,1,47343099,47344023,924,0.11696366034733248
18260,1578.140733,1578.149467,1,47344221,47344484,263,0.7269669341778344
18261,1578.1649,1578.170567,1,47344947,47345117,170,0.8285699366407004
18262,1578.203767,1578.2109,1,47346113,47346327,214,-0.013575160250736351
18263,1578.244467,1578.248667,1,47347334,47347460,126,0.3893051378903572
18264,1578.271333,1578.2744,1,47348139,47348232,93,0.9588471355726058
18265,1578.3119,1578.315333,1,47349357,47349459,102,0.8321993708540941
18266,1578.4865,1578.4914,1,47354595,47354742,147,0.6257476335889557
18267,1578.965967,1578.974033,1,47368979,47369220,241,0.7494189790736261
18268,1578.981233,1578.984667,1,47369436,47369540,104,0.9026980689616998
18269,1578.9881,1579.0252,1,47369643,47370756,1113,0.49064812300828836
18270,1579.032867,1579.072333,1,47370986,47372169,1183,0.5528609972068026
18271,1579.0785,1579.112967,1,47372355,47373389,1034,0.4042320466733686
18272,1579.130433,1579.149267,1,47373912,47374478,566,0.3329018909762861
18273,1579.16,1579.165467,1,47374800,47374964,164,0.6531778747967055
18274,1579.177333,1579.210733,1,47375319,47376321,1002,0.21595340455201015
18275,1579.295667,1579.300967,1,47378870,47379029,159,0.9612285415616447
18276,1580.019267,1580.0241,1,47400578,47400723,145,0.84194606205953
18277,1580.0367,1580.051867,1,47401101,47401556,455,0.2835212271018122
18278,1580.0644,1580.073967,1,47401932,47402219,287,0.2827824273029539
18279,1580.084167,1580.120333,1,47402525,47403609,1084,0.26947836513881707
18280,1580.162567,1580.179067,1,47404877,47405372,495,0.4217211243193336
18281,1580.1832,1580.196233,1,47405496,47405886,390,0.8551844891016638
18282,1580.1973,1580.2039,1,47405919,47406117,198,0.8466902275542163
18283,1580.231267,1580.251733,1,47406938,47407551,613,0.5174404413935095
18284,1580.551967,1580.5564,1,47416559,47416692,133,0.931306224650924
18285,1581.311867,1581.3181,1,47439356,47439543,187,0.6609609932840059
18286,1582.200233,1582.221067,1,47466006,47466632,626,0.30185745704069633
18287,1582.2391,1582.2815,1,47467173,47468445,1272,0.16466949046032514
18288,1582.293433,1582.3806,1,47468802,47471418,2616,0.12246687670877954
18289,1582.414033,1582.432033,1,47472420,47472960,540,0.5641775317543959
18290,1582.434267,1582.450167,1,47473028,47473505,477,0.565531448220415
18291,1582.4898,1582.5092,1,47474694,47475276,582,0.5938768414753829
18292,1582.515567,1582.5196,1,47475467,47475588,121,0.775183937448959
18293,1582.522367,1582.5454,1,47475671,47476362,691,0.6957597615908926
18294,1582.553067,1582.576,1,47476592,47477280,688,0.528257734748
18295,1582.577733,1582.616933,1,47477331,47478507,1176,0.5141371485797327
18296,1582.6204,1582.646333,1,47478612,47479389,777,0.15230472088897393
18297,1582.650633,1582.656367,1,47479518,47479691,173,0.9416693816156654
18298,1582.6574,1582.661933,1,47479722,47479857,135,0.8570467234994598
18299,1582.980667,1583.0472,1,47489420,47491416,1996,0.1927619893914903
18300,1583.0513,1583.108067,1,47491539,47493242,1703,0.20288209049352843
18301,1583.111267,1583.123433,1,47493338,47493702,364,0.8104455903259011
18302,1583.1357,1583.144033,1,47494071,47494320,249,0.8993139845029618
18303,1583.146333,1583.170433,1,47494389,47495112,723,0.5106896748581402
18304,1583.374433,1583.378033,1,47501232,47501340,108,0.8339615593421312
18305,1583.824667,1583.8295,1,47514740,47514885,145,0.7027201624538788
18306,1587.600433,1587.6044,1,47628012,47628132,120,0.8994039518906612
18307,1587.6062,1587.6152,1,47628186,47628456,270,0.868873758145486
18308,1587.9249,1587.933867,1,47637747,47638016,269,0.7055794208130904
18309,1587.9519,1587.956633,1,47638557,47638698,141,0.34966663431527034
18310,1588.0162,1588.073267,1,47640486,47642198,1712,0.11448916707819576
18311,1588.0781,1588.096833,1,47642343,47642904,561,0.6094147946079795
18312,1588.101367,1588.2305,1,47643041,47646915,3874,0.33388869483391376
18313,1588.2323,1588.263833,1,47646969,47647914,945,0.30760896176242464
18314,1588.2685,1588.3062,1,47648055,47649186,1131,0.6747110152058634
18315,1588.307367,1588.3389,1,47649221,47650167,946,0.4976379767846934
18316,1588.388333,1588.470067,1,47651649,47654102,2453,0.2991546265547471
18317,1588.4721,1588.5864,1,47654163,47657592,3429,0.3747011684162361
18318,1588.597267,1588.6155,1,47657918,47658465,547,0.4945882108682908
18319,1588.6513,1588.6899,1,47659539,47660697,1158,0.8072699019263561
18320,1588.6927,1588.710333,1,47660781,47661309,528,0.8796070916229118
18321,1588.711367,1588.717033,1,47661341,47661510,169,0.8982939752052842
18322,1588.735167,1588.7389,1,47662055,47662167,112,0.8955487385160444
18323,1588.779233,1588.7844,1,47663376,47663532,156,0.8153629888571703
18324,1588.787067,1588.8395,1,47663612,47665185,1573,0.8407082079088924
18325,1588.8428,1588.847067,1,47665284,47665412,128,0.9041385501795982
18326,1588.850467,1588.858767,1,47665514,47665763,249,0.9857768262669541
18327,1588.8745,1588.8845,1,47666235,47666535,300,0.8764241911064002
18328,1588.8861,1588.980367,1,47666583,47669411,2828,0.402847312351089
18329,1589.0258,1589.043167,1,47670774,47671295,521,0.8531714106657441
18330,1589.050867,1589.0574,1,47671526,47671722,196,0.8451825406004271
18331,1589.077567,1589.084567,1,47672327,47672537,210,0.9495341637030611
18332,1589.093967,1589.104933,1,47672819,47673147,328,0.9277787923562916
18333,1589.155933,1589.1783,1,47674677,47675349,672,0.4979131847706029
18334,1589.183933,1589.223167,1,47675517,47676695,1178,0.745992758522771
18335,1589.226967,1589.23,1,47676809,47676900,91,0.872281113514041
18336,1589.231067,1589.2353,1,47676932,47677059,127,0.9760504782201471
18337,1589.2476,1589.257567,1,47677428,47677727,299,0.9043682578526197
18338,1589.336833,1589.3636,1,47680104,47680908,804,0.7442349827121497
18339,1589.3694,1589.398067,1,47681082,47681942,860,0.41105770753542076
18340,1589.399467,1589.4029,1,47681984,47682087,103,0.8597794486962308
18341,1589.447333,1589.451433,1,47683419,47683542,123,0.6879641166602157
18342,1589.4527,1589.4612,1,47683581,47683836,255,0.8762688984308193
18343,1589.4634,1589.472033,1,47683902,47684160,258,0.9288332812918844
18344,1589.480233,1589.4846,1,47684406,47684538,132,0.9034796473939083
18345,1589.4992,1589.506,1,47684976,47685180,204,0.9340681428746735
18346,1589.509767,1589.515067,1,47685293,47685452,159,0.7536182571495789
18347,1589.597067,1589.601033,1,47687912,47688030,118,0.7510951378427718
18348,1589.642567,1589.646167,1,47689277,47689385,108,0.877333609076684
18349,1589.6669,1589.713267,1,47690007,47691398,1391,0.8319109494595079
18350,1589.7149,1589.7182,1,47691447,47691546,99,0.8365558001235032
18351,1589.797867,1589.828733,1,47693936,47694861,925,0.7649257598900622
18352,1589.8767,1589.8799,1,47696301,47696397,96,0.910840889848088
18353,1589.881667,1589.8864,1,47696450,47696592,142,0.8895953083707114
18354,1589.9081,1590.007367,1,47697243,47700221,2978,0.6620370387045872
18355,1590.0673,1590.0721,1,47702019,47702163,144,0.8714495605888976
18356,1590.078467,1590.098233,1,47702354,47702946,592,0.7796506469989556
18357,1590.1002,1590.114967,1,47703006,47703449,443,0.7493950009848123
18358,1590.116,1590.139533,1,47703480,47704185,705,0.9388633559747542
18359,1590.140567,1590.146367,1,47704217,47704391,174,0.9146088174602708
18360,1590.1615,1590.1654,1,47704845,47704962,117,0.3393102448654925
18361,1590.206,1590.236733,1,47706180,47707101,921,0.61740054571456
18362,1590.323133,1590.328,1,47709693,47709840,147,0.8229484932611587
18363,1590.3492,1590.3786,1,47710476,47711358,882,0.3598872679529479
18364,1590.444333,1590.471067,1,47713329,47714132,803,0.47916227369398134
18365,1590.472433,1590.476267,1,47714172,47714288,116,0.8372353534326473
18366,1590.4828,1590.5011,1,47714484,47715033,549,0.6696799823209343
18367,1590.5567,1590.567767,1,47716701,47717033,332,0.8251438712915579
18368,1590.5749,1590.5811,1,47717247,47717433,186,0.8725035307765678
18369,1590.6952,1590.699367,1,47720856,47720981,125,0.8316378368000736
18370,1590.717533,1590.721267,1,47721525,47721638,113,0.9137109824413138
18371,1590.769267,1590.779733,1,47723078,47723391,313,0.8282322571165205
18372,1590.8317,1590.850167,1,47724951,47725505,554,0.8210076766843979
18373,1590.869633,1590.8877,1,47726088,47726631,543,0.6644748471226366
18374,1590.894733,1590.897933,1,47726841,47726937,96,0.8244095378512488
18375,1590.903233,1590.9233,1,47727096,47727699,603,0.8077626759280356
18376,1590.945433,1590.952,1,47728362,47728560,198,0.869809778965018
18377,1590.9582,1590.961733,1,47728746,47728851,105,0.8885455095698119
18378,1590.967533,1591.018733,1,47729025,47730561,1536,0.8132774857090656
18379,1591.0207,1591.028167,1,47730621,47730845,224,0.9068610557204865
18380,1591.0502,1591.058167,1,47731506,47731745,239,0.8118498477200331
18381,1591.0758,1591.08,1,47732274,47732400,126,0.7748927234286886
18382,1591.081367,1591.084433,1,47732441,47732532,91,0.9501889577365455
18383,1591.105333,1591.122967,1,47733159,47733689,530,0.6932274853235536
18384,1591.129767,1591.134267,1,47733893,47734028,135,0.8902738039189323
18385,1591.155667,1591.186767,1,47734670,47735603,933,0.8551361582701296
18386,1591.197567,1591.204133,1,47735927,47736123,196,0.888689254726663
18387,1591.205133,1591.2101,1,47736153,47736303,150,0.8549013635947557
18388,1591.2123,1591.217067,1,47736369,47736512,143,0.8310617269859597
18389,1591.269567,1591.276667,1,47738087,47738300,213,0.8810054066311048
18390,1591.280967,1591.284433,1,47738429,47738532,103,0.8778083796925455
18391,1591.287967,1591.298267,1,47738639,47738948,309,0.6779634317069797
18392,1591.300767,1591.318233,1,47739023,47739546,523,0.9590222849157123
18393,1591.323167,1591.326967,1,47739695,47739809,114,0.7151912372637602
18394,1591.351967,1591.358967,1,47740559,47740769,210,0.8104181520429532
18395,1591.360267,1591.365333,1,47740808,47740959,151,0.7137689449057396
18396,1591.366667,1591.3706,1,47741000,47741118,118,0.9450630880276882
18397,1591.3716,1591.383,1,47741148,47741490,342,0.8931199268870406
18398,1591.400233,1591.416467,1,47742006,47742494,488,0.8260095149678998
18399,1591.438933,1591.4422,1,47743167,47743266,99,0.9376837946917892
18400,1591.509033,1591.526133,1,47745270,47745783,513,0.845092866135893
18401,1591.5355,1591.575767,1,47746065,47747273,1208,0.8786764389927405
18402,1591.581633,1591.592367,1,47747448,47747771,323,0.863765468563167
18403,1591.593567,1591.597067,1,47747807,47747912,105,0.9639900244464378
18404,1591.628967,1591.632667,1,47748869,47748980,111,0.9726676929304782
18405,1591.6359,1591.651033,1,47749077,47749530,453,0.684866761492172
18406,1591.6649,1591.668367,1,47749947,47750051,104,0.902768317546592
18407,1591.6695,1591.6727,1,47750085,47750181,96,0.900651205249848
18408,1591.7046,1591.7104,1,47751138,47751312,174,0.675956705237758
18409,1591.720233,1591.751933,1,47751606,47752557,951,0.8523976268247676
18410,1591.7926,1591.820267,1,47753778,47754608,830,0.4380343038184098
18411,1591.821267,1591.858067,1,47754638,47755742,1104,0.7468937904601832
18412,1591.902833,1591.924767,1,47757084,47757743,659,0.4774463939481054
18413,1591.9297,1591.944367,1,47757891,47758331,440,0.6599196020297764
18414,1591.9484,1591.974867,1,47758452,47759246,794,0.931806765866677
18415,1591.9776,1591.9837,1,47759328,47759511,183,0.8544984825844124
18416,1591.9903,1591.994267,1,47759709,47759828,119,0.9117728525095548
18417,1591.999333,1592.028533,1,47759979,47760855,876,0.5481868003569421
18418,1592.0366,1592.050967,1,47761098,47761529,431,0.9191813979946211
18419,1592.0691,1592.0722,1,47762073,47762166,93,0.9799376883801159
18420,1592.112967,1592.117233,1,47763389,47763516,127,0.713793677800138
18421,1592.126267,1592.157233,1,47763788,47764716,928,0.4999438063456804
18422,1592.162967,1592.1889,1,47764889,47765667,778,0.887673866552617
18423,1592.191133,1592.212167,1,47765733,47766365,632,0.6644013821404007
18424,1592.245667,1592.274,1,47767370,47768220,850,0.5101151066618459
18425,1592.2789,1592.314567,1,47768367,47769437,1070,0.7349438344611051
18426,1592.3783,1592.3863,1,47771349,47771589,240,0.7536017693502065
18427,1592.402133,1592.4086,1,47772063,47772258,195,0.879026583084644
18428,1592.418933,1592.4251,1,47772567,47772753,186,0.8655479480734312
18429,1592.4286,1592.454,1,47772858,47773620,762,0.35215363886145346
18430,1592.458033,1592.472333,1,47773740,47774169,429,0.693420935828158
18431,1592.474633,1592.4843,1,47774238,47774529,291,0.8848465583952357
18432,1592.485333,1592.4956,1,47774559,47774868,309,0.8363759514791683
18433,1592.6011,1592.608367,1,47778033,47778251,218,0.8059615684305506
18434,1592.627067,1592.630733,1,47778812,47778921,109,0.7728331316151713
18435,1592.634233,1592.650767,1,47779026,47779523,497,0.6769361372868267
18436,1592.659833,1592.695133,1,47779794,47780853,1059,0.6310127956281378
18437,1592.7066,1592.712467,1,47781198,47781374,176,0.8549666526122476
18438,1592.713633,1592.722867,1,47781408,47781686,278,0.870892123882101
18439,1592.7319,1592.7393,1,47781957,47782179,222,0.8925376007122491
18440,1592.741033,1592.745133,1,47782230,47782353,123,0.44368705607654235
18441,1592.748733,1592.752133,1,47782461,47782563,102,0.8585178401779757
18442,1592.794433,1592.826,1,47783832,47784780,948,0.5747910464839016
18443,1592.827433,1592.833833,1,47784822,47785014,192,0.777862372750386
18444,1592.8387,1592.8474,1,47785161,47785422,261,0.8821810987142498
18445,1592.8485,1592.852367,1,47785455,47785571,116,0.8940224485448001
18446,1592.853733,1592.861,1,47785611,47785830,219,0.8147357826455479
18447,1592.862033,1592.8675,1,47785860,47786025,165,0.9059948340813595
18448,1592.877333,1592.882233,1,47786319,47786466,147,0.9279452262151535
18449,1592.917433,1592.920667,1,47787522,47787620,98,0.7861207728635716
18450,1592.929267,1592.936467,1,47787878,47788094,216,0.8631040638245581
18451,1592.966167,1592.979967,1,47788985,47789399,414,0.5162286671605408
18452,1592.986933,1592.990433,1,47789607,47789712,105,0.8368095677000126
18453,1593.000533,1593.017733,1,47790015,47790531,516,0.5928588815052419
18454,1593.021167,1593.059867,1,47790635,47791796,1161,0.3399183453401343
18455,1593.063133,1593.0668,1,47791893,47792004,111,0.8231462275257562
18456,1593.077667,1593.085267,1,47792330,47792558,228,0.8186054917437635
18457,1593.091667,1593.101533,1,47792750,47793045,295,0.7737221551320258
18458,1593.1601,1593.165167,1,47794803,47794955,152,0.35648720602955575
18459,1593.1701,1593.210967,1,47795103,47796329,1226,0.410181474870189
18460,1593.222933,1593.236467,1,47796687,47797094,407,0.6597099623772238
18461,1593.2857,1593.301067,1,47798571,47799032,461,0.6952816194873384
18462,1593.302267,1593.3113,1,47799068,47799339,271,0.8543150226618114
18463,1593.320067,1593.360733,1,47799602,47800821,1219,0.4394655599400805
18464,1593.362233,1593.367367,1,47800866,47801021,155,0.6764823294945858
18465,1593.374867,1593.389967,1,47801246,47801699,453,0.87434435595998
18466,1593.4415,1593.4672,1,47803245,47804016,771,0.7292205465049882
18467,1593.4716,1593.526133,1,47804148,47805783,1635,0.45496767240566016
18468,1593.539233,1593.542433,1,47806176,47806272,96,0.8833205975740959
18469,1593.549167,1593.559133,1,47806475,47806773,298,0.9236646688131573
18470,1593.5947,1593.634833,1,47807841,47809044,1203,0.5473703398298146
18471,1593.636167,1593.6455,1,47809085,47809365,280,0.8304539603442674
18472,1593.6546,1593.670033,1,47809638,47810100,462,0.708860837055945
18473,1593.692533,1593.697067,1,47810775,47810912,137,0.9451372623379695
18474,1593.699233,1593.703067,1,47810976,47811092,116,0.9073473268391212
18475,1593.707267,1593.713367,1,47811218,47811401,183,0.8889239306098001
18476,1593.721633,1593.730733,1,47811648,47811921,273,0.43654626200298086
18477,1593.7583,1593.7625,1,47812749,47812875,126,0.9001728867029485
18478,1593.766067,1593.777633,1,47812982,47813328,346,0.6938268392394304
18479,1593.791067,1593.811533,1,47813732,47814345,613,0.41128771175864415
18480,1593.816033,1593.8334,1,47814480,47815002,522,0.5588852029932779
18481,1593.844267,1593.865233,1,47815328,47815956,628,0.3934251344568625
18482,1593.869733,1593.886567,1,47816091,47816597,506,0.6716323428755416
18483,1593.8957,1593.934267,1,47816871,47818028,1157,0.4457544305063247
18484,1593.936133,1593.943,1,47818083,47818290,207,0.8877479499711507
18485,1593.983267,1593.9897,1,47819498,47819691,193,0.7410007685627079
18486,1593.990933,1593.995067,1,47819727,47819852,125,0.7744790553555965
18487,1593.996333,1594.008067,1,47819889,47820242,353,0.8296722715392916
18488,1594.031,1594.054233,1,47820930,47821626,696,0.7622121221707394
18489,1594.062567,1594.087567,1,47821877,47822627,750,0.5320873734370543
18490,1594.094267,1594.1083,1,47822828,47823249,421,0.64544402914621
18491,1594.110767,1594.1566,1,47823323,47824698,1375,0.4473383000307921
18492,1594.168767,1594.183033,1,47825063,47825490,427,0.8168053260609053
18493,1594.2192,1594.263733,1,47826576,47827911,1335,0.49821211625198875
18494,1594.2862,1594.294667,1,47828586,47828840,254,0.7948296254649335
18495,1594.461367,1594.466833,1,47833841,47834004,163,0.8569077077284151
18496,1594.473767,1594.499133,1,47834213,47834973,760,0.6649591244028318
18497,1594.511433,1594.523433,1,47835342,47835702,360,0.6700716467628011
18498,1594.5246,1594.5606,1,47835738,47836818,1080,0.21023510780599333
18499,1594.570267,1594.5854,1,47837108,47837562,454,0.6546792477818898
18500,1594.5884,1594.5969,1,47837652,47837907,255,0.7587488034878119
18501,1594.603933,1594.622533,1,47838117,47838675,558,0.5779656269527478
18502,1594.656467,1594.6626,1,47839694,47839878,184,0.831398222885449
18503,1594.6781,1594.684967,1,47840343,47840549,206,0.8134461835728052
18504,1594.7009,1594.709267,1,47841027,47841278,251,0.7460823591073366
18505,1594.710333,1594.760267,1,47841309,47842808,1499,0.5611948220039576
18506,1594.773567,1594.784233,1,47843207,47843526,319,0.7767170436542454
18507,1594.7902,1594.7972,1,47843706,47843916,210,0.779539736896037
18508,1594.812933,1594.860033,1,47844387,47845800,1413,0.524908797208948
18509,1594.8614,1594.889433,1,47845842,47846682,840,0.8313580119747891
18510,1594.910633,1594.965067,1,47847318,47848952,1634,0.3588580545448272
18511,1594.9667,1594.974367,1,47849001,47849231,230,0.8043480385843169
18512,1594.979267,1594.9972,1,47849378,47849916,538,0.8129145366596282
18513,1595.071633,1595.0749,1,47852148,47852247,99,0.9251790734102174
18514,1595.076133,1595.0834,1,47852283,47852502,219,0.898642056646892
18515,1595.1221,1595.125367,1,47853663,47853761,98,0.982344254660135
18516,1595.135333,1595.152533,1,47854059,47854575,516,0.7972442586255977
18517,1595.159067,1595.1648,1,47854772,47854944,172,0.796141588360887
18518,1595.166267,1595.174733,1,47854988,47855241,253,0.7462197989988779
18519,1595.176133,1595.2177,1,47855283,47856531,1248,0.27266510564341495
18520,1595.2284,1595.232433,1,47856852,47856972,120,0.7988324844234412
18521,1595.249667,1595.264167,1,47857490,47857925,435,0.7652846368421583
18522,1595.288267,1595.295467,1,47858648,47858864,216,0.9083331700206375
18523,1595.297567,1595.355467,1,47858927,47860664,1737,0.3685583280570433
18524,1595.357133,1595.367933,1,47860713,47861037,324,0.8404698786263085
18525,1595.377133,1595.3974,1,47861313,47861922,609,0.9312042711570766
18526,1595.452833,1595.484233,1,47863584,47864526,942,0.210941799446131
18527,1595.486933,1595.4901,1,47864607,47864703,96,0.9181798838750781
18528,1595.492933,1595.5042,1,47864787,47865126,339,0.46381186152720716
18529,1595.5054,1595.510133,1,47865162,47865303,141,0.8618985945952293
18530,1595.519633,1595.5243,1,47865588,47865729,141,0.8857615235902524
18531,1595.5635,1595.5705,1,47866905,47867115,210,0.7780895510566216
18532,1595.596133,1595.6197,1,47867883,47868591,708,0.35232348801129687
18533,1595.623533,1595.644267,1,47868705,47869328,623,0.7404389469703664
18534,1595.7289,1595.733933,1,47871867,47872017,150,0.6036036659842333
18535,1595.782633,1595.7925,1,47873478,47873775,297,0.8466492469888253
18536,1595.810033,1595.814667,1,47874300,47874440,140,0.7829054700756819
18537,1595.823233,1595.836467,1,47874696,47875094,398,0.8578550753959586
18538,1595.839967,1595.853067,1,47875199,47875592,393,0.7864701634990082
18539,1595.907233,1595.910433,1,47877216,47877312,96,0.4569529323309189
18540,1595.922633,1595.932267,1,47877678,47877968,290,0.6049504004567767
18541,1595.933267,1595.950767,1,47877998,47878523,525,0.7575810281159331
18542,1595.979167,1595.993667,1,47879375,47879810,435,0.7250507552457827
18543,1595.996667,1596.020967,1,47879900,47880629,729,0.8840365261828238
18544,1596.057033,1596.0745,1,47881710,47882235,525,0.8391770234090811
18545,1596.084767,1596.104533,1,47882543,47883135,592,0.6786296241041485
18546,1596.106333,1596.1148,1,47883189,47883444,255,0.6244687936525993
18547,1596.1158,1596.131967,1,47883474,47883959,485,0.7457380644463732
18548,1596.133533,1596.138467,1,47884005,47884154,149,0.9178886849014156
18549,1596.1425,1596.147867,1,47884275,47884436,161,0.7928263669971897
18550,1596.197833,1596.203,1,47885934,47886090,156,0.8698541560779168
18551,1596.2108,1596.251667,1,47886324,47887550,1226,0.6675033962004734
18552,1596.256533,1596.267833,1,47887695,47888034,339,0.7331496693332231
18553,1596.269867,1596.279933,1,47888096,47888397,301,0.727437459503161
18554,1596.3402,1596.343533,1,47890206,47890305,99,0.595809973772372
18555,1596.347167,1596.356367,1,47890415,47890691,276,0.42916953714178113
18556,1596.359367,1596.398267,1,47890781,47891948,1167,0.4308015447210046
18557,1596.403033,1596.407033,1,47892090,47892210,120,0.7885681557987057
18558,1596.417033,1596.425067,1,47892510,47892752,242,0.6665863860147884
18559,1596.484333,1596.499967,1,47894529,47894999,470,0.3679530504788666
18560,1596.571667,1596.574867,1,47897150,47897246,96,0.8783309281925819
18561,1596.618833,1596.6311,1,47898564,47898933,369,0.5711110677760896
18562,1596.640433,1596.645833,1,47899212,47899374,162,0.7866283425173076
18563,1596.657733,1596.678833,1,47899731,47900364,633,0.5260102650082784
18564,1596.679933,1596.6902,1,47900397,47900706,309,0.7554423139216561
18565,1596.6947,1596.699267,1,47900841,47900978,137,0.7751149974885387
18566,1596.7226,1596.7449,1,47901678,47902347,669,0.7764423873258635
18567,1596.826333,1596.830133,1,47904789,47904903,114,-0.20239524758208077
18568,1596.8385,1596.853967,1,47905155,47905619,464,0.45247913505804477
18569,1596.859,1596.8654,1,47905770,47905962,192,0.5279082135746312
18570,1596.8804,1596.888933,1,47906412,47906667,255,0.8493967162819869
18571,1596.8983,1596.9049,1,47906949,47907147,198,0.5332481928409533
18572,1596.9063,1596.909833,1,47907189,47907294,105,0.5062798431817234
18573,1596.916067,1596.9239,1,47907482,47907717,235,0.6434009098903651
18574,1596.9368,1596.9434,1,47908104,47908302,198,0.6890633995588887
18575,1596.945267,1596.950467,1,47908358,47908514,156,0.2420379837112443
18576,1596.953767,1596.962167,1,47908613,47908865,252,0.5262761082603928
18577,1596.983333,1596.997867,1,47909499,47909936,437,0.5487826551133106
18578,1596.999067,1597.0026,1,47909972,47910078,106,0.624842043319511
18579,1597.0038,1597.018533,1,47910114,47910555,441,0.7798870296628396
18580,1597.0321,1597.047967,1,47910963,47911439,476,0.5895802321611187
18581,1597.052133,1597.0721,1,47911563,47912163,600,0.7357900067995895
18582,1597.080567,1597.0842,1,47912417,47912526,109,0.7851620430353572
18583,1597.0853,1597.1092,1,47912559,47913276,717,0.7720014155319394
18584,1597.1105,1597.116833,1,47913315,47913504,189,0.7675169921320142
18585,1597.1292,1597.149033,1,47913876,47914470,594,0.6643838306022921
18586,1597.158333,1597.170433,1,47914749,47915112,363,0.8121777633210631
18587,1597.178533,1597.188667,1,47915355,47915660,305,0.7472576966381347
18588,1597.189733,1597.194267,1,47915691,47915828,137,0.865811794617529
18589,1597.195433,1597.2014,1,47915862,47916042,180,0.7184003040771744
18590,1597.213733,1597.223967,1,47916411,47916719,308,0.8034527214943856
18591,1597.2294,1597.234133,1,47916882,47917023,141,0.8110942329373041
18592,1597.240833,1597.247433,1,47917224,47917422,198,0.8735398902588868
18593,1597.2485,1597.257367,1,47917455,47917721,266,0.7476924726447993
18594,1597.2584,1597.325633,1,47917752,47919768,2016,0.5227192530229442
18595,1597.334067,1597.377167,1,47920022,47921315,1293,0.6700131379510286
18596,1597.3811,1597.413733,1,47921433,47922411,978,0.42427331267505675
18597,1597.416833,1597.424667,1,47922504,47922740,236,0.7902201335498924
18598,1597.452033,1597.455833,1,47923560,47923674,114,0.7064737584113148
18599,1597.4573,1597.4653,1,47923719,47923959,240,0.7117153510827882
18600,1597.466567,1597.478133,1,47923997,47924343,346,0.6756971246413849
18601,1597.4834,1597.496933,1,47924502,47924907,405,0.6221318178527128
18602,1597.4981,1597.522833,1,47924943,47925684,741,0.16926740229421974
18603,1597.5328,1597.535933,1,47925984,47926077,93,0.8831057621692029
18604,1597.537,1597.544633,1,47926110,47926338,228,0.6217893479035552
18605,1597.5579,1597.571633,1,47926737,47927148,411,0.7529717495219046
18606,1597.574367,1597.587267,1,47927231,47927618,387,0.6366901124368889
18607,1597.601133,1597.624267,1,47928033,47928728,695,0.29879102896261345
18608,1597.628033,1597.6459,1,47928840,47929377,537,0.5672249038020675
18609,1597.737233,1597.743033,1,47932116,47932290,174,0.9192980714842255
18610,1597.757467,1597.769233,1,47932724,47933076,352,0.8966347630715378
18611,1597.770467,1597.774833,1,47933114,47933244,130,0.9327870337873799
18612,1597.822633,1597.827467,1,47934678,47934824,146,0.7249982913719475
18613,1597.834433,1597.856967,1,47935032,47935709,677,0.26354723091774196
18614,1597.858767,1597.8632,1,47935763,47935896,133,0.9202489870791181
18615,1597.869067,1597.886133,1,47936072,47936583,511,0.6963744786451019
18616,1598.144833,1598.150967,1,47944344,47944529,185,0.8525075308466263
18617,1598.170033,1598.173933,1,47945100,47945217,117,0.5239462180751446
18618,1598.178667,1598.1913,1,47945360,47945739,379,0.8689917696879614
18619,1598.211567,1598.2232,1,47946347,47946696,349,0.6143723426119125
18620,1598.224833,1598.229633,1,47946744,47946888,144,0.7941051192331203
18621,1598.257333,1598.260567,1,47947719,47947817,98,0.8637507645053031
18622,1598.261667,1598.277633,1,47947850,47948328,478,0.8922212549730603
18623,1598.280967,1598.300633,1,47948429,47949018,589,0.7760842833981246
18624,1598.309433,1598.384267,1,47949282,47951528,2246,0.5181150178876764
18625,1598.410267,1598.4137,1,47952308,47952411,103,0.642628381146764
18626,1601.099833,1601.120933,1,48032994,48033627,633,-0.13138175263991306
18627,1601.125333,1601.135033,1,48033759,48034050,291,-0.054301743266623376
18628,1601.143067,1601.151333,1,48034292,48034539,247,0.007050236829756434
18629,1601.156533,1601.170233,1,48034695,48035106,411,-0.217219337646705
18630,1601.1715,1601.1775,1,48035145,48035325,180,0.2935431563930676
18631,1601.178767,1601.182333,1,48035363,48035469,106,0.6648150557539297
18632,1602.292967,1602.303433,1,48068789,48069102,313,0.9099553214506587
18633,1602.324233,1602.327333,1,48069726,48069819,93,0.9273142846199459
18634,1602.398467,1602.4024,1,48071954,48072072,118,0.83347124190122
18635,1603.5269,1603.5358,1,48105807,48106074,267,0.17513779074057556
18636,1603.765533,1603.822167,1,48112965,48114665,1700,0.3399150629527869
18637,1603.8235,1603.836667,1,48114705,48115100,395,0.7905221936033389
18638,1603.841233,1603.844367,1,48115236,48115331,95,0.8813230573940981
18639,1604.320367,1604.3268,1,48129611,48129804,193,0.04400739431304692
18640,1604.328133,1604.336233,1,48129843,48130086,243,0.5840944939157583
18641,1604.3505,1604.500867,1,48130515,48135026,4511,0.286145635574517
18642,1604.544333,1604.6466,1,48136329,48139398,3069,0.7011079030289135
18643,1604.648633,1604.6607,1,48139458,48139821,363,0.8258627676942707
18644,1604.661833,1604.6899,1,48139854,48140697,843,0.6273052205050442
18645,1604.6921,1604.699533,1,48140763,48140985,222,0.8083519461249392
18646,1604.746633,1604.750133,1,48142398,48142503,105,0.8729523037230719
18647,1604.782667,1604.788267,1,48143480,48143648,168,0.8039327246540457
18648,1605.065133,1605.0761,1,48151953,48152283,330,0.6384194774898567
18649,1605.0919,1605.099667,1,48152757,48152990,233,0.8815435349897464
18650,1605.103533,1605.132733,1,48153105,48153981,876,0.5286310084641466
18651,1605.298067,1605.313033,1,48158942,48159390,448,0.7512888116890583
18652,1605.349033,1605.3679,1,48160470,48161037,567,0.8314911124547938
18653,1605.767033,1606.0089,1,48173010,48180267,7257,0.39354709383772746
18654,1606.012533,1606.052933,1,48180375,48181587,1212,0.36561152184147155
18655,1606.070467,1606.0737,1,48182114,48182211,97,0.8925634153951054
18656,1606.0751,1606.0805,1,48182253,48182415,162,0.867397809994042
18657,1606.0856,1606.2558,1,48182568,48187674,5106,0.4483960445379502
18658,1606.264833,1606.479367,1,48187944,48194381,6437,0.3677410515575074
18659,1606.480567,1606.506533,1,48194417,48195195,778,0.6474386364110987
18660,1606.5076,1606.514033,1,48195228,48195420,192,0.8739100592044682
18661,1606.527833,1606.538467,1,48195834,48196154,320,0.6380660239802259
18662,1606.556667,1606.562167,1,48196700,48196865,165,0.8812168553953439
18663,1606.563233,1606.603833,1,48196896,48198114,1218,0.7535628501672749
18664,1606.636833,1606.786433,1,48199104,48203592,4488,0.7086046466359459
18665,1606.787667,1606.7921,1,48203630,48203763,133,0.8276298015941344
18666,1606.793167,1606.802367,1,48203795,48204071,276,0.756700117082267
18667,1606.8034,1606.8261,1,48204102,48204783,681,0.8618157762573971
18668,1606.847233,1606.866967,1,48205416,48206009,593,0.8829156224319644
18669,1606.869133,1606.872367,1,48206073,48206171,98,0.8270569088483954
18670,1606.8738,1606.878533,1,48206214,48206355,141,0.9014797049658095
18671,1606.910433,1606.9465,1,48207312,48208395,1083,0.8650785939268416
18672,1606.972,1606.990867,1,48209160,48209726,566,0.9191232049915483
18673,1607.0305,1607.035367,1,48210915,48211061,146,0.6077465167647236
18674,1607.062567,1607.0689,1,48211877,48212067,190,0.7951200126811413
18675,1607.284967,1607.289133,1,48218549,48218673,124,0.5014647223624519
18676,1607.304067,1607.309033,1,48219122,48219270,148,0.8687939292873179
18677,1607.336067,1607.339767,1,48220082,48220193,111,0.9699680173426128
18678,1607.3465,1607.3502,1,48220395,48220506,111,0.7615268516418197
18679,1607.422,1607.441667,1,48222660,48223250,590,0.4981220227620852
18680,1607.509067,1607.544,1,48225272,48226320,1048,0.2511413166787995
18681,1607.736033,1607.770033,1,48232080,48233100,1020,0.4455308480747092
18682,1607.861967,1607.865233,1,48235859,48235956,97,0.831043705384749
18683,1607.869567,1607.873133,1,48236087,48236193,106,0.7751407832628797
18684,1607.8996,1607.9316,1,48236988,48237948,960,0.7690124397436912
18685,1607.936867,1607.953767,1,48238106,48238613,507,0.3915373978455093
18686,1608.460633,1608.553933,1,48253818,48256617,2799,0.2617145665741969
18687,1608.602167,1608.787033,1,48258065,48263610,5545,0.24572658529115923
18688,1608.795067,1608.7991,1,48263852,48263973,121,0.8525677249007587
18689,1608.809067,1608.844267,1,48264272,48265328,1056,0.7411977490556283
18690,1608.846133,1608.890067,1,48265383,48266702,1319,0.24881037443862322
18691,1608.9611,1608.967533,1,48268833,48269025,192,0.6302224900847407
18692,1608.970933,1608.997433,1,48269127,48269922,795,0.7947237537107459
18693,1609.003633,1609.042933,1,48270108,48271287,1179,0.12341328825670124
18694,1609.140267,1609.154967,1,48274208,48274649,441,0.8522572509708499
18695,1609.310867,1609.344167,1,48279326,48280325,999,0.6052034557905849
18696,1609.347567,1609.3905,1,48280427,48281715,1288,0.3087329295841466
18697,1609.428467,1609.450967,1,48282854,48283529,675,0.4622640980913811
18698,1609.454933,1609.475367,1,48283647,48284261,614,0.6935411207970158
18699,1609.4772,1609.4856,1,48284316,48284568,252,0.7500600357644891
18700,1609.4927,1609.496967,1,48284781,48284909,128,0.9281609194858991
18701,1609.499167,1609.5274,1,48284975,48285822,847,0.7928968217004152
18702,1609.540467,1609.544733,1,48286214,48286341,127,0.888059794381067
18703,1609.545967,1609.5662,1,48286379,48286986,607,0.9068799904019295
18704,1609.5967,1609.624,1,48287901,48288720,819,0.671654814818936
18705,1609.692267,1609.695533,1,48290768,48290865,97,-0.40861339498167937
18706,1609.741767,1609.856767,1,48292253,48295703,3450,0.3365566817032497
18707,1609.8645,1609.889767,1,48295935,48296693,758,0.6268920391115842
18708,1609.891067,1609.918533,1,48296732,48297555,823,0.6319852560190771
18709,1609.946833,1609.953867,1,48298404,48298616,212,0.34071569546505165
18710,1610.121833,1610.160267,1,48303654,48304808,1154,0.7801970274290906
18711,1610.642267,1610.6459,1,48319268,48319377,109,0.05874649486223274
18712,1610.700967,1610.7061,1,48321029,48321183,154,0.008500659613421295
18713,1610.709,1610.717933,1,48321270,48321537,267,-0.4210005700774048
18714,1610.719233,1610.759567,1,48321576,48322787,1211,0.04360515274336807
18715,1611.293633,1611.357867,1,48338808,48340736,1928,0.3550696561931966
18716,1611.380767,1611.3926,1,48341423,48341778,355,0.7238294466533876
18717,1611.444933,1611.450133,1,48343347,48343503,156,0.885456216507636
18718,1611.7708,1611.8909,1,48353124,48356727,3603,0.3669617609803455
18719,1611.904167,1611.939633,1,48357125,48358188,1063,0.6128342981766195
18720,1611.9437,1612.0159,1,48358311,48360477,2166,0.41887531463733135
18721,1612.018,1612.0224,1,48360540,48360672,132,0.7673949008098028
18722,1612.0261,1612.038733,1,48360783,48361161,378,0.7474449397807784
18723,1612.078133,1612.0838,1,48362343,48362514,171,0.9423439878606471
18724,1612.0889,1612.093367,1,48362667,48362801,134,0.86991939708859
18725,1612.094933,1612.0987,1,48362847,48362961,114,0.9083419604036902
18726,1612.099767,1612.1057,1,48362993,48363171,178,0.8423479212243601
18727,1612.116033,1612.1223,1,48363480,48363669,189,0.8868902835564045
18728,1612.1278,1612.1741,1,48363834,48365223,1389,0.9053265011282018
18729,1612.178033,1612.189967,1,48365340,48365699,359,0.6222580059933793
18730,1612.191533,1612.1995,1,48365745,48365985,240,0.8203994127213177
18731,1612.503333,1612.5068,1,48375099,48375204,105,0.6732275443491184
18732,1612.586567,1612.590233,1,48377597,48377706,109,0.5730678130261355
18733,1613.306533,1613.309567,1,48399195,48399287,92,0.48600051569372654
18734,1613.319133,1613.324433,1,48399573,48399732,159,0.12053599162660676
18735,1613.345467,1613.354433,1,48400364,48400632,268,0.3662851831886027
18736,1613.356567,1613.3604,1,48400697,48400812,115,0.31342691181519344
18737,1613.3628,1613.3662,1,48400884,48400986,102,0.06043083576661998
18738,1613.370767,1613.374233,1,48401123,48401226,103,-0.6259886738345847
18739,1613.437767,1613.5293,1,48403133,48405879,2746,0.3295234020022004
18740,1613.537167,1613.624,1,48406115,48408720,2605,0.26332975977885137
18741,1613.625333,1613.638733,1,48408759,48409161,402,0.803039803189177
18742,1613.6455,1613.653667,1,48409365,48409610,245,0.35483880360685105
18743,1613.659033,1613.7043,1,48409770,48411129,1359,0.5060824944963018
18744,1613.709433,1613.7532,1,48411282,48412596,1314,0.4761980772188011
18745,1613.754467,1613.778067,1,48412634,48413342,708,0.44443013766256434
18746,1613.7876,1613.813067,1,48413628,48414392,764,0.1457362846138236
18747,1613.990933,1613.9976,1,48419727,48419928,201,-0.004799849904842142
18748,1614.4163,1614.4489,1,48432489,48433467,978,0.059862797103258515
18749,1614.450233,1614.473967,1,48433506,48434219,713,0.16912274748095155
18750,1614.4845,1614.4921,1,48434535,48434763,228,0.099123555770573
18751,1614.500167,1614.503833,1,48435005,48435114,109,0.8307088896195515
18752,1614.5055,1614.650333,1,48435165,48439509,4344,0.2814773967304845
18753,1614.6564,1614.6627,1,48439692,48439881,189,0.8566112877367811
18754,1614.669333,1614.682167,1,48440079,48440465,386,0.5345624202719521
18755,1614.697967,1614.733067,1,48440939,48441992,1053,0.07131754973615163
18756,1614.739233,1614.765367,1,48442176,48442961,785,-0.14898640021662612
18757,1614.847667,1614.8662,1,48445430,48445986,556,0.5511013255925277
18758,1614.872667,1614.891,1,48446180,48446730,550,0.5822475997919494
18759,1614.893133,1614.9012,1,48446793,48447036,243,0.7179128738343442
18760,1614.903567,1614.9104,1,48447107,48447312,205,0.9328016528457942
18761,1614.932733,1614.961733,1,48447981,48448851,870,0.9207121417873263
18762,1614.962833,1614.968667,1,48448884,48449060,176,0.8144408010778793
18763,1614.990367,1615.0071,1,48449711,48450213,502,0.24780017349594857
18764,1615.062467,1615.073967,1,48451874,48452219,345,0.6077702528730768
18765,1615.107733,1615.1112,1,48453231,48453336,105,0.7875660623817852
18766,1615.265567,1615.269233,1,48457967,48458076,109,0.8861512452322415
18767,1615.538233,1615.566867,1,48466146,48467006,860,0.42102515850074607
18768,1615.575633,1615.593267,1,48467268,48467798,530,0.8570975355899814
18769,1615.620533,1615.633367,1,48468615,48469001,386,0.8766043794820249
18770,1615.647133,1615.651033,1,48469413,48469530,117,0.6533946951935811
18771,1615.6588,1615.6631,1,48469764,48469893,129,0.5773406026364506
18772,1616.758267,1616.761967,1,48502748,48502859,111,0.6722737748750975
18773,1617.288567,1617.3134,1,48518657,48519402,745,0.3433147160856656
18774,1617.3248,1617.3395,1,48519744,48520185,441,0.5265026263809256
18775,1617.352233,1617.437567,1,48520566,48523127,2561,0.47099874012329107
18776,1617.4388,1617.493367,1,48523164,48524801,1637,0.6811095298871499
18777,1617.654867,1617.6617,1,48529646,48529851,205,0.7351812568921963
18778,1617.730533,1617.7342,1,48531915,48532026,111,0.7427533772055288
18779,1617.774933,1617.7858,1,48533247,48533574,327,0.8011811657370853
18780,1617.8395,1617.873667,1,48535185,48536210,1025,0.4968913409919206
18781,1617.877967,1617.884633,1,48536339,48536538,199,0.12529978727806712
18782,1617.8864,1617.891867,1,48536592,48536756,164,0.4501506943937433
18783,1617.912333,1617.924733,1,48537369,48537741,372,0.6210773137178008
18784,1617.927467,1617.942433,1,48537824,48538272,448,0.8551879398668877
18785,1617.943467,1617.9537,1,48538304,48538611,307,0.553833694146751
18786,1617.954967,1617.961533,1,48538649,48538845,196,0.8698800643868336
18787,1618.219433,1618.235233,1,48546582,48547056,474,0.3362816380533065
18788,1618.254567,1618.300267,1,48547637,48549008,1371,0.03707670225637247
18789,1618.301867,1618.306733,1,48549056,48549201,145,0.9234923239588428
18790,1618.3078,1618.381333,1,48549234,48551439,2205,0.4574824176393445
18791,1618.384467,1618.421467,1,48551534,48552644,1110,0.4479763217316082
18792,1618.425133,1618.4316,1,48552753,48552948,195,0.6323219711962326
18793,1618.4335,1618.442067,1,48553005,48553262,257,0.7357855413543303
18794,1618.460333,1618.4791,1,48553809,48554373,564,0.6715809017852266
18795,1618.536067,1618.5559,1,48556082,48556677,595,0.655653291062033
18796,1618.557467,1618.5609,1,48556724,48556827,103,0.7266063840754658
18797,1618.562533,1618.589833,1,48556875,48557694,819,0.6431188605602725
18798,1618.598433,1618.609033,1,48557952,48558270,318,0.7615525012397997
18799,1618.727167,1618.731433,1,48561815,48561942,127,0.7951734270368636
18800,1618.808033,1618.8166,1,48564240,48564498,258,0.5008862333634041
18801,1619.243767,1619.314367,1,48577313,48579431,2118,0.15343977955327937
18802,1619.380733,1619.4229,1,48581421,48582687,1266,0.28461417015737134
18803,1619.426567,1619.4913,1,48582797,48584739,1942,-0.27421704934315455
18804,1619.495567,1619.516233,1,48584867,48585486,619,0.5345440325892319
18805,1619.525967,1619.647967,1,48585779,48589439,3660,0.23620114725804273
18806,1619.6494,1619.6556,1,48589482,48589668,186,0.695035337089916
18807,1619.668733,1619.671733,1,48590061,48590151,90,0.9121810815679795
18808,1619.694633,1619.699833,1,48590838,48590994,156,0.9216821646215898
18809,1619.7037,1619.7272,1,48591111,48591816,705,0.22045981566970696
18810,1619.729633,1619.777667,1,48591888,48593330,1442,0.14954729303494466
18811,1619.782567,1619.795167,1,48593477,48593855,378,0.2607748132994667
18812,1619.796967,1619.807,1,48593909,48594210,301,0.7239598232864001
18813,1619.861267,1619.882967,1,48595838,48596489,651,0.4132720652233506
18814,1619.888633,1619.904833,1,48596658,48597144,486,0.479841654542512
18815,1619.9177,1619.921033,1,48597531,48597630,99,0.8403883306926075
18816,1619.9255,1619.938367,1,48597765,48598151,386,0.8421734315123359
18817,1619.941667,1619.993467,1,48598250,48599804,1554,0.3043728137232854
18818,1620.0159,1620.021067,1,48600477,48600632,155,0.5497239380334783
18819,1620.0411,1620.044967,1,48601233,48601349,116,0.29513272681236097
18820,1620.0625,1620.096233,1,48601875,48602886,1011,0.5750048386912768
18821,1620.104433,1620.1383,1,48603132,48604149,1017,0.2014124010622846
18822,1620.141967,1620.1478,1,48604259,48604434,175,0.4582567056471332
18823,1620.3281,1620.3467,1,48609843,48610401,558,0.6113500637156816
18824,1621.115133,1621.187767,1,48633453,48635633,2180,0.11041640357646602
18825,1621.189267,1621.209433,1,48635678,48636282,604,0.33125149836480733
18826,1621.2173,1621.2613,1,48636519,48637839,1320,0.1814955013135385
18827,1621.262433,1621.369133,1,48637872,48641073,3201,0.17530639665738545
18828,1621.3707,1621.3904,1,48641121,48641712,591,0.7105699161368784
18829,1621.391567,1621.418933,1,48641747,48642567,820,0.30298539132506797
18830,1621.422467,1621.457867,1,48642674,48643736,1062,0.3069540628086283
18831,1621.4632,1621.4871,1,48643896,48644613,717,0.39505405335594457
18832,1621.507933,1621.524167,1,48645237,48645725,488,0.6066382536211776
18833,1621.5381,1621.555467,1,48646143,48646664,521,0.5430425739774479
18834,1621.557567,1621.563733,1,48646727,48646911,184,0.8688233399692527
18835,1621.564833,1621.5705,1,48646944,48647115,171,0.6246880872260077
18836,1621.5786,1621.611267,1,48647358,48648338,980,0.005978887451298167
18837,1621.6157,1621.6276,1,48648471,48648828,357,0.3063847605767031
18838,1621.628767,1621.683,1,48648863,48650490,1627,-0.024784545987910536
18839,1621.7112,1621.752867,1,48651336,48652586,1250,0.41187287167373177
18840,1621.8502,1621.8566,1,48655506,48655698,192,0.3691632573143335
18841,1621.8606,1621.863933,1,48655818,48655917,99,0.7594419991243915
18842,1621.868067,1621.8721,1,48656042,48656163,121,0.8919909312518398
18843,1621.875267,1621.881533,1,48656258,48656445,187,0.6414586895880158
18844,1621.883167,1621.8893,1,48656495,48656679,184,0.8011401567294199
18845,1621.890367,1621.908167,1,48656711,48657245,534,0.19880099329380718
18846,1621.9109,1621.915833,1,48657327,48657474,147,0.8685495404230156
18847,1621.917733,1621.9335,1,48657531,48658005,474,0.8770084077974559
18848,1621.9436,1621.9486,1,48658308,48658458,150,0.7195426173298448
18849,1621.951667,1621.967533,1,48658550,48659025,475,0.7955680749981051
18850,1621.9717,1621.977367,1,48659151,48659321,170,0.8394043866235363
18851,1621.981267,1621.985667,1,48659438,48659570,132,0.6210661346884463
18852,1621.987233,1622.0,1,48659616,48660000,384,0.7003887244304677
18853,1622.0781,1622.082133,1,48662343,48662463,120,0.7767801090413521
18854,1622.087233,1622.126167,1,48662616,48663785,1169,0.7176465530977498
18855,1622.1273,1622.1322,1,48663819,48663966,147,0.9193553611520191
18856,1622.133267,1622.182667,1,48663998,48665480,1482,0.5665237167630778
18857,1622.185433,1622.208367,1,48665562,48666251,689,0.7702950837796014
18858,1622.2098,1622.2132,1,48666294,48666396,102,0.8054804490049374
18859,1622.214533,1622.219867,1,48666435,48666596,161,0.7536806856298338
18860,1622.2261,1622.2295,1,48666783,48666885,102,0.9322387131249774
18861,1622.250033,1622.258533,1,48667500,48667755,255,0.824352167827549
18862,1622.266933,1622.270367,1,48668007,48668111,104,0.8566353053352089
18863,1622.309533,1622.3139,1,48669285,48669417,132,0.5364375719660825
18864,1622.331567,1622.337233,1,48669947,48670116,169,0.8588937842728429
18865,1622.339567,1622.3506,1,48670187,48670518,331,0.8797482912638733
18866,1622.369333,1622.3738,1,48671079,48671214,135,0.8396268229810994
18867,1622.3875,1622.394667,1,48671625,48671840,215,0.7872046228381818
18868,1622.506167,1622.5177,1,48675185,48675531,346,0.7356573891737558
18869,1622.519333,1622.5246,1,48675579,48675738,159,0.8522730600172451
18870,1622.530933,1622.535633,1,48675927,48676068,141,0.8459755826413344
18871,1622.536633,1622.539633,1,48676098,48676188,90,0.9594316302960668
18872,1622.542167,1622.583733,1,48676265,48677511,1246,0.32509693968382297
18873,1622.5888,1622.596033,1,48677664,48677880,216,0.6865396362696558
18874,1622.644133,1622.697867,1,48679323,48680936,1613,0.8098648822337267
18875,1622.7048,1622.730733,1,48681144,48681921,777,0.6392111194986577
18876,1622.7557,1622.839,1,48682671,48685170,2499,0.8428325749139239
18877,1622.840733,1622.897433,1,48685221,48686922,1701,0.4365841064946506
18878,1622.899667,1622.904467,1,48686990,48687134,144,0.8847744425301398
18879,1622.907567,1622.910967,1,48687227,48687329,102,0.7905760912664248
18880,1622.9241,1622.949233,1,48687723,48688476,753,0.8455681465811156
18881,1622.9512,1622.9812,1,48688536,48689436,900,0.7236575653280967
18882,1622.982267,1622.988833,1,48689468,48689664,196,0.8250877834846817
18883,1623.006333,1623.016967,1,48690189,48690509,320,0.897760439203948
18884,1623.018167,1623.036733,1,48690545,48691101,556,0.8076433984704151
18885,1623.047833,1623.056433,1,48691434,48691692,258,0.8056217369334382
18886,1623.067033,1623.070467,1,48692010,48692114,104,0.7891023859986254
18887,1623.0715,1623.119133,1,48692145,48693573,1428,0.791512273795192
18888,1623.124033,1623.134967,1,48693720,48694049,329,0.7744076677948293
18889,1623.140967,1623.1464,1,48694229,48694392,163,0.8037818279777155
18890,1623.1572,1623.1662,1,48694716,48694986,270,0.8737873744775113
18891,1623.1752,1623.1916,1,48695256,48695748,492,0.6148373878795578
18892,1623.1945,1623.205333,1,48695835,48696159,324,0.7945720065081938
18893,1623.207033,1623.2122,1,48696210,48696366,156,0.9534555940853683
18894,1623.213267,1623.2356,1,48696398,48697068,670,0.6301533084454699
18895,1623.2442,1623.3141,1,48697326,48699423,2097,0.5583506149874671
18896,1623.315633,1623.3671,1,48699468,48701013,1545,0.6573824882145154
18897,1623.370033,1623.385667,1,48701100,48701570,470,0.8152825438749592
18898,1623.386833,1623.411967,1,48701604,48702359,755,0.5575047526436939
18899,1623.414467,1623.426067,1,48702434,48702782,348,0.7936184016816099
18900,1623.429833,1623.464633,1,48702894,48703938,1044,0.09673408468099098
18901,1623.4721,1623.507,1,48704163,48705210,1047,0.2549744938610638
18902,1623.509133,1623.516533,1,48705273,48705495,222,0.4073776903997832
18903,1623.517967,1623.5471,1,48705539,48706413,874,0.7968224630631008
18904,1623.554,1623.6016,1,48706620,48708048,1428,0.7805920190113388
18905,1623.6085,1623.6385,1,48708255,48709155,900,0.8213063502119663
18906,1623.641467,1623.644567,1,48709244,48709337,93,0.4599728932340493
18907,1623.649333,1623.6538,1,48709479,48709614,135,0.7277848478124427
18908,1623.657933,1623.7129,1,48709737,48711387,1650,0.6838648070346984
18909,1623.715467,1623.7236,1,48711464,48711708,244,0.6249368329910213
18910,1623.726033,1623.7491,1,48711780,48712473,693,0.7193319737278246
18911,1623.750833,1623.7604,1,48712524,48712812,288,0.8293030830778122
18912,1623.7644,1623.797533,1,48712932,48713925,993,0.843246552522112
18913,1623.802867,1623.992233,1,48714086,48719766,5680,0.48085244186312304
18914,1624.0083,1624.014967,1,48720249,48720449,200,0.4762884068398632
18915,1624.016967,1624.0225,1,48720509,48720675,166,0.8618324163487585
18916,1624.028867,1624.0658,1,48720866,48721974,1108,0.8358067609845056
18917,1624.080333,1624.088667,1,48722409,48722660,251,0.9424552933756677
18918,1624.089667,1624.111033,1,48722690,48723330,640,0.9072865131589356
18919,1624.114433,1624.140667,1,48723432,48724220,788,0.8505551269602641
18920,1624.168267,1624.173,1,48725048,48725190,142,0.8440082232197293
18921,1624.1751,1624.1801,1,48725253,48725403,150,0.7307229783273747
18922,1624.1834,1624.203733,1,48725502,48726111,609,0.7633772172504218
18923,1624.204833,1624.211333,1,48726144,48726339,195,0.9022182533952787
18924,1624.2182,1624.241867,1,48726546,48727256,710,0.6642654828615696
18925,1624.247367,1624.27,1,48727421,48728100,679,0.5940921315983128
18926,1624.290667,1624.303733,1,48728720,48729111,391,0.7830234711089309
18927,1624.3134,1624.3169,1,48729402,48729507,105,0.6683655127831528
18928,1624.317933,1624.321167,1,48729537,48729635,98,0.5567409179505103
18929,1624.3403,1624.363267,1,48730209,48730898,689,0.7222558252747308
18930,1624.3647,1624.3774,1,48730941,48731322,381,0.7073851527786351
18931,1624.400167,1624.408667,1,48732005,48732260,255,0.7353405348145773
18932,1624.4183,1624.424867,1,48732549,48732746,197,0.8782075483494948
18933,1624.436433,1624.4496,1,48733092,48733488,396,0.820811794867325
18934,1624.453367,1624.467667,1,48733601,48734030,429,0.6858468323612347
18935,1624.469833,1624.479867,1,48734094,48734396,302,0.7696924299297111
18936,1624.482133,1624.4901,1,48734463,48734703,240,0.8649659500484888
18937,1624.4948,1624.5012,1,48734844,48735036,192,0.8692967034056622
18938,1624.548,1624.5731,1,48736440,48737193,753,0.7486660999946448
18939,1624.5745,1624.622933,1,48737235,48738687,1452,0.753831236163236
18940,1624.6338,1624.6537,1,48739014,48739611,597,0.6477891702036233
18941,1624.657233,1624.6752,1,48739716,48740256,540,0.6562477026379606
18942,1624.677467,1624.686267,1,48740324,48740588,264,0.6366593116843137
18943,1624.696867,1624.729667,1,48740906,48741890,984,0.47779594163086403
18944,1624.730967,1624.745033,1,48741929,48742350,421,0.5268004319243795
18945,1624.746333,1624.766067,1,48742389,48742982,593,0.5122530281526396
18946,1624.7698,1624.774033,1,48743094,48743220,126,0.7866211919841808
18947,1624.7905,1624.796933,1,48743715,48743907,192,0.8288883527365529
18948,1624.799333,1624.815567,1,48743979,48744467,488,0.7457233217436469
18949,1624.819067,1624.823233,1,48744572,48744696,124,0.6398346090498862
18950,1624.828567,1624.8435,1,48744857,48745305,448,0.8839994146159383
18951,1624.8851,1624.888967,1,48746553,48746669,116,0.712060608222172
18952,1624.890067,1624.896767,1,48746702,48746903,201,0.6994722887742433
18953,1624.901333,1624.9076,1,48747039,48747228,189,0.9075889177746125
18954,1624.913133,1624.9395,1,48747393,48748185,792,0.8459712822431666
18955,1624.941467,1624.949733,1,48748244,48748491,247,0.8880147691584644
18956,1624.951867,1624.9621,1,48748556,48748863,307,0.7531675875776862
18957,1624.979333,1624.9858,1,48749379,48749574,195,0.8714317638149475
18958,1624.9869,1624.992,1,48749607,48749760,153,0.9328486281785223
18959,1625.0556,1625.060767,1,48751668,48751823,155,0.9021998969951207
18960,1625.082333,1625.086233,1,48752469,48752586,117,0.825829042715897
18961,1625.089533,1625.105533,1,48752685,48753165,480,0.7301251311338217
18962,1625.106767,1625.1117,1,48753203,48753351,148,0.9255313837352388
18963,1625.124733,1625.1554,1,48753741,48754662,921,0.7399137223605834
18964,1625.160267,1625.164033,1,48754808,48754920,112,0.7191583329662202
18965,1625.1737,1625.176733,1,48755211,48755301,90,0.9602560241372061
18966,1625.180167,1625.2379,1,48755405,48757137,1732,0.6811074279979998
18967,1625.239233,1625.243233,1,48757176,48757296,120,0.8357223953722404
18968,1625.2669,1625.2756,1,48758007,48758268,261,0.8124070838251056
18969,1625.277633,1625.285033,1,48758328,48758550,222,0.9005615723416771
18970,1625.332,1625.338667,1,48759960,48760160,200,0.9232769510501547
18971,1625.340167,1625.3517,1,48760205,48760551,346,0.9562975013406229
18972,1625.360533,1625.368167,1,48760815,48761045,230,0.9354048796605402
18973,1625.4498,1625.4585,1,48763494,48763755,261,0.5600532343506578
18974,1625.4662,1625.478467,1,48763986,48764354,368,0.1310945263007926
18975,1625.8065,1625.812833,1,48774195,48774384,189,0.07003094680280444
18976,1626.001433,1626.007567,1,48780042,48780227,185,0.6148300749155097
18977,1626.013267,1626.0186,1,48780398,48780558,160,0.345171348203819
18978,1626.4434,1626.448167,1,48793302,48793445,143,0.6362837503800911
18979,1626.7853,1626.795233,1,48803559,48803856,297,0.111908157559952
18980,1626.799567,1626.803467,1,48803987,48804104,117,0.30210901666278345
18981,1627.312167,1627.338,1,48819365,48820140,775,0.3765365294977893
18982,1627.523367,1627.536367,1,48825701,48826091,390,0.4095663166549177
18983,1627.6809,1627.6906,1,48830427,48830718,291,0.7750177505956266
18984,1627.717767,1627.735867,1,48831533,48832076,543,0.20542715857062965
18985,1627.820567,1627.8244,1,48834617,48834732,115,0.19764873460068635
18986,1627.886567,1627.893733,1,48836597,48836811,214,0.2962309574929136
18987,1628.812467,1628.816433,1,48864374,48864492,118,0.2043515459705642
18988,1628.872767,1628.883133,1,48866183,48866493,310,0.6444402826259923
18989,1629.035167,1629.1485,1,48871055,48874455,3400,0.4065165157874673
18990,1629.173133,1629.206367,1,48875193,48876191,998,0.4025047314954802
18991,1629.226267,1629.2831,1,48876788,48878493,1705,0.38888107671102623
18992,1629.656133,1629.660167,1,48889683,48889805,122,0.7379643706092623
18993,1629.813867,1629.8202,1,48894416,48894606,190,0.8644227258207592
18994,1629.843667,1629.850067,1,48895310,48895502,192,0.8733701193110177
18995,1629.851167,1629.854767,1,48895535,48895643,108,0.5571522795352309
18996,1629.887,1630.018033,1,48896610,48900540,3930,0.21609538664846112
18997,1630.0249,1630.048033,1,48900747,48901440,693,0.7010787961714083
18998,1630.054267,1630.069333,1,48901628,48902079,451,0.1694923072577242
18999,1630.079667,1630.0878,1,48902390,48902634,244,0.5591172214324551
19000,1630.090533,1630.100533,1,48902715,48903015,300,0.6550906823805881
19001,1630.103333,1630.123833,1,48903099,48903714,615,0.3193671453540652
19002,1630.1252,1630.130267,1,48903756,48903908,152,0.8164936886957443
19003,1630.1876,1630.287167,1,48905628,48908615,2987,0.40194658100992836
19004,1630.292367,1630.299667,1,48908771,48908990,219,0.5154389277322087
19005,1630.300933,1630.3062,1,48909027,48909186,159,0.43191937257157215
19006,1630.3493,1630.360233,1,48910479,48910806,327,0.6596921689237178
19007,1630.3747,1630.3803,1,48911241,48911409,168,0.7702577754362585
19008,1630.382267,1630.389167,1,48911468,48911675,207,0.8371138360781594
19009,1630.407867,1630.4141,1,48912236,48912423,187,0.6083855250276716
19010,1630.4218,1630.5477,1,48912654,48916431,3777,0.4649289706656189
19011,1630.5494,1630.663333,1,48916482,48919899,3417,0.29366944822318775
19012,1630.6703,1630.683133,1,48920109,48920493,384,0.48025876717720817
19013,1630.694433,1630.805833,1,48920832,48924174,3342,0.5045349412066121
19014,1630.806933,1630.8107,1,48924207,48924321,114,0.9253613891583761
19015,1630.841333,1630.920033,1,48925239,48927600,2361,0.2479845128843773
19016,1630.9227,1630.9377,1,48927681,48928131,450,0.8068066789107305
19017,1630.939733,1630.943367,1,48928191,48928301,110,0.697782078346308
19018,1630.961233,1630.990433,1,48928836,48929712,876,0.5717662703274001
19019,1630.991433,1631.0455,1,48929742,48931365,1623,0.30682131336799034
19020,1631.046633,1631.052233,1,48931398,48931566,168,0.5758165172224079
19021,1631.055833,1631.058833,1,48931674,48931764,90,0.8170315117036214
19022,1631.0599,1631.070767,1,48931797,48932123,326,0.8724635626183302
19023,1631.109467,1631.114367,1,48933284,48933431,147,0.8337493362746726
19024,1631.1165,1631.1314,1,48933495,48933942,447,0.8421751406733504
19025,1631.134133,1631.1467,1,48934023,48934401,378,0.9239569541503633
19026,1631.149067,1631.158067,1,48934472,48934742,270,0.8277602780531205
19027,1631.165733,1631.209867,1,48934971,48936296,1325,0.4813904457507612
19028,1631.2281,1631.235933,1,48936843,48937077,234,0.7317863635680298
19029,1631.237467,1631.2438,1,48937124,48937314,190,0.841746272615245
19030,1631.244833,1631.2568,1,48937344,48937704,360,0.7716345073583523
19031,1631.258433,1631.263433,1,48937752,48937902,150,0.9101893746699876
19032,1631.2645,1631.271167,1,48937935,48938135,200,0.7379312997892455
19033,1631.2878,1631.328267,1,48938634,48939848,1214,0.42429314237148846
19034,1631.343867,1631.353933,1,48940316,48940617,301,0.903683128044743
19035,1631.355333,1631.388033,1,48940659,48941640,981,0.7738460911981379
19036,1631.393267,1631.4378,1,48941798,48943134,1336,0.604489501436475
19037,1631.443333,1631.488133,1,48943299,48944643,1344,0.22573521157235743
19038,1631.491733,1631.507633,1,48944751,48945228,477,0.7418445201188971
19039,1631.514967,1631.529133,1,48945449,48945873,424,0.676263965304437
19040,1631.542,1631.568467,1,48946260,48947054,794,0.43805833371681313
19041,1631.571433,1631.615067,1,48947142,48948452,1310,0.376442149132321
19042,1631.627233,1631.6308,1,48948816,48948924,108,0.6581234605123765
19043,1631.633467,1631.671033,1,48949004,48950130,1126,0.6649642371788093
19044,1631.687433,1631.693033,1,48950622,48950790,168,0.7952824013744786
19045,1631.6977,1631.7215,1,48950931,48951645,714,0.5790957135964198
19046,1631.734167,1631.825667,1,48952025,48954770,2745,0.25334533071118687
19047,1631.873533,1631.8784,1,48956205,48956352,147,0.7704039058980616
19048,1631.880167,1631.894533,1,48956405,48956835,430,0.9557015748426354
19049,1631.9045,1631.911467,1,48957135,48957344,209,0.8180629742008299
19050,1631.912467,1631.9532,1,48957374,48958596,1222,0.6703086162867741
19051,1631.957367,1631.967367,1,48958721,48959021,300,0.581483731931577
19052,1631.973767,1631.98,1,48959213,48959400,187,0.7908592014992599
19053,1631.983467,1632.105867,1,48959504,48963176,3672,0.5851371083997382
19054,1632.107567,1632.114233,1,48963227,48963426,199,0.8874271620104368
19055,1632.1171,1632.157667,1,48963513,48964730,1217,0.6145830156890822
19056,1632.1597,1632.255767,1,48964791,48967673,2882,0.5067416557201765
19057,1632.352967,1632.367833,1,48970589,48971034,445,0.4753100061204816
19058,1632.379367,1632.388,1,48971381,48971640,259,0.5300847168769558
19059,1632.389867,1632.402767,1,48971696,48972083,387,0.7714809677455671
19060,1632.404333,1632.4084,1,48972129,48972252,123,0.6636976018273517
19061,1632.418433,1632.422067,1,48972552,48972662,110,0.8835268449731652
19062,1632.4261,1632.5031,1,48972783,48975093,2310,0.8722688283048384
19063,1632.504233,1632.5092,1,48975126,48975276,150,0.9049966948456485
19064,1632.759467,1632.764633,1,48982784,48982938,154,0.4890463509179487
19065,1632.996867,1633.006267,1,48989906,48990188,282,0.29879085677664796
19066,1633.1012,1633.104267,1,48993036,48993128,92,0.6065170201660796
19067,1633.106967,1633.116133,1,48993209,48993483,274,0.5488259206142007
19068,1633.124233,1633.130933,1,48993726,48993927,201,0.3568709635212854
19069,1633.164433,1633.167867,1,48994932,48995036,104,0.8736524228965995
19070,1633.173633,1633.200233,1,48995208,48996006,798,0.8653373008834834
19071,1633.205933,1633.219867,1,48996177,48996596,419,0.913233416374979
19072,1633.237233,1633.266,1,48997116,48997980,864,0.21469270014019778
19073,1633.306267,1633.312133,1,48999188,48999363,175,-0.18555536163927921
19074,1633.3172,1633.331033,1,48999516,48999930,414,0.14284270492256418
19075,1633.410133,1633.414967,1,49002303,49002449,146,0.34555569994777585
19076,1633.695433,1633.698667,1,49010862,49010960,98,0.588717842181321
19077,1633.772333,1633.780533,1,49013169,49013415,246,0.530346593391351
19078,1633.882033,1633.891,1,49016460,49016730,270,0.5495172166111268
19079,1633.901833,1633.907767,1,49017054,49017233,179,0.7304629941202667
19080,1633.915633,1633.924633,1,49017468,49017738,270,0.7128162660504912
19081,1633.929733,1633.9394,1,49017891,49018182,291,0.3703856902228195
19082,1633.9406,1633.945133,1,49018218,49018353,135,0.7904680888265624
19083,1633.9475,1633.9888,1,49018425,49019664,1239,0.49951739713689963
19084,1634.0064,1634.023367,1,49020192,49020701,509,0.6774588719820701
19085,1634.045467,1634.048767,1,49021364,49021463,99,0.8317422981875711
19086,1634.076133,1634.1778,1,49022283,49025334,3051,0.7835400729261556
19087,1634.181067,1634.202867,1,49025432,49026086,654,0.7363316275996087
19088,1634.204367,1634.241567,1,49026131,49027247,1116,0.2550420527904417
19089,1634.244267,1634.247467,1,49027328,49027424,96,0.8032678885422617
19090,1634.2492,1634.263533,1,49027476,49027905,429,0.7981912588365283
19091,1634.266,1634.278467,1,49027980,49028354,374,0.6158030873021769
19092,1634.298867,1634.3034,1,49028966,49029102,136,0.7920881604987114
19093,1634.305067,1634.317333,1,49029152,49029519,367,0.7360959155480332
19094,1634.3282,1634.348267,1,49029846,49030448,602,0.6796247377130573
19095,1634.362,1634.387567,1,49030860,49031627,767,0.561132206998155
19096,1634.3936,1634.417267,1,49031808,49032518,710,0.2568025912178835
19097,1634.419667,1634.4529,1,49032590,49033587,997,0.3411850711655085
19098,1634.457133,1634.461367,1,49033713,49033841,128,0.13600513757738245
19099,1634.4722,1634.476367,1,49034166,49034291,125,0.8888283504644493
19100,1634.484867,1634.488333,1,49034546,49034649,103,0.8160581913890108
19101,1634.503367,1634.5232,1,49035101,49035696,595,0.4136638247445365
19102,1634.532567,1634.5396,1,49035977,49036188,211,0.8104276056796581
19103,1634.549667,1634.553633,1,49036490,49036608,118,0.9688001201391929
19104,1634.780867,1634.788433,1,49043426,49043652,226,0.7783487587310876
19105,1634.9083,1634.9347,1,49047249,49048041,792,0.5996090548124975
19106,1634.9568,1634.9612,1,49048704,49048836,132,0.8410001868856956
19107,1634.9658,1634.973033,1,49048974,49049190,216,0.32862487048157374
19108,1634.978867,1634.985933,1,49049366,49049577,211,0.6683639833397524
19109,1635.005233,1635.015367,1,49050156,49050461,305,0.39525291734441215
19110,1635.019,1635.025767,1,49050570,49050773,203,0.8551366660426066
19111,1635.027467,1635.0443,1,49050824,49051329,505,0.6711770493779131
19112,1635.0542,1635.0659,1,49051626,49051977,351,0.7560324392880786
19113,1635.1357,1635.1389,1,49054071,49054167,96,0.8104690701210627
19114,1635.168467,1635.1836,1,49055054,49055508,454,0.7732932799702614
19115,1635.236133,1635.261667,1,49057083,49057850,767,0.8654806792142358
19116,1635.522033,1635.5347,1,49065660,49066041,381,0.6785755135457957
19117,1635.670867,1635.686167,1,49070126,49070585,459,0.5795848843607244
19118,1635.7524,1635.764367,1,49072572,49072931,359,0.7784994428237356
19119,1635.776233,1635.781033,1,49073286,49073430,144,0.9497794515518037
19120,1635.7829,1635.790433,1,49073487,49073712,225,0.7429095790845428
19121,1635.792467,1635.795667,1,49073774,49073870,96,0.5712295263786052
19122,1635.806033,1635.809467,1,49074180,49074284,104,0.9663880931402237
19123,1635.8523,1635.861467,1,49075569,49075844,275,0.4326148065522779
19124,1635.867367,1635.871067,1,49076021,49076132,111,0.8054594846060076
19125,1635.917533,1635.922733,1,49077525,49077681,156,0.4911137327915926
19126,1635.931367,1635.935067,1,49077941,49078052,111,0.847960622949072
19127,1636.161333,1636.1748,1,49084839,49085244,405,0.4342521057403452
19128,1636.323033,1636.329467,1,49089690,49089884,194,0.8659978709268027
19129,1636.331167,1636.338533,1,49089935,49090155,220,0.7341600119156734
19130,1636.358533,1636.373633,1,49090755,49091208,453,0.7790553577035569
19131,1636.378833,1636.382467,1,49091364,49091474,110,0.8908087212599775
19132,1636.395067,1636.400867,1,49091852,49092026,174,0.8290090696818061
19133,1636.603233,1636.659933,1,49098096,49099797,1701,0.8240250984481199
19134,1636.6671,1636.673033,1,49100013,49100190,177,0.9551639069864913
19135,1636.674233,1636.6819,1,49100226,49100457,231,0.40647138196949645
19136,1636.6833,1636.697567,1,49100499,49100927,428,0.6129237884299605
19137,1636.698667,1636.708367,1,49100960,49101251,291,0.9299578940984244
19138,1636.739133,1636.745733,1,49102173,49102371,198,0.8741960565220508
19139,1636.788233,1636.818133,1,49103646,49104543,897,0.61189004817121
19140,1636.8344,1636.850267,1,49105032,49105508,476,0.7309147762611949
19141,1636.859767,1636.882333,1,49105793,49106469,676,0.5993481491703344
19142,1636.884167,1636.9027,1,49106525,49107081,556,0.7397186220924858
19143,1636.912367,1636.924633,1,49107371,49107738,367,0.6776764207013011
19144,1636.9289,1636.960033,1,49107867,49108800,933,0.44015789870848926
19145,1636.964467,1636.985533,1,49108934,49109565,631,-0.20246921220949018
19146,1637.0172,1637.029967,1,49110516,49110899,383,0.2634570729884095
19147,1637.0323,1637.0466,1,49110969,49111398,429,0.19500183950734223
19148,1637.047833,1637.076033,1,49111434,49112280,846,0.2310188606294005
19149,1637.0842,1637.0956,1,49112526,49112868,342,0.7797782189151148
19150,1637.0966,1637.100833,1,49112898,49113024,126,0.691944349241269
19151,1637.103633,1637.107867,1,49113108,49113236,128,0.8390138983215436
19152,1637.116067,1637.127433,1,49113482,49113822,340,0.832418076744047
19153,1637.132967,1637.148833,1,49113989,49114464,475,0.9055672775613025
19154,1637.231833,1637.427367,1,49116954,49122821,5867,0.5616959424000971
19155,1637.429367,1637.437867,1,49122881,49123136,255,0.8714191160666019
19156,1637.9959,1637.9994,1,49139877,49139982,105,0.5381708942307528
19157,1638.1962,1638.216967,1,49145886,49146509,623,0.16203102346228068
19158,1638.387333,1638.392267,1,49151619,49151768,149,-0.08779480955632595
19159,1638.395633,1638.420933,1,49151868,49152627,759,0.6488910821635004
19160,1638.422167,1638.425833,1,49152665,49152774,109,0.8744317282192506
19161,1638.435867,1638.449033,1,49153076,49153470,394,0.92276186443493
19162,1638.466833,1638.479933,1,49154004,49154397,393,0.7483512418895103
19163,1638.482767,1638.548733,1,49154483,49156461,1978,0.5971361233776706
19164,1638.566233,1638.576167,1,49156986,49157285,299,0.7689872965858653
19165,1638.577433,1638.6786,1,49157322,49160358,3036,0.4692166782170709
19166,1638.680433,1638.6896,1,49160412,49160688,276,0.6419517864578337
19167,1638.696133,1638.756333,1,49160883,49162689,1806,0.33507525385258125
19168,1638.7575,1638.7737,1,49162725,49163211,486,0.903848792965291
19169,1638.774967,1638.782333,1,49163249,49163469,220,0.8741959095172375
19170,1638.786933,1638.794467,1,49163607,49163834,227,0.8181392899822467
19171,1638.799667,1638.833333,1,49163990,49164999,1009,0.5500976848812514
19172,1638.838767,1638.898933,1,49165163,49166967,1804,0.4367304531331755
19173,1638.901133,1638.908133,1,49167033,49167243,210,0.7122102596028093
19174,1638.916433,1638.944667,1,49167492,49168340,848,0.5964872799746682
19175,1638.95,1638.9806,1,49168500,49169418,918,0.3685458827051267
19176,1638.9822,1638.993,1,49169466,49169790,324,0.7762045559279435
19177,1639.005333,1639.0114,1,49170159,49170342,183,0.6780368714461121
19178,1639.015333,1639.034533,1,49170459,49171035,576,0.818235992235263
19179,1639.035667,1639.065833,1,49171070,49171974,904,0.5887030965018527
19180,1639.0708,1639.1268,1,49172124,49173804,1680,0.31135989143489207
19181,1639.1411,1639.1474,1,49174233,49174422,189,0.2897387378464212
19182,1639.1523,1639.175333,1,49174569,49175259,690,0.4734018902406515
19183,1639.1874,1639.240967,1,49175622,49177229,1607,0.2977339009992229
19184,1639.250033,1639.260533,1,49177500,49177815,315,0.7301112684846482
19185,1639.2858,1639.2892,1,49178574,49178676,102,0.9465744671249964
19186,1639.293333,1639.3154,1,49178799,49179462,663,0.6766057489645868
19187,1639.319867,1639.352367,1,49179596,49180571,975,0.613940520760099
19188,1639.353767,1639.3628,1,49180613,49180884,271,0.8069161377226436
19189,1639.378633,1639.450767,1,49181358,49183523,2165,0.40387929312392246
19190,1639.454933,1639.4638,1,49183647,49183914,267,0.5043293843364481
19191,1639.486367,1639.508667,1,49184591,49185260,669,0.5020759452349162
19192,1639.509933,1639.516633,1,49185297,49185498,201,0.8660055352030667
19193,1639.5194,1639.555533,1,49185582,49186665,1083,0.4172758267394344
19194,1639.5639,1639.6144,1,49186917,49188432,1515,0.3112474860622153
19195,1639.6218,1639.625867,1,49188654,49188776,122,0.6906100065195389
19196,1639.630533,1639.635833,1,49188915,49189074,159,0.6902335958820203
19197,1639.6531,1639.6771,1,49189593,49190313,720,0.5247606141380375
19198,1639.6871,1639.736667,1,49190613,49192100,1487,0.40423361710439126
19199,1639.737733,1639.741633,1,49192131,49192248,117,0.8282430634487465
19200,1639.747567,1639.7535,1,49192427,49192605,178,0.77615926607627
19201,1639.755833,1639.764867,1,49192674,49192946,272,0.9737014564079178
19202,1639.7699,1639.832367,1,49193097,49194971,1874,0.44509390018830475
19203,1639.838633,1639.882033,1,49195158,49196460,1302,0.19452038776748368
19204,1639.897733,1639.902433,1,49196931,49197072,141,0.43449116245765257
19205,1639.9126,1639.9332,1,49197378,49197996,618,0.6206513684038288
19206,1639.934267,1639.939933,1,49198028,49198197,169,0.8695901313092327
19207,1639.947133,1639.977767,1,49198413,49199333,920,0.6748346072179022
19208,1639.9828,1640.0233,1,49199484,49200699,1215,0.5257446063936911
19209,1640.033133,1640.083267,1,49200993,49202498,1505,0.27230465951684507
19210,1640.102433,1640.1132,1,49203072,49203396,324,0.583385033070825
19211,1640.115067,1640.121567,1,49203452,49203647,195,0.733477183967028
19212,1640.1229,1640.134267,1,49203687,49204028,341,0.786502935660453
19213,1640.1357,1640.143267,1,49204071,49204298,227,0.8799092495798398
19214,1640.1479,1640.153767,1,49204437,49204613,176,0.7865959248037727
19215,1640.159833,1640.1784,1,49204794,49205352,558,0.5823487518954507
19216,1640.186133,1640.2426,1,49205583,49207278,1695,0.2897046408505113
19217,1640.2518,1640.2591,1,49207554,49207773,219,0.8206409531584993
19218,1640.2632,1640.273167,1,49207896,49208195,299,0.6517138909135933
19219,1640.275533,1640.304067,1,49208265,49209122,857,0.7641637507926676
19220,1640.308,1640.318067,1,49209240,49209542,302,0.8579754291865043
19221,1640.326633,1640.3509,1,49209798,49210527,729,0.6313661896408453
19222,1640.3648,1640.395733,1,49210944,49211871,927,0.6172289640022519
19223,1640.397367,1640.4307,1,49211921,49212921,1000,0.16940830495517128
19224,1640.4321,1640.4582,1,49212963,49213746,783,0.5568021710506155
19225,1640.500967,1640.530133,1,49215029,49215903,874,0.8383888743593223
19226,1640.531133,1640.542767,1,49215933,49216283,350,0.8568339674243679
19227,1640.5442,1640.591433,1,49216326,49217742,1416,0.7576862885842116
19228,1640.592967,1640.617533,1,49217789,49218525,736,0.5109391915936868
19229,1640.631233,1640.6361,1,49218936,49219083,147,0.7965703228249491
19230,1640.649667,1640.799333,1,49219490,49223979,4489,0.5659779315698015
19231,1640.920233,1640.938967,1,49227606,49228169,563,0.32817883173016965
19232,1640.94,1640.951667,1,49228200,49228550,350,0.8258091843928946
19233,1640.952767,1641.0161,1,49228583,49230483,1900,0.7832849165179422
19234,1641.1489,1641.151933,1,49234467,49234557,90,0.6343714679447847
19235,1641.452733,1641.456333,1,49243581,49243689,108,0.777627223279118
19236,1641.522133,1641.547733,1,49245663,49246431,768,0.5435608003593706
19237,1641.549267,1641.587333,1,49246478,49247619,1141,0.7492318413218578
19238,1641.592833,1641.6506,1,49247784,49249518,1734,0.8916279408183116
19239,1641.656767,1641.674167,1,49249703,49250225,522,0.5150066096702316
19240,1641.675833,1641.7024,1,49250274,49251072,798,0.7043822234416737
19241,1641.703433,1641.712867,1,49251102,49251386,284,0.9061918814410614
19242,1641.718867,1641.735167,1,49251566,49252055,489,0.8522703906689575
19243,1641.748567,1641.7566,1,49252457,49252698,241,0.6849216026771959
19244,1641.7674,1641.775,1,49253022,49253250,228,0.4606525822138719
19245,1641.776433,1641.807267,1,49253292,49254218,926,0.11514541193304548
19246,1641.8117,1641.899533,1,49254351,49256985,2634,0.2745462710425261
19247,1641.902,1642.064233,1,49257060,49261926,4866,0.5086165925191348
19248,1642.0654,1642.1393,1,49261962,49264179,2217,0.7305585935421576
19249,1642.1446,1642.1542,1,49264338,49264626,288,0.8276314218765217
19250,1642.1555,1642.2011,1,49264665,49266033,1368,0.7128530111629411
19251,1642.203833,1642.297,1,49266114,49268910,2796,0.4918392827950178
19252,1642.319533,1642.325967,1,49269585,49269779,194,0.4715066917042943
19253,1642.328567,1642.358167,1,49269857,49270745,888,0.44267589720437095
19254,1642.413533,1642.423067,1,49272405,49272692,287,0.8034437104937336
19255,1642.647133,1642.6558,1,49279413,49279674,261,0.10626813016924874
19256,1642.674567,1642.6786,1,49280237,49280358,121,0.03179210630869563
19257,1643.054533,1643.082133,1,49291635,49292463,828,-0.04171511410452128
19258,1643.233867,1643.263767,1,49297016,49297913,897,0.24605131041690523
19259,1643.268533,1643.286033,1,49298055,49298580,525,0.4633439891254006
19260,1643.288333,1643.298133,1,49298649,49298943,294,0.8522536693778292
19261,1643.308433,1643.312967,1,49299252,49299389,137,0.9547514986521887
19262,1643.314333,1643.324267,1,49299429,49299728,299,0.6421874446897052
19263,1643.327433,1643.333667,1,49299822,49300010,188,0.9030858214475815
19264,1643.335567,1643.343467,1,49300067,49300304,237,0.8263524739862991
19265,1643.578467,1643.6297,1,49307354,49308891,1537,0.5210987369331365
19266,1643.631167,1643.635333,1,49308935,49309059,124,0.7075401701287164
19267,1643.645667,1643.6488,1,49309370,49309464,94,0.8739619111018255
19268,1643.650133,1643.6596,1,49309503,49309788,285,0.5290272841082857
19269,1643.674,1643.6772,1,49310220,49310316,96,0.6852266946282002
19270,1643.710867,1643.7184,1,49311326,49311552,226,0.8707944654930931
19271,1643.7265,1643.736167,1,49311795,49312085,290,0.5137770672963824
19272,1643.738633,1643.741667,1,49312158,49312250,92,0.8413810400396726
19273,1643.798667,1643.804433,1,49313960,49314132,172,0.8399631578496155
19274,1643.9218,1643.937267,1,49317654,49318118,464,0.1386950324853669
19275,1644.0282,1644.032333,1,49320846,49320969,123,0.12681805216692943
19276,1644.061067,1644.076333,1,49321832,49322289,457,0.1825062573114861
19277,1644.084067,1644.088733,1,49322522,49322661,139,0.6117068560252481
19278,1644.2073,1644.2105,1,49326219,49326315,96,0.668812836251337
19279,1644.2191,1644.2261,1,49326573,49326783,210,0.6255281944109706
19280,1644.2305,1644.246033,1,49326915,49327380,465,0.10171758191467911
19281,1644.500033,1644.504067,1,49335000,49335122,122,0.6304857431762785
19282,1644.541867,1644.546333,1,49336256,49336389,133,0.20948901700964054
19283,1644.5487,1644.556633,1,49336461,49336698,237,0.2323777862480352
19284,1644.589733,1644.603,1,49337691,49338090,399,-0.006498947911688016
19285,1644.604633,1644.6159,1,49338138,49338477,339,-0.1992431430891201
19286,1644.617,1644.6227,1,49338510,49338681,171,0.01759310817725162
19287,1644.675533,1644.7493,1,49340265,49342479,2214,0.6940683252401961
19288,1644.785833,1644.821067,1,49343574,49344632,1058,0.8038835037364553
19289,1644.8223,1644.8459,1,49344669,49345377,708,0.626941574056203
19290,1644.856167,1644.881367,1,49345685,49346441,756,0.8581253031645063
19291,1644.926633,1644.9367,1,49347798,49348101,303,0.48029990518611154
19292,1644.942567,1644.958033,1,49348277,49348740,463,0.6453730962698323
19293,1644.9845,1644.990633,1,49349535,49349718,183,0.7508171503391625
19294,1645.0747,1645.093633,1,49352241,49352808,567,0.12834318466541586
19295,1645.0955,1645.105933,1,49352865,49353177,312,0.5813548403738614
19296,1645.357667,1645.3687,1,49360730,49361061,331,0.6181284536493206
19297,1645.401267,1645.416433,1,49362038,49362492,454,0.8764893270831287
19298,1645.4438,1645.4469,1,49363314,49363407,93,0.8924968931960712
19299,1645.7535,1645.767567,1,49372605,49373027,422,0.82100807375947
19300,1646.193367,1646.202833,1,49385801,49386084,283,0.272195360022026
19301,1646.204,1646.213467,1,49386120,49386404,284,0.8641423812167233
19302,1646.219367,1646.234033,1,49386581,49387020,439,0.877368833785808
19303,1646.3113,1646.317167,1,49389339,49389515,176,0.013574535665722661
19304,1646.465,1646.475067,1,49393950,49394252,302,0.5651937789334446
19305,1646.515067,1646.607967,1,49395452,49398239,2787,0.27085897326193004
19306,1646.612667,1646.6228,1,49398380,49398684,304,0.7314844000878685
19307,1646.625167,1646.6311,1,49398755,49398933,178,0.8526373258481361
19308,1646.6443,1646.6479,1,49399329,49399437,108,0.7062623004636658
19309,1646.652533,1646.6578,1,49399575,49399734,159,0.5470083174939977
19310,1647.028967,1647.033433,1,49410869,49411002,133,0.8882906561780776
19311,1647.209067,1647.2252,1,49416272,49416756,484,0.6578716175851828
19312,1647.241067,1647.2468,1,49417232,49417404,172,0.6464547142272554
19313,1647.363633,1647.367667,1,49420908,49421030,122,0.6398174570700795
19314,1647.371567,1647.3956,1,49421147,49421868,721,0.3472132778651947
19315,1647.397533,1647.411333,1,49421925,49422339,414,0.38120119214654713
19316,1647.415967,1647.425467,1,49422479,49422764,285,0.9004892431437812
19317,1647.4313,1647.4353,1,49422939,49423059,120,0.42254875540360864
19318,1647.465033,1647.469467,1,49423950,49424084,134,0.9023807014162591
19319,1647.4832,1647.510533,1,49424496,49425315,819,0.8489476161165335
19320,1647.511933,1647.516533,1,49425357,49425495,138,0.8456679965682156
19321,1647.535333,1647.539067,1,49426059,49426172,113,0.9153542365986679
19322,1647.540767,1647.5612,1,49426223,49426836,613,0.81812274604595
19323,1647.562333,1647.572067,1,49426869,49427162,293,0.6481002589784219
19324,1647.577,1647.582233,1,49427310,49427466,156,0.8824701216368975
19325,1647.5835,1647.5905,1,49427505,49427715,210,0.8940851427400008
19326,1647.5919,1647.5954,1,49427757,49427862,105,0.7153525650768964
19327,1647.597233,1647.604933,1,49427916,49428147,231,0.95979418806717
19328,1647.605967,1647.6212,1,49428179,49428636,457,0.8420991416389381
19329,1647.6293,1647.6696,1,49428879,49430088,1209,0.9083959654191134
19330,1647.6748,1647.704567,1,49430244,49431137,893,0.844882331082707
19331,1647.705567,1647.709033,1,49431167,49431270,103,0.865074067122044
19332,1647.728267,1647.828833,1,49431848,49434864,3016,0.48574941310657693
19333,1647.8361,1647.845467,1,49435083,49435364,281,0.8324924853038393
19334,1647.8497,1647.8549,1,49435491,49435647,156,0.6611289958477844
19335,1647.856967,1647.861567,1,49435709,49435847,138,0.7783162935960246
19336,1647.867633,1647.8912,1,49436028,49436736,708,0.7811448352158044
19337,1647.892567,1647.942033,1,49436777,49438260,1483,0.7987298308109865
19338,1647.949433,1647.9967,1,49438482,49439901,1419,0.5334865783203231
19339,1648.019667,1648.091133,1,49440590,49442733,2143,0.5662781650936192
19340,1648.092767,1648.102867,1,49442783,49443086,303,0.8947586668230489
19341,1648.113867,1648.1195,1,49443416,49443585,169,0.8305712032060069
19342,1648.134733,1648.144033,1,49444041,49444320,279,0.8316020615091387
19343,1648.145767,1648.1628,1,49444373,49444884,511,0.7737625508080664
19344,1648.164733,1648.214167,1,49444941,49446425,1484,0.3092084140312437
19345,1648.240733,1648.272233,1,49447221,49448166,945,0.7308943423436818
19346,1648.273233,1648.276833,1,49448196,49448304,108,0.7545946815011072
19347,1648.282233,1648.293267,1,49448466,49448798,332,0.6008068395024875
19348,1648.294667,1648.3069,1,49448840,49449207,367,0.6795836482196499
19349,1648.309733,1648.348633,1,49449291,49450458,1167,0.7704007315127614
19350,1648.361067,1648.4096,1,49450832,49452288,1456,0.31706615089506435
19351,1648.4327,1648.519467,1,49452981,49455584,2603,0.3817032898585557
19352,1648.552567,1648.575967,1,49456577,49457279,702,0.6850698432454555
19353,1648.577067,1648.631767,1,49457312,49458953,1641,0.37062349327016697
19354,1648.658967,1648.693967,1,49459769,49460819,1050,0.679319164108555
19355,1648.707833,1648.731833,1,49461234,49461954,720,0.6477093363111082
19356,1648.7416,1648.7891,1,49462248,49463673,1425,0.3880638614562534
19357,1648.790533,1648.793867,1,49463715,49463816,101,0.8661167564455039
19358,1648.822933,1648.839833,1,49464687,49465194,507,0.612909924379816
19359,1648.8454,1648.856533,1,49465362,49465695,333,0.6579919563020777
19360,1648.859967,1648.8892,1,49465799,49466676,877,0.6163943997720787
19361,1648.8972,1648.931633,1,49466916,49467948,1032,0.2788712439389636
19362,1648.9335,1648.943167,1,49468005,49468295,290,0.8858879247244843
19363,1648.976067,1649.0051,1,49469282,49470153,871,0.512096277168585
19364,1649.0083,1649.058033,1,49470249,49471740,1491,0.31799948991972793
19365,1649.080133,1649.136767,1,49472403,49474103,1700,0.5513257409350726
19366,1649.143367,1649.162967,1,49474301,49474889,588,0.24742421215655883
19367,1649.165967,1649.177833,1,49474979,49475334,355,0.8385506554482001
19368,1649.181333,1649.233167,1,49475439,49476995,1556,0.6834580703111163
19369,1649.234633,1649.239267,1,49477038,49477178,140,0.8938661082625913
19370,1649.2413,1649.2945,1,49477239,49478835,1596,0.33423290673790157
19371,1649.319967,1649.323533,1,49479599,49479705,106,0.8916914289492636
19372,1649.327633,1649.371767,1,49479828,49481153,1325,0.8179070428893764
19373,1649.3749,1649.3842,1,49481247,49481526,279,0.8989929460442765
19374,1649.388967,1649.430033,1,49481669,49482900,1231,0.5925686607009665
19375,1649.443567,1649.5319,1,49483307,49485957,2650,0.18640389810184663
19376,1649.594433,1649.598333,1,49487832,49487949,117,0.7437386746725633
19377,1649.599633,1649.648133,1,49487988,49489443,1455,0.8257167045595728
19378,1649.6841,1649.689233,1,49490523,49490676,153,0.5651948009180247
19379,1649.698033,1649.702133,1,49490940,49491063,123,0.8770552224284862
19380,1649.7095,1649.7137,1,49491285,49491411,126,0.7929681230290915
19381,1649.714867,1649.719367,1,49491446,49491581,135,0.8653599205145899
19382,1649.7225,1649.873333,1,49491675,49496199,4524,0.5065766635983917
19383,1649.9641,1649.979667,1,49498923,49499390,467,-0.11623699397335065
19384,1650.531067,1650.555933,1,49515932,49516677,745,0.830208231601854
19385,1650.561567,1650.566033,1,49516847,49516980,133,0.8955231967482769
19386,1650.5722,1650.594667,1,49517166,49517840,674,0.7288676001174063
19387,1650.595833,1650.6081,1,49517874,49518243,369,0.3033236109461141
19388,1650.621633,1650.630967,1,49518648,49518929,281,0.5541368014242536
19389,1650.639267,1650.687167,1,49519178,49520615,1437,0.7295748011836518
19390,1650.697467,1650.717533,1,49520924,49521525,601,0.726906462561002
19391,1650.7219,1650.787533,1,49521657,49523625,1968,0.38857258611115336
19392,1650.793933,1650.811633,1,49523817,49524348,531,0.7496923655890898
19393,1650.817267,1650.823,1,49524518,49524690,172,0.8708276723145182
19394,1650.835133,1650.859267,1,49525053,49525778,725,0.3616864772131597
19395,1650.8705,1650.9062,1,49526115,49527186,1071,0.06872552833666024
19396,1650.912233,1650.949367,1,49527366,49528481,1115,0.23562774420495386
19397,1650.954333,1650.969633,1,49528629,49529088,459,0.2983225925353904
19398,1650.980533,1651.106167,1,49529415,49533185,3770,0.314380765034666
19399,1651.111533,1651.119633,1,49533345,49533588,243,0.7058456189711321
19400,1651.121133,1651.291333,1,49533633,49538739,5106,0.21732472502587055
19401,1651.295067,1651.432267,1,49538852,49542968,4116,0.30754841927335835
19402,1651.433267,1651.513033,1,49542998,49545390,2392,0.16196346897244135
19403,1651.524333,1651.537867,1,49545729,49546136,407,0.16689650534800443
19404,1651.564767,1651.589933,1,49546943,49547697,754,0.07948262057508772
19405,1651.5955,1651.6105,1,49547865,49548315,450,0.161981930716869
19406,1651.7799,1651.7878,1,49553397,49553634,237,0.16719935640025188
19407,1651.8714,1651.889933,1,49556142,49556697,555,0.10283668468788722
19408,1651.904933,1651.911,1,49557147,49557330,183,0.27533551977972504
19409,1652.0038,1652.028233,1,49560114,49560846,732,0.30804896570906304
19410,1652.057567,1652.072567,1,49561727,49562177,450,0.8893294830928822
19411,1652.1089,1652.118267,1,49563267,49563548,281,0.5401072904473413
19412,1652.319167,1652.3378,1,49569575,49570134,559,-0.06925610612987326
19413,1652.384633,1652.389933,1,49571538,49571697,159,0.8341556989992347
19414,1652.397167,1652.400933,1,49571915,49572027,112,-0.24703450888358303
19415,1652.4041,1652.408767,1,49572123,49572263,140,0.7992632569731772
19416,1652.4266,1652.431567,1,49572798,49572947,149,0.8725954058237332
19417,1652.457667,1652.4617,1,49573730,49573851,121,0.839671500243011
19418,1652.507267,1652.514633,1,49575218,49575438,220,0.8142724802052478
19419,1652.7497,1652.774033,1,49582491,49583220,729,0.2110548201644021
19420,1652.776367,1652.783267,1,49583291,49583498,207,0.8146289087244034
19421,1652.8149,1652.8289,1,49584447,49584867,420,0.6428120415781348
19422,1652.8309,1652.853267,1,49584927,49585598,671,0.8481212871128044
19423,1652.8648,1652.868533,1,49585944,49586055,111,0.8736769541497619
19424,1652.9008,1652.9146,1,49587024,49587438,414,0.8472646478538592
19425,1652.934333,1652.938533,1,49588029,49588155,126,0.8099040189027731
19426,1652.9772,1652.986567,1,49589316,49589597,281,0.6820711011163003
19427,1653.008033,1653.0148,1,49590240,49590444,204,0.8031752186147418
19428,1653.016,1653.025633,1,49590480,49590768,288,0.09196581538415478
19429,1653.046767,1653.0675,1,49591403,49592025,622,-0.051665348543476854
19430,1653.0685,1653.080167,1,49592055,49592405,350,0.6954046332400184
19431,1653.0859,1653.110933,1,49592577,49593327,750,0.06871550883319236
19432,1653.112433,1653.148,1,49593372,49594440,1068,0.6628055906244693
19433,1653.157767,1653.171133,1,49594733,49595133,400,0.7751312234233848
19434,1653.555133,1653.567567,1,49606653,49607027,374,0.6742256931977049
19435,1653.6287,1653.637433,1,49608861,49609122,261,0.5396486039656292
19436,1653.646833,1653.650667,1,49609404,49609520,116,0.6888830380500688
19437,1653.657133,1653.6637,1,49609713,49609911,198,0.7800767771895467
19438,1653.8052,1653.808367,1,49614156,49614251,95,0.9131153955832358
19439,1653.8191,1653.823133,1,49614573,49614693,120,0.6655282167610194
19440,1653.869567,1653.9151,1,49616087,49617453,1366,0.6514448343906043
19441,1653.970567,1653.979433,1,49619117,49619382,265,0.5720344507855417
19442,1654.040567,1654.0566,1,49621217,49621698,481,-0.1670855253431934
19443,1654.057833,1654.060933,1,49621734,49621827,93,-0.15802317186653878
19444,1654.8582,1654.932533,1,49645746,49647975,2229,0.6510915731067759
19445,1654.934233,1654.9706,1,49648026,49649118,1092,0.7145983742576778
19446,1654.974933,1654.994633,1,49649247,49649838,591,0.8604288179843476
19447,1655.002967,1655.017167,1,49650089,49650515,426,0.6482682255927399
19448,1655.0543,1655.063167,1,49651629,49651895,266,0.8260499195856914
19449,1655.093033,1655.105567,1,49652790,49653167,377,0.9204560394319017
19450,1655.106967,1655.115833,1,49653209,49653474,265,0.9540380919289992
19451,1655.116967,1655.1206,1,49653509,49653618,109,0.8039962646701289
19452,1655.124,1655.131967,1,49653720,49653959,239,0.8706410411530837
19453,1655.1478,1655.1562,1,49654434,49654686,252,0.6984003755637896
19454,1655.1635,1655.175067,1,49654905,49655252,347,0.7292310579102442
19455,1655.188733,1655.196733,1,49655661,49655901,240,0.5582958371474338
19456,1655.2009,1655.2121,1,49656027,49656363,336,0.6406454744569393
19457,1655.229367,1655.244833,1,49656881,49657344,463,0.25643564242483763
19458,1655.465067,1655.482933,1,49663952,49664487,535,0.05507889206527256
19459,1655.507867,1655.5274,1,49665236,49665822,586,0.04476603308388483
19460,1655.720567,1655.745733,1,49671617,49672371,754,0.13401206412140734
19461,1655.8777,1655.884733,1,49676331,49676541,210,0.5533845669744764
19462,1655.895067,1655.918967,1,49676852,49677569,717,0.8203136863934273
19463,1655.973767,1655.9811,1,49679213,49679433,220,0.9134514193392327
19464,1655.989633,1655.996867,1,49679688,49679906,218,0.8909402294101179
19465,1656.007,1656.0122,1,49680210,49680366,156,0.41339821601093696
19466,1656.087267,1656.0908,1,49682618,49682724,106,0.3262898393178042
19467,1656.125367,1656.128933,1,49683761,49683867,106,-0.21664044742459132
19468,1656.1318,1656.137167,1,49683954,49684115,161,0.25209187854888804
19469,1656.2059,1656.210333,1,49686177,49686309,132,0.588313473027785
19470,1656.211333,1656.2284,1,49686339,49686852,513,0.8934613460970093
19471,1656.237467,1656.264433,1,49687124,49687932,808,0.753539577816078
19472,1656.267667,1656.3287,1,49688030,49689861,1831,0.7720373787744241
19473,1656.329867,1656.340467,1,49689896,49690214,318,0.4838067395714223
19474,1656.3546,1656.369067,1,49690638,49691072,434,0.48052886345319956
19475,1656.370067,1656.3854,1,49691102,49691562,460,0.6686903657551654
19476,1656.392733,1656.399133,1,49691781,49691973,192,0.7200000889358924
19477,1656.401933,1656.4088,1,49692057,49692264,207,0.4576562117215858
19478,1656.445233,1656.455967,1,49693356,49693679,323,0.8932204397363166
19479,1656.460833,1656.498367,1,49693824,49694951,1127,0.7706252234391114
19480,1656.499733,1656.508167,1,49694991,49695245,254,0.605164251099041
19481,1656.5135,1656.5249,1,49695405,49695747,342,0.8604022424581109
19482,1656.526533,1656.542867,1,49695795,49696286,491,0.7795670954293421
19483,1656.5443,1656.550633,1,49696329,49696518,189,0.8587840116741077
19484,1656.551667,1656.558133,1,49696550,49696743,193,0.9152285851194016
19485,1656.560667,1656.614567,1,49696820,49698437,1617,0.8587146357122729
19486,1656.619833,1656.658233,1,49698594,49699746,1152,0.6216662052870758
19487,1656.659367,1656.671133,1,49699781,49700133,352,0.8910414133909987
19488,1656.6727,1656.719167,1,49700181,49701575,1394,0.8287133420571284
19489,1656.7205,1656.724733,1,49701615,49701741,126,0.7526576786083438
19490,1656.725933,1656.766,1,49701777,49702980,1203,0.45323506930109897
19491,1656.7758,1656.784333,1,49703274,49703529,255,0.8778399418687163
19492,1656.787167,1656.861067,1,49703615,49705832,2217,0.4417340427901233
19493,1656.868933,1656.890267,1,49706067,49706708,641,0.7033468550642414
19494,1656.895333,1656.966233,1,49706859,49708986,2127,0.6296584459915372
19495,1656.978067,1656.986133,1,49709342,49709583,241,0.5444469875541081
19496,1656.990367,1657.024067,1,49709711,49710722,1011,0.5990178339984978
19497,1657.0279,1657.076067,1,49710837,49712282,1445,0.45463637834388787
19498,1657.084467,1657.089967,1,49712534,49712699,165,0.929648994351669
19499,1657.0938,1657.099267,1,49712814,49712978,164,0.7055995923113405
19500,1657.124567,1657.148667,1,49713737,49714460,723,0.4667239748567601
19501,1657.152567,1657.1911,1,49714577,49715733,1156,0.27569790560944296
19502,1657.192533,1657.203667,1,49715775,49716110,335,0.9223852889444893
19503,1657.222233,1657.2275,1,49716666,49716825,159,0.8134369759891332
19504,1657.2331,1657.264933,1,49716993,49717947,954,0.4316294741866222
19505,1657.268233,1657.3102,1,49718046,49719306,1260,0.39597538866462423
19506,1657.314567,1657.318167,1,49719437,49719545,108,0.8132589997132523
19507,1657.3282,1657.3338,1,49719846,49720014,168,0.7124855402418493
19508,1657.339567,1657.343133,1,49720187,49720293,106,0.8124891642352543
19509,1657.3443,1657.3724,1,49720329,49721172,843,0.4512192190247991
19510,1657.378333,1657.4366,1,49721349,49723098,1749,0.32924380605190884
19511,1657.4449,1657.448467,1,49723347,49723454,107,0.5705588471655467
19512,1657.455667,1657.4753,1,49723670,49724259,589,0.42199388712046354
19513,1657.477733,1657.481067,1,49724331,49724432,101,0.8025618619263128
19514,1657.4884,1657.531733,1,49724652,49725951,1299,0.3129666613897912
19515,1657.552467,1657.561,1,49726574,49726830,256,0.4790881141438326
19516,1657.5664,1657.594433,1,49726992,49727832,840,0.49089248782423683
19517,1657.603733,1657.626767,1,49728111,49728803,692,0.5703047159371867
19518,1657.6348,1657.669567,1,49729044,49730087,1043,0.41122595486862146
19519,1657.679033,1657.723533,1,49730370,49731705,1335,0.33971666780757104
19520,1657.744833,1657.7485,1,49732344,49732455,111,-0.3066164608134818
19521,1657.756333,1657.760367,1,49732689,49732811,122,0.7724353499574753
19522,1657.761367,1657.7878,1,49732841,49733634,793,0.5204890115685028
19523,1657.793167,1657.823767,1,49733795,49734713,918,0.31652370717850264
19524,1657.825433,1657.844633,1,49734762,49735338,576,0.7722573670634841
19525,1657.857333,1657.861467,1,49735719,49735844,125,0.7046326591040026
19526,1657.864467,1657.896767,1,49735934,49736903,969,0.4132627764294776
19527,1657.9044,1657.9421,1,49737132,49738263,1131,0.6781255880032029
19528,1657.951233,1658.009767,1,49738536,49740293,1757,0.34100306394035435
19529,1658.0378,1658.0622,1,49741134,49741866,732,0.4401285286433255
19530,1658.070633,1658.093833,1,49742118,49742814,696,0.530958697823261
19531,1658.0955,1658.108133,1,49742865,49743243,378,0.7714592899825744
19532,1658.114867,1658.170833,1,49743446,49745124,1678,0.32417664556393305
19533,1658.1891,1658.1936,1,49745673,49745808,135,0.9259620604188291
19534,1658.2106,1658.232767,1,49746318,49746983,665,0.645673566843665
19535,1658.2341,1658.2398,1,49747023,49747194,171,0.906987891443754
19536,1658.242767,1658.2536,1,49747283,49747608,325,0.6550104668148782
19537,1658.256833,1658.2923,1,49747704,49748769,1065,0.38840433209272757
19538,1658.309667,1658.3394,1,49749290,49750182,892,0.5159111455640696
19539,1658.3481,1658.370933,1,49750443,49751127,684,0.4814494261837708
19540,1658.3808,1658.429233,1,49751424,49752876,1452,0.2978783867094048
19541,1658.444867,1658.450233,1,49753346,49753506,160,0.9518232015762658
19542,1658.4914,1658.5066,1,49754742,49755198,456,0.5868974317116809
19543,1658.533067,1658.538667,1,49755992,49756160,168,0.9423951581542002
19544,1658.559867,1658.582267,1,49756796,49757468,672,0.507967795491745
19545,1658.595333,1658.632567,1,49757859,49758977,1118,0.5603255504288474
19546,1658.638333,1658.747067,1,49759149,49762412,3263,0.32762246484890867
19547,1658.785133,1658.796233,1,49763553,49763886,333,0.6826854489137952
19548,1658.798333,1658.8202,1,49763949,49764606,657,0.8810471269200624
19549,1658.8214,1658.830867,1,49764642,49764926,284,0.8409413489395273
19550,1658.832933,1658.835933,1,49764987,49765077,90,0.970077456175152
19551,1658.850667,1658.857233,1,49765520,49765716,196,0.8286340856819718
19552,1658.8933,1658.897267,1,49766799,49766918,119,0.8969783833034642
19553,1658.913767,1658.918833,1,49767413,49767564,151,0.8651203175439992
19554,1658.919867,1659.011867,1,49767596,49770356,2760,0.6894641054650197
19555,1659.014533,1659.0194,1,49770435,49770582,147,0.7656894127606192
19556,1659.0206,1659.121733,1,49770618,49773651,3033,0.669975722621287
19557,1659.1235,1659.1645,1,49773705,49774935,1230,0.81270847125786
19558,1659.165567,1659.2057,1,49774967,49776171,1204,0.7766588723897265
19559,1659.2092,1659.213667,1,49776276,49776410,134,0.9045144136274408
19560,1659.2309,1659.234133,1,49776927,49777023,96,0.9525894739627235
19561,1659.2355,1659.2735,1,49777065,49778205,1140,0.3361871660689891
19562,1659.317,1659.5369,1,49779510,49786107,6597,0.3802803117468879
19563,1659.613233,1659.634267,1,49788396,49789028,632,0.5494067206654303
19564,1659.681933,1659.7641,1,49790457,49792923,2466,0.5564272215115569
19565,1659.7658,1659.770867,1,49792974,49793126,152,0.8064555315829092
19566,1660.683267,1660.702267,1,49820498,49821068,570,0.3828726873533861
19567,1660.706233,1660.722767,1,49821186,49821683,497,0.8686453800868167
19568,1660.762533,1660.7918,1,49822875,49823754,879,0.6769764093921931
19569,1660.793867,1660.804333,1,49823816,49824129,313,0.9767232277839428
19570,1660.805367,1660.859333,1,49824161,49825779,1618,0.4261715108768976
19571,1660.863067,1660.8867,1,49825892,49826601,709,0.29757528636786124
19572,1660.887967,1660.8919,1,49826639,49826757,118,0.8336929437927829
19573,1660.9059,1660.945133,1,49827177,49828353,1176,0.5039424342589158
19574,1660.9463,1660.9572,1,49828389,49828716,327,0.8716445419666353
19575,1660.965867,1660.9781,1,49828976,49829343,367,0.8983290238621614
19576,1660.985067,1660.993933,1,49829552,49829817,265,0.6974191604850779
19577,1661.0011,1661.014533,1,49830033,49830435,402,0.7121408023158634
19578,1661.015967,1661.165833,1,49830479,49834974,4495,0.5490910370482649
19579,1661.172,1661.218167,1,49835160,49836545,1385,0.5421053382009666
19580,1661.220367,1661.2698,1,49836611,49838094,1483,0.3603009754353263
19581,1661.271467,1661.3011,1,49838144,49839033,889,0.5079297397606363
19582,1661.302567,1661.385633,1,49839077,49841568,2491,0.41676982215180797
19583,1661.395367,1661.415733,1,49841861,49842471,610,0.4884921917761079
19584,1661.4215,1661.4292,1,49842645,49842876,231,0.9515527715454242
19585,1661.713533,1661.719133,1,49851405,49851573,168,0.8883453476164835
19586,1661.720867,1661.725933,1,49851626,49851777,151,0.5122644923982466
19587,1661.737567,1661.743367,1,49852127,49852301,174,-0.1341286160479811
19588,1661.7471,1661.763533,1,49852413,49852905,492,0.3182699511993894
19589,1661.773033,1661.779733,1,49853190,49853391,201,0.7981444655467519
19590,1661.804733,1661.8102,1,49854141,49854306,165,0.5682903417439418
19591,1661.8136,1661.8203,1,49854408,49854609,201,0.815314854051214
19592,1661.822,1661.829067,1,49854660,49854872,212,0.8770563256623741
19593,1661.853667,1661.865667,1,49855610,49855970,360,0.9245639731777476
19594,1661.866767,1661.8959,1,49856003,49856877,874,0.6189830530597454
19595,1661.899933,1661.903533,1,49856997,49857105,108,0.8630156694257922
19596,1661.909833,1661.950267,1,49857294,49858508,1214,0.5246860738841196
19597,1661.958167,1661.981133,1,49858745,49859433,688,0.6272412956591777
19598,1661.982367,1662.002367,1,49859471,49860071,600,0.4275169262111238
19599,1662.0041,1662.047633,1,49860123,49861428,1305,0.3183706153808472
19600,1662.054167,1662.104633,1,49861625,49863138,1513,0.32096246769300935
19601,1662.1189,1662.1284,1,49863567,49863852,285,0.5810979596245981
19602,1662.13,1662.1508,1,49863900,49864524,624,0.20187134117335342
19603,1662.331867,1662.3537,1,49869956,49870611,655,0.07531732398808375
19604,1662.361167,1662.372667,1,49870835,49871180,345,0.25753214716376327
19605,1662.3859,1662.399767,1,49871577,49871993,416,0.5669830421353983
19606,1662.4008,1662.420833,1,49872024,49872624,600,0.3919297022393628
19607,1662.4388,1662.444233,1,49873164,49873326,162,0.14999983422961347
19608,1662.4459,1662.4626,1,49873377,49873878,501,0.39128451416460475
19609,1662.470167,1662.475133,1,49874105,49874253,148,0.7333262348177423
19610,1663.067733,1663.0996,1,49892031,49892988,957,0.07474478234329802
19611,1663.1071,1663.1205,1,49893213,49893615,402,0.47554697929529066
19612,1663.122667,1663.127033,1,49893680,49893810,130,0.8173423244411685
19613,1663.129867,1663.159267,1,49893896,49894778,882,0.5018201725656491
19614,1663.2094,1663.216767,1,49896282,49896503,221,-0.08266068353279821
19615,1663.4239,1663.4604,1,49902717,49903812,1095,0.39450216995576665
19616,1663.596833,1663.603033,1,49907904,49908090,186,0.8334339791783586
19617,1663.6307,1663.646,1,49908921,49909380,459,0.44824856678867425
19618,1663.971133,1664.015867,1,49919133,49920476,1343,0.2813801694779213
19619,1664.017033,1664.0269,1,49920510,49920807,297,0.8148108621822344
19620,1664.0305,1664.044733,1,49920915,49921341,426,0.8529955901050245
19621,1664.0469,1664.0597,1,49921407,49921791,384,-0.05391371159958346
19622,1664.066467,1664.072867,1,49921994,49922186,192,0.2518962772488552
19623,1664.076633,1664.0864,1,49922298,49922592,294,0.13451144092168943
19624,1664.090333,1664.109,1,49922709,49923270,561,0.4819986883054178
19625,1664.5985,1664.602567,1,49937955,49938077,122,0.6990728799335635
19626,1665.2145,1665.245567,1,49956435,49957367,932,0.24546987058434008
19627,1665.246833,1665.254167,1,49957404,49957625,221,0.6275188635637357
19628,1665.258867,1665.273467,1,49957766,49958204,438,0.6387431439036368
19629,1665.2785,1665.2875,1,49958355,49958625,270,0.38723124565736394
19630,1665.292167,1665.295467,1,49958765,49958864,99,0.7842412050635644
19631,1665.370033,1665.399633,1,49961100,49961988,888,0.8509460730773277
19632,1665.401033,1665.439733,1,49962030,49963191,1161,0.3167781860166111
19633,1665.507867,1665.531367,1,49965236,49965941,705,0.7825590163894018
19634,1665.5328,1665.556933,1,49965984,49966707,723,0.8377114178183274
19635,1665.589833,1665.6075,1,49967694,49968225,531,0.37446555801196263
19636,1665.620833,1665.676033,1,49968624,49970280,1656,0.6621166779910068
19637,1665.677833,1665.6889,1,49970334,49970667,333,0.8308003994313171
19638,1665.708567,1665.712667,1,49971257,49971380,123,0.5077456869101113
19639,1665.7144,1665.718833,1,49971432,49971564,132,0.6169826924132789
19640,1665.7314,1665.737067,1,49971942,49972112,170,-0.12543117857268576
19641,1665.740867,1665.7439,1,49972226,49972317,91,0.775817964615336
19642,1665.751067,1665.761267,1,49972532,49972838,306,0.8843551354587614
19643,1665.7646,1665.777733,1,49972938,49973331,393,0.38280514058797216
19644,1665.791833,1665.8007,1,49973754,49974021,267,0.6778467829070227
19645,1665.8039,1665.8099,1,49974117,49974297,180,0.7904748139251837
19646,1665.810967,1665.8234,1,49974329,49974702,373,0.5343405783341073
19647,1665.833233,1665.8444,1,49974996,49975332,336,0.3300540965568708
19648,1665.856367,1665.862233,1,49975691,49975866,175,0.05028598269770035
19649,1666.115967,1666.120033,1,49983479,49983600,121,0.8480384664695694
19650,1666.123433,1666.129,1,49983702,49983870,168,0.8591839376804453
19651,1666.1341,1666.161333,1,49984023,49984839,816,0.7693047154673223
19652,1667.016567,1667.020767,1,50010497,50010623,126,0.8877965714726788
19653,1667.325467,1667.330033,1,50019764,50019900,136,0.7922125592217463
19654,1667.3313,1667.356033,1,50019939,50020680,741,0.7403583889558288
19655,1667.4786,1667.4827,1,50024358,50024481,123,0.9086865996203007
19656,1667.6202,1667.625333,1,50028606,50028759,153,0.8672318314134763
19657,1667.630833,1667.634933,1,50028924,50029047,123,0.918487521691407
19658,1667.742633,1667.764733,1,50032278,50032941,663,0.6714299135014368
19659,1667.781333,1667.785533,1,50033439,50033565,126,0.48385730376236546
19660,1667.786667,1667.798033,1,50033600,50033940,340,0.1572410123763068
19661,1667.850467,1667.854467,1,50035514,50035634,120,0.8256363547476389
19662,1667.8794,1667.899167,1,50036382,50036975,593,0.8853357747129288
19663,1667.913533,1667.9353,1,50037405,50038059,654,0.4071611131006444
19664,1668.027333,1668.054467,1,50040819,50041634,815,0.7475452812376645
19665,1668.060033,1668.0898,1,50041800,50042694,894,0.30849574263796825
19666,1668.1744,1668.1777,1,50045232,50045331,99,0.7689205273405051
19667,1668.181033,1668.205,1,50045430,50046150,720,0.8459221874455847
19668,1668.222033,1668.242633,1,50046660,50047278,618,0.1725540412554537
19669,1668.263467,1668.2674,1,50047904,50048022,118,0.477611027844078
19670,1668.555367,1668.5602,1,50056661,50056806,145,0.7847934927062944
19671,1668.561867,1668.591733,1,50056856,50057751,895,0.38319175685483414
19672,1668.598933,1668.621567,1,50057967,50058647,680,0.5132216512897692
19673,1668.727933,1668.7394,1,50061837,50062182,345,0.7756308232201828
19674,1668.757067,1668.769367,1,50062712,50063081,369,0.368026932096783
19675,1668.771533,1668.790867,1,50063145,50063726,581,0.6175002868908819
19676,1669.0097,1669.014267,1,50070291,50070428,137,0.8424641713946888
19677,1669.2428,1669.259733,1,50077284,50077791,507,0.11136416985324704
19678,1669.310567,1669.342733,1,50079317,50080281,964,0.7742376537537928
19679,1669.3439,1669.349167,1,50080317,50080475,158,0.6719333194656957
19680,1669.351367,1669.357633,1,50080541,50080728,187,0.5862876362636462
19681,1669.3641,1669.3684,1,50080923,50081052,129,0.8670502510219866
19682,1669.370333,1669.3736,1,50081109,50081208,99,0.9660744847743062
19683,1669.3795,1669.391833,1,50081385,50081754,369,0.9113092869419052
19684,1669.406,1669.432367,1,50082180,50082971,791,0.7797768213063561
19685,1669.4422,1669.454667,1,50083266,50083640,374,0.7045297097709589
19686,1669.4561,1669.4594,1,50083683,50083782,99,0.923403634414531
19687,1669.4724,1669.494033,1,50084172,50084820,648,0.8531963625250695
19688,1669.5,1669.547433,1,50085000,50086422,1422,0.44741663603111553
19689,1669.575633,1669.578733,1,50087268,50087361,93,0.5349682891114577
19690,1669.580667,1669.5898,1,50087420,50087694,274,0.5341364679300201
19691,1669.605033,1669.6883,1,50088150,50090649,2499,0.42910925050078824
19692,1669.6899,1669.693367,1,50090697,50090801,104,0.8179966520223425
19693,1669.7042,1669.748233,1,50091126,50092446,1320,0.6260641822159383
19694,1669.753533,1669.8001,1,50092605,50094003,1398,0.301816303863871
19695,1669.803333,1669.8093,1,50094099,50094279,180,0.8079340515389248
19696,1669.812267,1669.817233,1,50094368,50094516,148,0.8142617148019283
19697,1669.830033,1669.8474,1,50094900,50095422,522,0.6518157637635916
19698,1669.860267,1669.913167,1,50095808,50097395,1587,0.5999456954868355
19699,1669.9308,1669.9348,1,50097924,50098044,120,0.6145512439584422
19700,1669.936333,1669.970867,1,50098089,50099126,1037,0.29560175781178355
19701,1669.971933,1669.985333,1,50099157,50099559,402,0.7278980705120495
19702,1670.0075,1670.0129,1,50100225,50100387,162,0.4737303788940461
19703,1670.035333,1670.063,1,50101059,50101890,831,0.5538078883751304
19704,1670.065767,1670.070867,1,50101973,50102126,153,0.8426935761512032
19705,1670.081467,1670.090433,1,50102444,50102712,268,0.8318374262954615
19706,1670.092367,1670.097,1,50102771,50102910,139,0.5141957010527575
19707,1670.1022,1670.154233,1,50103066,50104626,1560,0.3942662327956066
19708,1670.1559,1670.165233,1,50104677,50104956,279,0.8542765021801251
19709,1670.1669,1670.172267,1,50105007,50105168,161,0.6482167832477598
19710,1670.179433,1670.2181,1,50105382,50106543,1161,0.703956683903219
19711,1670.221767,1670.2253,1,50106653,50106759,106,0.8012015775824286
19712,1670.226867,1670.271233,1,50106806,50108136,1330,0.3552936081055353
19713,1670.274433,1670.295033,1,50108232,50108850,618,0.8850803295302356
19714,1670.302467,1670.3259,1,50109074,50109777,703,0.4473408192203494
19715,1670.332467,1670.385167,1,50109974,50111555,1581,0.3360969759510836
19716,1670.4175,1670.443233,1,50112525,50113296,771,0.6540877919144255
19717,1670.4448,1670.450967,1,50113344,50113529,185,0.7348493960225808
19718,1670.4555,1670.483567,1,50113665,50114507,842,0.627548601388718
19719,1670.490833,1670.537467,1,50114724,50116124,1400,0.43666802608504124
19720,1670.552533,1670.5613,1,50116575,50116839,264,0.7898675055719228
19721,1670.583,1670.6094,1,50117490,50118282,792,0.5567685840899276
19722,1670.613633,1670.659367,1,50118408,50119781,1373,0.4096910930149957
19723,1670.6646,1670.668967,1,50119938,50120069,131,0.8567758771845868
19724,1670.670667,1670.678067,1,50120120,50120342,222,0.3624054908385445
19725,1670.725633,1670.7456,1,50121768,50122368,600,0.3198012054567083
19726,1670.756733,1670.782267,1,50122701,50123468,767,0.4370946775005217
19727,1670.790067,1670.844133,1,50123702,50125323,1621,0.28396862437932047
19728,1670.862033,1670.8676,1,50125860,50126028,168,0.311548802487979
19729,1670.882733,1670.9102,1,50126481,50127306,825,0.47538831734798614
19730,1670.924233,1670.951833,1,50127726,50128554,828,0.6675286123410629
19731,1670.965167,1670.979567,1,50128955,50129387,432,0.4606745242351316
19732,1670.988633,1671.006433,1,50129658,50130192,534,0.3540914512998509
19733,1671.0076,1671.061067,1,50130228,50131832,1604,0.11893345509994363
19734,1671.0622,1671.068533,1,50131866,50132055,189,0.7719676531556031
19735,1671.072133,1671.076967,1,50132163,50132309,146,0.3642627366873598
19736,1671.117733,1671.1382,1,50133531,50134146,615,0.6403264291730489
19737,1671.1508,1671.163567,1,50134524,50134907,383,0.7736986770659254
19738,1671.174233,1671.2084,1,50135226,50136252,1026,0.3810809770026525
19739,1671.222867,1671.263167,1,50136686,50137895,1209,0.20465010307049714
19740,1671.264833,1671.273,1,50137944,50138190,246,0.4016439874702363
19741,1671.322233,1671.3706,1,50139666,50141118,1452,0.3828300354119049
19742,1671.371833,1671.3821,1,50141154,50141463,309,0.7069279431983473
19743,1671.383467,1671.446833,1,50141504,50143404,1900,0.7905460600287555
19744,1671.4516,1671.5707,1,50143548,50147121,3573,0.516472864954343
19745,1671.572467,1671.5784,1,50147174,50147352,178,0.7885597164472938
19746,1671.580767,1671.609267,1,50147423,50148278,855,0.5664181599679049
19747,1671.610433,1671.635867,1,50148312,50149076,764,0.8403926535195294
19748,1671.6457,1671.652533,1,50149371,50149575,204,0.8859366622267401
19749,1671.6643,1671.682433,1,50149929,50150472,543,0.7574965059859133
19750,1671.683833,1671.7215,1,50150514,50151645,1131,0.7576101748470812
19751,1671.722567,1671.840967,1,50151677,50155229,3552,0.6056704347128327
19752,1671.856233,1671.9162,1,50155686,50157486,1800,0.5928078218366832
19753,1671.917633,1671.922233,1,50157528,50157666,138,0.700343677873804
19754,1671.976733,1672.016133,1,50159301,50160483,1182,0.5683273519535342
19755,1672.074567,1672.177633,1,50162237,50165328,3091,0.3157818935828237
19756,1672.179767,1672.274367,1,50165393,50168231,2838,0.3871826580699665
19757,1672.280467,1672.284567,1,50168414,50168537,123,0.2969717623066946
19758,1672.289967,1672.294067,1,50168699,50168822,123,0.5485476803868387
19759,1672.298467,1672.3244,1,50168954,50169732,778,0.3539326539519639
19760,1672.3591,1672.362433,1,50170773,50170872,99,0.7893064524031187
19761,1672.369967,1672.407433,1,50171099,50172222,1123,0.7093483416015041
19762,1672.408433,1672.415833,1,50172252,50172474,222,0.4592630654235374
19763,1672.421167,1672.440033,1,50172635,50173200,565,0.25574657325780825
19764,1672.476233,1672.528767,1,50174286,50175863,1577,0.13063291629600926
19765,1672.5806,1672.595833,1,50177418,50177874,456,0.16489637182136674
19766,1672.794733,1672.7982,1,50183841,50183946,105,0.7531398905061691
19767,1672.833367,1672.837067,1,50185001,50185112,111,0.7289988979282246
19768,1672.8611,1672.867767,1,50185833,50186033,200,0.8420277167182892
19769,1672.873867,1672.877033,1,50186216,50186310,94,0.6594711289689195
19770,1672.886933,1672.945567,1,50186607,50188367,1760,0.8624136459783959
19771,1672.9912,1672.9994,1,50189736,50189982,246,0.6017245356080728
19772,1673.0005,1673.004667,1,50190015,50190140,125,0.7401857381146049
19773,1673.01,1673.014,1,50190300,50190420,120,0.6553850272695748
19774,1673.467933,1673.482033,1,50204037,50204460,423,0.506139973854707
19775,1673.484367,1673.510533,1,50204531,50205315,784,0.646021401518325
19776,1673.519667,1673.527033,1,50205590,50205810,220,0.8007626465301921
19777,1673.640033,1673.646633,1,50209200,50209398,198,0.8031043892707239
19778,1673.830933,1673.905233,1,50214927,50217156,2229,0.35207677303981205
19779,1673.912267,1673.916833,1,50217368,50217504,136,0.8242068294646526
19780,1673.932267,1673.939367,1,50217968,50218181,213,0.8706152254989897
19781,1673.942667,1673.947233,1,50218280,50218416,136,0.10966413404332871
19782,1674.373,1674.377967,1,50231190,50231339,149,0.8213529093439531
19783,1674.454467,1674.457767,1,50233634,50233733,99,0.4683213595107734
19784,1674.5627,1674.5665,1,50236881,50236995,114,0.6313533420265497
19785,1674.567667,1674.596167,1,50237030,50237885,855,0.8627162233263446
19786,1674.597267,1674.6018,1,50237918,50238054,136,0.8873864366268805
19787,1674.603033,1674.6376,1,50238090,50239128,1038,0.7586503217536756
19788,1674.641967,1674.6514,1,50239259,50239542,283,0.7026179283578963
19789,1674.672467,1674.735633,1,50240174,50242068,1894,0.6809647892231757
19790,1674.737067,1674.744867,1,50242112,50242346,234,0.9146151527179333
19791,1675.0976,1675.201967,1,50252928,50256059,3131,0.5386717543693095
19792,1675.212633,1675.234167,1,50256378,50257025,647,0.9016772678284625
19793,1675.250133,1675.254167,1,50257503,50257625,122,0.8942666190237263
19794,1675.255167,1675.278933,1,50257655,50258367,712,0.7977527617478652
19795,1675.289833,1675.310633,1,50258694,50259318,624,0.5736373462945329
19796,1675.325967,1675.3304,1,50259779,50259912,133,0.8738341425511851
19797,1675.3326,1675.3737,1,50259978,50261211,1233,0.5817540107327025
19798,1675.383033,1675.400167,1,50261490,50262005,515,0.7773305269009568
19799,1675.4015,1675.4187,1,50262045,50262561,516,0.7591035255278138
19800,1675.431967,1675.4426,1,50262959,50263278,319,0.6311867008882055
19801,1675.4488,1675.455967,1,50263464,50263679,215,0.8454296463286275
19802,1675.477633,1675.482933,1,50264328,50264487,159,0.5938945907624572
19803,1675.4848,1675.487933,1,50264544,50264637,93,0.8500201520079578
19804,1675.489,1675.545067,1,50264670,50266352,1682,0.5814540291237149
19805,1675.551633,1675.5731,1,50266548,50267193,645,0.933038269129226
19806,1675.620233,1675.626,1,50268606,50268780,174,0.8313301119869484
19807,1675.6292,1675.666067,1,50268876,50269982,1106,0.8682603801082979
19808,1675.693067,1675.700833,1,50270792,50271024,232,0.7928345606578666
19809,1675.7293,1675.7323,1,50271879,50271969,90,0.8956765855805241
19810,1675.7824,1675.850433,1,50273472,50275512,2040,0.7346940935651429
19811,1675.8537,1675.865333,1,50275611,50275959,348,0.8547629801631665
19812,1675.874667,1675.878567,1,50276240,50276357,117,0.8172428080597158
19813,1675.880233,1675.8911,1,50276406,50276733,327,0.7967013517517985
19814,1675.904233,1675.915333,1,50277126,50277459,333,0.7521995689339399
19815,1675.921,1675.948333,1,50277630,50278449,819,0.6557320711537408
19816,1675.9587,1675.970767,1,50278761,50279123,362,0.8502844835675212
19817,1675.972133,1675.9752,1,50279163,50279256,93,0.8262389872943956
19818,1675.976533,1675.9959,1,50279295,50279877,582,0.6800081394455388
19819,1675.998767,1676.006733,1,50279963,50280201,238,0.6683233279713947
19820,1676.064133,1676.068833,1,50281923,50282064,141,0.962934203944062
19821,1676.0934,1676.113733,1,50282802,50283411,609,0.909098526357377
19822,1676.166,1676.171367,1,50284980,50285141,161,0.7985038132853504
19823,1676.199233,1676.221767,1,50285976,50286653,677,0.17518602053467008
19824,1676.265567,1676.269667,1,50287967,50288090,123,0.8621641760099458
19825,1676.6289,1676.6355,1,50298867,50299065,198,0.668246617001067
19826,1676.6635,1676.6647,1,50299905,50299941,36,0.7799169937188163
19827,1676.6684,1676.695067,1,50300052,50300852,800,0.59022855078492
19828,1676.718767,1676.7404,1,50301563,50302212,649,0.8076032166073404
19829,1676.770067,1676.7932,1,50303102,50303796,694,0.43145719856948317
19830,1676.814133,1676.8172,1,50304423,50304516,93,0.9333567206084203
19831,1676.8253,1676.8305,1,50304759,50304915,156,0.9225473557978849
19832,1676.844867,1676.8627,1,50305346,50305881,535,0.20229581392232565
19833,1676.9642,1676.974367,1,50308926,50309231,305,0.7871766054078995
19834,1676.976867,1676.995167,1,50309306,50309855,549,0.6399711641736334
19835,1677.036033,1677.045767,1,50311080,50311373,293,0.8638933111407275
19836,1677.0528,1677.0651,1,50311584,50311953,369,0.8100262668075728
19837,1677.067467,1677.074767,1,50312024,50312243,219,0.7909196607954229
19838,1677.0924,1677.096,1,50312772,50312880,108,0.8595301247144953
19839,1677.219633,1677.227967,1,50316588,50316839,251,0.8844277457949119
19840,1677.2389,1677.244367,1,50317167,50317331,164,0.7864669463504179
19841,1677.3006,1677.311567,1,50319018,50319347,329,0.6903216469815106
19842,1677.326967,1677.330033,1,50319809,50319900,91,0.002285083321256734
19843,1677.335733,1677.3784,1,50320071,50321352,1281,0.31464612479880294
19844,1677.3827,1677.394067,1,50321481,50321822,341,0.7271905500987355
19845,1677.3965,1677.401533,1,50321895,50322045,150,0.890971882034774
19846,1678.641333,1678.646567,1,50359239,50359397,158,-0.24683374226428043
19847,1678.661133,1678.673033,1,50359833,50360190,357,0.15050962627859904
19848,1679.021533,1679.028067,1,50370645,50370842,197,0.8927814741276556
19849,1679.237633,1679.2452,1,50377128,50377356,228,0.6208311507744197
19850,1679.483467,1679.4889,1,50384504,50384667,163,0.9182541479842452
19851,1679.5115,1679.517333,1,50385345,50385519,174,0.8168254361307377
19852,1679.526233,1679.535233,1,50385786,50386056,270,0.901673712689608
19853,1679.536833,1679.544433,1,50386104,50386332,228,0.8127525711195268
19854,1679.547867,1679.5522,1,50386436,50386566,130,0.8334536797644925
19855,1679.554933,1679.558533,1,50386647,50386755,108,0.9174767738115952
19856,1679.564833,1679.5692,1,50386944,50387076,132,0.20795401448326467
19857,1679.579733,1679.6235,1,50387391,50388705,1314,0.6952826849378029
19858,1679.6281,1679.6546,1,50388843,50389638,795,0.8396795697138238
19859,1679.657933,1679.661533,1,50389737,50389845,108,0.7071343439439013
19860,1679.662533,1679.667733,1,50389875,50390031,156,0.9347931336693637
19861,1679.723367,1679.753233,1,50391701,50392596,895,0.8066089437735515
19862,1679.758433,1679.774233,1,50392752,50393226,474,0.9248338541501846
19863,1679.779033,1679.782433,1,50393370,50393472,102,0.9198766596974313
19864,1679.7842,1679.792667,1,50393526,50393780,254,0.8841398580845298
19865,1679.7948,1679.799767,1,50393844,50393993,149,0.7784247903834499
19866,1679.805733,1679.8165,1,50394171,50394495,324,0.899594901778814
19867,1679.834867,1679.875333,1,50395046,50396259,1213,0.7425431943786591
19868,1679.8764,1679.896833,1,50396292,50396904,612,0.7305598314133445
19869,1679.925567,1679.934933,1,50397767,50398047,280,0.5893481790962029
19870,1679.939533,1679.974867,1,50398185,50399246,1061,0.5856117993088304
19871,1679.9763,1680.0278,1,50399289,50400834,1545,0.48054029908524853
19872,1680.043333,1680.053367,1,50401299,50401601,302,0.7879360826951897
19873,1680.062567,1680.0853,1,50401877,50402559,682,0.44262198024795796
19874,1680.096867,1680.1361,1,50402906,50404083,1177,0.285847272662609
19875,1680.161433,1680.171167,1,50404842,50405135,293,0.6391195579558469
19876,1680.206267,1680.242367,1,50406188,50407271,1083,0.46577807111677494
19877,1680.2436,1680.285533,1,50407308,50408565,1257,0.22007981371499974
19878,1680.286567,1680.2937,1,50408597,50408811,214,0.7070031161056611
19879,1680.309833,1680.312867,1,50409294,50409386,92,0.9056915196786101
19880,1680.325033,1680.331933,1,50409750,50409957,207,0.6977799358149648
19881,1680.333667,1680.3573,1,50410010,50410719,709,0.6759581529137949
19882,1680.368233,1680.398467,1,50411046,50411954,908,0.7044684519417473
19883,1680.4068,1680.439067,1,50412204,50413172,968,0.2801016356085592
19884,1680.440133,1680.448367,1,50413203,50413451,248,0.6828009290570334
19885,1680.500167,1680.577967,1,50415005,50417339,2334,0.3282987307616084
19886,1680.579,1680.587433,1,50417370,50417622,252,0.6919093531845235
19887,1680.5919,1680.6003,1,50417757,50418009,252,0.5627890042509298
19888,1680.612867,1680.6413,1,50418386,50419239,853,0.5328527014112971
19889,1680.651533,1680.675333,1,50419545,50420259,714,0.7201336631432361
19890,1680.683,1680.7327,1,50420490,50421981,1491,0.33989047496513464
19891,1680.744667,1680.747867,1,50422340,50422436,96,0.6121196991400394
19892,1680.762767,1680.7667,1,50422883,50423001,118,0.8216194193338592
19893,1680.767867,1680.774033,1,50423036,50423220,184,0.8479156481476321
19894,1680.787567,1680.7958,1,50423627,50423874,247,0.21019890424704984
19895,1680.800467,1680.8462,1,50424014,50425386,1372,0.4726560340742865
19896,1680.8491,1680.8704,1,50425473,50426112,639,0.6080490129269644
19897,1680.873633,1680.929533,1,50426208,50427885,1677,0.3522622537527647
19898,1680.931133,1680.974333,1,50427933,50429229,1296,0.44383072346594066
19899,1681.008167,1681.035333,1,50430245,50431059,814,0.6348129825007508
19900,1681.0419,1681.0896,1,50431257,50432688,1431,0.5209178589093084
19901,1681.1068,1681.111767,1,50433204,50433353,149,0.848035311966418
19902,1681.113533,1681.1432,1,50433405,50434296,891,0.8165747023920887
19903,1681.156533,1681.162533,1,50434695,50434875,180,0.7967246725908855
19904,1681.164767,1681.175333,1,50434943,50435259,316,0.5976079936065146
19905,1681.182267,1681.232733,1,50435468,50436981,1513,0.43641561898875686
19906,1681.2517,1681.259933,1,50437551,50437797,246,0.778323561768708
19907,1681.275233,1681.2946,1,50438256,50438838,582,0.5537339694982376
19908,1681.305033,1681.330867,1,50439150,50439926,776,0.7678922644659825
19909,1681.333667,1681.348533,1,50440010,50440455,445,0.6794149194766781
19910,1681.360467,1681.3717,1,50440814,50441151,337,0.7296794383073234
19911,1681.380233,1681.383533,1,50441406,50441505,99,0.9015744361132422
19912,1681.392067,1681.400067,1,50441762,50442002,240,0.6674381455068161
19913,1681.419767,1681.443667,1,50442593,50443310,717,0.6433530712513127
19914,1681.4607,1681.491633,1,50443821,50444748,927,0.6405006323180424
19915,1681.505467,1681.5463,1,50445164,50446389,1225,0.35202304905005205
19916,1681.553233,1681.562167,1,50446596,50446865,269,0.5592284090022915
19917,1681.5748,1681.5907,1,50447244,50447721,477,0.6349733410429571
19918,1681.602967,1681.6136,1,50448089,50448408,319,0.7750486520189426
19919,1681.615933,1681.6225,1,50448477,50448675,198,0.7646106696113293
19920,1681.6389,1681.6727,1,50449167,50450181,1014,0.5507268111070619
19921,1681.681133,1681.684133,1,50450433,50450523,90,0.5941559245791082
19922,1681.686433,1681.7356,1,50450592,50452068,1476,0.5257862547790237
19923,1681.7369,1681.762833,1,50452107,50452884,777,0.3166092259996759
19924,1681.763833,1681.776867,1,50452914,50453306,392,0.5828893116985915
19925,1681.7889,1681.794133,1,50453667,50453823,156,0.915219148436131
19926,1681.797733,1681.8141,1,50453931,50454423,492,0.8443717747843126
19927,1681.8274,1681.831433,1,50454822,50454942,120,0.6186203276053799
19928,1681.851667,1681.855467,1,50455550,50455664,114,0.8404030591623248
19929,1681.865,1681.869167,1,50455950,50456075,125,0.868477345982034
19930,1681.9025,1681.9058,1,50457075,50457174,99,0.8240894226632998
19931,1681.919067,1681.922833,1,50457572,50457684,112,0.8503590023763508
19932,1681.925467,1682.090333,1,50457764,50462709,4945,0.6855171941335524
19933,1682.093233,1682.112633,1,50462796,50463378,582,0.8515328076423058
19934,1682.113667,1682.1255,1,50463410,50463765,355,0.8894355874567322
19935,1682.1359,1682.166833,1,50464077,50465004,927,0.751842406879914
19936,1682.1694,1682.172767,1,50465082,50465183,101,0.9268916532377026
19937,1682.174067,1682.179767,1,50465222,50465393,171,0.9231688487332559
19938,1682.187333,1682.3189,1,50465619,50469567,3948,0.772724454894131
19939,1682.319933,1682.3267,1,50469597,50469801,204,0.7830553693675933
19940,1682.3337,1682.338467,1,50470011,50470154,143,0.9032163310983324
19941,1682.339667,1682.3844,1,50470190,50471532,1342,0.7147142498876635
19942,1682.386733,1682.3961,1,50471601,50471883,282,0.8606777960193635
19943,1682.4235,1682.4271,1,50472705,50472813,108,0.9378678662905093
19944,1682.428167,1682.565767,1,50472845,50476973,4128,0.5381725857784795
19945,1682.566833,1682.6644,1,50477004,50479932,2928,0.63522212192997
19946,1682.6654,1682.717467,1,50479962,50481524,1562,0.2751742818326772
19947,1683.713633,1683.721367,1,50511408,50511641,233,0.6416412633615663
19948,1683.9513,1683.955667,1,50518539,50518670,131,0.3591990177559805
19949,1684.120333,1684.1276,1,50523609,50523828,219,0.07784447328226353
19950,1684.2808,1684.296267,1,50528424,50528888,464,0.4156470679379752
19951,1684.297467,1684.301067,1,50528924,50529032,108,0.8034950383763336
19952,1684.3031,1684.3123,1,50529093,50529369,276,0.8110372677055915
19953,1684.338267,1684.3442,1,50530148,50530326,178,0.7828722259727677
19954,1684.346067,1684.371567,1,50530382,50531147,765,0.5328335741864035
19955,1684.4015,1684.420433,1,50532045,50532612,567,0.3884007609644905
19956,1684.453633,1684.464933,1,50533608,50533947,339,0.4776400725713973
19957,1684.704267,1684.7139,1,50541128,50541417,289,0.6512542024852769
19958,1684.830133,1684.845933,1,50544903,50545377,474,0.7884475715751821
19959,1684.911833,1684.942933,1,50547354,50548287,933,0.2514037670851475
19960,1685.184733,1685.1918,1,50555541,50555754,213,0.540881370699227
19961,1685.248633,1685.253633,1,50557458,50557608,150,0.8481484375622168
19962,1685.399433,1685.402833,1,50561982,50562084,102,0.7043386924602466
19963,1685.404133,1685.416333,1,50562123,50562489,366,0.4079176172158165
19964,1685.838633,1685.843,1,50575158,50575290,132,0.8031690069463591
19965,1686.4437,1686.451333,1,50593311,50593539,228,0.48980880139243343
19966,1686.882367,1686.8916,1,50606471,50606748,277,0.37946229408243043
19967,1686.997433,1687.003833,1,50609922,50610114,192,0.7019423720481214
19968,1687.0214,1687.033133,1,50610642,50610993,351,0.1943650656236452
19969,1687.061333,1687.0708,1,50611839,50612124,285,0.7034971616621402
19970,1687.0992,1687.1119,1,50612976,50613357,381,0.2621921653728093
19971,1687.141933,1687.1469,1,50614257,50614407,150,-0.09841716560554703
19972,1687.15,1687.1531,1,50614500,50614593,93,0.8442595221778625
19973,1687.224333,1687.247533,1,50616729,50617425,696,0.25856493431752026
19974,1687.353067,1687.358067,1,50620592,50620742,150,-0.02120386555020294
19975,1687.368567,1687.429733,1,50621057,50622891,1834,0.7057083935374581
19976,1687.431367,1687.438733,1,50622941,50623161,220,0.8623295450003018
19977,1687.458867,1687.4698,1,50623766,50624094,328,0.7871382573874708
19978,1687.471033,1687.605967,1,50624130,50628179,4049,0.35878408312727883
19979,1687.609367,1687.879733,1,50628281,50636391,8110,0.5039192544064288
19980,1687.8836,1687.886633,1,50636508,50636598,90,0.5218557155045582
19981,1687.8952,1687.9099,1,50636856,50637297,441,0.8851721152783493
19982,1687.944767,1687.9485,1,50638343,50638455,112,0.7378161911595376
19983,1688.011533,1688.0182,1,50640345,50640546,201,0.8855836553386054
19984,1688.038933,1688.0441,1,50641167,50641323,156,0.7393446225903959
19985,1688.077933,1688.089,1,50642337,50642670,333,0.9056965320845753
19986,1688.1018,1688.123933,1,50643054,50643717,663,0.7029650387753724
19987,1688.125233,1688.129733,1,50643756,50643891,135,0.7640178632651127
19988,1688.132867,1688.1405,1,50643986,50644215,229,0.5233117633408412
19989,1688.146267,1688.150233,1,50644388,50644506,118,0.9102532570298428
19990,1688.151233,1688.1681,1,50644536,50645043,507,0.8258480296129562
19991,1688.187767,1688.201367,1,50645633,50646041,408,0.8317837864783693
19992,1688.2033,1688.2102,1,50646099,50646306,207,0.7621500663866226
19993,1688.222167,1688.229767,1,50646665,50646893,228,0.46100093326909647
19994,1688.233533,1688.240767,1,50647005,50647223,218,0.3816827908230842
19995,1688.250333,1688.2594,1,50647509,50647782,273,0.5329420045075589
19996,1688.370733,1688.3751,1,50651121,50651253,132,0.670564034251555
19997,1688.388,1688.448433,1,50651640,50653452,1812,0.6023566620462082
19998,1688.667833,1688.677867,1,50660034,50660336,302,0.6286256155017311
19999,1688.6791,1688.6937,1,50660373,50660811,438,0.6265271214727118
20000,1688.695667,1688.7029,1,50660870,50661087,217,0.6298444971137458
20001,1688.7046,1688.712667,1,50661138,50661380,242,0.9143838214685
20002,1688.7207,1688.7252,1,50661621,50661756,135,0.8995977290738847
20003,1688.731733,1688.744167,1,50661951,50662325,374,0.5236619774649466
20004,1689.554233,1689.569667,1,50686626,50687090,464,0.19028122698416836
20005,1689.576367,1689.5898,1,50687291,50687694,403,0.5279629714448264
20006,1689.9489,1689.952033,1,50698467,50698560,93,0.6340751250588968
20007,1690.217533,1690.224767,1,50706525,50706743,218,0.8050189073580797
20008,1690.2325,1690.2475,1,50706975,50707425,450,0.45460791520108335
20009,1690.438133,1690.445367,1,50713143,50713361,218,0.910639324196205
20010,1690.4744,1690.4777,1,50714232,50714331,99,0.9601992287902693
20011,1690.4833,1690.4864,1,50714499,50714592,93,0.9850641580155742
20012,1690.9342,1690.9522,1,50728026,50728566,540,0.2621980064832757
20013,1690.977067,1690.981,1,50729312,50729430,118,0.545002592571464
20014,1691.0565,1691.060067,1,50731695,50731802,107,0.8000258541115812
20015,1691.062967,1691.072567,1,50731889,50732177,288,0.09222531079194718
20016,1691.141567,1691.1465,1,50734247,50734395,148,0.26019871736709854
20017,1691.177233,1691.2029,1,50735316,50736087,771,0.6676605999546988
20018,1691.2043,1691.2077,1,50736129,50736231,102,0.8053537570107707
20019,1691.208933,1691.2399,1,50736267,50737197,930,0.7134683910363017
20020,1691.257967,1691.263933,1,50737739,50737917,178,0.9040188209091022
20021,1691.265533,1691.298833,1,50737965,50738964,999,0.7076996510620188
20022,1691.709433,1691.715133,1,50751282,50751453,171,0.8533431628818443
20023,1691.993233,1691.997433,1,50759796,50759922,126,0.9744551418419829
20024,1691.998933,1692.036133,1,50759967,50761083,1116,0.9500249465689503
20025,1692.056467,1692.073867,1,50761694,50762216,522,0.9034649064584321
20026,1692.0757,1692.079,1,50762271,50762370,99,0.5909131810343738
20027,1692.083667,1692.110867,1,50762510,50763326,816,0.9219665840723158
20028,1692.204467,1692.218867,1,50766134,50766566,432,0.09283300290905135
20029,1692.235633,1692.2713,1,50767068,50768139,1071,0.653195927791681
20030,1692.272767,1692.276567,1,50768183,50768297,114,0.8680254208180557
20031,1692.277867,1692.2815,1,50768336,50768445,109,0.7404323851630157
20032,1692.2929,1692.299933,1,50768787,50768997,210,0.7766440896617967
20033,1692.301133,1692.9562,1,50769033,50788686,19653,0.4299301502736757
20034,1692.958833,1693.056533,1,50788764,50791695,2931,0.279770591056801
20035,1693.061867,1693.1237,1,50791856,50793711,1855,0.19438873104963755
20036,1693.132633,1693.138667,1,50793978,50794160,182,0.8439380783203403
20037,1693.155333,1693.159633,1,50794659,50794788,129,0.21029645388507404
20038,1693.160867,1693.185467,1,50794826,50795564,738,0.010881001491952043
20039,1693.191433,1693.201367,1,50795742,50796041,299,0.8250181942304693
20040,1693.2087,1693.239667,1,50796261,50797190,929,0.4513073490866548
20041,1693.265833,1693.270333,1,50797974,50798109,135,0.558988791779792
20042,1693.32,1693.323267,1,50799600,50799698,98,0.7574106869713193
20043,1693.3298,1693.3337,1,50799894,50800011,117,0.9461215064588478
20044,1693.354133,1693.3769,1,50800623,50801307,684,0.802556845304798
20045,1693.3984,1693.402567,1,50801952,50802077,125,0.9538692203313411
20046,1693.404767,1693.4232,1,50802143,50802696,553,0.4819405496725641
20047,1693.432633,1693.4416,1,50802978,50803248,270,0.6704785571661313
20048,1693.4552,1693.4601,1,50803656,50803803,147,0.7842950981538441
20049,1693.4613,1693.492833,1,50803839,50804784,945,0.2821476427299222
20050,1693.646567,1693.659333,1,50809397,50809779,382,0.6559346396490944
20051,1693.6639,1693.693267,1,50809917,50810798,881,0.6510058162385239
20052,1693.707533,1693.727867,1,50811225,50811836,611,0.2426695801404644
20053,1693.728867,1693.745433,1,50811866,50812362,496,0.5431521510105896
20054,1693.7546,1693.760733,1,50812638,50812821,183,0.6680270007622143
20055,1693.761833,1693.789467,1,50812854,50813684,830,0.41741884271313806
20056,1693.803067,1693.817433,1,50814092,50814522,430,0.7487425447219856
20057,1694.3092,1694.3145,1,50829276,50829435,159,0.09249599415637011
20058,1694.5947,1694.6011,1,50837841,50838033,192,0.3949625155170783
20059,1694.7237,1694.734633,1,50841711,50842038,327,0.6789094826591678
20060,1694.753,1694.756133,1,50842590,50842683,93,0.8831789356891344
20061,1694.758967,1694.7645,1,50842769,50842935,166,0.5358466920992875
20062,1694.814667,1694.888667,1,50844440,50846660,2220,0.16975042669620902
20063,1694.893567,1694.9414,1,50846807,50848242,1435,0.38419510872475787
20064,1694.967733,1694.970933,1,50849031,50849127,96,0.8464558362832088
20065,1694.980567,1695.0108,1,50849417,50850324,907,0.5021464458533214
20066,1695.0625,1695.068333,1,50851875,50852049,174,0.7097825112368298
20067,1695.082,1695.092533,1,50852460,50852775,315,0.6244385390575322
20068,1695.1709,1695.177067,1,50855127,50855312,185,0.8457756507784929
20069,1695.328933,1695.501033,1,50859867,50865030,5163,0.5836809945933581
20070,1695.502167,1695.679567,1,50865065,50870387,5322,0.6993055804158387
20071,1695.691033,1695.727667,1,50870730,50871830,1100,0.45636877780996277
20072,1695.729367,1695.7333,1,50871881,50871999,118,0.9323190024464464
20073,1695.734867,1695.739833,1,50872046,50872194,148,0.962756519645808
20074,1695.772167,1695.790467,1,50873165,50873714,549,0.49786567531261977
20075,1695.845933,1695.8642,1,50875377,50875926,549,0.4209328155877299
20076,1695.8748,1695.880433,1,50876244,50876412,168,0.913849292711527
20077,1695.883767,1695.892633,1,50876513,50876778,265,0.7262895089709972
20078,1695.8939,1695.955367,1,50876817,50878661,1844,0.46016535451640583
20079,1695.962633,1695.992633,1,50878878,50879778,900,0.6339389518252548
20080,1695.993933,1695.9983,1,50879817,50879949,132,0.7098662190933702
20081,1696.0088,1696.013167,1,50880264,50880395,131,0.9468981864738426
20082,1696.033833,1696.051133,1,50881014,50881533,519,0.8624965949223551
20083,1696.0525,1696.0563,1,50881575,50881689,114,0.8027781021148143
20084,1696.057333,1696.073067,1,50881719,50882192,473,0.8218583632860088
20085,1696.0853,1696.107667,1,50882559,50883230,671,0.8128797052389843
20086,1696.1185,1696.122933,1,50883555,50883687,132,0.9504976509432858
20087,1696.125367,1696.128767,1,50883761,50883863,102,0.95089099523306
20088,1696.1299,1696.160633,1,50883897,50884818,921,0.7791503629115535
20089,1696.1626,1696.195467,1,50884878,50885864,986,0.36868269153596284
20090,1696.208233,1696.2239,1,50886246,50886717,471,0.6768036673474462
20091,1696.239667,1696.245433,1,50887190,50887362,172,0.7944582329406153
20092,1696.286867,1696.306267,1,50888606,50889188,582,0.5398301366875599
20093,1696.307333,1696.358733,1,50889219,50890761,1542,0.28043243449196276
20094,1696.383633,1696.458633,1,50891508,50893758,2250,0.5126935744482013
20095,1696.460433,1696.4778,1,50893812,50894334,522,0.8674089378953035
20096,1696.483433,1696.538433,1,50894502,50896152,1650,0.3768062186613822
20097,1696.547533,1696.5507,1,50896425,50896521,96,0.9433043411302944
20098,1696.565033,1696.568567,1,50896950,50897057,107,0.7274945175240604
20099,1696.5735,1696.5944,1,50897205,50897832,627,0.31238718152332656
20100,1696.605733,1696.633733,1,50898171,50899011,840,0.4433699246082846
20101,1696.6454,1696.692467,1,50899362,50900774,1412,0.41634587462256667
20102,1696.706733,1696.710867,1,50901201,50901326,125,0.5845517460935787
20103,1696.7121,1696.718467,1,50901363,50901554,191,0.6569109533355993
20104,1696.748967,1696.773967,1,50902469,50903219,750,0.5216478353698647
20105,1696.7795,1696.819633,1,50903385,50904588,1203,0.6551329980164959
20106,1696.8284,1696.877667,1,50904852,50906330,1478,0.46528190425532373
20107,1696.893933,1696.897767,1,50906817,50906933,116,0.8559269074200617
20108,1696.917467,1696.941767,1,50907524,50908253,729,0.4814256240855291
20109,1696.943367,1696.9465,1,50908301,50908395,94,0.9206341996753171
20110,1696.948067,1696.992233,1,50908442,50909766,1324,0.5728001780641302
20111,1697.0074,1697.013033,1,50910222,50910390,168,0.7571277157063544
20112,1697.0447,1697.0625,1,50911341,50911875,534,0.40427481005621974
20113,1697.065533,1697.070633,1,50911965,50912118,153,0.6729419474689908
20114,1697.103567,1697.1352,1,50913107,50914056,949,0.6819540761648087
20115,1697.148933,1697.1828,1,50914467,50915484,1017,0.4251905616123988
20116,1697.1891,1697.2431,1,50915673,50917293,1620,0.2769247880086744
20117,1697.266567,1697.270233,1,50917997,50918106,109,0.8709157035622399
20118,1697.276167,1697.279633,1,50918285,50918388,103,0.9117810706523687
20119,1697.284667,1697.309967,1,50918540,50919299,759,0.6146890917711347
20120,1697.314333,1697.343167,1,50919429,50920295,866,0.7222643246386762
20121,1697.362867,1697.407467,1,50920886,50922224,1338,0.3082054388359194
20122,1697.437033,1697.464633,1,50923110,50923938,828,0.44153205516210786
20123,1697.4691,1697.493133,1,50924073,50924793,720,0.77010640874536
20124,1697.510367,1697.553367,1,50925311,50926601,1290,0.5131518090222772
20125,1697.555133,1697.5647,1,50926653,50926941,288,0.8743254632097713
20126,1697.5703,1697.608267,1,50927109,50928248,1139,0.5431618996500763
20127,1697.611867,1697.624367,1,50928356,50928731,375,0.7974252314583657
20128,1697.627367,1697.661567,1,50928821,50929847,1026,0.2028323334657512
20129,1697.6708,1697.677433,1,50930124,50930322,198,0.8237083996322564
20130,1697.6893,1697.725033,1,50930679,50931750,1071,0.23696465667682692
20131,1697.726033,1697.729867,1,50931780,50931896,116,0.4110185369363839
20132,1697.747733,1697.751067,1,50932431,50932532,101,0.8340685219744298
20133,1697.763033,1697.7867,1,50932890,50933601,711,0.8437112019317135
20134,1697.789167,1697.813067,1,50933675,50934392,717,0.6500498382162312
20135,1697.829733,1697.871267,1,50934891,50936138,1247,0.5198569754036965
20136,1697.881167,1697.937533,1,50936435,50938125,1690,0.41469640518972645
20137,1697.938533,1697.9779,1,50938155,50939337,1182,0.3174276097927375
20138,1697.980867,1697.995767,1,50939426,50939873,447,0.6346743357197397
20139,1697.9982,1698.036833,1,50939946,50941104,1158,0.3693562755030566
20140,1698.094133,1698.099033,1,50942823,50942970,147,0.8255629095716118
20141,1698.107333,1698.1163,1,50943219,50943489,270,0.6849748929749965
20142,1698.1298,1698.337667,1,50943894,50950130,6236,0.5422843570742761
20143,1698.357767,1698.361133,1,50950733,50950833,100,0.8215147709432017
20144,1698.405,1698.4087,1,50952150,50952261,111,0.9032783250266985
20145,1698.4314,1698.4379,1,50952942,50953137,195,0.6493596368195468
20146,1698.447533,1698.4705,1,50953425,50954115,690,0.5597402372984357
20147,1698.5081,1698.522633,1,50955243,50955678,435,0.8178012112119896
20148,1698.527467,1698.5632,1,50955824,50956896,1072,0.46122486207948743
20149,1698.586433,1698.5938,1,50957592,50957814,222,0.8486198508492292
20150,1698.610133,1698.614333,1,50958303,50958429,126,0.9099610552384636
20151,1698.617333,1698.6764,1,50958519,50960292,1773,0.29688106343594156
20152,1698.685867,1698.729633,1,50960576,50961888,1312,0.20560424691862725
20153,1698.754967,1698.789233,1,50962649,50963676,1027,0.7807484101340457
20154,1698.825333,1698.8394,1,50964759,50965182,423,0.10070511618797118
20155,1698.845467,1698.849667,1,50965364,50965490,126,0.68075243633276
20156,1699.051967,1699.056433,1,50971559,50971692,133,0.9318487820038591
20157,1699.082133,1699.098233,1,50972463,50972946,483,0.7091609997766538
20158,1699.099833,1699.104167,1,50972994,50973125,131,0.6556120992812559
20159,1699.105233,1699.129,1,50973156,50973870,714,0.8603607136361544
20160,1699.130467,1699.148367,1,50973914,50974451,537,0.7252473240073788
20161,1699.150133,1699.154533,1,50974503,50974635,132,0.7049209445506679
20162,1699.5454,1699.551167,1,50986362,50986535,173,0.3332809710028481
20163,1699.688133,1699.698267,1,50990643,50990948,305,0.8192153487859587
20164,1699.7064,1699.7142,1,50991192,50991426,234,0.15498315901883103
20165,1699.743033,1699.747733,1,50992290,50992431,141,0.4368654516151236
20166,1699.769933,1699.775767,1,50993097,50993273,176,0.5181881673686152
20167,1699.8414,1699.905833,1,50995242,50997174,1932,0.4653689203144946
20168,1699.9119,1699.917267,1,50997357,50997518,161,0.873380599756761
20169,1700.0362,1700.039567,1,51001086,51001187,101,0.9372485756619351
20170,1700.1881,1700.193233,1,51005643,51005796,153,0.8618976988027344
20171,1700.5899,1700.599833,1,51017697,51017994,297,0.43585920709514553
20172,1700.692667,1700.699733,1,51020780,51020991,211,0.122699782878107
20173,1700.878533,1700.897,1,51026355,51026910,555,0.6123578649563546
20174,1700.955667,1701.007333,1,51028670,51030219,1549,0.1445493540833665
20175,1701.012733,1701.023133,1,51030381,51030693,312,0.7006015779693889
20176,1701.0285,1701.031767,1,51030855,51030953,98,0.8494233776169419
20177,1701.0335,1701.0376,1,51031005,51031128,123,0.5762656636527722
20178,1701.0411,1701.060967,1,51031233,51031829,596,0.7051770281728781
20179,1701.062733,1701.076467,1,51031881,51032294,413,0.7468815128007364
20180,1701.0967,1701.100767,1,51032901,51033023,122,0.7181308783001584
20181,1701.102467,1701.114667,1,51033074,51033440,366,0.6841192796757304
20182,1701.1759,1701.199833,1,51035277,51035994,717,0.7893590468005997
20183,1701.201667,1701.2047,1,51036050,51036141,91,0.9583890592897852
20184,1701.264033,1701.268733,1,51037920,51038061,141,0.4978907305506133
20185,1701.274067,1701.2817,1,51038222,51038451,229,0.1950270981766936
20186,1701.310867,1701.319033,1,51039326,51039570,244,0.6264986615023425
20187,1701.323567,1701.326933,1,51039707,51039807,100,0.8929047813796639
20188,1701.328533,1701.3448,1,51039855,51040344,489,0.24953841852262607
20189,1701.348367,1701.3527,1,51040451,51040581,130,0.7678323817909289
20190,1701.367167,1701.3787,1,51041015,51041361,346,0.663624738753758
20191,1701.3851,1701.392633,1,51041553,51041778,225,0.6068558147844298
20192,1701.393667,1701.400267,1,51041810,51042008,198,0.6846682037552639
20193,1701.422533,1701.434033,1,51042675,51043020,345,0.7219769174410001
20194,1701.4353,1701.443067,1,51043059,51043292,233,0.516820484681324
20195,1701.457833,1701.461667,1,51043734,51043850,116,0.7251743270090816
20196,1701.4641,1701.467733,1,51043923,51044031,108,0.5337700077837507
20197,1701.475367,1701.478667,1,51044261,51044360,99,0.7020179945001982
20198,1701.485967,1701.499133,1,51044579,51044973,394,0.6807922999653276
20199,1701.505833,1701.509267,1,51045174,51045278,104,0.7460364727755487
20200,1701.510733,1701.524933,1,51045321,51045747,426,0.8634418998420562
20201,1701.527567,1701.530933,1,51045827,51045927,100,0.9601746656030345
20202,1701.532933,1701.557267,1,51045987,51046718,731,0.6286619951063596
20203,1701.558567,1701.5644,1,51046757,51046932,175,0.7999288899121596
20204,1701.570967,1701.590233,1,51047129,51047706,577,0.7262888317769483
20205,1701.628067,1701.6316,1,51048842,51048948,106,0.6795426350815846
20206,1701.688967,1701.710533,1,51050669,51051315,646,0.6787335251210523
20207,1701.712467,1701.758767,1,51051374,51052763,1389,0.53957571113689
20208,1701.760267,1701.8467,1,51052808,51055401,2593,0.6418043420461036
20209,1701.856167,1701.861233,1,51055685,51055836,151,0.854912579483302
20210,1701.889667,1701.893533,1,51056690,51056805,115,0.7556146908180239
20211,1701.907833,1701.911333,1,51057234,51057339,105,0.1339536957383148
20212,1701.9125,1701.917533,1,51057375,51057525,150,0.4469769410280579
20213,1701.919733,1701.9373,1,51057591,51058119,528,0.25221147241119923
20214,1701.950133,1701.9546,1,51058503,51058638,135,0.8915846944553757
20215,1702.053533,1702.057,1,51061605,51061710,105,0.9043508754680565
20216,1702.068467,1702.079533,1,51062054,51062385,331,0.8131225648241738
20217,1702.080667,1702.086433,1,51062420,51062592,172,0.8813775966078748
20218,1702.328667,1702.335167,1,51069860,51070055,195,0.8028860196796793
20219,1702.343233,1702.367233,1,51070296,51071016,720,0.6738995243300311
20220,1702.371633,1702.3897,1,51071148,51071691,543,0.6476383205337393
20221,1702.4101,1702.439733,1,51072303,51073191,888,0.8758401936193755
20222,1702.658767,1702.675,1,51079763,51080250,487,0.5396622991313812
20223,1702.707133,1702.711133,1,51081213,51081333,120,0.8764865190395412
20224,1702.944533,1702.952167,1,51088335,51088565,230,0.0008717916394182206
20225,1704.3305,1704.337967,1,51129915,51130139,224,0.47206452263471826
20226,1704.796767,1704.799933,1,51143903,51143997,94,0.7914540463627813
20227,1704.817233,1704.821667,1,51144516,51144650,134,0.4903536715292559
20228,1704.833533,1704.8503,1,51145005,51145509,504,0.8464780760155449
20229,1704.851333,1704.896233,1,51145539,51146886,1347,0.862868458353199
20230,1704.902267,1704.905667,1,51147068,51147170,102,0.910104044180268
20231,1704.9074,1704.9476,1,51147222,51148428,1206,0.7906724507397933
20232,1704.948667,1704.952333,1,51148460,51148569,109,0.8532012446843247
20233,1704.958167,1704.961467,1,51148745,51148844,99,0.7873910076443554
20234,1704.9734,1704.9845,1,51149202,51149535,333,0.9309282935543731
20235,1705.0046,1705.009833,1,51150138,51150294,156,0.9038617601504942
20236,1705.0118,1705.015433,1,51150354,51150462,108,0.9364458793118572
20237,1705.017767,1705.024967,1,51150533,51150749,216,0.8325952631700655
20238,1705.041533,1705.044833,1,51151245,51151344,99,0.9252646946647287
20239,1705.0801,1705.0926,1,51152403,51152778,375,0.6510398344438201
20240,1705.093833,1705.138767,1,51152814,51154163,1349,0.8851886086158625
20241,1705.141067,1705.258233,1,51154232,51157746,3514,0.5212614837731694
20242,1705.2666,1705.294533,1,51157998,51158835,837,0.4717517326484788
20243,1705.312667,1705.316467,1,51159380,51159494,114,0.8582827705397705
20244,1705.3223,1705.331967,1,51159669,51159959,290,0.4948478098785821
20245,1705.3336,1705.357767,1,51160008,51160733,725,0.7068190644827254
20246,1705.3798,1705.435667,1,51161394,51163070,1676,0.7953253079632866
20247,1705.439467,1705.4565,1,51163184,51163695,511,0.5774240719163686
20248,1705.481267,1705.485333,1,51164438,51164559,121,0.8803526695550117
20249,1705.503067,1705.516333,1,51165092,51165489,397,0.8365671048123816
20250,1705.517367,1705.553167,1,51165521,51166595,1074,0.7720481557882277
20251,1705.554667,1705.57,1,51166640,51167100,460,0.641279195641452
20252,1705.5811,1705.602067,1,51167433,51168062,629,0.6006729223940078
20253,1705.618967,1705.625467,1,51168569,51168764,195,0.5485156276420307
20254,1705.632767,1705.6493,1,51168983,51169479,496,0.8196173863418162
20255,1705.650367,1705.656633,1,51169511,51169698,187,0.8997044493461682
20256,1705.658033,1705.7145,1,51169740,51171435,1695,0.6612187771685434
20257,1705.716033,1705.734933,1,51171480,51172047,567,0.6598288768169831
20258,1705.735933,1705.776333,1,51172077,51173289,1212,0.6948061056246967
20259,1705.782833,1705.819667,1,51173484,51174590,1106,0.604958341190315
20260,1705.830333,1705.8533,1,51174909,51175599,690,0.23645516048525853
20261,1705.9602,1705.966667,1,51178806,51179000,194,0.46505502415090194
20262,1706.010267,1706.0247,1,51180308,51180741,433,0.04956322363072051
20263,1706.092933,1706.114467,1,51182787,51183434,647,0.4522719633170276
20264,1706.282267,1706.308133,1,51188468,51189243,775,0.5622643272721863
20265,1706.328067,1706.337967,1,51189842,51190139,297,0.18391722839532684
20266,1706.4078,1706.431967,1,51192234,51192959,725,0.6317106293971158
20267,1706.446967,1706.476733,1,51193409,51194301,892,0.19422095253448574
20268,1706.515033,1706.5216,1,51195450,51195648,198,0.8724439495773405
20269,1706.536233,1706.541433,1,51196086,51196242,156,0.8256142535316862
20270,1706.543033,1706.566667,1,51196290,51197000,710,0.7776263861399982
20271,1706.5692,1706.573733,1,51197076,51197211,135,0.6913165870792888
20272,1706.583633,1706.61,1,51197508,51198300,792,0.2774676812283022
20273,1706.611633,1706.619933,1,51198348,51198597,249,0.5429398694811852
20274,1706.707467,1706.712433,1,51201224,51201372,148,0.7227678411014857
20275,1706.7514,1706.763367,1,51202542,51202901,359,0.12945485958114797
20276,1706.8519,1706.8586,1,51205557,51205758,201,0.6646869078301595
20277,1706.861733,1706.881367,1,51205851,51206441,590,0.649014798526358
20278,1706.896433,1706.923767,1,51206892,51207713,821,0.34778880125691575
20279,1707.004233,1707.019267,1,51210126,51210578,452,0.6332365716033548
20280,1707.0203,1707.024733,1,51210609,51210741,132,0.7665171281180846
20281,1707.027533,1707.030533,1,51210825,51210915,90,0.7502199482957181
20282,1707.046967,1707.065067,1,51211409,51211952,543,0.12625126141687412
20283,1707.1874,1707.190533,1,51215622,51215715,93,0.8841573351141735
20284,1707.195733,1707.198833,1,51215871,51215964,93,0.8655556400953142
20285,1707.218567,1707.223433,1,51216557,51216702,145,0.4349674524284112
20286,1707.2257,1707.244867,1,51216771,51217346,575,0.4519028166701471
20287,1707.359067,1707.3643,1,51220772,51220929,157,0.8840914965339515
20288,1707.3969,1707.401267,1,51221907,51222038,131,0.3471829790624467
20289,1707.402567,1707.409633,1,51222077,51222288,211,0.4392802560409692
20290,1707.570967,1707.5749,1,51227129,51227247,118,0.667586710750388
20291,1710.945333,1711.056767,1,51328359,51331703,3344,0.1979577622860884
20292,1711.0585,1711.088267,1,51331755,51332648,893,0.585879111047064
20293,1711.0928,1711.1311,1,51332784,51333933,1149,0.20593570709682713
20294,1711.1325,1711.143467,1,51333975,51334304,329,0.8753289452702717
20295,1711.144667,1711.1583,1,51334340,51334749,409,0.8339948468237381
20296,1711.1636,1711.1909,1,51334908,51335727,819,0.5583688904113779
20297,1711.218067,1711.228133,1,51336542,51336843,301,0.032805795294900596
20298,1711.750067,1711.754033,1,51352502,51352620,118,0.8413379242285618
20299,1711.7556,1711.805533,1,51352668,51354165,1497,0.9466718583360004
20300,1711.820767,1711.8438,1,51354623,51355314,691,0.9138852965537075
20301,1711.848367,1711.852233,1,51355451,51355566,115,0.8589111350399552
20302,1711.856633,1711.859633,1,51355698,51355788,90,0.7853454375898984
20303,1711.872,1711.877167,1,51356160,51356315,155,0.7782232094532441
20304,1711.8847,1711.895733,1,51356541,51356871,330,0.9293988728273538
20305,1711.9396,1711.944,1,51358188,51358320,132,0.9635360331004829
20306,1711.945067,1711.952867,1,51358352,51358586,234,0.9190147616841441
20307,1711.9541,1711.9939,1,51358623,51359817,1194,0.94648279630612
20308,1711.9954,1712.002033,1,51359862,51360060,198,0.89608441071543
20309,1712.023567,1712.0404,1,51360707,51361212,505,0.9309938315391252
20310,1712.0414,1712.0529,1,51361242,51361587,345,0.8673027237524318
20311,1712.068367,1712.106367,1,51362051,51363191,1140,0.6168688293805693
20312,1712.107967,1712.149133,1,51363239,51364473,1234,0.7730598241320268
20313,1712.1554,1712.160267,1,51364662,51364808,146,0.8439011410626508
20314,1712.164,1712.183433,1,51364920,51365502,582,0.7608670283221299
20315,1712.191633,1712.253433,1,51365748,51367602,1854,0.3984776442835227
20316,1712.267433,1712.270433,1,51368022,51368112,90,0.7484042757072875
20317,1712.275467,1712.288433,1,51368264,51368652,388,0.6448452160027162
20318,1712.298367,1712.3326,1,51368951,51369978,1027,0.8023592779236195
20319,1712.339733,1712.3533,1,51370191,51370599,408,0.6770987631144569
20320,1712.366833,1712.372067,1,51371004,51371162,158,0.8960424378154987
20321,1712.374233,1712.3993,1,51371226,51371979,753,0.9394764370984129
20322,1712.4028,1712.461367,1,51372084,51373841,1757,0.7108890868875534
20323,1712.483633,1712.49,1,51374508,51374700,192,0.4800014357676473
20324,1712.496767,1712.522333,1,51374903,51375669,766,0.8252061970747255
20325,1712.531333,1712.575233,1,51375939,51377256,1317,0.46820855439687614
20326,1712.610233,1712.6775,1,51378306,51380325,2019,0.36043651767083784
20327,1712.698033,1712.705667,1,51380940,51381170,230,0.8314073552985964
20328,1712.7068,1712.7817,1,51381204,51383451,2247,0.3814484261929234
20329,1712.801133,1712.806833,1,51384033,51384204,171,0.445550698858959
20330,1712.809067,1712.842833,1,51384272,51385284,1012,0.596981292560831
20331,1712.8526,1712.892067,1,51385578,51386762,1184,0.5659648192595925
20332,1712.904633,1712.939967,1,51387138,51388199,1061,0.33828204155052716
20333,1712.941033,1712.9519,1,51388230,51388557,327,0.6308894073867556
20334,1712.965667,1712.972133,1,51388970,51389163,193,0.718999598975905
20335,1712.994333,1713.0272,1,51389829,51390816,987,0.5899175247292585
20336,1713.052533,1713.058667,1,51391575,51391760,185,0.7337205609698684
20337,1713.070233,1713.1127,1,51392106,51393381,1275,0.5572901120915892
20338,1713.1151,1713.129167,1,51393453,51393875,422,0.652904759972777
20339,1713.135433,1713.151033,1,51394062,51394530,468,0.7929476628519562
20340,1713.1523,1713.168233,1,51394569,51395046,477,0.7457319072236808
20341,1713.1739,1713.233167,1,51395217,51396995,1778,0.5440383743019934
20342,1713.255133,1713.258833,1,51397653,51397764,111,0.9173340917304197
20343,1713.2817,1713.302,1,51398451,51399060,609,0.6149020386582806
20344,1713.309833,1713.341867,1,51399294,51400256,962,0.7206208721542133
20345,1713.3509,1713.400767,1,51400527,51402023,1496,0.4447720076051116
20346,1713.420333,1713.425033,1,51402609,51402750,141,0.8041294869465818
20347,1713.441333,1713.4637,1,51403239,51403911,672,0.4285895091661644
20348,1713.485733,1713.515033,1,51404571,51405450,879,0.6688018965072157
20349,1713.5161,1713.519267,1,51405483,51405578,95,0.9685544190646794
20350,1713.526667,1713.568267,1,51405800,51407048,1248,0.4033040158165899
20351,1713.569267,1713.575267,1,51407078,51407258,180,0.7714636877376984
20352,1713.590667,1713.5966,1,51407720,51407898,178,0.7928151682788728
20353,1713.598533,1713.6026,1,51407955,51408078,123,-0.014181635460394481
20354,1713.614667,1713.633333,1,51408440,51408999,559,0.6298640850519135
20355,1713.6468,1713.671,1,51409404,51410130,726,0.7259252812271556
20356,1713.6854,1713.722033,1,51410562,51411660,1098,0.5779352594244518
20357,1713.726467,1713.7659,1,51411794,51412977,1183,0.2937287122663907
20358,1713.775033,1713.822667,1,51413250,51414680,1430,0.33628749705083905
20359,1713.824433,1713.8688,1,51414732,51416064,1332,0.20461144165751005
20360,1713.8699,1713.874033,1,51416097,51416220,123,0.8522985926027395
20361,1713.8818,1713.898467,1,51416454,51416954,500,0.3413553007343277
20362,1713.925467,1713.931333,1,51417764,51417939,175,0.8453223761612343
20363,1713.954033,1713.985367,1,51418620,51419561,941,0.34467102004084327
20364,1713.998367,1714.014033,1,51419951,51420420,469,0.7111570365477795
20365,1714.0155,1714.0255,1,51420465,51420765,300,0.7640797616112203
20366,1714.034567,1714.1189,1,51421037,51423567,2530,0.5808985620350084
20367,1714.1236,1714.430033,1,51423708,51432900,9192,0.5215260371579034
20368,1714.431467,1714.4818,1,51432944,51434454,1510,0.7208244896092484
20369,1714.4876,1714.497967,1,51434628,51434939,311,0.6278320603014297
20370,1714.503833,1714.519367,1,51435114,51435581,467,0.6361840334832426
20371,1714.520833,1714.526533,1,51435624,51435795,171,0.8161044829990683
20372,1714.5294,1714.5356,1,51435882,51436068,186,0.779860680907445
20373,1714.551733,1714.556733,1,51436551,51436701,150,0.8616752269201017
20374,1714.6098,1714.616867,1,51438294,51438506,212,0.4083149264700647
20375,1714.618167,1714.666033,1,51438545,51439980,1435,0.3923052733375299
20376,1714.689267,1714.714867,1,51440678,51441446,768,0.7626962952585474
20377,1714.722,1714.7427,1,51441660,51442281,621,0.21759517887636276
20378,1714.767533,1714.770733,1,51443025,51443121,96,0.6931621210553863
20379,1714.7738,1714.954867,1,51443214,51448646,5432,0.6815419101101537
20380,1714.955933,1714.997233,1,51448677,51449916,1239,0.8674224852702069
20381,1715.0062,1715.010167,1,51450186,51450305,119,0.9079790657698228
20382,1715.028533,1715.059367,1,51450855,51451781,926,0.3383982645035501
20383,1715.060567,1715.080167,1,51451817,51452405,588,0.5610538920695658
20384,1715.149733,1715.3131,1,51454491,51459393,4902,0.3018008248509894
20385,1715.3193,1715.323733,1,51459579,51459711,132,0.8113705804736487
20386,1715.341733,1715.350067,1,51460251,51460502,251,0.7949323285117493
20387,1715.861667,1715.865333,1,51475850,51475959,109,0.8513101297271523
20388,1717.624067,1717.6337,1,51528722,51529011,289,0.8053388912143253
20389,1718.060133,1718.095433,1,51541803,51542862,1059,0.527179663688506
20390,1718.1016,1718.114467,1,51543048,51543434,386,0.5845678100302312
20391,1718.478467,1718.481733,1,51554354,51554451,97,0.6343951388471134
20392,1718.5241,1718.5311,1,51555723,51555933,210,0.4899003367895181
20393,1718.558767,1718.562033,1,51556763,51556860,97,0.7038515592947472
20394,1718.731367,1718.752733,1,51561941,51562581,640,0.6988110494151138
20395,1718.754867,1718.774733,1,51562646,51563241,595,0.9100766198096981
20396,1718.776733,1718.792033,1,51563301,51563760,459,0.7911869708789513
20397,1718.794133,1718.7992,1,51563823,51563976,153,0.8404287322487803
20398,1718.8004,1718.805533,1,51564012,51564165,153,0.8642039432368225
20399,1718.807267,1718.8133,1,51564218,51564399,181,0.6654813096600898
20400,1718.823233,1718.828,1,51564696,51564840,144,0.9364477610337938
20401,1718.8297,1718.833767,1,51564891,51565013,122,0.9550523560401765
20402,1718.836533,1718.8436,1,51565095,51565308,213,0.8588907134687821
20403,1718.882967,1718.898367,1,51566489,51566951,462,0.8330067552974668
20404,1718.904567,1718.9143,1,51567137,51567429,292,0.9155537129268686
20405,1718.9198,1718.923733,1,51567594,51567711,117,0.8637116079420386
20406,1718.9252,1718.929133,1,51567756,51567873,117,0.8375375103062843
20407,1718.9359,1718.939,1,51568077,51568170,93,0.7717993874636954
20408,1718.9484,1718.952067,1,51568452,51568562,110,0.7874824946940618
20409,1718.957767,1718.961567,1,51568733,51568847,114,0.8992763855517371
20410,1718.992267,1719.002533,1,51569768,51570075,307,0.8932590734853427
20411,1719.025767,1719.030533,1,51570773,51570915,142,0.7878601884192994
20412,1719.055733,1719.063233,1,51571671,51571896,225,0.8597602424520682
20413,1719.068733,1719.1095,1,51572061,51573285,1224,0.39849663218226106
20414,1719.113033,1719.116167,1,51573390,51573485,95,0.7322495292357475
20415,1719.1172,1719.120567,1,51573516,51573617,101,0.3044467532527509
20416,1719.121833,1719.148433,1,51573654,51574452,798,0.5573001336778682
20417,1719.151433,1719.154967,1,51574542,51574649,107,0.6444051682961888
20418,1719.158133,1719.161233,1,51574743,51574836,93,0.9230139288140111
20419,1719.1712,1719.174867,1,51575136,51575246,110,0.8452137401017579
20420,1719.178967,1719.1938,1,51575369,51575814,445,0.7306406149298302
20421,1719.203767,1719.227233,1,51576113,51576816,703,0.5122043241824004
20422,1719.2419,1719.270667,1,51577257,51578120,863,0.18511884990404917
20423,1719.284867,1719.327567,1,51578546,51579827,1281,0.21699116562450133
20424,1719.3534,1719.3623,1,51580602,51580869,267,0.8831803662072721
20425,1719.3646,1719.4103,1,51580938,51582309,1371,0.5460126676447664
20426,1719.4114,1719.4334,1,51582342,51583002,660,0.6142822528085391
20427,1719.444833,1719.4484,1,51583344,51583452,108,0.7783302072921522
20428,1719.470167,1719.4804,1,51584105,51584412,307,0.8164961211147099
20429,1719.481833,1719.491467,1,51584454,51584744,290,0.8389922455171698
20430,1719.495933,1719.5021,1,51584877,51585063,186,0.7850784351833572
20431,1719.5052,1719.529267,1,51585156,51585878,722,0.7006769714445664
20432,1719.531167,1719.535333,1,51585935,51586059,124,0.25556201729589445
20433,1719.675,1719.693267,1,51590250,51590798,548,0.42756178689410607
20434,1719.705133,1719.7095,1,51591153,51591285,132,0.30637496913436785
20435,1719.713167,1719.729067,1,51591395,51591872,477,0.20517282759178548
20436,1719.820267,1719.841733,1,51594608,51595251,643,0.682859407233706
20437,1719.843533,1719.8469,1,51595305,51595407,102,0.8689845009412898
20438,1719.867467,1719.870667,1,51596024,51596120,96,0.6009959544939274
20439,1719.873367,1719.8914,1,51596201,51596742,541,-0.16269806007539675
20440,1719.902,1719.914067,1,51597060,51597422,362,0.5957137915682867
20441,1719.924133,1719.945933,1,51597723,51598377,654,0.1347100636940085
20442,1719.9516,1719.954667,1,51598548,51598640,92,0.8763363572779937
20443,1720.433967,1720.442133,1,51613019,51613263,244,0.4396127109497624
20444,1720.451067,1720.458067,1,51613532,51613742,210,0.298041661512878
20445,1721.377167,1721.390067,1,51641315,51641702,387,0.794765212019128
20446,1721.418433,1721.458367,1,51642552,51643751,1199,0.44703076234839473
20447,1721.460167,1721.4635,1,51643805,51643905,100,0.1211981044841892
20448,1721.469933,1721.5167,1,51644097,51645501,1404,0.3667431649451987
20449,1721.523533,1721.555533,1,51645705,51646665,960,0.5489997860337189
20450,1721.579333,1721.5918,1,51647379,51647754,375,0.7875248327743276
20451,1721.605333,1721.620133,1,51648159,51648603,444,0.3194512968654936
20452,1721.997667,1722.001333,1,51659930,51660039,109,0.5276064403094828
20453,1722.013867,1722.024167,1,51660416,51660725,309,0.6875891250383603
20454,1722.073567,1722.078733,1,51662207,51662361,154,0.1191914423294487
20455,1722.0828,1722.085833,1,51662484,51662574,90,0.9607690528498914
20456,1722.097267,1722.1079,1,51662918,51663237,319,0.6744964776462786
20457,1722.3178,1722.324867,1,51669534,51669746,212,0.5608745006570998
20458,1722.4842,1722.491833,1,51674526,51674754,228,0.7972758676213102
20459,1722.493167,1722.509967,1,51674795,51675299,504,0.5474301232378357
20460,1722.52,1722.5233,1,51675600,51675699,99,0.7460482288491127
20461,1722.6156,1722.627233,1,51678468,51678816,348,0.4344869040148001
20462,1722.633067,1722.670467,1,51678992,51680114,1122,0.3255978978202602
20463,1722.688633,1722.739367,1,51680658,51682181,1523,0.49205476726589564
20464,1722.809367,1722.812867,1,51684281,51684386,105,0.9717907708632115
20465,1723.076367,1723.081067,1,51692291,51692432,141,0.3110045350901157
20466,1724.129167,1724.135967,1,51723875,51724079,204,0.523851071959824
20467,1724.186233,1724.1979,1,51725586,51725937,351,0.13774997877780165
20468,1724.867933,1724.8722,1,51746037,51746166,129,0.6210773143644502
20469,1724.873833,1724.9098,1,51746214,51747294,1080,0.528474990305649
20470,1726.5627,1726.604467,1,51796881,51798134,1253,0.2795163877487651
20471,1727.0547,1727.1153,1,51811641,51813459,1818,0.6377972774848117
20472,1727.116767,1727.121833,1,51813503,51813654,151,0.6634595613316421
20473,1727.123067,1727.129833,1,51813692,51813894,202,0.8971931811361743
20474,1727.131033,1727.135867,1,51813930,51814076,146,0.8040055391549846
20475,1727.150133,1727.153933,1,51814503,51814617,114,0.8689091271357341
20476,1727.165733,1727.1762,1,51814971,51815286,315,0.8289482524757593
20477,1727.1833,1727.192767,1,51815499,51815783,284,0.7606962230119841
20478,1727.193767,1727.198833,1,51815813,51815964,151,0.3019472663936443
20479,1727.212833,1727.217867,1,51816384,51816536,152,0.7706849836994187
20480,1727.220933,1727.2322,1,51816627,51816966,339,0.7532033413951407
20481,1727.242133,1727.247667,1,51817263,51817430,167,0.8798793807788109
20482,1727.3135,1727.332633,1,51819405,51819978,573,0.17240883289865425
20483,1727.349567,1727.3553,1,51820487,51820659,172,0.8516646078828229
20484,1727.37,1727.384533,1,51821100,51821535,435,0.8875571576750724
20485,1727.387133,1727.394567,1,51821613,51821837,224,0.585822800668965
20486,1727.3957,1727.408667,1,51821871,51822260,389,0.6827701390227877
20487,1727.4644,1727.481633,1,51823932,51824448,516,0.36523677940309485
20488,1727.5323,1727.538567,1,51825969,51826157,188,0.5374398626330776
20489,1727.599133,1727.606933,1,51827973,51828207,234,0.44267511185272584
20490,1728.115667,1728.118967,1,51843470,51843569,99,0.643766429302574
20491,1728.124233,1728.151133,1,51843726,51844533,807,0.454574064222043
20492,1728.2216,1728.253467,1,51846648,51847604,956,0.8517044403861181
20493,1728.2693,1728.280733,1,51848079,51848421,342,0.8341638226592849
20494,1728.281933,1728.2903,1,51848457,51848709,252,0.7860680655417974
20495,1728.403033,1728.415833,1,51852090,51852474,384,0.839994968506312
20496,1728.425733,1728.480733,1,51852771,51854421,1650,0.7581050836720478
20497,1728.4824,1728.485767,1,51854472,51854573,101,0.8641131121912105
20498,1728.4872,1728.495433,1,51854616,51854862,246,0.8233148170095
20499,1728.4965,1728.500767,1,51854895,51855023,128,0.8124484932432471
20500,1728.514867,1728.518933,1,51855446,51855567,121,0.8696589064386
20501,1728.5222,1728.5254,1,51855666,51855762,96,0.8127077859715163
20502,1728.5602,1728.565167,1,51856806,51856955,149,0.9130975273368113
20503,1728.576467,1728.579633,1,51857294,51857388,94,0.8568028264067883
20504,1728.5808,1728.5997,1,51857424,51857991,567,0.7546763426184591
20505,1728.608333,1728.611567,1,51858249,51858347,98,0.8895971492534038
20506,1728.617567,1728.624767,1,51858527,51858743,216,0.5064008869441479
20507,1728.640833,1728.657267,1,51859224,51859718,494,0.5827572174120726
20508,1728.6837,1728.7011,1,51860511,51861033,522,0.676513335909367
20509,1728.725467,1728.734033,1,51861764,51862020,256,0.9456167492225122
20510,1728.737867,1728.750767,1,51862136,51862523,387,0.6338312133867074
20511,1728.755067,1728.761933,1,51862652,51862857,205,0.8361353699962656
20512,1728.788633,1728.7939,1,51863658,51863817,159,0.9548820381168475
20513,1728.795667,1728.8572,1,51863870,51865716,1846,0.6540216375303975
20514,1728.859267,1728.880433,1,51865778,51866412,634,0.6939350528162936
20515,1728.883167,1728.888367,1,51866495,51866651,156,0.8569033878910317
20516,1728.900933,1728.941033,1,51867027,51868230,1203,0.8660552285973477
20517,1728.9509,1728.9733,1,51868527,51869199,672,0.7867806991439812
20518,1728.975867,1729.0123,1,51869276,51870369,1093,0.658767038410683
20519,1729.0754,1729.0793,1,51872262,51872379,117,0.8987545633741784
20520,1729.219967,1729.223533,1,51876599,51876705,106,0.9123569344410062
20521,1729.259967,1729.27,1,51877799,51878100,301,0.8218806665279617
20522,1729.290133,1729.390667,1,51878703,51881720,3017,0.3671746685238524
20523,1729.393767,1729.423733,1,51881813,51882711,898,0.504502996724078
20524,1729.915667,1729.9416,1,51897470,51898248,778,0.6405103774086964
20525,1729.9512,1729.954433,1,51898536,51898632,96,0.911596498469979
20526,1729.964667,1729.9764,1,51898940,51899292,352,0.43858609447370933
20527,1729.978567,1729.996767,1,51899357,51899903,546,0.24365592932850746
20528,1730.0018,1730.006,1,51900054,51900180,126,0.7320124963404184
20529,1730.0118,1730.059333,1,51900354,51901779,1425,0.5719615929225105
20530,1730.0612,1730.073867,1,51901836,51902216,380,0.7744746569434356
20531,1730.075367,1730.079667,1,51902261,51902390,129,0.8596854486152026
20532,1730.090633,1730.107033,1,51902718,51903210,492,0.34181600365121534
20533,1730.108633,1730.142033,1,51903258,51904260,1002,0.6308767660224599
20534,1730.1499,1730.180033,1,51904497,51905400,903,0.21341611236300828
20535,1730.194967,1730.2006,1,51905849,51906018,169,0.960681657200567
20536,1730.205267,1730.2118,1,51906158,51906354,196,0.9214373980090587
20537,1730.221633,1730.238733,1,51906648,51907161,513,0.09773575840845838
20538,1730.260667,1730.263767,1,51907820,51907913,93,0.9073964023195797
20539,1730.291433,1730.301967,1,51908742,51909059,317,0.23165019804455617
20540,1730.310833,1730.313867,1,51909324,51909416,92,0.8275257213694093
20541,1730.316367,1730.329067,1,51909491,51909872,381,0.7979788115204074
20542,1730.457267,1730.461433,1,51913718,51913842,124,0.8228722248785801
20543,1730.465567,1730.468833,1,51913967,51914064,97,0.8557088745034761
20544,1730.473033,1730.495033,1,51914190,51914850,660,0.16719655923982424
20545,1730.577833,1730.608167,1,51917334,51918245,911,0.6755661800291844
20546,1730.6347,1730.640667,1,51919041,51919220,179,0.6900835888669437
20547,1730.6609,1730.674833,1,51919827,51920244,417,0.7016952787694486
20548,1731.575933,1731.584767,1,51947277,51947543,266,0.7383187508714857
20549,1731.585967,1731.5894,1,51947579,51947682,103,0.6225957643364466
20550,1731.5904,1731.598367,1,51947712,51947951,239,-0.07025641285748742
20551,1731.599433,1731.6407,1,51947982,51949221,1239,0.05362441347625764
20552,1731.653,1731.681133,1,51949590,51950433,843,0.2261423512620448
20553,1731.700433,1731.7037,1,51951012,51951111,99,0.8419643512654155
20554,1731.751767,1731.759967,1,51952553,51952799,246,0.7766008835258115
20555,1731.768733,1731.782367,1,51953061,51953471,410,0.3819043641273523
20556,1731.786167,1731.813767,1,51953585,51954413,828,0.5799765782003989
20557,1731.820367,1731.826733,1,51954611,51954801,190,0.6908854134361202
20558,1731.833667,1731.8368,1,51955010,51955104,94,0.9257479724571288
20559,1731.8417,1731.845367,1,51955251,51955361,110,0.7085448458059607
20560,1736.293,1736.367233,1,52088790,52091016,2226,0.12433924705639827
20561,1736.375533,1736.4417,1,52091265,52093251,1986,0.2508478770450061
20562,1736.443167,1736.4474,1,52093295,52093422,127,0.9141236695370549
20563,1736.886467,1736.989133,1,52106594,52109673,3079,0.12237174444217469
20564,1736.9908,1737.0079,1,52109724,52110237,513,0.3801671433854487
20565,1737.009867,1737.0691,1,52110296,52112073,1777,0.12096833398584331
20566,1737.080233,1737.116733,1,52112406,52113501,1095,0.4703895935062645
20567,1737.138133,1737.149233,1,52114143,52114476,333,0.09264585178499501
20568,1740.668167,1740.681633,1,52220045,52220448,403,0.6026023494734876
20569,1740.683367,1740.686833,1,52220501,52220604,103,0.8786921679927979
20570,1740.6907,1740.697033,1,52220721,52220910,189,0.8512332536616393
20571,1740.7014,1740.706867,1,52221042,52221206,164,-0.24821194744399722
20572,1743.041033,1743.0475,1,52291230,52291425,195,0.7774398656681806
20573,1743.0541,1743.0617,1,52291623,52291851,228,0.8364854115933141
20574,1743.07,1743.1153,1,52292100,52293459,1359,0.1777607779744418
20575,1743.1166,1743.1422,1,52293498,52294266,768,0.10188699022168299
20576,1743.143267,1743.1944,1,52294298,52295832,1534,0.1527943600051615
20577,1744.066667,1744.125567,1,52322000,52323767,1767,0.13654669145469445
20578,1744.134667,1744.139767,1,52324040,52324193,153,0.6066491166575645
20579,1744.1416,1744.178467,1,52324248,52325354,1106,0.1528957704793905
20580,1744.180033,1744.199,1,52325400,52325970,570,0.3537508788857555
20581,1744.2001,1744.210733,1,52326003,52326321,318,0.7031132042853249
20582,1744.222867,1744.259433,1,52326686,52327782,1096,0.3045557540787459
20583,1744.261633,1744.266167,1,52327848,52327985,137,0.29652685317617605
20584,1745.146,1745.149533,1,52354380,52354485,105,0.24600432762795393
20585,1745.965767,1745.985133,1,52378973,52379553,580,0.3224521392581833
20586,1747.124367,1747.129833,1,52413731,52413894,163,0.746806474215588
20587,1747.148967,1747.361333,1,52414469,52420839,6370,0.7556653330263148
20588,1748.785067,1748.797967,1,52463552,52463939,387,0.3189118663538023
20589,1749.257433,1749.279167,1,52477722,52478375,653,0.4981468984471161
20590,1749.3852,1749.3937,1,52481556,52481811,255,0.7021656304429431
20591,1749.407,1749.563167,1,52482210,52486895,4685,0.7967319542969359
20592,1749.564567,1749.618467,1,52486937,52488554,1617,0.7929491668750692
20593,1749.693467,1749.704267,1,52490804,52491128,324,0.6931254447662178
20594,1749.728233,1749.791633,1,52491846,52493748,1902,0.368035841436796
20595,1749.800133,1749.844133,1,52494003,52495323,1320,0.7434460753789444
20596,1749.845367,1750.007867,1,52495361,52500236,4875,0.7586226488408293
20597,1750.0157,1750.051867,1,52500471,52501556,1085,0.6506103203554447
20598,1750.062833,1750.068533,1,52501884,52502055,171,0.8483971930826348
20599,1750.2434,1750.251367,1,52507302,52507541,239,0.04751568850949914
20600,1750.562867,1750.572433,1,52516886,52517172,286,0.13804637420963137
20601,1750.885567,1750.894,1,52526567,52526820,253,0.006357217892444633
20602,1750.8953,1750.9076,1,52526859,52527228,369,0.463139863253128
20603,1750.942667,1750.946633,1,52528280,52528398,118,0.6262517309328818
20604,1751.2199,1751.2363,1,52536597,52537089,492,0.11017008859068636
20605,1751.2536,1751.266967,1,52537608,52538009,401,0.0849529481327279
20606,1751.268467,1751.275067,1,52538054,52538252,198,0.7885813516817257
20607,1751.957,1752.2114,1,52558710,52566342,7632,0.7754572455141191
20608,1752.422533,1752.428633,1,52572675,52572858,183,0.6624185432127151
20609,1752.492833,1752.5884,1,52574784,52577652,2868,0.801644632617039
20610,1752.7902,1752.837133,1,52583706,52585113,1407,0.23056577474668127
20611,1752.841467,1752.897333,1,52585244,52586919,1675,0.3018785852907761
20612,1752.9605,1753.038033,1,52588815,52591140,2325,0.26180752413355374
20613,1753.045333,1753.052,1,52591359,52591560,201,0.8563213511695967
20614,1753.094833,1753.131133,1,52592844,52593933,1089,0.2534928320983977
20615,1753.135433,1753.178167,1,52594062,52595345,1283,0.29261406342760804
20616,1753.233533,1753.266333,1,52597005,52597989,984,0.33607889375849126
20617,1753.268233,1753.3212,1,52598046,52599636,1590,0.17630556563570798
20618,1753.322367,1753.3503,1,52599671,52600509,838,0.08366094796787314
20619,1753.358967,1753.363767,1,52600769,52600913,144,0.9377971772977453
20620,1753.367567,1753.404133,1,52601027,52602123,1096,0.1187448087866286
20621,1753.409667,1753.440567,1,52602290,52603217,927,0.2922893838445997
20622,1753.5139,1753.519233,1,52605417,52605576,159,0.8998225597900662
20623,1753.5289,1753.542633,1,52605867,52606278,411,0.8029135285760105
20624,1753.5505,1753.5538,1,52606515,52606614,99,0.7184310261043947
20625,1753.556,1753.5974,1,52606680,52607922,1242,0.4885821179699127
20626,1753.598433,1753.602833,1,52607952,52608084,132,0.48623540119988024
20627,1753.604367,1753.612267,1,52608131,52608368,237,0.8160896714477287
20628,1753.676033,1753.680533,1,52610280,52610415,135,0.7751842356218721
20629,1753.688633,1753.7075,1,52610658,52611225,567,0.8522177265819353
20630,1753.723733,1753.759667,1,52611711,52612790,1079,0.6553745336760973
20631,1753.8378,1753.8478,1,52615134,52615434,300,0.7946760439945465
20632,1753.849433,1753.8594,1,52615482,52615782,300,0.8167567629672704
20633,1753.8614,1753.870233,1,52615842,52616106,264,0.5790586088655905
20634,1753.891667,1753.909233,1,52616750,52617276,526,0.3495012890445494
20635,1754.019133,1754.024433,1,52620573,52620732,159,0.47258866228595525
20636,1754.025967,1754.040133,1,52620779,52621203,424,0.49955738385537657
20637,1754.051833,1754.0566,1,52621554,52621698,144,0.7974705489577928
20638,1754.073633,1754.082833,1,52622208,52622484,276,0.31001488544158795
20639,1754.084533,1754.0926,1,52622535,52622778,243,0.8865959220765619
20640,1754.601433,1754.6119,1,52638042,52638357,315,0.17794174322245698
20641,1754.624367,1754.652667,1,52638731,52639580,849,0.13220765515650112
20642,1754.6827,1754.704067,1,52640481,52641122,641,0.05298808335756461
20643,1754.715567,1754.728433,1,52641467,52641852,385,0.7724705807965626
20644,1754.741333,1754.765133,1,52642239,52642953,714,0.3890238073532501
20645,1755.3779,1755.393867,1,52661337,52661816,479,0.3802834734778268
20646,1755.394967,1755.401267,1,52661849,52662038,189,0.3430800040731747
20647,1755.4245,1755.430867,1,52662735,52662926,191,0.7626690954134752
20648,1755.9206,1756.0889,1,52677618,52682667,5049,0.7277794768512675
20649,1756.515,1756.570933,1,52695450,52697127,1677,0.6689598667400183
20650,1756.659733,1756.924667,1,52699791,52707740,7949,0.7190093487929055
20651,1757.251733,1757.344,1,52717551,52720320,2769,0.6605200885510369
20652,1757.434133,1757.475433,1,52723023,52724262,1239,0.6659059323005015
20653,1757.489267,1757.495433,1,52724678,52724862,184,0.16373404908993563
20654,1757.497767,1757.6723,1,52724933,52730169,5236,0.7136872470679425
20655,1760.2104,1760.367467,1,52806312,52811024,4712,0.7884753436057114
20656,1760.372667,1760.409767,1,52811180,52812293,1113,0.7540483828795412
20657,1760.523033,1760.5488,1,52815690,52816464,774,0.7001864185429917
20658,1760.550333,1760.685633,1,52816509,52820568,4059,0.766278865504244
20659,1762.6988,1762.7042,1,52880964,52881126,162,0.6985142251625804
20660,1762.705467,1762.7108,1,52881164,52881324,160,0.4159619127778974
20661,1765.504933,1765.5114,1,52965147,52965342,195,0.7037175089130824
20662,1765.519967,1765.534,1,52965599,52966020,421,0.13572357777910402
20663,1765.539533,1765.557733,1,52966185,52966731,546,0.1478985497423926
20664,1765.5678,1765.590333,1,52967034,52967709,675,0.6846075038775089
20665,1765.604567,1765.610367,1,52968137,52968311,174,0.35919901957337746
20666,1765.622467,1765.626767,1,52968674,52968803,129,0.8082538980331834
20667,1765.6368,1765.6449,1,52969104,52969347,243,0.7914573072000961
20668,1765.653,1765.819433,1,52969590,52974582,4992,0.7441826908766188
20669,1765.8233,1765.883267,1,52974699,52976498,1799,0.7515242510216179
20670,1766.350233,1766.3565,1,52990506,52990695,189,0.8845342022321137
20671,1766.363333,1766.383933,1,52990899,52991517,618,-0.08430583791661421
20672,1766.385067,1766.4222,1,52991552,52992666,1114,-0.13472283076413655
20673,1766.426267,1766.444367,1,52992788,52993331,543,-0.08517848189809751
20674,1766.4527,1766.5051,1,52993581,52995153,1572,0.11481379399216575
20675,1766.519833,1766.526067,1,52995594,52995782,188,0.8652642131641014
20676,1766.527433,1766.5315,1,52995822,52995945,123,0.732522820102006
20677,1766.8433,1766.862967,1,53005299,53005889,590,0.8506167654043144
20678,1766.884967,1766.8945,1,53006549,53006835,286,0.6345263610230706
20679,1766.9211,1766.998367,1,53007633,53009951,2318,0.7491230170334406
20680,1767.105,1767.339533,1,53013150,53020185,7035,0.7115849986086913
20681,1767.4383,1767.4431,1,53023149,53023293,144,0.9014195989671506
20682,1767.4445,1767.573333,1,53023335,53027199,3864,0.7411183004255261
20683,1767.6449,1767.8054,1,53029347,53034162,4815,0.7252400973875556
20684,1768.2339,1768.288767,1,53047017,53048663,1646,0.7211614699772174
20685,1768.294667,1768.387,1,53048840,53051610,2770,0.6688503405118961
20686,1768.3935,1768.398533,1,53051805,53051955,150,0.837812217040957
20687,1768.4055,1768.484267,1,53052165,53054528,2363,0.6581666179452621
20688,1768.53,1768.533167,1,53055900,53055995,95,0.19858615061802004
20689,1768.5358,1768.593267,1,53056074,53057798,1724,0.7883660052634178
20690,1768.693367,1768.9115,1,53060801,53067345,6544,0.7219545850460924
20691,1769.003833,1769.035067,1,53070114,53071052,938,0.44797143653879323
20692,1769.044,1769.0655,1,53071320,53071965,645,0.6768619543817653
20693,1769.1195,1769.142233,1,53073585,53074266,681,0.5748183112852666
20694,1769.234833,1769.328933,1,53077044,53079867,2823,0.7463843758565618
20695,1769.331933,1769.353567,1,53079957,53080607,650,0.6318041194245777
20696,1769.4896,1769.508267,1,53084688,53085248,560,0.5785718951498277
20697,1769.509533,1769.5411,1,53085285,53086233,948,0.7295564339226803
20698,1769.5504,1769.5726,1,53086512,53087178,666,0.8060192067479568
20699,1769.602667,1769.611433,1,53088080,53088342,262,0.6447137299616632
20700,1769.616633,1769.6284,1,53088498,53088852,354,0.6178313264102557
20701,1769.631633,1769.721033,1,53088948,53091630,2682,0.16595278345474448
20702,1769.7225,1769.8204,1,53091675,53094612,2937,0.16511082980879918
20703,1769.829567,1769.848133,1,53094887,53095443,556,0.679285359493682
20704,1769.849433,1769.854267,1,53095482,53095628,146,0.9193522190296215
20705,1769.8871,1770.076333,1,53096613,53102289,5676,0.7457935903474093
20706,1770.0843,1770.117433,1,53102529,53103522,993,0.6667189699269599
20707,1770.162233,1770.2073,1,53104866,53106219,1353,0.0536225364632903
20708,1770.2343,1770.349967,1,53107029,53110499,3470,0.15315166738322603
20709,1770.350967,1770.369333,1,53110529,53111079,550,0.28967903660361644
20710,1770.370367,1770.486767,1,53111111,53114603,3492,0.1641323964341335
20711,1770.488267,1770.5774,1,53114648,53117322,2674,0.2966164973349579
20712,1770.578733,1770.581767,1,53117361,53117453,92,0.6924148678385688
20713,1770.5962,1770.612533,1,53117886,53118375,489,0.48603687583573113
20714,1770.658633,1770.674267,1,53119758,53120228,470,0.5368463587611155
20715,1770.689367,1770.719,1,53120681,53121570,889,0.6214236863085674
20716,1770.7638,1770.784,1,53122914,53123520,606,0.601602356090614
20717,1770.833433,1770.8779,1,53125002,53126337,1335,0.5716062493965871
20718,1770.8834,1770.8924,1,53126502,53126772,270,0.4243052555376512
20719,1770.898633,1770.909233,1,53126958,53127276,318,0.46124086811359916
20720,1770.923333,1770.939567,1,53127699,53128187,488,0.6201016778749956
20721,1770.9417,1770.954733,1,53128251,53128641,390,0.6159695255293566
20722,1771.050233,1771.219133,1,53131506,53136573,5067,0.6993996773133124
20723,1771.290767,1771.294733,1,53138723,53138841,118,0.24909832293069276
20724,1771.3515,1771.380033,1,53140545,53141400,855,0.6415630970066493
20725,1771.387633,1771.663267,1,53141628,53149898,8270,0.7079656719138653
20726,1771.7701,1771.778733,1,53153103,53153361,258,0.7824378164772569
20727,1771.786367,1771.968767,1,53153591,53159063,5472,0.5556534297906921
20728,1771.975567,1772.041433,1,53159267,53161242,1975,0.6634293413668002
20729,1772.501567,1772.523033,1,53175047,53175690,643,0.0052787372164333265
20730,1773.604333,1773.609333,1,53208129,53208279,150,0.5509675690591859
20731,1773.671933,1773.7013,1,53210157,53211039,882,0.7330226333540903
20732,1773.707867,1773.9493,1,53211236,53218479,7243,0.711636844944356
20733,1774.155967,1774.306133,1,53224679,53229183,4504,0.7094759632650725
20734,1774.4131,1774.5067,1,53232393,53235201,2808,0.731326507313685
20735,1774.569233,1774.5744,1,53237076,53237232,156,0.36796715022888465
20736,1774.576833,1774.594967,1,53237304,53237849,545,0.7162040359170304
20737,1774.596267,1774.6219,1,53237888,53238657,769,0.7481322592513598
20738,1774.6791,1774.686433,1,53240373,53240592,219,0.7475162245280679
20739,1774.6883,1774.695067,1,53240649,53240852,203,0.7506512476320405
20740,1774.7078,1774.716333,1,53241234,53241489,255,0.4133535558208363
20741,1774.718133,1774.731433,1,53241543,53241942,399,0.7977500574125899
20742,1774.980367,1775.148833,1,53249411,53254464,5053,0.7773840114014727
20743,1775.1574,1775.176533,1,53254722,53255295,573,0.7499038342374471
20744,1775.1796,1775.209767,1,53255388,53256293,905,0.765466368890442
20745,1775.310167,1775.5727,1,53259305,53267181,7876,0.6848165297083841
20746,1775.5738,1775.599633,1,53267214,53267988,774,0.7207313658448238
20747,1776.398,1776.4148,1,53291940,53292444,504,0.06344311214849789
20748,1776.540967,1776.545833,1,53296229,53296374,145,0.7643021632638822
20749,1776.547067,1776.552533,1,53296412,53296575,163,0.6742383294841011
20750,1776.605067,1776.616333,1,53298152,53298489,337,0.7849088637215452
20751,1776.623,1776.646133,1,53298690,53299383,693,0.5095659821206483
20752,1776.663533,1776.673033,1,53299905,53300190,285,0.8130856591909756
20753,1776.674233,1776.683833,1,53300226,53300514,288,0.33469770525678905
20754,1776.6976,1776.740467,1,53300928,53302214,1286,0.505076638481713
20755,1776.741733,1776.7968,1,53302251,53303904,1653,0.2931253954360123
20756,1777.118333,1777.1275,1,53313549,53313825,276,0.3492484067856156
20757,1777.159067,1777.168367,1,53314772,53315051,279,0.8125175709042277
20758,1777.460967,1777.472133,1,53323829,53324163,334,-0.03045370141212698
20759,1777.4815,1777.487533,1,53324445,53324625,180,-0.3730759542970694
20760,1777.492033,1777.4953,1,53324760,53324859,99,0.45812708098577243
20761,1777.6634,1777.6684,1,53329902,53330052,150,0.6174351886371414
20762,1777.763633,1778.000467,1,53332908,53340014,7106,0.5873403812753187
20763,1778.001567,1778.022333,1,53340047,53340669,622,0.8389674397462505
20764,1778.0237,1778.031533,1,53340711,53340945,234,0.575285343127855
20765,1778.219933,1778.233733,1,53346597,53347011,414,0.726543623558759
20766,1778.240567,1778.246267,1,53347217,53347388,171,0.836667852990338
20767,1778.2552,1778.258367,1,53347656,53347751,95,0.8465703107157783
20768,1778.342633,1778.3501,1,53350278,53350503,225,0.2851000399442517
20769,1778.358033,1778.3641,1,53350740,53350923,183,0.6862187335638693
20770,1778.371567,1778.376133,1,53351147,53351283,136,0.8517820815767294
20771,1778.819867,1778.823767,1,53364596,53364713,117,0.10791998809137794
20772,1778.832567,1778.837,1,53364977,53365110,133,0.36812721120535735
20773,1778.839,1778.850233,1,53365170,53365506,336,0.024257472567461556
20774,1778.858633,1778.8635,1,53365758,53365905,147,-0.21982121070785354
20775,1778.8682,1778.872333,1,53366046,53366169,123,0.4947099280526064
20776,1778.887333,1778.894067,1,53366619,53366822,203,0.6772277991971397
20777,1778.9062,1778.909433,1,53367186,53367282,96,0.16852856629757565
20778,1778.929133,1778.933,1,53367873,53367990,117,0.843212624175282
20779,1779.0166,1779.037267,1,53370498,53371118,620,0.6640687809963649
20780,1779.055267,1779.108167,1,53371658,53373245,1587,0.324394087631272
20781,1779.126467,1779.130667,1,53373794,53373920,126,0.8617050426833063
20782,1779.132567,1779.144133,1,53373977,53374323,346,0.8308180139220113
20783,1779.1452,1779.152433,1,53374356,53374572,216,0.8198819881390482
20784,1779.3773,1779.3804,1,53381319,53381412,93,0.6733160685199883
20785,1779.389867,1779.3956,1,53381696,53381868,172,0.795625226590302
20786,1779.643433,1779.646867,1,53389302,53389406,104,0.8434325564680645
20787,1779.6563,1779.662967,1,53389689,53389889,200,0.8151853754952852
20788,1779.665633,1779.6705,1,53389968,53390115,147,0.6378503012936866
20789,1779.6735,1779.677633,1,53390205,53390328,123,0.7380280824652209
20790,1779.679367,1779.833433,1,53390381,53395002,4621,0.7368489854377082
20791,1780.0049,1780.096067,1,53400147,53402882,2735,0.6782229181721524
20792,1780.379167,1780.4051,1,53411375,53412153,778,0.26001488537881273
20793,1780.412333,1780.457867,1,53412369,53413736,1367,0.23527096467048408
20794,1780.459467,1780.4658,1,53413784,53413974,190,0.6240090865080338
20795,1780.4668,1780.480867,1,53414004,53414426,422,0.610932045162732
20796,1780.487233,1780.518633,1,53414616,53415558,942,0.5474109699756053
20797,1780.527633,1780.539867,1,53415828,53416196,368,0.1168199305128154
20798,1780.542267,1780.558333,1,53416268,53416749,481,0.5759350662726326
20799,1780.562833,1780.581367,1,53416884,53417441,557,0.5572433586080775
20800,1780.586933,1780.591733,1,53417607,53417751,144,0.6971408938961113
20801,1780.593767,1780.597133,1,53417813,53417913,100,0.9176430803897582
20802,1780.6039,1780.611033,1,53418117,53418330,213,0.7700057577714913
20803,1780.617,1780.658533,1,53418510,53419755,1245,0.4060507477093268
20804,1780.6651,1780.683033,1,53419953,53420490,537,0.045085846549237994
20805,1780.684733,1780.7033,1,53420541,53421099,558,0.5884488267018813
20806,1780.7077,1780.711667,1,53421231,53421350,119,0.7624447977683633
20807,1780.712767,1780.7405,1,53421383,53422215,832,0.3686156856143253
20808,1780.741567,1780.7449,1,53422247,53422347,100,0.8461803479396883
20809,1780.746967,1780.770567,1,53422409,53423117,708,0.46010041161393317
20810,1780.778567,1780.799333,1,53423357,53423979,622,0.5659274294250355
20811,1780.815767,1780.831167,1,53424473,53424935,462,0.8084718738493857
20812,1780.833033,1780.841267,1,53424990,53425238,248,0.7034587003328079
20813,1780.850967,1780.893867,1,53425529,53426816,1287,0.4544254625986542
20814,1780.9076,1780.9278,1,53427228,53427834,606,0.29511289470287316
20815,1780.929933,1780.938267,1,53427897,53428148,251,0.6438698804078137
20816,1780.9598,1780.9636,1,53428794,53428908,114,0.8798969099776435
20817,1780.9669,1780.977267,1,53429007,53429318,311,0.6227862637808773
20818,1780.996267,1781.031667,1,53429888,53430950,1062,0.1843011935335503
20819,1781.0328,1781.049733,1,53430984,53431491,507,0.3169145965633972
20820,1781.0586,1781.065867,1,53431758,53431976,218,0.7826186942040166
20821,1781.067433,1781.115,1,53432022,53433450,1428,0.17447767445451662
20822,1781.117033,1781.133,1,53433510,53433990,480,0.5476773535426429
20823,1781.168067,1781.174933,1,53435042,53435247,205,0.6554922045537168
20824,1781.187767,1781.196467,1,53435633,53435894,261,0.5334089109190913
20825,1781.214367,1781.218833,1,53436431,53436564,133,0.8436424683664779
20826,1781.9822,1781.991367,1,53459466,53459741,275,0.486119906587648
20827,1781.997967,1782.0301,1,53459939,53460903,964,0.1711740275453725
20828,1782.056,1782.120667,1,53461680,53463620,1940,0.7123922230208009
20829,1782.196167,1782.503267,1,53465885,53475098,9213,0.7216288591851387
20830,1782.5128,1782.516867,1,53475384,53475506,122,0.7121607089526611
20831,1782.6024,1782.685467,1,53478072,53480564,2492,0.6932975467054265
20832,1782.772433,1782.8923,1,53483172,53486769,3597,0.42534019452888566
20833,1782.8973,1782.9559,1,53486919,53488677,1758,0.6916878958521969
20834,1782.9572,1783.060667,1,53488716,53491820,3104,0.6981939188472528
20835,1783.1398,1783.157233,1,53494194,53494716,522,0.5235033913254119
20836,1783.2352,1783.2462,1,53497056,53497386,330,0.563472357210426
20837,1783.266067,1783.2762,1,53497982,53498286,304,0.5539656132702999
20838,1783.288733,1783.291833,1,53498661,53498754,93,0.10883030125577196
20839,1783.3439,1783.384967,1,53500317,53501549,1232,0.7451624477497111
20840,1783.3901,1783.3973,1,53501703,53501919,216,0.5800187962203092
20841,1783.403933,1783.4116,1,53502117,53502348,231,0.4622153926650893
20842,1783.435467,1783.4456,1,53503064,53503368,304,0.5619469289639225
20843,1783.4507,1783.4624,1,53503521,53503872,351,0.4981825213037968
20844,1783.566033,1783.749867,1,53506980,53512496,5516,0.6520854914033067
20845,1784.2971,1784.3252,1,53528913,53529756,843,0.21791286670400745
20846,1784.413867,1784.481833,1,53532416,53534454,2038,0.6366390894060552
20847,1784.5692,1784.620533,1,53537076,53538615,1539,0.6686195680787996
20848,1784.636767,1784.7059,1,53539103,53541177,2074,0.7532218299951675
20849,1784.778533,1784.908433,1,53543355,53547252,3897,0.6629210799588149
20850,1784.913133,1785.128667,1,53547393,53553860,6467,0.7053418339571627
20851,1785.310067,1785.3176,1,53559302,53559528,226,0.6286747502350489
20852,1785.332967,1785.443633,1,53559989,53563308,3319,0.6702604977575908
20853,1785.4447,1785.4546,1,53563341,53563638,297,0.7949215594272211
20854,1785.456133,1785.461467,1,53563683,53563844,161,0.7571369139018079
20855,1785.4676,1785.4839,1,53564028,53564517,489,0.5732879768409594
20856,1785.578567,1785.612767,1,53567357,53568383,1026,0.6504319680656453
20857,1785.620567,1785.6975,1,53568617,53570925,2308,0.6557450461018589
20858,1785.759367,1785.7804,1,53572781,53573412,631,0.6514273334471945
20859,1785.790633,1785.897633,1,53573718,53576928,3210,0.650612168467371
20860,1785.901233,1785.919733,1,53577036,53577591,555,0.6792439835877295
20861,1785.957067,1785.964333,1,53578712,53578929,217,0.8092771422722429
20862,1785.966267,1785.973667,1,53578988,53579210,222,0.7592340965475357
20863,1785.9822,1786.019567,1,53579466,53580587,1121,0.17680829073028187
20864,1786.021133,1786.0736,1,53580633,53582208,1575,0.4707518802371986
20865,1786.075367,1786.3087,1,53582261,53589261,7000,0.7254273996627906
20866,1786.3557,1786.373267,1,53590671,53591198,527,0.14518815617695516
20867,1786.374967,1786.401633,1,53591249,53592048,799,0.2284138538603065
20868,1786.404133,1786.411067,1,53592123,53592332,209,0.8940457538770995
20869,1786.427667,1786.4378,1,53592830,53593134,304,0.7958815332895478
20870,1786.442267,1786.458467,1,53593268,53593754,486,0.6824569296589176
20871,1786.461667,1786.5314,1,53593850,53595942,2092,0.11296064111278831
20872,1786.5343,1786.541767,1,53596029,53596253,224,0.8408352245510964
20873,1786.553,1786.627533,1,53596590,53598825,2235,0.28725197795041524
20874,1786.6317,1786.664467,1,53598951,53599934,983,0.23087781642115363
20875,1786.670133,1786.685967,1,53600103,53600579,476,0.13855045061780605
20876,1786.6872,1786.6918,1,53600616,53600754,138,-0.15033591097936957
20877,1786.693333,1786.8316,1,53600799,53604948,4149,0.26646789736810134
20878,1786.835467,1786.892633,1,53605064,53606778,1714,0.25757350005060015
20879,1786.908233,1786.9285,1,53607246,53607855,609,0.6383934332410354
20880,1786.930133,1786.9549,1,53607903,53608647,744,0.68396391100536
20881,1786.963567,1786.990267,1,53608907,53609708,801,0.18396603459172564
20882,1787.0367,1787.0627,1,53611101,53611881,780,0.5916049998125882
20883,1787.066167,1787.0729,1,53611985,53612187,202,0.6983089660868417
20884,1787.082667,1787.0926,1,53612480,53612778,298,0.6453808206126486
20885,1787.093967,1787.100733,1,53612819,53613021,202,0.4176510506540732
20886,1787.115033,1787.132,1,53613450,53613960,510,0.519027174155084
20887,1787.199467,1787.245733,1,53615984,53617371,1387,0.6472006614739255
20888,1787.258933,1787.2685,1,53617767,53618055,288,0.38647902643581156
20889,1787.2741,1787.302233,1,53618223,53619066,843,0.6145190758813963
20890,1787.306367,1787.315567,1,53619191,53619467,276,0.605672146922393
20891,1787.320067,1787.329667,1,53619602,53619890,288,0.6131110606475583
20892,1787.4209,1787.6052,1,53622627,53628156,5529,0.8295805575420567
20893,1787.607167,1787.610667,1,53628215,53628320,105,0.4064462049415855
20894,1787.625967,1787.6324,1,53628779,53628972,193,0.6715384396551793
20895,1787.634233,1787.688933,1,53629026,53630667,1641,0.03503868437687054
20896,1787.6903,1787.704533,1,53630709,53631135,426,-0.20788592221825608
20897,1787.727133,1787.730633,1,53631813,53631918,105,0.8269305764319441
20898,1787.732233,1787.763367,1,53631966,53632901,935,0.5310024540288508
20899,1787.764633,1787.9395,1,53632938,53638185,5247,0.6632984668674268
20900,1788.000867,1788.005567,1,53640026,53640167,141,0.2772192326793191
20901,1788.136267,1788.143167,1,53644088,53644295,207,0.6863480228368983
20902,1788.1811,1788.339433,1,53645433,53650182,4749,0.7584751528581993
20903,1788.343533,1788.373367,1,53650305,53651201,896,0.634377012821137
20904,1788.482067,1788.4994,1,53654462,53654982,520,0.6576673830913398
20905,1788.504567,1788.509633,1,53655137,53655288,151,0.7489228057988678
20906,1788.511467,1788.5278,1,53655344,53655834,490,0.4374798404543308
20907,1788.528933,1788.5328,1,53655867,53655984,117,0.47852812250301485
20908,1788.546267,1788.5825,1,53656388,53657475,1087,0.4558513787138825
20909,1788.584867,1788.6497,1,53657546,53659491,1945,0.11430831797937807
20910,1788.670533,1788.7037,1,53660115,53661111,996,0.5882498912017111
20911,1788.707033,1788.7129,1,53661210,53661387,177,0.8192439745037411
20912,1788.714133,1788.7544,1,53661423,53662632,1209,0.15978050711489966
20913,1788.798067,1788.825433,1,53663942,53664762,820,0.6486506709211322
20914,1788.866,1788.9072,1,53665980,53667216,1236,0.7552622864293518
20915,1788.9517,1788.970333,1,53668551,53669109,558,0.5031989381961912
20916,1788.9718,1788.995067,1,53669154,53669852,698,0.6542854135613962
20917,1789.000267,1789.011767,1,53670008,53670353,345,0.5488699882020308
20918,1789.033067,1789.041933,1,53670992,53671257,265,0.3650582937051402
20919,1789.048967,1789.0585,1,53671469,53671755,286,0.5956554470268957
20920,1789.0633,1789.0763,1,53671899,53672289,390,0.5730997363274605
20921,1789.083,1789.098267,1,53672490,53672948,458,0.7043004495202887
20922,1789.0993,1789.114467,1,53672979,53673434,455,0.767756086356548
20923,1789.186933,1789.195267,1,53675607,53675858,251,0.5281802728763706
20924,1789.200933,1789.226167,1,53676027,53676785,758,0.7588964712080843
20925,1789.227267,1789.303167,1,53676818,53679095,2277,0.7429763373892573
20926,1789.388767,1789.3924,1,53681663,53681772,109,0.7789103725780123
20927,1789.4372,1789.446767,1,53683116,53683403,287,0.3499409508877205
20928,1789.4478,1789.461533,1,53683434,53683845,411,0.6140362925929377
20929,1789.4779,1789.484167,1,53684337,53684525,188,0.7476171962063233
20930,1789.486,1789.489033,1,53684580,53684670,90,0.8245956966714972
20931,1789.493967,1789.497067,1,53684819,53684912,93,0.7778908468764811
20932,1789.550333,1789.563667,1,53686509,53686910,401,0.7559022681236126
20933,1789.594933,1789.598433,1,53687847,53687952,105,0.7456926635942003
20934,1789.605433,1789.609567,1,53688162,53688287,125,0.8280771686051528
20935,1789.615467,1789.62,1,53688464,53688600,136,0.5769911188777623
20936,1789.6401,1789.645767,1,53689203,53689373,170,0.7195491555081196
20937,1789.752233,1789.774167,1,53692566,53693225,659,0.37771553262925484
20938,1789.7832,1789.7885,1,53693496,53693655,159,0.6839768395436757
20939,1789.798533,1789.830667,1,53693955,53694920,965,0.7673219511878364
20940,1789.8393,1789.869167,1,53695179,53696075,896,0.7441516827509069
20941,1789.877667,1789.884833,1,53696330,53696544,214,0.5572843345884748
20942,1789.892067,1789.930567,1,53696762,53697917,1155,0.7217671257126302
20943,1789.9615,1789.965733,1,53698845,53698971,126,0.9049104153981501
20944,1789.9799,1790.0386,1,53699397,53701158,1761,0.29996879944999666
20945,1790.063233,1790.068267,1,53701896,53702048,152,0.8875087773928899
20946,1790.076333,1790.0839,1,53702289,53702517,228,0.8943584681406566
20947,1790.085767,1790.112667,1,53702573,53703380,807,0.723023872272812
20948,1790.123,1790.275733,1,53703690,53708271,4581,0.7250775098727607
20949,1790.281333,1790.299933,1,53708439,53708997,558,0.6873947742384662
20950,1790.325267,1790.3322,1,53709758,53709966,208,0.8940791688567602
20951,1790.424067,1790.5285,1,53712722,53715855,3133,0.6191979322276449
20952,1790.551733,1790.560833,1,53716551,53716824,273,0.3890841230400543
20953,1790.568,1790.624933,1,53717040,53718747,1707,0.5579051104735185
20954,1790.626067,1790.6439,1,53718782,53719317,535,0.7822925681334457
20955,1790.6451,1790.769033,1,53719353,53723070,3717,0.7107217587790268
20956,1790.789767,1790.8303,1,53723693,53724909,1216,0.1916383187907348
20957,1790.832467,1790.859,1,53724974,53725770,796,0.5168046956945435
20958,1790.862,1790.865533,1,53725860,53725965,105,0.35626078791360205
20959,1790.883967,1791.118767,1,53726519,53733563,7044,0.6519640310459797
20960,1791.123533,1791.190467,1,53733705,53735714,2009,0.6813627799289885
20961,1791.270433,1791.359033,1,53738112,53740770,2658,0.7181309400912982
20962,1791.408933,1791.412533,1,53742267,53742375,108,0.7115845892776829
20963,1791.489133,1791.498033,1,53744673,53744940,267,0.07537021714346626
20964,1791.517067,1791.7674,1,53745512,53753022,7510,0.7196301001623494
20965,1791.875367,1791.990233,1,53756261,53759706,3445,0.7508865294010528
20966,1792.054067,1792.068933,1,53761622,53762067,445,0.13479361041337626
20967,1792.070033,1792.202233,1,53762100,53766066,3966,0.8177082127677465
20968,1792.528167,1792.681767,1,53775845,53780453,4608,0.733964483786011
20969,1792.683033,1792.898167,1,53780490,53786945,6455,0.6732458683316123
20970,1792.9914,1793.024033,1,53789742,53790720,978,0.6865483676091054
20971,1793.0287,1793.0376,1,53790861,53791128,267,0.6307228120242345
20972,1793.0394,1793.0844,1,53791182,53792532,1350,0.2188719873827645
20973,1793.0892,1793.092967,1,53792676,53792789,113,0.642937713006651
20974,1793.1176,1793.3904,1,53793528,53801712,8184,0.5765678020946664
20975,1793.5504,1793.574333,1,53806512,53807229,717,0.7926583368245956
20976,1793.6445,1793.7178,1,53809335,53811534,2199,0.7014586236863836
20977,1793.719,1793.852233,1,53811570,53815566,3996,0.728340778574991
20978,1793.922633,1793.9563,1,53817678,53818689,1011,0.6268793178671543
20979,1794.0051,1794.0288,1,53820153,53820864,711,0.5832288425087079
20980,1794.062267,1794.066133,1,53821868,53821983,115,0.2978029319606498
20981,1794.0692,1794.073267,1,53822076,53822198,122,0.2831577950948237
20982,1794.101733,1794.1526,1,53823051,53824578,1527,0.6908115840065963
20983,1794.1551,1794.283767,1,53824653,53828513,3860,0.6610120411628931
20984,1794.287267,1794.421833,1,53828618,53832654,4036,0.6877250059315264
20985,1794.435067,1794.527733,1,53833052,53835831,2779,0.6947979581276619
20986,1794.638233,1794.6697,1,53839146,53840091,945,0.611659748091478
20987,1794.799767,1794.834233,1,53843993,53845026,1033,0.6766809768704645
20988,1794.839633,1794.998067,1,53845188,53849942,4754,0.7070386134358707
20989,1795.015467,1795.054733,1,53850464,53851641,1177,0.5244324729064779
20990,1795.649967,1795.658533,1,53869499,53869755,256,0.14276215001554532
20991,1795.659733,1795.759533,1,53869791,53872785,2994,0.5395865920321553
20992,1795.830467,1796.1957,1,53874914,53885871,10957,0.6975896874813127
20993,1796.426867,1796.5256,1,53892806,53895768,2962,0.6801659640199735
20994,1796.612333,1796.8795,1,53898369,53906385,8016,0.5123333370257352
20995,1797.198833,1797.369233,1,53915964,53921076,5112,0.7087998834821657
20996,1797.706167,1797.743533,1,53931185,53932305,1120,0.2227712460360992
20997,1797.802333,1797.928733,1,53934069,53937861,3792,0.6614438156621111
20998,1798.003367,1798.234567,1,53940101,53947037,6936,0.7084780452468813
20999,1798.240833,1798.244367,1,53947224,53947331,107,0.8470691231388869
21000,1798.299733,1798.465233,1,53948991,53953956,4965,0.6838656334099067
21001,1798.580567,1798.597933,1,53957417,53957937,520,0.6104481679212307
21002,1798.697733,1798.895433,1,53960931,53966862,5931,0.7154863656342839
21003,1798.899367,1798.922467,1,53966981,53967674,693,0.5807376086764787
21004,1798.963367,1798.972333,1,53968901,53969169,268,-0.45148745614778024
21005,1798.9784,1799.027267,1,53969352,53970818,1466,-0.02271337410466084
21006,1799.058467,1799.062767,1,53971754,53971883,129,0.6394847357806969
21007,1799.075133,1799.0878,1,53972253,53972634,381,0.7205722926584986
21008,1799.5452,1799.574233,1,53986356,53987226,870,0.6453578219543322
21009,1799.620333,1799.642667,1,53988609,53989280,671,0.547161921976435
21010,1799.643667,1799.653833,1,53989310,53989614,304,0.31513699802362416
21011,1799.706,1799.754933,1,53991180,53992647,1467,0.6341677480775856
21012,1799.770033,1799.836067,1,53993100,53995082,1982,0.6275336507181773
21013,1799.8381,1799.954367,1,53995143,53998631,3488,0.6889683517196875
21014,1800.0148,1800.022533,1,54000444,54000675,231,0.06590593834075784
21015,1800.034,1800.055067,1,54001020,54001652,632,0.3878355556194929
21016,1800.077067,1800.0833,1,54002312,54002499,187,0.3699223019217706
21017,1800.101167,1800.140933,1,54003035,54004227,1192,0.09681814050038275
21018,1800.145833,1800.1817,1,54004374,54005451,1077,0.5878107127884871
21019,1800.183667,1800.311067,1,54005510,54009332,3822,0.6594383134751681
21020,1800.3148,1800.324767,1,54009444,54009743,299,0.8529944758769396
21021,1800.342867,1800.452433,1,54010286,54013572,3286,0.1123067683649279
21022,1800.454033,1800.501267,1,54013620,54015038,1418,0.21102078024493873
21023,1800.504133,1800.6237,1,54015123,54018711,3588,0.6983891431301478
21024,1800.6275,1800.665133,1,54018825,54019953,1128,0.22748185742255542
21025,1800.6666,1800.6881,1,54019998,54020643,645,0.1377243029958662
21026,1800.689567,1800.728067,1,54020687,54021842,1155,0.47917842035072933
21027,1800.730833,1800.770033,1,54021924,54023100,1176,0.050125286853449295
21028,1800.779767,1800.814167,1,54023393,54024425,1032,0.5982530765700906
21029,1800.820267,1800.980633,1,54024608,54029418,4810,0.73273075738439
21030,1800.992,1801.025933,1,54029760,54030777,1017,0.6455582801470443
21031,1801.0274,1801.031733,1,54030822,54030951,129,0.8604540492485648
21032,1801.059867,1801.067633,1,54031796,54032028,232,0.03206913739307761
21033,1801.069,1801.1478,1,54032070,54034434,2364,0.40477234764405945
21034,1801.155767,1801.191733,1,54034673,54035751,1078,0.2810784906701074
21035,1801.192933,1801.2117,1,54035787,54036351,564,0.16760522729773863
21036,1801.213333,1801.225233,1,54036399,54036756,357,0.12263640009233699
21037,1801.227433,1801.242133,1,54036822,54037263,441,0.6655072824878622
21038,1801.244033,1801.263,1,54037320,54037890,570,0.7625258160535688
21039,1801.277667,1801.3083,1,54038330,54039249,919,0.328380619032318
21040,1801.313967,1801.331333,1,54039419,54039939,520,0.10709016517194778
21041,1801.3421,1801.4533,1,54040263,54043599,3336,0.39134222842318017
21042,1801.455233,1801.488133,1,54043656,54044643,987,0.6132939272122416
21043,1801.533267,1801.539733,1,54045998,54046191,193,0.7320484836573831
21044,1801.55,1801.5722,1,54046500,54047166,666,0.5677065266409801
21045,1801.573233,1801.661633,1,54047196,54049848,2652,0.7029429928448723
21046,1801.668367,1801.6903,1,54050051,54050709,658,0.6856416399242825
21047,1801.918767,1801.928567,1,54057563,54057857,294,0.6324839120374208
21048,1801.932267,1801.936367,1,54057968,54058091,123,0.5240574479018509
21049,1801.950633,1801.9543,1,54058518,54058629,111,0.7053135943318178
21050,1802.1001,1802.106833,1,54063003,54063204,201,0.5531233426137936
21051,1802.1156,1802.120467,1,54063468,54063614,146,0.8696923127459593
21052,1802.124367,1802.130733,1,54063731,54063921,190,-0.5339533410681264
21053,1802.141133,1802.1716,1,54064233,54065148,915,0.35193772709099175
21054,1802.203,1802.231067,1,54066090,54066932,842,0.10522347966341342
21055,1802.241833,1802.246667,1,54067254,54067400,146,0.8381981587501395
21056,1802.255633,1802.327533,1,54067668,54069825,2157,0.2684298794258532
21057,1802.459533,1802.470367,1,54073785,54074111,326,0.732922491339776
21058,1803.2072,1803.2273,1,54096216,54096819,603,0.2992639205453863
21059,1803.306833,1803.4705,1,54099204,54104115,4911,0.15433001865227924
21060,1803.471767,1803.5077,1,54104153,54105231,1078,0.3560642862991513
21061,1803.5105,1803.588567,1,54105315,54107657,2342,0.26513071400651833
21062,1803.5906,1803.597367,1,54107718,54107921,203,0.7476235774169129
21063,1804.1145,1804.118567,1,54123435,54123557,122,0.6701624176151689
21064,1804.127967,1804.142633,1,54123839,54124278,439,0.23345080072645283
21065,1804.144067,1804.176633,1,54124322,54125298,976,0.13010689064928674
21066,1804.249367,1804.273033,1,54127481,54128190,709,0.43953701420211877
21067,1804.6052,1804.737833,1,54138156,54142134,3978,0.7202869859114778
21068,1804.745367,1804.759867,1,54142361,54142796,435,0.5749915187916781
21069,1804.767067,1804.791467,1,54143012,54143744,732,0.6550487914471961
21070,1804.901667,1804.909533,1,54147050,54147285,235,0.7033485097008872
21071,1804.9106,1804.914167,1,54147318,54147425,107,0.8564639324368231
21072,1804.978467,1804.987367,1,54149354,54149621,267,0.5791268300736442
21073,1804.990467,1805.023267,1,54149714,54150698,984,0.7052745921300533
21074,1805.024433,1805.061433,1,54150732,54151842,1110,0.8408922995137685
21075,1805.0626,1805.072433,1,54151878,54152172,294,0.8037185145190594
21076,1805.0739,1805.0862,1,54152217,54152586,369,0.33829361674783004
21077,1805.0875,1805.096133,1,54152625,54152883,258,0.625561171587848
21078,1805.104567,1805.123833,1,54153137,54153714,577,0.7011209317735694
21079,1805.407267,1805.494567,1,54162218,54164837,2619,0.15876289638625002
21080,1805.500633,1805.5068,1,54165018,54165204,186,0.9009398986645556
21081,1805.5116,1805.521633,1,54165348,54165648,300,0.5893760616422824
21082,1805.5232,1805.526267,1,54165696,54165788,92,0.7618448549090855
21083,1805.5273,1805.5369,1,54165819,54166107,288,0.3149486299870969
21084,1805.538767,1805.679733,1,54166163,54170391,4228,0.2056161651359053
21085,1805.6953,1805.701167,1,54170859,54171035,176,0.7598207082274453
21086,1805.708867,1805.729667,1,54171266,54171890,624,0.338104136856694
21087,1805.734667,1805.743167,1,54172040,54172295,255,0.3541485727559149
21088,1805.752833,1805.759767,1,54172584,54172793,209,0.6188202921804
21089,1805.768233,1805.816167,1,54173046,54174485,1439,0.012986408430273507
21090,1805.886567,1805.899667,1,54176597,54176990,393,0.3732713033217391
21091,1807.211467,1807.246233,1,54216344,54217386,1042,0.17667659140900518
21092,1807.269533,1807.274933,1,54218085,54218247,162,0.7150901208376421
21093,1807.285533,1807.354467,1,54218565,54220634,2069,0.6416845208539392
21094,1807.449767,1807.504867,1,54223493,54225146,1653,0.5206874371929189
21095,1807.5068,1807.525067,1,54225204,54225752,548,0.6458863673883581
21096,1807.527,1807.545267,1,54225810,54226358,548,0.5980897993633932
21097,1807.547533,1807.826967,1,54226425,54234809,8384,0.7029999418538021
21098,1807.840867,1807.9726,1,54235226,54239178,3952,0.6868056225843691
21099,1808.055333,1808.103233,1,54241659,54243096,1437,0.6298081212072828
21100,1808.109333,1808.1448,1,54243279,54244344,1065,0.6412633019029921
21101,1808.187267,1808.190467,1,54245618,54245714,96,0.9096726436324336
21102,1808.204467,1808.213433,1,54246134,54246402,268,0.442155489069362
21103,1808.2146,1808.324667,1,54246438,54249740,3302,0.721299698516798
21104,1808.5752,1808.604967,1,54257256,54258149,893,0.1923870230560503
21105,1808.664133,1808.703167,1,54259923,54261095,1172,0.32716055367556873
21106,1808.720533,1808.731733,1,54261615,54261951,336,0.49544917742824035
21107,1808.7716,1808.7997,1,54263148,54263991,843,0.6627911911424375
21108,1808.800833,1808.818167,1,54264024,54264545,521,0.7026825296523417
21109,1808.8348,1808.850733,1,54265044,54265521,477,0.4548315358122498
21110,1808.856467,1808.860767,1,54265694,54265823,129,0.613794811326988
21111,1808.862733,1808.882433,1,54265881,54266472,591,0.7280946012333517
21112,1808.9126,1808.9593,1,54267378,54268779,1401,0.6876892850339563
21113,1808.981833,1809.086767,1,54269454,54272603,3149,0.7668206316577989
21114,1809.210367,1809.2757,1,54276311,54278271,1960,0.7264026119470695
21115,1809.637733,1809.7093,1,54289131,54291279,2148,0.09984317269137002
21116,1809.7103,1809.729967,1,54291309,54291899,590,0.16044945340641942
21117,1809.7325,1809.823133,1,54291975,54294693,2718,0.1881190012098576
21118,1809.825033,1809.844533,1,54294750,54295335,585,0.311696878976203
21119,1809.857433,1809.9473,1,54295722,54298419,2697,0.2550972325718514
21120,1809.954433,1809.966333,1,54298632,54298989,357,0.8349340015227518
21121,1809.970933,1809.9747,1,54299127,54299241,114,0.7413900379651845
21122,1810.583,1810.594467,1,54317490,54317834,344,0.24826923401774223
21123,1810.597267,1810.702433,1,54317918,54321072,3154,0.13365356187288366
21124,1810.715233,1810.740833,1,54321456,54322224,768,0.1646007721798164
21125,1810.743767,1810.8598,1,54322313,54325794,3481,0.07874860552552561
21126,1810.866767,1810.877967,1,54326003,54326339,336,0.06392665208994311
21127,1810.881933,1810.890133,1,54326457,54326703,246,0.493808775013522
21128,1810.895333,1810.903033,1,54326859,54327090,231,0.6435250310648701
21129,1810.911267,1810.956733,1,54327338,54328701,1363,0.1727491816193137
21130,1810.998633,1811.0034,1,54329958,54330102,144,0.7810710947360755
21131,1811.006567,1811.011,1,54330197,54330330,133,0.8066062934287718
21132,1811.012067,1811.0179,1,54330362,54330537,175,0.8737173569956744
21133,1811.020933,1811.0244,1,54330627,54330732,105,0.7383676981303495
21134,1811.0657,1811.0824,1,54331971,54332472,501,0.4369856104705699
21135,1811.965967,1811.966767,1,54358979,54359003,24,0.984538308707963
21136,1811.977433,1812.044567,1,54359322,54361337,2015,0.6608927339993047
21137,1812.0694,1812.149567,1,54362082,54364487,2405,0.6852486994840234
21138,1812.214067,1812.2627,1,54366422,54367881,1459,0.7103975221114056
21139,1812.342967,1812.352867,1,54370289,54370586,297,0.47777071061963583
21140,1812.367733,1812.375433,1,54371031,54371262,231,0.44757291336643057
21141,1812.3771,1812.401067,1,54371313,54372032,719,0.6470281775562653
21142,1812.501333,1812.5142,1,54375039,54375426,387,0.596731956275294
21143,1812.524467,1812.550167,1,54375734,54376505,771,0.7484334400542515
21144,1812.553833,1812.559633,1,54376614,54376788,174,0.7950244414129218
21145,1812.5665,1812.6873,1,54376995,54380619,3624,0.7008353807397988
21146,1812.691333,1812.751867,1,54380739,54382556,1817,0.7118386098137062
21147,1812.888067,1812.891533,1,54386642,54386745,103,0.5081950231632427
21148,1812.897933,1813.130967,1,54386937,54393929,6992,0.7356564710150693
21149,1813.570367,1813.5795,1,54407111,54407385,274,0.34000136241089113
21150,1813.586,1813.6687,1,54407580,54410061,2481,0.09187456619390234
21151,1813.6775,1813.708633,1,54410325,54411258,933,0.24947767488957992
21152,1813.709733,1813.712733,1,54411291,54411381,90,0.9821151675742874
21153,1813.714167,1813.847133,1,54411425,54415413,3988,0.20854745551665535
21154,1813.848367,1813.8636,1,54415451,54415908,457,0.5392015516522913
21155,1814.207533,1814.213367,1,54426225,54426401,176,0.7724834093329741
21156,1814.229633,1814.286833,1,54426888,54428604,1716,0.4413759665574304
21157,1814.287867,1814.3049,1,54428636,54429147,511,0.4604059847036726
21158,1814.307733,1814.316267,1,54429231,54429488,257,0.5331675115806035
21159,1814.3836,1814.388967,1,54431508,54431669,161,0.7304346314485254
21160,1814.395667,1814.410233,1,54431870,54432306,436,0.604940124311322
21161,1814.4127,1814.584133,1,54432381,54437523,5142,0.6882608901493498
21162,1814.8481,1814.8567,1,54445443,54445701,258,0.7194120433774335
21163,1814.862233,1814.951867,1,54445866,54448556,2690,0.1865770999575526
21164,1814.953967,1815.111967,1,54448619,54453359,4740,0.659097305353331
21165,1815.188667,1815.2522,1,54455660,54457566,1906,0.6621708039019613
21166,1815.262333,1815.328467,1,54457869,54459854,1985,0.7499651309894128
21167,1815.435,1815.564767,1,54463050,54466943,3893,0.7044298204788154
21168,1815.7748,1815.871333,1,54473244,54476139,2895,-0.030559826050418543
21169,1815.878267,1816.016867,1,54476348,54480506,4158,0.10437177880573976
21170,1816.029633,1816.032933,1,54480888,54480987,99,0.9113372550562577
21171,1816.041067,1816.046267,1,54481232,54481388,156,0.7607396104961366
21172,1816.09,1816.095567,1,54482700,54482867,167,0.8826126183228601
21173,1816.188333,1816.1925,1,54485649,54485775,126,0.8031630148385768
21174,1816.2023,1816.2071,1,54486069,54486213,144,0.10496118694044805
21175,1816.211767,1816.2192,1,54486353,54486576,223,0.3941707330068172
21176,1816.275233,1816.28,1,54488256,54488400,144,0.4427541111994626
21177,1816.5388,1816.5624,1,54496164,54496872,708,0.14020363990452092
21178,1816.5673,1816.584967,1,54497019,54497549,530,0.3432865577773284
21179,1817.094367,1817.0981,1,54512831,54512943,112,0.5146095990414116
21180,1817.266067,1817.269067,1,54517982,54518072,90,0.7307287593593204
21181,1817.323133,1817.339867,1,54519693,54520196,503,0.09478782009994416
21182,1817.3458,1817.358467,1,54520374,54520754,380,0.7166800107795814
21183,1817.3919,1817.3975,1,54521757,54521925,168,0.6013975162200216
21184,1817.406467,1817.413633,1,54522194,54522408,214,0.7711978500881895
21185,1817.467933,1817.474033,1,54524037,54524220,183,0.5745512214260295
21186,1817.4793,1817.482633,1,54524379,54524478,99,0.3374487537031412
21187,1817.492267,1817.496133,1,54524768,54524883,115,0.7824086320017688
21188,1817.5132,1817.5187,1,54525396,54525561,165,0.6908733598061044
21189,1817.5277,1817.538433,1,54525831,54526152,321,0.2123969194013575
21190,1817.559333,1817.709933,1,54526779,54531297,4518,0.03795970262937982
21191,1817.711633,1817.8438,1,54531348,54535314,3966,0.13690693670572696
21192,1817.859333,1817.8772,1,54535779,54536316,537,0.6750251874308192
21193,1817.9345,1817.9396,1,54538035,54538188,153,0.48973941992993614
21194,1818.971533,1819.0681,1,54569145,54572043,2898,0.15108667778642051
21195,1819.069433,1819.079067,1,54572082,54572372,290,0.7012907143538526
21196,1819.080567,1819.111333,1,54572417,54573339,922,0.4114838546942672
21197,1819.112833,1819.147633,1,54573384,54574428,1044,0.25890385798874854
21198,1819.152467,1819.159233,1,54574574,54574776,202,0.4254849447266198
21199,1819.162333,1819.2511,1,54574869,54577533,2664,0.2583808754659236
21200,1820.222533,1820.2334,1,54606675,54607002,327,0.8243179137807443
21201,1820.2417,1820.341567,1,54607251,54610247,2996,0.14802412357431238
21202,1820.3433,1820.3471,1,54610299,54610413,114,0.889996540166785
21203,1820.348567,1820.415867,1,54610457,54612476,2019,0.045058750530238154
21204,1820.418133,1820.4292,1,54612543,54612876,333,0.12256403599457086
21205,1820.436267,1820.5445,1,54613088,54616335,3247,0.22101047375346813
21206,1820.547233,1820.573767,1,54616416,54617213,797,0.7333505593207382
21207,1820.5832,1820.622867,1,54617496,54618686,1190,0.23795056974244666
21208,1820.6242,1820.635467,1,54618726,54619064,338,0.24462805760373632
21209,1820.637467,1820.641367,1,54619124,54619241,117,0.8624248991562522
21210,1820.6464,1820.6566,1,54619392,54619698,306,0.7430667244912298
21211,1820.6625,1820.667733,1,54619875,54620031,156,0.5821804630417464
21212,1820.672633,1820.682033,1,54620178,54620460,282,0.8589341302869837
21213,1820.687733,1820.6915,1,54620631,54620745,114,0.6887953377166739
21214,1820.6963,1820.7238,1,54620889,54621714,825,0.15152310540342534
21215,1820.735167,1820.741433,1,54622055,54622242,187,0.1741481145383755
21216,1820.758133,1820.768633,1,54622743,54623058,315,0.4253191508709572
21217,1820.800033,1820.812533,1,54624000,54624375,375,0.7323406085657758
21218,1820.815367,1820.823433,1,54624461,54624702,241,0.7735887426632511
21219,1820.8398,1820.852367,1,54625194,54625571,377,0.6427877298756999
21220,1820.859067,1820.870367,1,54625772,54626111,339,0.5496501258629028
21221,1820.8909,1820.901967,1,54626727,54627059,332,0.20668086184368034
21222,1820.917,1820.933,1,54627510,54627990,480,0.791148789861147
21223,1820.934767,1820.953667,1,54628043,54628610,567,0.6300818345757621
21224,1820.9575,1820.962833,1,54628725,54628884,159,0.4231047399080788
21225,1820.971267,1820.991967,1,54629138,54629759,621,0.3960998619477652
21226,1820.998067,1821.010433,1,54629942,54630312,370,0.24369828067487756
21227,1821.018733,1821.0349,1,54630561,54631047,486,0.29698789193639735
21228,1821.036033,1821.039367,1,54631080,54631181,101,0.868619269365215
21229,1821.0701,1821.073333,1,54632103,54632199,96,0.8075015908930119
21230,1821.0803,1821.090267,1,54632409,54632708,299,0.580559644771891
21231,1821.094367,1821.097867,1,54632831,54632936,105,0.8932076959426897
21232,1821.1086,1821.114167,1,54633258,54633425,167,0.6546760527494039
21233,1821.132167,1821.1566,1,54633965,54634698,733,0.3574540247160521
21234,1821.1665,1821.1856,1,54634995,54635568,573,0.32560346949717706
21235,1821.191367,1821.1948,1,54635741,54635844,103,0.5735854285043331
21236,1821.2599,1821.264767,1,54637797,54637943,146,0.38811263206391117
21237,1821.3066,1821.310567,1,54639198,54639317,119,0.8473930508290906
21238,1821.3148,1821.327833,1,54639444,54639834,390,0.35615995401529843
21239,1821.360367,1821.365733,1,54640811,54640971,160,0.6933265089281642
21240,1821.3826,1821.386233,1,54641478,54641586,108,0.5902120737966156
21241,1821.4117,1821.4179,1,54642351,54642537,186,0.8400470603483595
21242,1821.419067,1821.447067,1,54642572,54643412,840,0.6192052596418852
21243,1821.4492,1821.4547,1,54643476,54643641,165,0.6230954813730984
21244,1821.458567,1821.490767,1,54643757,54644723,966,0.28831324518478896
21245,1821.493967,1821.502233,1,54644819,54645066,247,0.6548091358120804
21246,1821.503267,1821.508167,1,54645098,54645245,147,0.755466825237701
21247,1821.5272,1821.537567,1,54645816,54646127,311,0.191640310279238
21248,1821.5447,1821.5515,1,54646341,54646545,204,0.8040988443053813
21249,1821.554967,1821.591433,1,54646649,54647742,1093,0.39806560071058267
21250,1821.5932,1821.6,1,54647796,54648000,204,0.7088611840489834
21251,1821.6116,1821.635133,1,54648348,54649053,705,0.34621383841320874
21252,1821.637067,1821.651033,1,54649112,54649530,418,0.29693982585611134
21253,1821.740533,1821.753833,1,54652215,54652614,399,0.5298383295502603
21254,1821.764767,1821.768533,1,54652943,54653055,112,0.8931763105234244
21255,1821.801433,1821.809433,1,54654042,54654282,240,0.8525914510868045
21256,1821.811133,1821.821833,1,54654333,54654654,321,0.39544504600279934
21257,1822.264567,1822.275267,1,54667937,54668258,321,0.602859599982248
21258,1822.2765,1822.3924,1,54668295,54671772,3477,0.137428841489343
21259,1822.406733,1822.437033,1,54672201,54673110,909,0.149764935221579
21260,1822.445567,1822.537133,1,54673367,54676113,2746,0.10761686086722172
21261,1822.541767,1822.575167,1,54676253,54677255,1002,0.15332717826079892
21262,1822.577767,1822.7303,1,54677333,54681909,4576,0.016128000839285676
21263,1822.759633,1822.772433,1,54682788,54683172,384,0.7334754450719725
21264,1823.2501,1823.327167,1,54697503,54699815,2312,0.051631842842201944
21265,1823.350567,1823.4241,1,54700517,54702723,2206,0.27938088851227105
21266,1823.4362,1823.494133,1,54703086,54704823,1737,0.16615663468611086
21267,1823.503067,1823.509767,1,54705092,54705293,201,0.6231266466158658
21268,1823.512567,1823.524733,1,54705377,54705741,364,0.5238417735879641
21269,1823.611933,1823.618867,1,54708357,54708566,209,0.6874742956977717
21270,1823.7064,1823.715067,1,54711192,54711452,260,0.4127509273716477
21271,1823.724567,1823.766067,1,54711737,54712982,1245,0.1784530395586779
21272,1823.8027,1823.8783,1,54714081,54716349,2268,0.13255469335122225
21273,1823.895833,1823.960867,1,54716874,54718826,1952,0.09864803045950016
21274,1824.0128,1824.0871,1,54720384,54722613,2229,0.18826949694369807
21275,1824.0885,1824.093567,1,54722655,54722807,152,0.7866720396665444
21276,1824.119433,1824.1269,1,54723582,54723807,225,0.7876787890325414
21277,1824.1287,1824.1324,1,54723861,54723972,111,0.8256405902159695
21278,1824.1336,1824.1625,1,54724008,54724875,867,0.149883933291148
21279,1824.164233,1824.204333,1,54724926,54726129,1203,0.29045339674601506
21280,1824.205867,1824.211767,1,54726176,54726353,177,0.5273921510565579
21281,1824.2142,1824.354733,1,54726426,54730641,4215,0.09367893921370189
21282,1824.3678,1824.391133,1,54731034,54731733,699,0.1433962721716585
21283,1824.404933,1824.414567,1,54732147,54732437,290,0.4603072481679116
21284,1824.420633,1824.451933,1,54732618,54733557,939,0.18885210236733307
21285,1824.4606,1824.506867,1,54733818,54735206,1388,0.20618822691588537
21286,1824.602367,1824.6094,1,54738071,54738282,211,0.910090846922623
21287,1824.852967,1824.8561,1,54745589,54745683,94,0.8013567554366808
21288,1824.858867,1824.878567,1,54745766,54746357,591,0.10204856806257878
21289,1824.8801,1824.951833,1,54746403,54748554,2151,0.10637145283059579
21290,1825.010467,1825.044267,1,54750314,54751328,1014,0.33543212115116194
21291,1825.081133,1825.0946,1,54752433,54752838,405,0.3448985585268558
21292,1825.098533,1825.126467,1,54752955,54753794,839,0.7548500296105655
21293,1825.128,1825.132033,1,54753840,54753960,120,0.747881175862395
21294,1825.1403,1825.1747,1,54754209,54755241,1032,0.4137738891237893
21295,1825.180467,1825.198267,1,54755414,54755948,534,0.5813167645995068
21296,1825.6871,1825.6904,1,54770613,54770712,99,0.8295990167193664
21297,1825.696233,1825.776167,1,54770886,54773285,2399,0.19718923393019114
21298,1825.7822,1825.794833,1,54773466,54773844,378,0.6950799708143177
21299,1825.8074,1825.938,1,54774222,54778140,3918,0.19238251820000116
21300,1825.939133,1825.9428,1,54778173,54778284,111,0.8339509513474621
21301,1825.944033,1825.947733,1,54778320,54778431,111,0.9600519514581045
21302,1825.957633,1825.9613,1,54778728,54778839,111,0.7124314577081073
21303,1825.969067,1825.9917,1,54779072,54779751,679,0.4463245512123093
21304,1826.0311,1826.0418,1,54780933,54781254,321,0.6491260895084889
21305,1827.060633,1827.065,1,54811818,54811950,132,0.3180858059702157
21306,1827.071767,1827.0931,1,54812153,54812793,640,0.06054945416104246
21307,1827.103033,1827.114967,1,54813090,54813449,359,0.23280563129498064
21308,1827.161267,1827.166633,1,54814838,54814998,160,0.9105285822263237
21309,1827.385933,1827.3928,1,54821577,54821784,207,0.38305069462370467
21310,1827.401167,1827.540067,1,54822035,54826202,4167,0.21413156911412157
21311,1827.541733,1827.5805,1,54826251,54827415,1164,0.1581992166619164
21312,1827.5819,1827.675267,1,54827457,54830258,2801,0.20383134281434212
21313,1828.407433,1828.575967,1,54852222,54857279,5057,0.12720684427725346
21314,1828.6291,1828.7056,1,54858873,54861168,2295,0.21174475443722576
21315,1828.738133,1828.761533,1,54862143,54862845,702,0.2975858982829996
21316,1828.773367,1828.78,1,54863201,54863400,199,0.523788960224819
21317,1828.865967,1828.8706,1,54865979,54866118,139,0.5070106013847969
21318,1829.3305,1829.410367,1,54879915,54882311,2396,0.1603488799782197
21319,1829.432133,1829.435367,1,54882963,54883061,98,0.8045074218311564
21320,1829.4736,1829.558,1,54884208,54886740,2532,0.24640737774139998
21321,1829.572867,1829.667067,1,54887186,54890012,2826,0.19473268367197444
21322,1829.672867,1829.704,1,54890186,54891120,934,0.2996384041452481
21323,1829.793733,1829.807667,1,54893811,54894230,419,0.6381632349050861
21324,1830.268167,1830.407467,1,54908045,54912224,4179,0.16943088994181513
21325,1830.409133,1830.569167,1,54912273,54917075,4802,0.20976567909338956
21326,1830.572567,1830.5818,1,54917177,54917454,277,0.5099394860041283
21327,1830.717367,1830.727033,1,54921521,54921810,289,0.26316484299674725
21328,1831.7607,1831.7654,1,54952821,54952962,141,0.7671604102260973
21329,1831.769067,1831.847067,1,54953072,54955412,2340,0.20176568074499943
21330,1831.8503,1831.855467,1,54955509,54955664,155,0.514033756589511
21331,1831.8615,1831.8646,1,54955845,54955938,93,0.6277640681989249
21332,1831.947567,1831.987233,1,54958427,54959616,1189,0.25263391696261606
21333,1831.9887,1832.004833,1,54959661,54960144,483,0.33993112200159
21334,1832.012867,1832.020033,1,54960386,54960600,214,0.41287314392771524
21335,1832.060867,1832.0981,1,54961826,54962943,1117,0.4924878721973088
21336,1832.120333,1832.126033,1,54963609,54963780,171,0.7686598238651909
21337,1832.7664,1832.77,1,54982992,54983100,108,0.8579488533050033
21338,1832.771033,1832.78,1,54983130,54983400,270,0.5306925094456262
21339,1832.8431,1832.8598,1,54985293,54985794,501,0.291499807788793
21340,1832.861933,1832.9183,1,54985857,54987549,1692,0.18581066289317447
21341,1832.922833,1832.9397,1,54987684,54988191,507,0.29451131855321094
21342,1832.9416,1832.9693,1,54988248,54989079,831,0.08801259449841958
21343,1832.977,1832.995267,1,54989310,54989858,548,0.251009875724326
21344,1833.009833,1833.1285,1,54990294,54993855,3561,0.1607641627251137
21345,1833.147933,1833.169733,1,54994437,54995091,654,0.23062665737276505
21346,1833.1753,1833.1893,1,54995259,54995679,420,0.4476401935224836
21347,1833.1907,1833.193767,1,54995721,54995813,92,0.21922351047577093
21348,1833.204567,1833.235133,1,54996137,54997053,916,0.5259217581567985
21349,1833.236967,1833.240133,1,54997109,54997203,94,0.7807835634528779
21350,1833.241533,1833.255233,1,54997245,54997656,411,0.8195265861315048
21351,1833.258033,1833.2771,1,54997740,54998313,573,0.3420203333474108
21352,1833.280467,1833.2949,1,54998414,54998847,433,0.5428118268675529
21353,1834.815267,1834.923967,1,55044458,55047719,3261,0.16069962076126845
21354,1834.933267,1834.970367,1,55047998,55049111,1113,0.18474769503399338
21355,1834.976167,1834.9867,1,55049285,55049601,316,0.24912648600234547
21356,1834.991967,1835.024433,1,55049759,55050732,973,0.21661227444003164
21357,1835.042433,1835.133367,1,55051272,55054001,2729,0.14543724065925787
21358,1836.794367,1836.8883,1,55103831,55106649,2818,0.10450319293743895
21359,1836.891833,1836.947267,1,55106754,55108418,1664,0.09211198771629077
21360,1836.948667,1836.953167,1,55108460,55108595,135,0.728461555264755
21361,1836.972967,1837.068833,1,55109189,55112064,2875,0.12026640099337486
21362,1837.079467,1837.123767,1,55112384,55113713,1329,0.2830764646769427
21363,1837.137733,1837.168967,1,55114131,55115069,938,0.02418102562463344
21364,1837.176867,1837.208033,1,55115306,55116240,934,0.09199788963345616
21365,1837.215833,1837.2551,1,55116474,55117653,1179,0.2108059335820112
21366,1837.3309,1837.335933,1,55119927,55120077,150,0.7226987034658323
21367,1837.351367,1837.354967,1,55120541,55120649,108,0.8202680163815531
21368,1837.357933,1837.3787,1,55120737,55121361,624,0.5190476865162212
21369,1837.382667,1837.3862,1,55121480,55121586,106,0.8556753670947835
21370,1837.404933,1837.4243,1,55122147,55122729,582,0.21135152172787472
21371,1837.430633,1837.4349,1,55122918,55123047,129,0.16054223982609486
21372,1837.4444,1837.4527,1,55123332,55123581,249,0.684180049028817
21373,1837.462333,1837.4669,1,55123869,55124007,138,0.7240967899683286
21374,1837.468367,1837.4774,1,55124051,55124322,271,0.5560659910949856
21375,1837.4789,1837.497867,1,55124367,55124936,569,0.6568456005063283
21376,1837.509367,1837.5127,1,55125281,55125381,100,0.9338918967026808
21377,1837.5244,1837.550367,1,55125732,55126511,779,0.435941292288299
21378,1837.566733,1837.575233,1,55127001,55127256,255,0.6966595646626652
21379,1837.601167,1837.678367,1,55128035,55130351,2316,0.24920352889373706
21380,1837.6838,1837.760167,1,55130514,55132805,2291,0.26786591936150916
21381,1837.761267,1837.7757,1,55132838,55133271,433,0.3922780299373223
21382,1837.777133,1837.805,1,55133313,55134150,837,0.3086420530501153
21383,1837.8063,1837.8098,1,55134189,55134294,105,0.9314873437021998
21384,1837.811,1837.872067,1,55134330,55136162,1832,0.38099000280572864
21385,1837.885033,1837.9134,1,55136550,55137402,852,0.3185950515048429
21386,1837.916033,1837.930567,1,55137480,55137917,437,0.6084374829630267
21387,1837.940033,1837.952367,1,55138200,55138571,371,0.09430998318356475
21388,1837.953633,1837.968667,1,55138608,55139060,452,0.35403351917283477
21389,1837.9698,1838.004633,1,55139094,55140138,1044,0.7811839034796719
21390,1838.016467,1838.0407,1,55140494,55141221,727,0.5178256610563715
21391,1838.043733,1838.050533,1,55141311,55141515,204,0.7548119548941781
21392,1838.0609,1838.067667,1,55141827,55142030,203,0.7349655360865024
21393,1838.1302,1838.1356,1,55143906,55144068,162,0.6995208934984121
21394,1838.1394,1838.1447,1,55144182,55144341,159,0.6389993632669422
21395,1838.1457,1838.152233,1,55144371,55144566,195,0.7108672198005868
21396,1838.153767,1838.157533,1,55144613,55144725,112,0.7624890749259821
21397,1838.161267,1838.1645,1,55144838,55144935,97,0.5723168142176429
21398,1838.189267,1838.195633,1,55145678,55145868,190,0.8218770250684589
21399,1838.1988,1838.207233,1,55145964,55146216,252,0.8286841797248206
21400,1838.337567,1838.3445,1,55150127,55150335,208,0.6164553997165133
21401,1838.387067,1838.393533,1,55151612,55151805,193,0.7206724690501011
21402,1838.398167,1838.410233,1,55151945,55152306,361,0.006582553603321983
21403,1838.747967,1838.8544,1,55162439,55165632,3193,0.12386457311552562
21404,1838.8567,1838.9095,1,55165701,55167285,1584,0.20608214875583844
21405,1838.924033,1839.05,1,55167720,55171500,3780,0.12026013241091665
21406,1839.071733,1839.103033,1,55172151,55173090,939,0.07477833056859816
21407,1839.131,1839.1578,1,55173930,55174734,804,0.5920224577525578
21408,1839.165933,1839.172233,1,55174977,55175166,189,0.9134644072120988
21409,1839.182033,1839.2021,1,55175460,55176063,603,0.3725760389877491
21410,1839.3488,1839.3531,1,55180464,55180593,129,0.6605761655415544
21411,1839.421733,1839.4266,1,55182651,55182798,147,0.6438416705838585
21412,1839.471233,1839.476633,1,55184136,55184298,162,0.6811964296388339
21413,1839.5372,1839.5733,1,55186116,55187199,1083,0.36296563109656566
21414,1839.7026,1839.706733,1,55191078,55191201,123,0.8052582032282621
21415,1839.724133,1839.728167,1,55191723,55191845,122,0.8495493115766657
21416,1839.731233,1839.825267,1,55191936,55194758,2822,0.1300587138548459
21417,1839.833833,1839.841533,1,55195014,55195245,231,0.3873744023238793
21418,1839.850833,1839.8925,1,55195524,55196775,1251,0.26365819499292115
21419,1839.907233,1840.0843,1,55197216,55202529,5313,0.12754630490535113
21420,1840.6623,1840.7171,1,55219869,55221513,1644,0.0956967755560583
21421,1840.7201,1840.737433,1,55221603,55222122,519,0.32889381372315435
21422,1840.7609,1840.7919,1,55222827,55223757,930,0.1295140188727133
21423,1840.793167,1840.798333,1,55223795,55223949,154,0.7302852421131835
21424,1840.816733,1840.921367,1,55224501,55227641,3140,0.16525605685308112
21425,1840.9514,1840.9723,1,55228542,55229169,627,0.32233873702487253
21426,1840.995167,1841.0087,1,55229855,55230261,406,0.5194584915400625
21427,1841.0129,1841.0192,1,55230387,55230576,189,0.7071437538468155
21428,1841.1351,1841.1411,1,55234053,55234233,180,0.14567549951782538
21429,1841.1481,1841.151967,1,55234443,55234559,116,0.6372139887590272
21430,1841.154033,1841.248433,1,55234620,55237452,2832,0.20298539813856228
21431,1841.272933,1841.333867,1,55238187,55240016,1829,0.08331535239542331
21432,1841.336167,1841.358233,1,55240085,55240746,661,0.565655854435285
21433,1842.5632,1842.5724,1,55276896,55277172,276,0.13081672269006184
21434,1842.573567,1842.5775,1,55277207,55277325,118,0.6053532718272996
21435,1842.5839,1842.594967,1,55277517,55277849,332,-0.10855809373731856
21436,1842.6052,1842.658767,1,55278156,55279763,1607,0.10458145857747389
21437,1842.669333,1842.6866,1,55280079,55280598,519,0.20071667964030868
21438,1842.703033,1842.748933,1,55281090,55282467,1377,0.19495827982037747
21439,1842.754267,1842.822067,1,55282628,55284662,2034,0.04341139774835843
21440,1842.8281,1842.8371,1,55284843,55285113,270,0.7438590099635466
21441,1842.859133,1842.8774,1,55285773,55286322,549,0.7382033133608026
21442,1842.941567,1842.9456,1,55288247,55288368,121,0.7714824845188387
21443,1842.9978,1843.009933,1,55289934,55290297,363,0.21459258527956193
21444,1843.0126,1843.081233,1,55290378,55292436,2058,0.15143099174514552
21445,1843.091133,1843.101033,1,55292733,55293030,297,0.45598757997321265
21446,1843.115833,1843.157733,1,55293474,55294731,1257,0.42882343385399546
21447,1843.172467,1843.213633,1,55295174,55296408,1234,0.3363904869171212
21448,1843.239767,1843.250767,1,55297193,55297523,330,0.7348284894846497
21449,1843.254533,1843.261633,1,55297635,55297848,213,0.8464391437187434
21450,1843.264367,1843.273067,1,55297931,55298192,261,0.8284967175797282
21451,1843.2912,1843.3078,1,55298736,55299234,498,0.47115007275784376
21452,1843.309133,1843.322,1,55299273,55299660,387,0.6217121357919101
21453,1844.003,1844.0109,1,55320090,55320327,237,0.5177976771673921
21454,1844.0223,1844.091233,1,55320669,55322736,2067,0.17034856757777633
21455,1844.092867,1844.111567,1,55322786,55323347,561,0.22782569207013245
21456,1844.114833,1844.165333,1,55323444,55324959,1515,0.15023415203277368
21457,1844.171833,1844.3181,1,55325154,55329543,4389,0.1281213089056026
21458,1844.3278,1844.3368,1,55329834,55330104,270,0.6404128579071082
21459,1845.2192,1845.478,1,55356576,55364340,7764,0.2546061136190117
21460,1845.488933,1845.506933,1,55364667,55365207,540,0.25934390078309233
21461,1845.514033,1845.5536,1,55365420,55366608,1188,0.16801929997316722
21462,1846.0632,1846.0664,1,55381896,55381992,96,0.9006049573920788
21463,1846.089233,1846.097833,1,55382676,55382934,258,0.782694384929809
21464,1846.126433,1846.131333,1,55383792,55383939,147,0.5585320624805707
21465,1846.1389,1846.280967,1,55384167,55388429,4262,0.08860868453186718
21466,1846.285633,1846.288833,1,55388568,55388664,96,0.6833092182151618
21467,1846.301867,1846.4423,1,55389056,55393269,4213,0.13371269668722754
21468,1846.4576,1846.475433,1,55393728,55394262,534,0.21912178277234343
21469,1846.485267,1846.488567,1,55394558,55394657,99,0.9789833033771936
21470,1846.4897,1846.514067,1,55394691,55395422,731,0.08200579951603607
21471,1846.515133,1846.566033,1,55395453,55396980,1527,0.030832073650768916
21472,1846.636433,1846.6482,1,55399092,55399446,354,0.42533586265920376
21473,1846.6504,1846.670167,1,55399512,55400105,593,0.28089246231401727
21474,1846.679167,1846.683067,1,55400375,55400492,117,0.6874999301105312
21475,1846.685033,1846.697267,1,55400550,55400918,368,0.4447292948456348
21476,1846.708867,1846.723433,1,55401266,55401702,436,0.273247240128466
21477,1846.754,1846.759633,1,55402620,55402788,168,0.6687544982992746
21478,1846.807167,1846.816633,1,55404215,55404498,283,0.2806363144622227
21479,1846.882867,1846.891567,1,55406486,55406747,261,0.15618339506171056
21480,1846.904267,1846.9076,1,55407128,55407228,100,0.9085735905232066
21481,1846.9164,1846.9774,1,55407492,55409322,1830,0.2370461261128371
21482,1846.9806,1846.989933,1,55409418,55409697,279,0.37477263469535543
21483,1846.998867,1847.010667,1,55409966,55410320,354,0.32213684334655573
21484,1847.0131,1847.025967,1,55410393,55410779,386,0.37567878541042937
21485,1847.049667,1847.054633,1,55411490,55411638,148,0.8105636247657872
21486,1847.064433,1847.089767,1,55411932,55412693,761,0.260802860228634
21487,1847.0952,1847.146433,1,55412856,55414392,1536,-0.06118588134341362
21488,1847.148067,1847.237667,1,55414442,55417130,2688,0.06718426548128877
21489,1847.781233,1847.791233,1,55433436,55433736,300,0.15414361826361245
21490,1847.7948,1847.906133,1,55433844,55437183,3339,0.22676758359799162
21491,1847.908167,1847.978633,1,55437245,55439358,2113,0.26531237160669574
21492,1847.979667,1848.084533,1,55439390,55442535,3145,0.18396942476087713
21493,1848.129367,1848.135333,1,55443881,55444059,178,0.8701514953863156
21494,1848.143733,1848.154367,1,55444311,55444631,320,0.7029879668474591
21495,1848.1574,1848.1679,1,55444722,55445037,315,0.5571389224237656
21496,1848.6189,1848.634667,1,55458567,55459040,473,0.3382936185478096
21497,1848.6357,1848.701067,1,55459071,55461032,1961,0.10775653597848958
21498,1848.703233,1848.713633,1,55461096,55461408,312,0.5393915469734798
21499,1848.716967,1848.7203,1,55461509,55461609,100,0.951208382596939
21500,1848.723167,1848.7266,1,55461695,55461798,103,0.7820630302151812
21501,1848.734967,1848.791733,1,55462049,55463751,1702,0.21873426264073542
21502,1848.799167,1848.888133,1,55463975,55466643,2668,0.09246458047910404
21503,1848.895733,1848.911633,1,55466871,55467348,477,0.01804141773083072
21504,1848.9148,1848.9379,1,55467444,55468137,693,0.2787853867628048
21505,1848.954833,1849.0306,1,55468644,55470918,2274,0.15659923409529522
21506,1849.051567,1849.068933,1,55471547,55472067,520,0.5133452738989862
21507,1849.070933,1849.076267,1,55472127,55472288,161,0.8592113983963836
21508,1849.093567,1849.104033,1,55472807,55473120,313,0.49995424803230953
21509,1849.105233,1849.129133,1,55473156,55473873,717,0.39706662629011585
21510,1849.144433,1849.1493,1,55474332,55474479,147,0.8190367381378089
21511,1849.156067,1849.1635,1,55474682,55474905,223,0.0867885098040262
21512,1849.2192,1849.222867,1,55476576,55476686,110,0.7032877855167755
21513,1850.7075,1850.7116,1,55521225,55521348,123,0.14359108897870132
21514,1850.729833,1850.840267,1,55521894,55525208,3314,0.18355144456636413
21515,1850.841267,1850.949933,1,55525238,55528497,3259,0.034830288958201616
21516,1850.951233,1850.973867,1,55528536,55529216,680,0.0650131775691609
21517,1850.975333,1851.0004,1,55529259,55530012,753,0.1362465808884889
21518,1851.002367,1851.085433,1,55530071,55532562,2491,0.22470107126588304
21519,1851.119333,1851.1264,1,55533579,55533792,213,0.8512255074057711
21520,1851.134533,1851.139967,1,55534035,55534199,164,0.8313709124193359
21521,1851.172433,1851.197733,1,55535172,55535931,759,0.3336296246172919
21522,1851.641,1851.7193,1,55549230,55551579,2349,-0.00624709231642448
21523,1851.720967,1851.746667,1,55551629,55552400,771,0.21932883917649207
21524,1851.7546,1851.8496,1,55552638,55555488,2850,0.12964186424552007
21525,1851.851467,1851.900467,1,55555544,55557014,1470,0.18021139189266572
21526,1851.9073,1851.984467,1,55557219,55559534,2315,0.11484626876995617
21527,1851.991067,1852.005367,1,55559732,55560161,429,0.14649011094394873
21528,1852.8043,1852.8911,1,55584129,55586733,2604,0.1306564582266187
21529,1852.9135,1853.053267,1,55587405,55591598,4193,0.12912497406405843
21530,1853.060733,1853.0697,1,55591821,55592091,270,0.7622742257629798
21531,1853.278933,1853.282933,1,55598367,55598487,120,0.4364570237939809
21532,1853.2885,1853.300867,1,55598655,55599026,371,0.27208906138673755
21533,1853.785,1853.925533,1,55613550,55617765,4215,0.13250069140814957
21534,1853.935033,1854.1053,1,55618050,55623159,5109,0.07494858666925525
21535,1854.1068,1854.1294,1,55623204,55623882,678,0.08111966773867187
21536,1854.154633,1854.206267,1,55624638,55626188,1550,0.09360541296728121
21537,1854.273433,1854.2831,1,55628202,55628493,291,0.5714305683531244
21538,1854.3033,1854.311133,1,55629099,55629333,234,0.37118877325096783
21539,1854.574967,1854.6853,1,55637249,55640559,3310,0.13435279928058794
21540,1854.7158,1854.734167,1,55641474,55642025,551,0.06473414171953454
21541,1854.758767,1854.785067,1,55642763,55643552,789,0.186240287865513
21542,1854.786433,1854.8314,1,55643592,55644942,1350,0.0024072402665763735
21543,1854.832933,1854.847633,1,55644987,55645428,441,0.2619398226945266
21544,1854.855333,1854.858833,1,55645659,55645764,105,0.6950621862528049
21545,1854.861233,1854.8652,1,55645836,55645956,120,0.8468560416833725
21546,1854.9,1855.016533,1,55647000,55650495,3495,0.08081974413829271
21547,1855.0475,1855.054433,1,55651425,55651632,207,0.6587670322435482
21548,1855.455867,1855.5187,1,55663676,55665561,1885,0.2262621055743748
21549,1855.520633,1855.549133,1,55665618,55666473,855,0.44925973702344113
21550,1855.554333,1855.5608,1,55666629,55666824,195,0.5986286249244491
21551,1855.562367,1855.569833,1,55666871,55667094,223,0.4034007761956931
21552,1855.579567,1855.628267,1,55667387,55668848,1461,0.088672688476345
21553,1855.629567,1855.7151,1,55668887,55671453,2566,0.11057531199544132
21554,1855.7458,1855.7701,1,55672374,55673103,729,0.15456679171321636
21555,1855.810167,1855.844867,1,55674305,55675346,1041,0.08317012277358232
21556,1855.8971,1855.924667,1,55676913,55677740,827,0.15495155388587484
21557,1855.938233,1855.942467,1,55678146,55678274,128,0.7975546990853511
21558,1855.979933,1855.991467,1,55679397,55679744,347,0.2293831123821238
21559,1855.996433,1856.0013,1,55679892,55680039,147,0.35429834667422944
21560,1856.308067,1856.3152,1,55689242,55689456,214,0.6704446693778194
21561,1856.3473,1856.353067,1,55690419,55690592,173,0.8064347413648506
21562,1856.372667,1856.3783,1,55691180,55691349,169,0.5297993320434043
21563,1856.389833,1856.401367,1,55691694,55692041,347,0.3625569793944409
21564,1856.4027,1856.415533,1,55692081,55692465,384,0.7337498693663383
21565,1856.417433,1856.424767,1,55692522,55692743,221,0.5981828098383881
21566,1856.4269,1856.446667,1,55692807,55693400,593,0.598306443863204
21567,1856.483367,1856.502367,1,55694501,55695071,570,0.8888821188946876
21568,1857.225067,1857.2356,1,55716752,55717068,316,0.2234910211405804
21569,1857.269,1857.3581,1,55718070,55720743,2673,0.19974418528204319
21570,1857.370367,1857.424067,1,55721111,55722722,1611,0.295129047799851
21571,1857.443467,1857.566933,1,55723304,55727007,3703,0.11339894998598748
21572,1858.635367,1858.740233,1,55759061,55762206,3145,0.07753871900825751
21573,1858.749933,1858.8189,1,55762497,55764567,2070,0.03925982451130795
21574,1858.821067,1858.856133,1,55764632,55765683,1051,-0.06330560104300335
21575,1858.8703,1858.973733,1,55766109,55769211,3102,0.07215098026145139
21576,1858.974733,1858.996067,1,55769241,55769882,641,0.17799927381289155
21577,1858.9978,1859.001667,1,55769934,55770050,116,0.8930933629725996
21578,1859.043,1859.056467,1,55771290,55771694,404,0.26621004070521936
21579,1859.1472,1859.152433,1,55774416,55774572,156,0.5232045616364182
21580,1859.1582,1859.167367,1,55774746,55775021,275,0.30743584241215693
21581,1859.1726,1859.1774,1,55775178,55775322,144,0.21885823655117276
21582,1859.1984,1859.2063,1,55775952,55776189,237,0.31577466181089653
21583,1859.4645,1859.4697,1,55783935,55784091,156,0.6638196828795137
21584,1859.5189,1859.524233,1,55785567,55785726,159,0.8878157711032993
21585,1860.0748,1860.1376,1,55802244,55804128,1884,0.1083902347119205
21586,1860.152567,1860.178767,1,55804577,55805363,786,0.18146048162436826
21587,1860.187967,1860.250367,1,55805639,55807511,1872,0.04673488991534534
21588,1860.284933,1860.306,1,55808547,55809180,633,0.5116657938772163
21589,1860.3071,1860.311833,1,55809213,55809354,141,0.6905818474811589
21590,1860.339333,1860.3534,1,55810179,55810602,423,0.22949054130769342
21591,1860.3618,1860.369,1,55810854,55811070,216,0.5398804537602135
21592,1860.416333,1860.426033,1,55812489,55812780,291,0.5896996986752964
21593,1861.256233,1861.259767,1,55837686,55837793,107,0.7376721973377887
21594,1861.265933,1861.357867,1,55837977,55840736,2759,-0.016600330555281793
21595,1861.359833,1861.373467,1,55840794,55841204,410,0.1366388740055561
21596,1861.376367,1861.3796,1,55841291,55841388,97,0.5704652347953585
21597,1861.385333,1861.403367,1,55841559,55842101,542,0.38067086234179986
21598,1861.404367,1861.429667,1,55842131,55842890,759,0.11650893981706693
21599,1861.473267,1861.590967,1,55844198,55847729,3531,0.05958497050935241
21600,1861.632667,1861.639933,1,55848980,55849197,217,0.2627139610256098
21601,1862.172133,1862.275533,1,55865163,55868265,3102,0.07085282509467376
21602,1862.282033,1862.290567,1,55868460,55868717,257,0.5998875679659991
21603,1862.291933,1862.347133,1,55868757,55870413,1656,0.20821167381380856
21604,1862.3514,1862.487667,1,55870542,55874630,4088,0.14101308202468993
21605,1862.490167,1862.5924,1,55874705,55877772,3067,0.11873940837216244
21606,1862.604833,1862.609967,1,55878144,55878299,155,0.7886121985594506
21607,1862.611067,1862.6471,1,55878332,55879413,1081,0.3038666735553142
21608,1862.6486,1862.676467,1,55879458,55880294,836,0.15917971691818766
21609,1862.689867,1862.698433,1,55880696,55880952,256,0.15139070068581562
21610,1862.7071,1862.790333,1,55881213,55883709,2496,0.21434651100217036
21611,1862.809933,1862.820367,1,55884297,55884611,314,0.15188479125151244
21612,1862.8276,1862.8417,1,55884828,55885251,423,0.07152857954020966
21613,1862.8451,1862.875467,1,55885353,55886264,911,0.2650833847286704
21614,1862.8782,1862.884467,1,55886346,55886534,188,0.46142320974111506
21615,1862.891,1862.914667,1,55886730,55887440,710,0.30499740284251375
21616,1862.937167,1862.9419,1,55888115,55888257,142,0.13491121205595566
21617,1862.968767,1862.985167,1,55889063,55889555,492,0.3111829307796281
21618,1862.986967,1863.020067,1,55889609,55890602,993,0.4975058661020237
21619,1863.03,1863.045367,1,55890900,55891361,461,0.21212098279592906
21620,1863.046667,1863.059567,1,55891400,55891787,387,0.2914173286838172
21621,1863.076833,1863.079967,1,55892304,55892399,95,0.8871297362714354
21622,1863.0813,1863.0884,1,55892439,55892652,213,-0.18596669816434588
21623,1863.0978,1863.1139,1,55892934,55893417,483,0.007930018801650576
21624,1863.115133,1863.119833,1,55893453,55893594,141,0.6760090048412234
21625,1863.127367,1863.162967,1,55893821,55894889,1068,0.41909498787660765
21626,1863.1673,1863.198433,1,55895019,55895952,933,0.4349988973096057
21627,1863.201833,1863.2108,1,55896054,55896324,270,0.2755090943488185
21628,1863.278933,1863.2842,1,55898367,55898526,159,0.6089184178940218
21629,1863.2857,1863.2928,1,55898571,55898784,213,0.6142382599988959
21630,1863.315433,1863.321433,1,55899462,55899642,180,0.6934693408546592
21631,1863.330067,1863.357533,1,55899902,55900725,823,0.4473506176836073
21632,1863.4145,1863.418267,1,55902435,55902548,113,0.7089610552371464
21633,1863.491433,1863.496233,1,55904742,55904886,144,0.7923814736052543
21634,1863.6357,1863.717533,1,55909071,55911525,2454,0.14073786337480707
21635,1863.7402,1863.826767,1,55912206,55914803,2597,0.1916203492884713
21636,1863.8334,1863.854333,1,55915002,55915629,627,-0.03035932975714222
21637,1863.857167,1863.879933,1,55915715,55916397,682,0.11203948725219794
21638,1863.890433,1863.943033,1,55916712,55918290,1578,0.4006272886983264
21639,1863.968767,1863.993733,1,55919063,55919811,748,0.49279592545628575
21640,1863.994967,1864.002733,1,55919849,55920081,232,0.35572761514346735
21641,1864.011367,1864.0173,1,55920341,55920519,178,0.8481640244488798
21642,1864.020167,1864.034033,1,55920605,55921020,415,0.3334226901091374
21643,1864.040267,1864.049233,1,55921208,55921476,268,0.12209905037074202
21644,1864.175233,1864.181667,1,55925256,55925450,194,0.24833816535931705
21645,1864.225933,1864.2329,1,55926777,55926987,210,0.7439890616354826
21646,1864.3111,1864.348167,1,55929333,55930445,1112,0.012366116413469248
21647,1864.3596,1864.363733,1,55930788,55930911,123,0.09807210370425788
21648,1864.365267,1864.393433,1,55930958,55931802,844,0.05392609104461402
21649,1864.534167,1864.537467,1,55936025,55936124,99,0.1434845410793507
21650,1864.5394,1864.546567,1,55936182,55936397,215,0.49523045040575464
21651,1864.548,1864.626267,1,55936440,55938788,2348,0.09547262723675141
21652,1864.6278,1864.633067,1,55938834,55938992,158,0.47458478611992777
21653,1864.6404,1864.703267,1,55939212,55941098,1886,0.06717551001327243
21654,1864.7043,1864.725933,1,55941129,55941777,648,0.06466433483703747
21655,1864.727233,1864.842333,1,55941816,55945269,3453,0.07249534342457946
21656,1864.8446,1864.928533,1,55945338,55947855,2517,0.03852584652084
21657,1864.930367,1864.974467,1,55947911,55949234,1323,0.12032225412378204
21658,1864.9957,1865.0179,1,55949871,55950537,666,0.10544605117231455
21659,1865.0324,1865.058167,1,55950972,55951745,773,0.2253865185787257
21660,1865.065633,1865.108167,1,55951968,55953245,1277,0.15514078461003591
21661,1865.148267,1865.1571,1,55954448,55954713,265,0.4928751670916685
21662,1865.158533,1865.172,1,55954755,55955160,405,0.8823285248304977
21663,1865.2015,1865.2167,1,55956045,55956501,456,0.43410461835279057
21664,1866.2325,1866.2465,1,55986975,55987395,420,0.47232815997544497
21665,1866.248633,1866.265367,1,55987458,55987961,503,0.025630451361281996
21666,1866.2678,1866.3565,1,55988034,55990695,2661,0.21039421921387086
21667,1866.357567,1866.4553,1,55990727,55993659,2932,0.15982687286465075
21668,1866.459167,1866.542533,1,55993775,55996275,2500,0.02391903363397323
21669,1866.543967,1866.547367,1,55996319,55996421,102,0.9602131468112738
21670,1866.549,1866.590733,1,55996470,55997721,1251,0.004986607288556792
21671,1866.618333,1866.638167,1,55998549,55999145,596,0.2007021128012568
21672,1866.6607,1866.676733,1,55999821,56000301,480,0.14550065153894737
21673,1866.678367,1866.682533,1,56000351,56000475,124,0.9554898758872366
21674,1866.691967,1866.735,1,56000759,56002050,1291,0.19014393358953238
21675,1866.8186,1866.824867,1,56004558,56004746,188,0.6298854203315758
21676,1866.844033,1866.854067,1,56005320,56005622,302,0.3188445308019103
21677,1866.906233,1866.913867,1,56007186,56007416,230,0.12663469890130918
21678,1867.380933,1867.385367,1,56021427,56021561,134,0.39789286795905243
21679,1867.393333,1867.397033,1,56021799,56021910,111,0.6853991508075998
21680,1867.399633,1867.476733,1,56021988,56024301,2313,0.1306909652663652
21681,1867.477767,1867.481067,1,56024333,56024432,99,0.20397607332199214
21682,1867.4995,1867.626767,1,56024985,56028803,3818,0.16892079138108168
21683,1867.634333,1867.646733,1,56029029,56029401,372,0.6660770944427565
21684,1867.672967,1867.676967,1,56030189,56030309,120,0.32196681385448433
21685,1867.678767,1867.703333,1,56030363,56031099,736,0.21439970668722308
21686,1867.711267,1867.7301,1,56031338,56031903,565,0.09783176150442364
21687,1867.767767,1867.802267,1,56033033,56034068,1035,0.31959068362431337
21688,1867.805733,1867.8117,1,56034171,56034351,180,0.7147754372249756
21689,1867.8245,1867.855067,1,56034735,56035652,917,0.18073937105551466
21690,1867.856633,1867.860567,1,56035698,56035817,119,0.8075757057242497
21691,1867.873067,1867.885467,1,56036192,56036564,372,0.4184175869477643
21692,1867.8977,1867.9243,1,56036931,56037729,798,0.13123318192935046
21693,1867.928467,1867.932,1,56037854,56037960,106,0.7696370014839007
21694,1867.955667,1867.973267,1,56038670,56039198,528,0.4273888451869559
21695,1868.117633,1868.1903,1,56043528,56045709,2181,0.2955357366598823
21696,1868.1954,1868.200033,1,56045862,56046000,138,0.803067935723661
21697,1868.2574,1868.267267,1,56047722,56048018,296,0.6320776018414926
21698,1868.276733,1868.282167,1,56048301,56048465,164,0.7275040965716258
21699,1868.358,1868.3639,1,56050740,56050917,177,0.32705591394335676
21700,1868.365167,1868.3686,1,56050955,56051058,103,0.708611473261358
21701,1868.3707,1868.388067,1,56051121,56051642,521,0.02849000419915903
21702,1868.7885,1868.871967,1,56063655,56066159,2504,0.028555724041996525
21703,1868.8734,1868.9072,1,56066202,56067216,1014,0.044525955732102905
21704,1868.9103,1868.925867,1,56067309,56067776,467,0.13392365109791804
21705,1868.934533,1868.9644,1,56068035,56068932,897,0.2446557108781099
21706,1868.965533,1868.971233,1,56068965,56069136,171,0.8417435472932123
21707,1868.9723,1869.070167,1,56069169,56072105,2936,0.11362821494949782
21708,1869.0935,1869.0991,1,56072805,56072973,168,0.2591740009470862
21709,1869.108067,1869.144567,1,56073242,56074337,1095,0.14199448984446222
21710,1869.160133,1869.1858,1,56074803,56075574,771,0.28058242667954575
21711,1869.189733,1869.199767,1,56075691,56075993,302,0.21923899515598527
21712,1869.2531,1869.257467,1,56077593,56077724,131,0.9495062951602607
21713,1869.2619,1869.265733,1,56077857,56077971,114,0.8141642919738153
21714,1869.2755,1869.2824,1,56078265,56078472,207,0.801462442161645
21715,1869.6297,1869.6329,1,56088891,56088987,96,0.8582245034490013
21716,1869.6412,1869.655733,1,56089236,56089671,435,0.1465449427289889
21717,1869.658233,1869.725733,1,56089746,56091771,2025,0.017941969461469302
21718,1869.7321,1869.741667,1,56091963,56092250,287,0.7062308657092936
21719,1869.745933,1869.7929,1,56092377,56093787,1410,0.1464414788593746
21720,1869.7939,1869.941933,1,56093817,56098257,4440,0.19852829617268922
21721,1869.943633,1869.968133,1,56098308,56099043,735,0.06357955877905148
21722,1869.9705,1869.9735,1,56099115,56099205,90,0.21346621490187556
21723,1869.9772,1869.9992,1,56099316,56099976,660,-0.02816926693678984
21724,1870.004667,1870.0464,1,56100140,56101392,1252,0.09753297479371467
21725,1870.078067,1870.081467,1,56102342,56102444,102,0.7392242927064466
21726,1870.1322,1870.1458,1,56103966,56104374,408,0.39067234712344096
21727,1870.155467,1870.161367,1,56104664,56104841,177,0.4514334143677181
21728,1870.163533,1870.173767,1,56104905,56105213,308,0.20138448644109652
21729,1870.186733,1870.2019,1,56105601,56106057,456,0.0028297863445340115
21730,1870.2154,1870.2205,1,56106462,56106615,153,0.41636359248779337
21731,1870.2224,1870.237633,1,56106672,56107128,456,0.5712967232701028
21732,1870.270567,1870.284067,1,56108117,56108522,405,0.11926478508113741
21733,1870.3626,1870.372933,1,56110878,56111187,309,0.16327450497140103
21734,1870.4256,1870.4324,1,56112768,56112972,204,0.4124803944215259
21735,1870.4462,1870.460633,1,56113386,56113818,432,0.6284326744663046
21736,1870.584767,1870.589,1,56117543,56117670,127,0.195164905132074
21737,1870.8581,1870.944,1,56125743,56128320,2577,0.24965946434690062
21738,1870.953,1871.0448,1,56128590,56131344,2754,0.17437458164944558
21739,1871.0536,1871.062833,1,56131608,56131884,276,0.14211852778934364
21740,1871.079033,1871.1102,1,56132370,56133306,936,0.126932740436352
21741,1871.112433,1871.126767,1,56133372,56133803,431,0.8222604791580667
21742,1871.136567,1871.170567,1,56134097,56135117,1020,0.5150273681626684
21743,1871.1748,1871.191133,1,56135244,56135733,489,0.4637303543513342
21744,1871.192233,1871.201633,1,56135766,56136048,282,0.5925095993701172
21745,1871.218233,1871.2459,1,56136546,56137377,831,0.31996663564369315
21746,1871.248033,1871.256633,1,56137440,56137698,258,0.45303384575882705
21747,1871.260067,1871.310767,1,56137802,56139323,1521,0.49330139939607504
21748,1871.312,1871.340767,1,56139360,56140223,863,0.275795462632127
21749,1871.3437,1871.364367,1,56140311,56140931,620,0.5284473131573666
21750,1871.3697,1871.3809,1,56141091,56141427,336,0.3222582202983226
21751,1871.387033,1871.402867,1,56141610,56142086,476,0.7872890402508292
21752,1871.409867,1871.437433,1,56142296,56143122,826,0.3742683822370387
21753,1871.4399,1871.451267,1,56143197,56143538,341,0.5424163741528327
21754,1871.464333,1871.495733,1,56143929,56144871,942,0.29633466973866096
21755,1871.4992,1871.5669,1,56144976,56147007,2031,0.30594507188016756
21756,1871.575767,1871.5797,1,56147273,56147391,118,0.9280431671580152
21757,1871.584167,1871.593367,1,56147525,56147801,276,0.7158762964774483
21758,1871.5979,1871.611033,1,56147937,56148330,393,0.7966025446146497
21759,1871.6157,1871.6193,1,56148471,56148579,108,0.8748180651674174
21760,1871.6315,1871.651167,1,56148945,56149535,590,0.5505928844943491
21761,1871.6534,1871.658633,1,56149602,56149758,156,0.34540170083923444
21762,1871.660233,1871.665833,1,56149806,56149974,168,0.497881890620791
21763,1871.8578,1871.875033,1,56155734,56156250,516,0.22680116208454024
21764,1871.888733,1871.949467,1,56156661,56158484,1823,0.07866544664188387
21765,1871.953933,1871.965433,1,56158617,56158962,345,0.09731581906882689
21766,1871.997567,1872.053633,1,56159927,56161608,1681,0.22615928901101398
21767,1872.0547,1872.095067,1,56161641,56162852,1211,0.20911695993615967
21768,1872.0978,1872.1058,1,56162934,56163174,240,0.7543653071149155
21769,1872.107767,1872.156567,1,56163233,56164697,1464,0.146973628443581
21770,1872.157933,1872.171433,1,56164737,56165142,405,0.7632618533598702
21771,1872.173733,1872.211233,1,56165211,56166336,1125,0.6945320852785728
21772,1872.212367,1872.2175,1,56166371,56166525,154,0.8473691996204696
21773,1872.2232,1872.243,1,56166696,56167290,594,0.26886868591311003
21774,1872.244433,1872.2634,1,56167332,56167902,570,0.28003867687108386
21775,1872.265867,1872.2746,1,56167976,56168238,262,0.40153223342904915
21776,1872.306967,1872.313667,1,56169209,56169410,201,0.6591599109495777
21777,1872.316733,1872.352733,1,56169501,56170581,1080,0.5589527259007575
21778,1872.353867,1872.3597,1,56170616,56170791,175,0.5486717936022215
21779,1872.361933,1872.401467,1,56170857,56172044,1187,0.11424218163013863
21780,1872.403267,1872.4106,1,56172098,56172318,220,0.327454899655868
21781,1872.4688,1872.512033,1,56174064,56175360,1296,0.21940172090345658
21782,1872.532433,1872.554333,1,56175972,56176629,657,-0.11353119936589004
21783,1872.597567,1872.604767,1,56177927,56178143,216,0.45192273739955574
21784,1872.669467,1872.676367,1,56180084,56180291,207,0.5879692262689175
21785,1872.931467,1873.0281,1,56187944,56190843,2899,0.0939719160697409
21786,1873.029867,1873.045633,1,56190896,56191368,472,0.3103122077693633
21787,1873.0483,1873.155833,1,56191449,56194674,3225,0.11989667071412041
21788,1873.205033,1873.307333,1,56196150,56199219,3069,0.10219159116536769
21789,1873.308433,1873.342833,1,56199252,56200284,1032,0.2794634390959469
21790,1873.3556,1873.387133,1,56200668,56201613,945,0.06421524921878283
21791,1873.3993,1873.447867,1,56201979,56203436,1457,0.021292797607353944
21792,1873.4519,1873.456467,1,56203557,56203694,137,0.8269192942645547
21793,1873.4648,1873.493233,1,56203944,56204796,852,0.10925988718346995
21794,1873.494367,1873.5267,1,56204831,56205801,970,0.1877630608784879
21795,1873.566467,1873.588933,1,56206994,56207667,673,0.5112298906367562
21796,1873.6101,1873.6249,1,56208303,56208747,444,0.33600899224155767
21797,1873.989533,1874.003767,1,56219685,56220113,428,0.19886508794332797
21798,1874.010533,1874.314833,1,56220315,56229444,9129,0.1671118111500804
21799,1874.321433,1874.329967,1,56229642,56229899,257,0.7922711852591721
21800,1874.332667,1874.341833,1,56229980,56230254,274,0.689824775109731
21801,1874.949667,1875.056667,1,56248490,56251700,3210,0.159419610056228
21802,1875.072367,1875.155533,1,56252171,56254665,2494,0.18713136814848513
21803,1875.162267,1875.173333,1,56254868,56255199,331,0.6410183835370769
21804,1875.1779,1875.202867,1,56255337,56256086,749,0.300731262112219
21805,1875.205433,1875.250233,1,56256162,56257506,1344,0.1598842006683081
21806,1875.251433,1875.2664,1,56257542,56257992,450,0.21988970335451588
21807,1875.297033,1875.304633,1,56258910,56259138,228,0.6267675820734387
21808,1875.312167,1875.315267,1,56259365,56259458,93,0.8035907633098186
21809,1875.336767,1875.350833,1,56260103,56260524,421,0.35474553653006186
21810,1875.373667,1875.378033,1,56261210,56261340,130,0.8383150783652387
21811,1875.3798,1875.386933,1,56261394,56261607,213,0.4935889256107501
21812,1875.389467,1875.3994,1,56261684,56261982,298,0.3172893558852952
21813,1875.844933,1875.928533,1,56275347,56277855,2508,-0.0305424215020199
21814,1875.935667,1875.9539,1,56278070,56278617,547,0.36833539958088196
21815,1875.9578,1875.986533,1,56278734,56279595,861,0.02725767455877141
21816,1875.987533,1875.9909,1,56279625,56279727,102,0.7255736470460458
21817,1876.029233,1876.081233,1,56280876,56282436,1560,0.22263044721613823
21818,1876.0826,1876.096933,1,56282478,56282907,429,-0.034418525803137395
21819,1876.104933,1876.1081,1,56283147,56283243,96,0.9454640024415014
21820,1876.115667,1876.146533,1,56283470,56284395,925,0.13708031820617944
21821,1876.1783,1876.2024,1,56285349,56286072,723,0.5455663047662493
21822,1876.214933,1876.234533,1,56286447,56287035,588,0.43594365581016215
21823,1876.3069,1876.31,1,56289207,56289300,93,0.8801716102057254
21824,1877.255333,1877.259833,1,56317659,56317794,135,0.8426800039803475
21825,1877.3031,1877.377133,1,56319093,56321313,2220,0.1327204217993276
21826,1877.381067,1877.473033,1,56321432,56324190,2758,0.10784038420898549
21827,1877.4745,1877.5863,1,56324235,56327589,3354,0.03911430480507021
21828,1877.5937,1877.610667,1,56327811,56328320,509,0.20296878289545867
21829,1877.6402,1877.6565,1,56329206,56329695,489,0.13257811841194883
21830,1877.667667,1877.708833,1,56330030,56331264,1234,0.16584440739872083
21831,1877.7444,1877.748467,1,56332332,56332454,122,0.8800730823268273
21832,1877.9257,1877.9613,1,56337771,56338839,1068,0.14168853272683815
21833,1877.963967,1878.0114,1,56338919,56340342,1423,0.12060433675475442
21834,1878.013233,1878.0276,1,56340396,56340828,432,0.4863353737559919
21835,1878.0683,1878.163033,1,56342049,56344890,2841,0.09959347726352476
21836,1878.164233,1878.189033,1,56344926,56345670,744,0.1736462769959514
21837,1878.2034,1878.207733,1,56346102,56346231,129,0.8243250489369333
21838,1878.2234,1878.238833,1,56346702,56347164,462,0.23169756024343044
21839,1878.265633,1878.2961,1,56347968,56348883,915,0.32580578423206813
21840,1878.303867,1878.310133,1,56349116,56349303,187,0.5537794335635879
21841,1878.920867,1879.043933,1,56367626,56371317,3691,0.0682234324192416
21842,1879.047167,1879.303233,1,56371415,56379096,7681,0.1530332843732592
21843,1879.913467,1879.919433,1,56397404,56397582,178,0.6996970346776716
21844,1879.923933,1879.9304,1,56397717,56397912,195,0.3360922281285229
21845,1879.9315,1880.010333,1,56397945,56400309,2364,0.07714675720474085
21846,1880.012533,1880.067067,1,56400375,56402012,1637,0.31554046950179404
21847,1880.068267,1880.0917,1,56402048,56402751,703,0.14800899061772735
21848,1880.0929,1880.1044,1,56402787,56403132,345,0.35306396070146656
21849,1880.122833,1880.136333,1,56403684,56404089,405,0.5443342682079905
21850,1880.1792,1880.197033,1,56405376,56405910,534,0.31417223653461923
21851,1880.198567,1880.205467,1,56405957,56406164,207,0.8701901154298057
21852,1880.2087,1880.221733,1,56406261,56406651,390,0.4862718791587331
21853,1880.225367,1880.249533,1,56406761,56407485,724,0.621291442847644
21854,1880.264,1880.284033,1,56407920,56408520,600,0.6128629089837462
21855,1880.2864,1880.299233,1,56408592,56408976,384,0.33136914344312374
21856,1880.310567,1880.3462,1,56409317,56410386,1069,0.13718271581849587
21857,1880.351933,1880.362733,1,56410557,56410881,324,0.35884158568317887
21858,1880.364567,1880.3702,1,56410937,56411106,169,0.5629161325388847
21859,1880.374667,1880.383767,1,56411240,56411513,273,0.5446416361954534
21860,1880.384933,1880.4024,1,56411547,56412072,525,0.6307319027324487
21861,1880.4062,1880.427733,1,56412186,56412831,645,0.2369541342672267
21862,1880.431567,1880.442767,1,56412947,56413283,336,0.11528408939458
21863,1880.4532,1880.519033,1,56413596,56415570,1974,0.3376132036524788
21864,1880.521867,1880.531667,1,56415656,56415950,294,0.13026103071087491
21865,1880.5395,1880.5516,1,56416185,56416548,363,0.3550492191041418
21866,1880.5566,1880.561533,1,56416698,56416845,147,0.7951390401609577
21867,1880.562667,1880.568467,1,56416880,56417054,174,0.8961224046348977
21868,1880.5695,1880.6048,1,56417085,56418144,1059,0.6673849407760032
21869,1880.6067,1880.632667,1,56418201,56418980,779,0.27504458807788984
21870,1880.6393,1880.653867,1,56419179,56419616,437,0.1944458521006382
21871,1880.682267,1880.686233,1,56420468,56420586,118,0.7656812934894103
21872,1880.6873,1880.6982,1,56420619,56420946,327,0.30210181514343454
21873,1880.699467,1880.705767,1,56420984,56421173,189,0.5843543754825807
21874,1880.707667,1880.710833,1,56421230,56421324,94,0.2367867723633047
21875,1880.7371,1880.766767,1,56422113,56423003,890,0.43011049189235023
21876,1880.8912,1880.9021,1,56426736,56427063,327,0.4503891042719829
21877,1880.930333,1880.9354,1,56427909,56428062,153,0.7742642868060249
21878,1880.9377,1880.952767,1,56428131,56428583,452,0.4352031131138946
21879,1880.999867,1881.0698,1,56429996,56432094,2098,0.21098445608838587
21880,1881.079567,1881.1387,1,56432387,56434161,1774,0.19903940487011093
21881,1881.1428,1881.229,1,56434284,56436870,2586,0.11754205174214565
21882,1881.235667,1881.259767,1,56437070,56437793,723,0.2986681313066054
21883,1881.261,1881.284467,1,56437830,56438534,704,-0.004408694745355455
21884,1881.292833,1881.310967,1,56438784,56439329,545,0.07382484788818222
21885,1881.312833,1881.317167,1,56439384,56439515,131,0.7237975704554648
21886,1881.318833,1881.406333,1,56439564,56442189,2625,0.1880840713867446
21887,1881.414333,1881.475333,1,56442429,56444259,1830,0.5018164324129533
21888,1881.481067,1881.4976,1,56444432,56444928,496,0.39170316305114056
21889,1881.499167,1881.5144,1,56444975,56445432,457,0.3172582049656021
21890,1882.066833,1882.142433,1,56462004,56464272,2268,0.05104538522210408
21891,1882.143533,1882.224067,1,56464305,56466722,2417,0.14440446914527783
21892,1882.2373,1882.3112,1,56467119,56469336,2217,0.16158408207385666
21893,1882.3251,1882.4035,1,56469753,56472105,2352,0.1544474838984937
21894,1882.407567,1882.449933,1,56472227,56473497,1270,0.008462445394243323
21895,1882.4513,1882.5304,1,56473539,56475912,2373,-0.04414335617656205
21896,1882.797233,1882.800433,1,56483916,56484012,96,0.8301458856696454
21897,1882.8909,1882.916433,1,56486727,56487492,765,0.3518567418538627
21898,1882.9181,1882.933367,1,56487543,56488001,458,-0.0035579751177563456
21899,1882.950533,1882.972,1,56488515,56489160,645,0.23544170802630793
21900,1882.985433,1883.032967,1,56489562,56490989,1427,-0.0017257583481755437
21901,1883.035,1883.0418,1,56491050,56491254,204,0.7176579244028677
21902,1883.047967,1883.072,1,56491439,56492160,721,0.2717954553067075
21903,1883.076433,1883.082867,1,56492292,56492486,194,0.5547966688210642
21904,1883.129633,1883.147333,1,56493888,56494419,531,-0.07558866303632764
21905,1883.148333,1883.218867,1,56494449,56496566,2117,0.16064866910276926
21906,1883.222067,1883.250167,1,56496662,56497505,843,0.16455329702310953
21907,1883.251467,1883.305467,1,56497544,56499164,1620,0.038608507982750256
21908,1883.338033,1883.494467,1,56500140,56504834,4694,0.1373288150819286
21909,1883.501633,1883.507567,1,56505048,56505227,179,0.9255861180581949
21910,1883.511433,1883.550967,1,56505342,56506529,1187,0.2875615373619186
21911,1883.5816,1883.6402,1,56507448,56509206,1758,0.15207160157218036
21912,1883.6441,1883.6543,1,56509323,56509629,306,0.8300051602904814
21913,1884.9204,1884.928533,1,56547612,56547855,243,0.4484184602507874
21914,1884.9325,1885.032467,1,56547975,56550974,2999,0.1795081149708395
21915,1885.037733,1885.041567,1,56551131,56551247,116,0.9599821442915856
21916,1885.043167,1885.1104,1,56551295,56553312,2017,0.1654080403561518
21917,1885.116133,1885.151833,1,56553483,56554554,1071,0.08018081352020553
21918,1885.161367,1885.2512,1,56554841,56557536,2695,0.17979729455247812
21919,1885.2682,1885.275333,1,56558046,56558259,213,0.43322325490275065
21920,1885.286933,1885.311933,1,56558607,56559357,750,0.3373120129574138
21921,1885.371733,1885.376233,1,56561151,56561286,135,0.6803397036988887
21922,1886.3169,1886.3215,1,56589507,56589645,138,0.8865545318748651
21923,1886.352667,1886.467733,1,56590580,56594031,3451,0.20479573469710655
21924,1886.478733,1886.6739,1,56594361,56600217,5856,0.11322606893980779
21925,1886.678,1886.682633,1,56600340,56600478,138,0.45041477008037845
21926,1886.7116,1886.7314,1,56601348,56601942,594,0.24007309933911938
21927,1886.7576,1886.792933,1,56602728,56603787,1059,0.14974069552651872
21928,1886.878667,1886.881967,1,56606360,56606459,99,0.869372956115412
21929,1886.886433,1886.890767,1,56606592,56606723,131,0.549360900033962
21930,1887.304133,1887.4062,1,56619123,56622186,3063,0.21899167492000185
21931,1887.407767,1887.4355,1,56622233,56623065,832,0.09092684005684652
21932,1887.438667,1887.470367,1,56623160,56624111,951,0.24412924832420213
21933,1887.471367,1887.516467,1,56624141,56625494,1353,0.3456345778309423
21934,1887.538,1887.636067,1,56626140,56629082,2942,0.13851076855613906
21935,1887.6481,1887.674167,1,56629443,56630225,782,0.051105872575548564
21936,1887.7022,1887.727733,1,56631066,56631831,765,0.07424719590150146
21937,1887.7377,1887.7999,1,56632131,56633997,1866,0.2741775496391837
21938,1887.8011,1887.8414,1,56634033,56635242,1209,0.14155886993792244
21939,1888.934067,1888.943233,1,56668022,56668296,274,0.38557306592388735
21940,1888.9999,1889.120667,1,56669997,56673620,3623,0.20252827316632857
21941,1889.121767,1889.199567,1,56673653,56675987,2334,-0.07038908712139283
21942,1889.200733,1889.309233,1,56676021,56679276,3255,0.1254249842044428
21943,1889.3111,1889.314467,1,56679333,56679434,101,0.87134221752095
21944,1889.317967,1889.343133,1,56679539,56680293,754,0.17208692968588143
21945,1889.344433,1889.364333,1,56680332,56680929,597,0.005095677303873548
21946,1889.381367,1889.406667,1,56681441,56682200,759,0.008444810999993349
21947,1889.408033,1889.4226,1,56682240,56682678,438,0.026962811546903626
21948,1889.439567,1889.466233,1,56683187,56683986,799,0.06836989569884579
21949,1889.469467,1889.473467,1,56684084,56684204,120,0.8713824629828196
21950,1889.476633,1889.512933,1,56684298,56685387,1089,0.13157370557255582
21951,1889.975367,1889.979967,1,56699261,56699399,138,0.6482927092734877
21952,1889.981,1889.984633,1,56699430,56699538,108,0.8625776837870132
21953,1890.0895,1890.097633,1,56702685,56702928,243,0.46027538955331126
21954,1890.101033,1890.110567,1,56703030,56703317,287,0.4476747594545801
21955,1890.114367,1890.218967,1,56703431,56706569,3138,0.19141763673055945
21956,1890.223733,1890.236433,1,56706711,56707092,381,0.2649868944847441
21957,1890.238133,1890.243533,1,56707143,56707305,162,0.8894813800829666
21958,1890.2773,1890.3246,1,56708319,56709738,1419,0.3769756746266451
21959,1890.341267,1890.376367,1,56710238,56711291,1053,0.5026650995408254
21960,1890.979333,1890.983767,1,56729379,56729513,134,0.8303106994302405
21961,1891.0006,1891.095767,1,56730018,56732873,2855,0.11753397861993259
21962,1891.097367,1891.170467,1,56732921,56735114,2193,0.1979432086697563
21963,1891.179567,1891.272967,1,56735387,56738189,2802,0.13535997077509992
21964,1891.287233,1891.308667,1,56738616,56739260,644,0.2002044452154
21965,1891.332067,1891.364067,1,56739962,56740922,960,0.004279056909743396
21966,1891.396633,1891.441567,1,56741898,56743247,1349,0.09699656827009612
21967,1891.5208,1891.5261,1,56745624,56745783,159,0.8526156506242242
21968,1891.550267,1891.554933,1,56746508,56746647,139,0.8044967390531351
21969,1891.702,1891.734933,1,56751060,56752047,987,0.25772472429604654
21970,1891.792033,1891.7982,1,56753760,56753946,186,0.8286055240451685
21971,1891.808033,1891.813367,1,56754240,56754401,161,0.7778013561565964
21972,1891.814367,1891.8241,1,56754431,56754723,292,0.8330006393229232
21973,1891.837333,1891.847333,1,56755119,56755419,300,0.48977464424126677
21974,1891.849433,1891.858467,1,56755482,56755754,272,0.2850986890337285
21975,1891.865633,1891.8785,1,56755968,56756355,387,0.6746516825319052
21976,1891.8836,1891.903833,1,56756508,56757114,606,0.4853086697739738
21977,1891.9054,1891.920433,1,56757162,56757612,450,0.2746301347811956
21978,1891.925533,1891.9297,1,56757765,56757891,126,0.8305098516277145
21979,1891.936667,1891.992,1,56758100,56759760,1660,0.3461464265513281
21980,1891.999333,1892.021433,1,56759979,56760642,663,0.7417875546176093
21981,1892.023667,1892.0452,1,56760710,56761356,646,0.20153177567604852
21982,1892.0463,1892.054833,1,56761389,56761644,255,0.16003739638540682
21983,1892.059533,1892.1199,1,56761785,56763597,1812,0.28904347714860495
21984,1892.125933,1892.142133,1,56763777,56764263,486,0.31283840097371063
21985,1892.144167,1892.152167,1,56764325,56764565,240,0.16581038511522098
21986,1892.1582,1892.1717,1,56764746,56765151,405,0.5048922064890606
21987,1892.173233,1892.2112,1,56765196,56766336,1140,0.3997351905820414
21988,1892.2123,1892.225867,1,56766369,56766776,407,0.7879798109218116
21989,1892.237633,1892.264867,1,56767128,56767946,818,0.38892716692871815
21990,1892.2826,1892.287033,1,56768478,56768610,132,0.40768024490723515
21991,1892.292267,1892.2955,1,56768768,56768865,97,0.3607237105012213
21992,1892.305433,1892.3168,1,56769162,56769504,342,0.22426433655255787
21993,1892.328,1892.3356,1,56769840,56770068,228,0.6769332574044598
21994,1892.336667,1892.359033,1,56770100,56770770,670,0.773803366265248
21995,1892.360633,1892.3652,1,56770818,56770956,138,0.7193799735354914
21996,1892.3715,1892.398933,1,56771145,56771967,822,0.21239339272087168
21997,1892.400067,1892.407567,1,56772002,56772227,225,0.4337269822309314
21998,1892.4165,1892.4305,1,56772495,56772915,420,0.02314740752498334
21999,1892.448167,1892.467,1,56773445,56774010,565,-0.002822298873886838
22000,1892.471233,1892.510133,1,56774136,56775303,1167,0.27730171210528465
22001,1892.511267,1892.517133,1,56775338,56775513,175,0.9047968868677223
22002,1892.525933,1892.5488,1,56775777,56776464,687,0.335632195849804
22003,1892.559767,1892.567233,1,56776793,56777016,223,0.3946039783532154
22004,1893.2456,1893.253967,1,56797368,56797619,251,0.6409332964157167
22005,1893.2575,1893.319067,1,56797725,56799572,1847,0.13273002846410933
22006,1893.320133,1893.426,1,56799603,56802780,3177,0.23826445797433277
22007,1893.445433,1893.5281,1,56803362,56805843,2481,0.09630542553554566
22008,1893.538,1893.552367,1,56806140,56806571,431,0.030622040523852503
22009,1893.5542,1893.575633,1,56806626,56807268,642,0.2438108018773958
22010,1893.6022,1893.628267,1,56808066,56808848,782,-0.003465559019677747
22011,1893.633133,1893.645133,1,56808993,56809353,360,0.34213908810692145
22012,1893.6546,1893.675467,1,56809638,56810264,626,0.26382067512249213
22013,1893.765367,1893.787533,1,56812961,56813625,664,0.1791178179010264
22014,1893.788833,1893.793167,1,56813664,56813795,131,0.803829162738861
22015,1893.824,1893.8283,1,56814720,56814849,129,0.8564590211843549
22016,1893.874233,1893.8965,1,56816226,56816895,669,0.13585401289771298
22017,1893.912633,1893.958733,1,56817378,56818761,1383,0.003734731773108233
22018,1893.965733,1893.969033,1,56818971,56819070,99,0.8641655015810648
22019,1893.970967,1893.998167,1,56819129,56819945,816,0.08383281280154849
22020,1894.0565,1894.0671,1,56821695,56822013,318,0.7966462646649723
22021,1894.0703,1894.073933,1,56822109,56822217,108,0.7289570935843228
22022,1894.076633,1894.079767,1,56822298,56822393,95,0.7871099102776585
22023,1894.0878,1894.094267,1,56822634,56822828,194,0.8690429307310874
22024,1894.095433,1894.103233,1,56822862,56823096,234,0.8167673186878072
22025,1894.1135,1894.1213,1,56823405,56823639,234,0.4018131743325026
22026,1894.133633,1894.189633,1,56824008,56825688,1680,0.10002856404548402
22027,1894.206833,1894.229633,1,56826204,56826888,684,0.4217554487170646
22028,1894.231933,1894.238367,1,56826957,56827151,194,0.44962494479195736
22029,1895.2225,1895.2866,1,56856675,56858598,1923,0.03941675157932024
22030,1895.288,1895.307567,1,56858640,56859227,587,0.23568799617353295
22031,1895.316967,1895.331267,1,56859509,56859938,429,0.4107184198325
22032,1895.3351,1895.377133,1,56860053,56861313,1260,0.2142169085221563
22033,1895.378433,1895.3838,1,56861352,56861514,162,0.857475262798955
22034,1895.398567,1895.551667,1,56861957,56866550,4593,0.29891690628965956
22035,1896.1928,1896.196533,1,56885784,56885895,111,0.8179706266476477
22036,1896.2024,1896.2059,1,56886072,56886177,105,0.8089474545525693
22037,1896.221567,1896.2275,1,56886647,56886825,178,0.30578425559823796
22038,1896.237,1896.308067,1,56887110,56889242,2132,0.2698730068232923
22039,1896.3363,1896.345433,1,56890089,56890362,273,0.8356806413780248
22040,1896.346833,1896.3519,1,56890404,56890557,153,0.8707915295767502
22041,1896.3531,1896.362633,1,56890593,56890878,285,0.790912952247452
22042,1896.3694,1896.377267,1,56891082,56891318,236,0.7355983129065269
22043,1896.870633,1897.018667,1,56906118,56910560,4442,0.17411171948614215
22044,1897.019733,1897.156733,1,56910591,56914701,4110,0.11360610749341671
22045,1897.158433,1897.1991,1,56914752,56915973,1221,0.2597303958253677
22046,1897.214967,1897.2299,1,56916449,56916897,448,0.19255081669105795
22047,1897.237867,1897.2486,1,56917136,56917458,322,0.32354603420826855
22048,1897.265433,1897.286867,1,56917962,56918606,644,0.10709001603079861
22049,1897.2946,1897.3345,1,56918838,56920035,1197,0.0956447543985236
22050,1897.362167,1897.367167,1,56920865,56921015,150,0.8941820664201612
22051,1898.289567,1898.293933,1,56948687,56948817,130,0.62819459647668
22052,1898.296833,1898.3006,1,56948904,56949018,114,0.7058076487989723
22053,1898.3138,1898.427167,1,56949414,56952815,3401,0.18006255960017573
22054,1898.4376,1898.481633,1,56953128,56954448,1320,0.1596782169102195
22055,1898.4859,1898.4996,1,56954577,56954988,411,0.5640057002783034
22056,1898.513567,1898.6217,1,56955407,56958651,3244,0.1586256900872949
22057,1898.627467,1898.6539,1,56958824,56959617,793,0.016842123907684265
22058,1898.6676,1898.711067,1,56960028,56961332,1304,0.17669584637784821
22059,1898.732667,1898.7699,1,56961980,56963097,1117,0.13310446993772218
22060,1898.860367,1898.872867,1,56965811,56966186,375,0.1954239591020099
22061,1899.4003,1899.4079,1,56982009,56982237,228,0.2903537007336348
22062,1899.4125,1899.498467,1,56982375,56984954,2579,0.16202385367055114
22063,1899.5,1899.562767,1,56985000,56986883,1883,0.2106842214623646
22064,1899.587567,1899.621267,1,56987627,56988638,1011,0.03061342240175465
22065,1899.622867,1899.822467,1,56988686,56994674,5988,0.36004677075299285
22066,1899.8275,1899.873733,1,56994825,56996211,1386,0.26130855912795803
22067,1899.8972,1899.9103,1,56996916,56997309,393,0.17487675532489566
22068,1899.9113,1899.921733,1,56997339,56997651,312,0.8919474860595205
22069,1899.928933,1899.934267,1,56997867,56998028,161,0.8865997386055148
22070,1899.944667,1899.958733,1,56998340,56998761,421,0.3559844045755576
22071,1899.961,1899.964367,1,56998830,56998931,101,0.7234566931738017
22072,1901.130567,1901.137433,1,57033917,57034122,205,0.5491286306699898
22073,1901.148833,1901.160867,1,57034464,57034826,362,-0.026122061514270357
22074,1901.163867,1901.167667,1,57034916,57035030,114,0.9295137421692157
22075,1901.172267,1901.220867,1,57035168,57036626,1458,0.09717295646546509
22076,1901.225033,1901.2419,1,57036750,57037257,507,-0.006120444166318502
22077,1901.2597,1901.2989,1,57037791,57038967,1176,-0.07241722465682464
22078,1901.339867,1901.373033,1,57040196,57041190,994,0.24636226134488795
22079,1901.396933,1901.438267,1,57041907,57043148,1241,0.24192938322198315
22080,1901.521,1901.532567,1,57045630,57045977,347,0.7554167710885569
22081,1901.5353,1901.541167,1,57046059,57046235,176,0.8464594232805617
22082,1901.564233,1901.569,1,57046926,57047070,144,0.9219181002375213
22083,1902.473767,1902.576767,1,57074213,57077303,3090,0.150117995093651
22084,1902.586,1902.633667,1,57077580,57079010,1430,0.16219487179342143
22085,1902.648,1902.769,1,57079440,57083070,3630,0.04305295798626518
22086,1902.7704,1902.7843,1,57083112,57083529,417,0.6628922851472123
22087,1902.799933,1902.823733,1,57083997,57084711,714,0.6895420176077852
22088,1902.8285,1902.832067,1,57084855,57084962,107,0.9520589103360928
22089,1902.927967,1902.9345,1,57087839,57088035,196,0.4883462542735349
22090,1903.081267,1903.1051,1,57092438,57093153,715,0.3563514826523498
22091,1903.1066,1903.1171,1,57093198,57093513,315,0.0119678232467414
22092,1903.134167,1903.147033,1,57094025,57094410,385,0.5240480389557558
22093,1903.1562,1903.159833,1,57094686,57094794,108,0.5043437415992509
22094,1903.171,1903.184167,1,57095130,57095525,395,0.09237982302756066
22095,1903.188867,1903.2041,1,57095666,57096123,457,0.005050298166309943
22096,1903.205467,1903.209333,1,57096164,57096279,115,0.4930427915928939
22097,1903.2113,1903.235867,1,57096339,57097076,737,0.19440588494336397
22098,1903.240567,1903.246767,1,57097217,57097403,186,0.7803792642707623
22099,1903.249267,1903.2786,1,57097478,57098358,880,0.4489625413421951
22100,1903.3602,1903.368967,1,57100806,57101069,263,0.5009948849085719
22101,1903.374567,1903.476333,1,57101237,57104289,3052,0.21496293671228311
22102,1903.4821,1903.486333,1,57104463,57104589,126,0.9340598909693094
22103,1903.487367,1903.492533,1,57104621,57104775,154,0.7073398565785739
22104,1903.495233,1903.586467,1,57104856,57107594,2738,0.23069200780045754
22105,1903.587633,1903.590667,1,57107628,57107720,92,0.7899160728400147
22106,1903.599767,1903.7191,1,57107993,57111573,3580,0.05258619404356338
22107,1903.727267,1903.732067,1,57111818,57111962,144,0.8191245478865018
22108,1903.734133,1903.755467,1,57112023,57112664,641,0.43018037260030567
22109,1903.788433,1903.815467,1,57113652,57114464,812,-0.0053900442957662935
22110,1903.819767,1903.854333,1,57114593,57115629,1036,0.1567750309252684
22111,1903.943467,1903.9553,1,57118304,57118659,355,0.46960384337622196
22112,1903.9617,1903.970267,1,57118851,57119108,257,0.4791114880102831
22113,1903.9809,1904.039,1,57119427,57121170,1743,0.17559648509093
22114,1904.0429,1904.092733,1,57121287,57122781,1494,0.24618057204021823
22115,1905.280667,1905.415133,1,57158420,57162453,4033,0.11663622390088789
22116,1905.416133,1905.604133,1,57162483,57168123,5640,0.25494274064287853
22117,1905.624167,1905.658967,1,57168725,57169769,1044,0.25461204099682994
22118,1905.660067,1905.664533,1,57169802,57169935,133,0.8745376382515795
22119,1905.691233,1905.734167,1,57170736,57172025,1289,0.1693999995060095
22120,1905.7452,1905.7991,1,57172356,57173973,1617,0.17947050597812955
22121,1905.837333,1905.868133,1,57175119,57176043,924,0.34274019238988257
22122,1905.876467,1905.881967,1,57176294,57176459,165,0.9393197575308361
22123,1905.931833,1905.9416,1,57177954,57178248,294,0.6686213809856341
22124,1906.431167,1906.4357,1,57192935,57193071,136,0.35023986146533825
22125,1906.5759,1906.580833,1,57197277,57197424,147,0.6361783801213606
22126,1906.584933,1906.657067,1,57197547,57199712,2165,0.12300434514009517
22127,1906.659733,1906.663833,1,57199791,57199914,123,0.6921723914970267
22128,1906.6682,1906.700733,1,57200046,57201021,975,0.22007121317576597
22129,1906.7039,1906.706933,1,57201117,57201207,90,0.46014698917798297
22130,1906.711733,1906.759233,1,57201351,57202776,1425,0.2845832171209254
22131,1906.7809,1906.895167,1,57203427,57206855,3428,0.08435406313321314
22132,1906.915933,1906.942867,1,57207477,57208286,809,0.14728986152156917
22133,1906.949167,1906.954233,1,57208475,57208626,151,0.6305254053209974
22134,1906.9603,1906.970333,1,57208809,57209109,300,0.6240056729574429
22135,1906.9744,1906.981933,1,57209232,57209457,225,0.3649574983114732
22136,1908.807567,1908.812533,1,57264227,57264375,148,0.7805417799433131
22137,1908.815933,1908.8258,1,57264477,57264774,297,0.5525161511063298
22138,1908.827333,1908.9532,1,57264819,57268596,3777,0.2558833078385561
22139,1908.956133,1909.024633,1,57268683,57270738,2055,0.09650908346586484
22140,1909.029967,1909.108333,1,57270899,57273249,2350,0.20803147881499592
22141,1909.109767,1909.113433,1,57273293,57273402,109,0.8761811520132807
22142,1909.114433,1909.119133,1,57273432,57273573,141,0.8467153434528126
22143,1909.321167,1909.327867,1,57279635,57279836,201,0.7722378516279413
22144,1909.329167,1909.332733,1,57279875,57279981,106,0.6632646370647702
22145,1909.335167,1909.3385,1,57280055,57280155,100,0.6341328670106969
22146,1909.3718,1909.396,1,57281154,57281880,726,0.3442190415886001
22147,1909.3975,1909.401,1,57281925,57282030,105,0.898934815606602
22148,1909.4545,1909.4578,1,57283635,57283734,99,0.6029887968851438
22149,1909.477333,1909.487533,1,57284319,57284625,306,0.7372292754549701
22150,1909.520033,1909.526567,1,57285600,57285797,197,0.8803765328430596
22151,1909.570567,1909.575333,1,57287117,57287259,142,0.8591529740534857
22152,1909.9906,1910.0283,1,57299718,57300849,1131,0.15057931518486936
22153,1910.0363,1910.047033,1,57301089,57301410,321,0.34386310489687266
22154,1910.062433,1910.176733,1,57301872,57305301,3429,0.1257357552934535
22155,1910.186067,1910.2003,1,57305582,57306009,427,0.6100584170296625
22156,1910.2048,1910.217967,1,57306144,57306539,395,0.8584455298303875
22157,1910.220233,1910.2504,1,57306606,57307512,906,0.2946954402076397
22158,1910.2515,1910.265767,1,57307545,57307973,428,0.21436370295262272
22159,1910.279667,1910.3226,1,57308390,57309678,1288,0.5299563653821292
22160,1910.324833,1910.328767,1,57309744,57309863,119,0.7936104345280591
22161,1910.333133,1910.3762,1,57309993,57311286,1293,0.3449233404626188
22162,1910.395,1910.3987,1,57311850,57311961,111,0.8123124981910167
22163,1910.412167,1910.4215,1,57312365,57312645,280,0.34500917041560125
22164,1910.458,1910.483833,1,57313740,57314514,774,0.5737224260623875
22165,1910.548167,1910.5904,1,57316445,57317712,1267,0.44175691014932017
22166,1910.595167,1910.618533,1,57317855,57318555,700,0.31490515086366416
22167,1910.625433,1910.6394,1,57318762,57319182,420,0.38870087842505663
22168,1910.670433,1910.751967,1,57320112,57322559,2447,0.24984378147630393
22169,1910.753067,1910.764133,1,57322592,57322923,331,0.299248732109285
22170,1910.765633,1910.7833,1,57322968,57323499,531,0.353889352450059
22171,1910.8024,1910.850333,1,57324072,57325509,1437,0.2339885134941703
22172,1910.862367,1910.952467,1,57325871,57328574,2703,0.19628887208158285
22173,1910.9562,1910.997367,1,57328686,57329921,1235,0.2026232573889054
22174,1910.9992,1911.070833,1,57329976,57332124,2148,0.18666082173432424
22175,1911.0974,1911.1011,1,57332922,57333033,111,0.8533078178251681
22176,1911.103367,1911.1128,1,57333101,57333384,283,0.6510527135785734
22177,1911.114067,1911.1191,1,57333422,57333573,151,0.6682935561209423
22178,1911.120367,1911.134267,1,57333611,57334028,417,0.6564151902507422
22179,1911.173133,1911.182933,1,57335193,57335487,294,0.7197774743906691
22180,1911.184433,1911.198367,1,57335532,57335951,419,0.704752047027881
22181,1911.4674,1911.4742,1,57344022,57344226,204,0.785688862029518
22182,1911.499367,1911.5153,1,57344981,57345459,478,0.154064899835608
22183,1911.516467,1911.519633,1,57345494,57345588,94,0.8777575094331291
22184,1911.550367,1911.635533,1,57346511,57349065,2554,0.14269611197234125
22185,1911.641867,1911.6478,1,57349256,57349434,178,0.7393634884448061
22186,1911.649433,1911.655533,1,57349482,57349665,183,0.6447982105984172
22187,1911.657933,1911.7549,1,57349737,57352647,2910,0.2117141067644391
22188,1911.7742,1911.8555,1,57353226,57355665,2439,0.14980867739636888
22189,1911.861667,1911.8842,1,57355850,57356526,676,0.09048204046550455
22190,1911.885267,1911.903367,1,57356558,57357101,543,0.45172280533094405
22191,1911.9057,1911.915733,1,57357171,57357471,300,0.5262680528440865
22192,1911.918567,1911.9623,1,57357557,57358869,1312,0.2785022955778103
22193,1911.989967,1912.0011,1,57359699,57360033,334,0.4922575159831161
22194,1912.842167,1912.925367,1,57385265,57387761,2496,0.12562296659320654
22195,1912.927,1912.942167,1,57387810,57388265,455,0.1102235868706632
22196,1912.9436,1912.9633,1,57388308,57388899,591,0.10506828032591647
22197,1912.964533,1913.018267,1,57388935,57390548,1613,0.1770074438343575
22198,1913.0303,1913.154033,1,57390909,57394620,3711,0.08968278103679732
22199,1913.202733,1913.223167,1,57396081,57396695,614,0.6003768211216073
22200,1913.3239,1913.3587,1,57399717,57400761,1044,0.3731480951839351
22201,1913.379967,1913.408933,1,57401399,57402267,868,0.4062164575963362
22202,1913.898667,1913.902267,1,57416960,57417068,108,0.8108093831329996
22203,1913.908633,1914.2949,1,57417258,57428847,11589,0.07056520150227019
22204,1914.364133,1914.3705,1,57430923,57431115,192,0.8242502944913748
22205,1914.402267,1914.406067,1,57432068,57432182,114,0.7027818953111415
22206,1914.430833,1914.4376,1,57432924,57433128,204,0.7440286253835899
22207,1914.825367,1914.915967,1,57444761,57447479,2718,0.26203736921025245
22208,1914.919767,1914.9393,1,57447593,57448179,586,0.34818544225676956
22209,1914.9424,1914.977167,1,57448272,57449315,1043,0.04753706072022941
22210,1914.985067,1915.0058,1,57449552,57450174,622,0.16214987676285855
22211,1915.007167,1915.084967,1,57450215,57452549,2334,0.21515976545056115
22212,1915.0945,1915.111833,1,57452835,57453354,519,0.5551672775113528
22213,1915.1129,1915.120833,1,57453387,57453624,237,0.5125741230726018
22214,1915.123033,1915.141567,1,57453690,57454247,557,0.8668110090841284
22215,1915.1461,1915.1798,1,57454383,57455394,1011,0.3297407054714489
22216,1915.243467,1915.2564,1,57457304,57457692,388,0.4842019807577029
22217,1915.259733,1915.2658,1,57457791,57457974,183,0.7256073301335929
22218,1915.296067,1915.308967,1,57458882,57459269,387,0.7866601801931443
22219,1915.358767,1915.3719,1,57460763,57461157,394,0.09364180262185996
22220,1915.402467,1915.439633,1,57462074,57463188,1114,0.3108895944231546
22221,1915.440767,1915.456367,1,57463223,57463691,468,0.3256985363940539
22222,1915.467667,1915.479733,1,57464030,57464391,361,0.3380971331182645
22223,1915.494967,1915.589233,1,57464849,57467676,2827,0.04162915440779572
22224,1915.5952,1915.610933,1,57467856,57468327,471,0.36004355943554606
22225,1915.6223,1915.6253,1,57468669,57468759,90,0.8695551665207631
22226,1915.640733,1915.659433,1,57469221,57469782,561,0.2648990814379784
22227,1915.668133,1915.691833,1,57470043,57470754,711,0.12843087418342822
22228,1915.693133,1915.700733,1,57470793,57471021,228,0.4167445444310559
22229,1915.703933,1915.737433,1,57471117,57472122,1005,0.012426813768688589
22230,1915.882567,1915.8892,1,57476477,57476676,199,0.31498169724578573
22231,1915.9228,1915.9299,1,57477684,57477897,213,-0.0259560839613692
22232,1915.931433,1916.015733,1,57477942,57480471,2529,0.10584883153815658
22233,1916.019733,1916.034733,1,57480591,57481041,450,0.08920742065203902
22234,1916.072333,1916.082433,1,57482169,57482472,303,0.46421777646994256
22235,1916.0868,1916.141033,1,57482604,57484230,1626,0.12891581061709953
22236,1916.145533,1916.160667,1,57484365,57484820,455,0.21767687534016456
22237,1916.166033,1916.172933,1,57484980,57485187,207,0.8108121719612602
22238,1916.1922,1916.2628,1,57485766,57487884,2118,0.10044153873233003
22239,1916.317167,1916.324367,1,57489515,57489731,216,0.46032729337844003
22240,1916.8829,1916.889333,1,57506487,57506679,192,0.395752233993833
22241,1916.890533,1916.925833,1,57506715,57507774,1059,0.12108682146472287
22242,1916.939,1916.959033,1,57508170,57508770,600,0.22912345915091975
22243,1916.9753,1917.004767,1,57509259,57510143,884,0.15890556546642812
22244,1917.020367,1917.114267,1,57510611,57513428,2817,0.20149101698041263
22245,1917.136533,1917.144733,1,57514095,57514341,246,0.16904237859135754
22246,1917.148467,1917.160267,1,57514454,57514808,354,0.4031708662300379
22247,1917.163,1917.1795,1,57514890,57515385,495,0.25286729007780656
22248,1917.180767,1917.185033,1,57515423,57515550,127,0.852145030395079
22249,1917.203033,1917.223333,1,57516090,57516699,609,0.49042155686751404
22250,1917.920467,1917.934567,1,57537614,57538037,423,-0.1048785157748625
22251,1917.944667,1918.029467,1,57538340,57540884,2544,0.1790042203323686
22252,1918.0315,1918.0875,1,57540945,57542625,1680,0.1370785826240097
22253,1918.0919,1918.095233,1,57542757,57542856,99,0.3296039763019227
22254,1918.101567,1918.179533,1,57543047,57545385,2338,0.06337980973777482
22255,1918.192933,1918.2093,1,57545787,57546279,492,0.2666514722745608
22256,1918.226233,1918.2419,1,57546786,57547257,471,0.24613130467858588
22257,1918.268633,1918.296767,1,57548058,57548903,845,0.05110080880558152
22258,1918.300133,1918.304267,1,57549003,57549128,125,0.47555572758233555
22259,1918.317533,1918.346,1,57549525,57550380,855,0.18572363956286458
22260,1918.3557,1918.3923,1,57550671,57551769,1098,0.21683181361419473
22261,1918.433467,1918.4593,1,57553004,57553779,775,0.40738755070367866
22262,1918.469033,1918.495567,1,57554070,57554867,797,0.40637959841865146
22263,1918.515233,1918.531433,1,57555456,57555942,486,0.520949253034944
22264,1918.541633,1918.545,1,57556248,57556350,102,0.9305262803007022
22265,1918.546833,1918.5729,1,57556404,57557187,783,0.6597352791472088
22266,1918.574,1918.583667,1,57557220,57557510,290,0.8789123156481942
22267,1918.5925,1918.5955,1,57557775,57557865,90,0.825662411427948
22268,1918.604567,1918.6229,1,57558137,57558687,550,0.42568869445905044
22269,1919.197567,1919.202667,1,57575927,57576080,153,0.5993379157801891
22270,1919.204133,1919.272533,1,57576123,57578175,2052,0.2508277815766381
22271,1919.3186,1919.323567,1,57579558,57579707,149,0.8590102101027514
22272,1920.439867,1920.5429,1,57613196,57616287,3091,0.11767184994878586
22273,1920.544033,1920.6012,1,57616320,57618036,1716,0.16303713144914916
22274,1920.6024,1920.6085,1,57618072,57618255,183,0.8704884176446602
22275,1920.618933,1920.694067,1,57618567,57620822,2255,0.10654868589576218
22276,1920.703933,1920.782433,1,57621117,57623472,2355,0.10449300341581298
22277,1920.8003,1920.8346,1,57624009,57625038,1029,0.12800864761465042
22278,1920.8445,1920.858467,1,57625335,57625754,419,0.17900837083989915
22279,1920.8596,1920.868667,1,57625788,57626060,272,0.4998887842865408
22280,1920.871967,1920.883033,1,57626159,57626490,331,0.8736185305395807
22281,1920.907233,1920.9116,1,57627216,57627348,132,0.3753388147985726
22282,1920.912633,1920.9162,1,57627378,57627486,108,0.7565000277197484
22283,1921.343667,1921.3822,1,57640310,57641466,1156,0.11768164672163992
22284,1921.387467,1921.3991,1,57641624,57641973,349,0.2673362052188302
22285,1921.428467,1921.5011,1,57642854,57645033,2179,0.13688450959721518
22286,1921.5066,1921.5732,1,57645198,57647196,1998,0.10502257890138192
22287,1921.586033,1921.6091,1,57647580,57648273,693,0.11303536105176296
22288,1921.617633,1921.655867,1,57648528,57649676,1148,0.10500148101871623
22289,1921.663967,1921.671467,1,57649919,57650144,225,0.5742477033595718
22290,1921.677667,1921.748033,1,57650330,57652440,2110,0.20929542117932104
22291,1921.749433,1921.753733,1,57652482,57652611,129,0.87246801211666
22292,1921.7653,1921.7935,1,57652959,57653805,846,0.20559767018379385
22293,1921.797567,1921.822,1,57653927,57654660,733,0.29571627897757824
22294,1921.829167,1921.838233,1,57654875,57655146,271,0.34868401534326116
22295,1921.8646,1921.868267,1,57655938,57656048,110,0.6098175134720193
22296,1922.158033,1922.191333,1,57664740,57665739,999,0.23540179744296139
22297,1922.193167,1922.3285,1,57665795,57669855,4060,0.30907683994281393
22298,1922.3322,1922.335333,1,57669966,57670059,93,0.8072111671803038
22299,1922.338567,1922.346267,1,57670157,57670388,231,0.5679040106063712
22300,1922.3525,1922.4477,1,57670575,57673431,2856,0.3499548516588832
22301,1922.482367,1922.489367,1,57674471,57674681,210,0.5890649296542014
22302,1922.4912,1922.523567,1,57674736,57675707,971,0.5549964884328263
22303,1922.535667,1922.539167,1,57676070,57676175,105,0.7510827317200993
22304,1922.550733,1922.5545,1,57676521,57676635,114,0.8564198458450624
22305,1922.5619,1922.567133,1,57676857,57677013,156,0.6581309955773056
22306,1922.5741,1922.578233,1,57677223,57677346,123,0.8160181867866935
22307,1922.691567,1922.702867,1,57680747,57681086,339,0.22750783064422936
22308,1922.738,1922.745167,1,57682140,57682355,215,0.8391564230493229
22309,1922.746567,1922.749867,1,57682397,57682496,99,0.9113230969706126
22310,1922.786,1922.7958,1,57683580,57683874,294,0.8278978082886197
22311,1922.856267,1922.883567,1,57685688,57686507,819,-0.0234811865381427
22312,1922.897633,1922.913567,1,57686928,57687407,479,0.4217057623773686
22313,1922.932933,1923.018833,1,57687987,57690564,2577,0.014081195141400162
22314,1923.133533,1923.1397,1,57694005,57694191,186,0.7804737401571495
22315,1923.8273,1923.831767,1,57714819,57714953,134,0.7544863130362248
22316,1923.833033,1923.990733,1,57714990,57719721,4731,0.10768786225996414
22317,1924.0037,1924.140033,1,57720111,57724200,4089,0.16419659133587688
22318,1924.148167,1924.161467,1,57724445,57724844,399,0.5509594930891843
22319,1924.194433,1924.197833,1,57725832,57725934,102,0.16193999661569342
22320,1924.577833,1924.665867,1,57737334,57739976,2642,0.12174834669945085
22321,1924.6688,1924.686433,1,57740064,57740592,528,0.2421040993651099
22322,1924.688967,1924.7562,1,57740669,57742686,2017,0.045614261694147396
22323,1924.762467,1924.7969,1,57742874,57743907,1033,0.2559101534750926
22324,1924.802167,1924.876767,1,57744065,57746303,2238,0.18059993799271645
22325,1924.878167,1924.893267,1,57746345,57746798,453,0.26196042304995554
22326,1924.897833,1924.9087,1,57746934,57747261,327,0.0768872979630209
22327,1924.9188,1924.944,1,57747564,57748320,756,0.07918733391989824
22328,1924.9453,1924.948533,1,57748359,57748455,96,0.7858304548180884
22329,1924.965767,1925.022633,1,57748973,57750678,1705,0.2760709140770198
22330,1925.492967,1925.498967,1,57764789,57764969,180,0.5370607747577374
22331,1925.507933,1925.515133,1,57765237,57765453,216,0.19571219302364454
22332,1925.9141,1926.022167,1,57777423,57780665,3242,0.15742031746186172
22333,1926.0234,1926.097267,1,57780702,57782918,2216,0.12386151487089753
22334,1926.1065,1926.2786,1,57783195,57788358,5163,0.012766669245125113
22335,1926.2854,1926.307067,1,57788562,57789212,650,0.25856832471404534
22336,1926.3095,1926.368167,1,57789285,57791045,1760,-0.008438023671991335
22337,1926.459,1926.4655,1,57793770,57793965,195,0.5107100734311034
22338,1926.501533,1926.515,1,57795045,57795450,405,0.34181783161755874
22339,1926.5211,1926.5867,1,57795633,57797601,1968,0.18240387401204552
22340,1926.610567,1926.620667,1,57798317,57798620,303,0.44173918966868875
22341,1926.6248,1926.6729,1,57798744,57800187,1443,0.07025084997100597
22342,1926.694333,1926.8538,1,57800829,57805614,4785,0.09953556516175106
22343,1926.855533,1926.895667,1,57805665,57806870,1205,0.0879337281324511
22344,1926.9035,1926.958867,1,57807105,57808766,1661,0.07388240730194337
22345,1926.9675,1926.9834,1,57809025,57809502,477,0.10834963860856461
22346,1926.9916,1927.016233,1,57809748,57810486,738,0.0709212431404979
22347,1927.029633,1927.0668,1,57810888,57812004,1116,0.16469489914879593
22348,1927.1039,1927.143233,1,57813117,57814296,1179,0.07834032287348049
22349,1927.155567,1927.190567,1,57814667,57815717,1050,0.3278612157294177
22350,1927.200567,1927.2037,1,57816017,57816111,94,0.4637204956065799
22351,1927.2697,1927.3348,1,57818091,57820044,1953,0.2128976809224728
22352,1927.339467,1927.344,1,57820184,57820320,136,0.6581942377223388
22353,1927.348967,1927.363067,1,57820469,57820892,423,0.16877673912439872
22354,1927.365067,1927.463967,1,57820952,57823919,2967,0.09772335123388104
22355,1927.467933,1927.545233,1,57824037,57826356,2319,0.2992734896317911
22356,1927.550433,1927.5539,1,57826512,57826617,105,0.822352710508594
22357,1927.561933,1927.569633,1,57826857,57827088,231,0.8053712397080444
22358,1927.6291,1927.632667,1,57828873,57828980,107,0.8121509014914369
22359,1928.311267,1928.407733,1,57849338,57852231,2893,0.06501810076090038
22360,1928.409067,1928.415367,1,57852272,57852461,189,0.7081731609425709
22361,1928.420233,1928.439133,1,57852606,57853173,567,0.2595021599702431
22362,1928.440767,1928.477867,1,57853223,57854336,1113,0.18510699056941654
22363,1928.4828,1928.4927,1,57854484,57854781,297,0.18410868987082102
22364,1928.5,1928.507467,1,57855000,57855224,224,0.645490218708609
22365,1928.5183,1928.613333,1,57855549,57858399,2850,0.1812654984491488
22366,1928.6497,1928.653933,1,57859491,57859617,126,0.7742990615755208
22367,1928.670067,1928.686933,1,57860102,57860607,505,0.714830476703788
22368,1929.124733,1929.201033,1,57873741,57876030,2289,0.12368096704795593
22369,1929.204233,1929.239733,1,57876126,57877191,1065,0.2605111412583767
22370,1929.247067,1929.353067,1,57877412,57880592,3180,0.1402755403891247
22371,1929.366433,1929.394567,1,57880992,57881837,845,0.1971348481430498
22372,1929.4121,1929.435267,1,57882363,57883058,695,-0.05858129163148604
22373,1929.4365,1929.462733,1,57883095,57883881,786,0.12037605593818375
22374,1929.482433,1929.549967,1,57884472,57886499,2027,0.18706967194090593
22375,1929.575167,1929.599667,1,57887255,57887990,735,0.09805532782114731
22376,1929.641833,1929.658867,1,57889254,57889766,512,0.06455613846577835
22377,1929.6628,1929.680233,1,57889884,57890406,522,0.4584084204576245
22378,1929.681333,1929.692067,1,57890439,57890762,323,0.6911426819212434
22379,1930.415,1930.4239,1,57912450,57912717,267,0.5466467206317268
22380,1930.433667,1930.4979,1,57913010,57914937,1927,0.08734040971356011
22381,1930.508467,1930.531333,1,57915254,57915939,685,0.22078933698520964
22382,1930.543567,1930.5586,1,57916307,57916758,451,0.18425049212642072
22383,1930.559733,1930.6655,1,57916791,57919965,3174,0.11941442771908857
22384,1930.6668,1930.669867,1,57920004,57920096,92,0.7661334391593813
22385,1930.707367,1930.786833,1,57921221,57923604,2383,0.25797770870395587
22386,1930.8076,1930.811733,1,57924228,57924351,123,0.7224756703600187
22387,1930.871967,1930.8764,1,57926159,57926292,133,0.6198906645470644
22388,1930.880467,1930.884833,1,57926414,57926544,130,0.38326962072974086
22389,1930.916867,1930.922567,1,57927506,57927677,171,0.4892611206812116
22390,1930.923633,1930.930733,1,57927708,57927921,213,0.5565662814053378
22391,1930.932467,1930.949433,1,57927974,57928482,508,0.5397030006832775
22392,1931.2091,1931.367433,1,57936273,57941022,4749,-0.11981364617730288
22393,1931.3695,1931.505967,1,57941085,57945179,4094,0.09285854753522882
22394,1931.5288,1931.5499,1,57945864,57946497,633,0.17729320471893756
22395,1931.5693,1931.600833,1,57947079,57948024,945,0.13278647987323258
22396,1931.606667,1931.647933,1,57948200,57949437,1237,0.2645119112914834
22397,1931.688767,1931.692433,1,57950663,57950772,109,0.8055903709618312
22398,1931.698833,1931.703133,1,57950964,57951093,129,0.8777900472937048
22399,1931.7271,1931.743533,1,57951813,57952305,492,0.4005163460484804
22400,1931.854467,1931.857567,1,57955634,57955727,93,0.5935408896366775
22401,1931.9771,1931.984633,1,57959313,57959538,225,0.4594977975781808
22402,1931.9894,1932.052633,1,57959682,57961578,1896,0.38631306231274093
22403,1932.058233,1932.062433,1,57961746,57961872,126,0.8331488345746587
22404,1932.1992,1932.205333,1,57965976,57966159,183,0.8549615048065676
22405,1932.344267,1932.356167,1,57970328,57970685,357,0.6443252365526888
22406,1932.399867,1932.411867,1,57971996,57972356,360,0.7100471713725867
22407,1932.476967,1932.4805,1,57974309,57974415,106,-0.07214445492840846
22408,1932.482533,1932.486533,1,57974475,57974595,120,0.1434272143959121
22409,1932.4889,1932.4939,1,57974667,57974817,150,0.513803586576858
22410,1932.496767,1932.501967,1,57974903,57975059,156,0.023463603054143693
22411,1932.5039,1932.577533,1,57975117,57977325,2208,0.2417338372322543
22412,1932.5835,1932.5875,1,57977505,57977625,120,0.26371566958283016
22413,1932.601533,1932.605267,1,57978045,57978158,113,0.02594797401349573
22414,1932.6552,1932.659833,1,57979656,57979794,138,0.8118408494080935
22415,1932.667133,1932.672467,1,57980013,57980174,161,0.8249355398968464
22416,1932.6752,1932.6814,1,57980256,57980442,186,0.6314872978010793
22417,1932.6828,1932.691833,1,57980484,57980754,270,0.7669653759057881
22418,1932.699767,1932.707467,1,57980993,57981224,231,0.620269278365736
22419,1932.7256,1932.7429,1,57981768,57982287,519,0.5326031621924561
22420,1933.160433,1933.2397,1,57994812,57997191,2379,0.06563442857118032
22421,1933.242967,1933.260067,1,57997289,57997802,513,0.3096215823978414
22422,1933.2615,1933.282467,1,57997845,57998474,629,0.2515023613072831
22423,1933.287667,1933.316633,1,57998630,57999498,868,0.1754102039210978
22424,1933.321967,1933.3461,1,57999659,58000383,724,0.11367643596526628
22425,1933.3684,1933.3722,1,58001052,58001166,114,0.8539266944846974
22426,1933.375367,1933.444333,1,58001261,58003329,2068,0.06534756039931947
22427,1933.47,1933.474933,1,58004100,58004247,147,0.848699586426547
22428,1934.1001,1934.3177,1,58023003,58029531,6528,0.7626882756698724
22429,1934.468067,1934.6345,1,58034042,58039035,4993,0.7726270740236881
22430,1934.640333,1934.6506,1,58039209,58039518,309,0.4185147665361051
22431,1934.676833,1934.691267,1,58040304,58040738,434,0.41826789594150704
22432,1935.086433,1935.1345,1,58052592,58054035,1443,0.003150613980254689
22433,1935.149833,1935.195133,1,58054494,58055853,1359,0.334686126221289
22434,1935.1972,1935.225567,1,58055916,58056767,851,0.6104560899750823
22435,1935.227133,1935.230233,1,58056813,58056906,93,0.6035298470770795
22436,1935.242767,1935.3027,1,58057283,58059081,1798,0.5668175371565392
22437,1936.384033,1936.4733,1,58091520,58094199,2679,-0.003615831218763994
22438,1936.478733,1936.530767,1,58094361,58095923,1562,0.05339003678859169
22439,1936.536933,1936.6772,1,58096107,58100316,4209,0.09961533069847522
22440,1936.680167,1936.688,1,58100405,58100640,235,0.782189552815027
22441,1936.689933,1936.718533,1,58100697,58101555,858,0.1411777631024822
22442,1936.722267,1936.752933,1,58101668,58102587,919,0.08281349765759301
22443,1936.753967,1936.767633,1,58102619,58103028,409,0.24968965822964334
22444,1936.7773,1936.831333,1,58103319,58104939,1620,0.34484223012393017
22445,1936.871467,1936.876,1,58106144,58106280,136,0.6068072142557285
22446,1936.924833,1936.935933,1,58107744,58108077,333,-0.12161254057821429
22447,1936.958433,1936.968333,1,58108752,58109049,297,0.39864253379426934
22448,1936.969467,1936.972867,1,58109084,58109186,102,0.8286136535324261
22449,1936.992,1936.995233,1,58109760,58109856,96,-0.05258956074809896
22450,1937.736833,1937.7412,1,58132104,58132236,132,0.6154744488669442
22451,1937.747533,1937.917533,1,58132425,58137525,5100,0.5530110686696047
22452,1937.982167,1937.985267,1,58139465,58139558,93,0.7065812031020048
22453,1937.9867,1937.998167,1,58139601,58139945,344,0.4241217366841467
22454,1938.0007,1938.007067,1,58140021,58140212,191,0.6739174762800272
22455,1938.018567,1938.0414,1,58140557,58141242,685,0.6764396975904535
22456,1938.045033,1938.0633,1,58141350,58141899,549,0.6696235926416478
22457,1938.065233,1938.0932,1,58141956,58142796,840,0.7921541867663772
22458,1938.160767,1938.164067,1,58144823,58144922,99,0.23909879272598786
22459,1938.193067,1938.2431,1,58145792,58147293,1501,0.45386908205692506
22460,1938.2457,1938.284033,1,58147371,58148520,1149,0.2700894602313688
22461,1938.291967,1938.302333,1,58148759,58149069,310,0.13545242091030757
22462,1938.304167,1938.322867,1,58149125,58149686,561,0.7543967337714825
22463,1938.3321,1938.3423,1,58149963,58150269,306,0.8306565519052475
22464,1938.345067,1938.359133,1,58150352,58150773,421,0.66623722010807
22465,1938.361467,1938.403833,1,58150844,58152114,1270,0.19718890703476202
22466,1938.413767,1938.421667,1,58152413,58152650,237,-0.06056779442071549
22467,1938.447033,1938.4852,1,58153410,58154556,1146,0.6335050357913462
22468,1938.4865,1938.5857,1,58154595,58157571,2976,0.6885991690120778
22469,1938.5872,1938.594233,1,58157616,58157826,210,0.6911169011799395
22470,1938.625567,1938.6298,1,58158767,58158894,127,0.2509175452803383
22471,1938.633,1938.668567,1,58158990,58160057,1067,0.46088164641826374
22472,1938.678833,1938.687867,1,58160364,58160636,272,-0.1005897809531524
22473,1938.697867,1938.703433,1,58160936,58161102,166,0.8534598982605066
22474,1938.705067,1938.736567,1,58161152,58162097,945,0.5882050196214765
22475,1938.742967,1938.769433,1,58162289,58163082,793,0.19904303443052823
22476,1938.7887,1938.7931,1,58163661,58163793,132,0.273354037445281
22477,1938.799633,1938.8099,1,58163988,58164297,309,0.3211921180874644
22478,1938.8204,1938.829867,1,58164612,58164896,284,0.15538780044212946
22479,1938.836367,1938.858767,1,58165091,58165763,672,0.6009277405937261
22480,1938.859967,1938.891967,1,58165799,58166759,960,0.7000121641283996
22481,1938.893,1938.905033,1,58166790,58167150,360,0.8268152873020453
22482,1938.917033,1938.9221,1,58167510,58167663,153,0.5995836496855149
22483,1938.9366,1938.9471,1,58168098,58168413,315,0.7405050037816006
22484,1938.950467,1938.954733,1,58168514,58168641,127,0.7865972410561642
22485,1938.957967,1939.001967,1,58168739,58170059,1320,0.02973513197122702
22486,1939.003267,1939.014167,1,58170098,58170425,327,0.011392975594116075
22487,1939.0166,1939.064433,1,58170498,58171932,1434,0.5972969883160475
22488,1939.066233,1939.124533,1,58171986,58173735,1749,0.17910144356953925
22489,1939.132467,1939.139467,1,58173974,58174184,210,0.45882221378762805
22490,1939.1407,1939.1477,1,58174221,58174431,210,0.45631719475966304
22491,1939.1558,1939.160067,1,58174674,58174802,128,0.774561422878014
22492,1939.161967,1939.1688,1,58174859,58175064,205,0.7625831136373344
22493,1939.179067,1939.2036,1,58175372,58176108,736,0.7581070420828583
22494,1939.206233,1939.281867,1,58176186,58178456,2270,0.6551261170593139
22495,1939.284967,1939.301,1,58178549,58179030,481,0.6123005674099816
22496,1939.404733,1939.416,1,58182141,58182480,339,0.2683325742385157
22497,1939.4256,1939.432633,1,58182768,58182978,210,0.7739004608271793
22498,1939.448733,1939.4628,1,58183461,58183884,423,0.7123456878698697
22499,1939.469067,1939.477067,1,58184072,58184312,240,0.4728358453500294
22500,1939.483467,1939.4961,1,58184504,58184883,379,0.14259227227140156
22501,1939.502533,1939.5845,1,58185075,58187535,2460,0.01546068523116894
22502,1939.585633,1939.633467,1,58187568,58189004,1436,0.021560389919219762
22503,1939.639133,1939.657033,1,58189173,58189710,537,0.06435699606009074
22504,1939.6702,1939.695267,1,58190106,58190858,752,0.20376092436896664
22505,1939.703033,1939.733733,1,58191090,58192011,921,0.14585830407098205
22506,1939.794133,1939.874533,1,58193823,58196235,2412,0.6523630880951714
22507,1939.967867,1940.0799,1,58199036,58202397,3361,0.5952872989340258
22508,1940.085833,1940.294333,1,58202574,58208829,6255,0.655123220500959
22509,1940.482867,1940.4884,1,58214486,58214652,166,0.7254080000419608
22510,1940.494367,1940.497567,1,58214831,58214927,96,0.6007376971606792
22511,1940.502533,1940.507567,1,58215075,58215227,152,0.6310890685711203
22512,1940.510133,1940.600267,1,58215303,58218008,2705,0.6188659272911909
22513,1940.7491,1940.762533,1,58222473,58222875,402,0.5384060756665199
22514,1940.8112,1940.818867,1,58224336,58224566,230,0.6427427911406501
22515,1940.8219,1940.8269,1,58224657,58224807,150,0.730678473807435
22516,1940.8374,1940.8522,1,58225122,58225566,444,0.7207024905764191
22517,1940.864867,1940.875833,1,58225946,58226274,328,0.31935050206234833
22518,1940.8769,1940.896167,1,58226307,58226885,578,0.6490077476348067
22519,1940.912533,1940.917967,1,58227375,58227539,164,0.8609675699705612
22520,1940.9232,1940.971,1,58227696,58229130,1434,0.2044155674302132
22521,1940.976467,1940.994433,1,58229294,58229832,538,0.6172963109334436
22522,1940.9955,1941.020033,1,58229865,58230600,735,0.5672259982167082
22523,1941.021233,1941.150033,1,58230636,58234500,3864,0.6706661184299973
22524,1941.157333,1941.189833,1,58234719,58235694,975,0.7692315010811309
22525,1941.194667,1941.203267,1,58235840,58236098,258,0.48048846234902204
22526,1941.205133,1941.2952,1,58236153,58238856,2703,0.7339606397794622
22527,1941.303533,1941.3186,1,58239105,58239558,453,0.7620285473644592
22528,1941.334867,1941.358033,1,58240046,58240740,694,0.3531035719127401
22529,1941.369533,1941.4024,1,58241085,58242072,987,0.47051735763832936
22530,1941.406567,1941.412,1,58242197,58242360,163,0.7441662916850356
22531,1941.420367,1941.4241,1,58242611,58242723,112,0.7828882863466907
22532,1941.4405,1941.459667,1,58243215,58243790,575,0.20577745760298097
22533,1941.4843,1941.511433,1,58244529,58245342,813,0.46899746838890066
22534,1941.517467,1941.702067,1,58245524,58251062,5538,0.6961562372825
22535,1942.0161,1942.025833,1,58260483,58260774,291,0.1562168292685237
22536,1942.1005,1942.150267,1,58263015,58264508,1493,0.6401660439510904
22537,1942.158767,1942.170967,1,58264763,58265129,366,0.5376098498056995
22538,1942.183133,1942.221533,1,58265493,58266645,1152,0.5374601905363903
22539,1942.222533,1942.258233,1,58266675,58267746,1071,0.5926294984677494
22540,1942.267333,1942.2712,1,58268019,58268136,117,0.9019734428892057
22541,1942.3085,1942.3342,1,58269255,58270026,771,0.5895655876815681
22542,1942.369033,1942.409933,1,58271070,58272297,1227,0.5539052474270035
22543,1942.4149,1942.427567,1,58272447,58272827,380,0.5292707133147646
22544,1942.446767,1942.4783,1,58273403,58274349,946,0.513864706665508
22545,1942.4986,1942.5032,1,58274958,58275096,138,0.6273527505702913
22546,1942.581,1942.606333,1,58277430,58278189,759,0.6671452548782363
22547,1942.6106,1942.731467,1,58278318,58281944,3626,0.6581229364937119
22548,1942.795433,1942.8017,1,58283862,58284051,189,0.7320052102474514
22549,1942.8495,1942.8555,1,58285485,58285665,180,0.914461815895555
22550,1943.134,1943.137867,1,58294020,58294136,116,0.658295315140326
22551,1943.1423,1943.2314,1,58294269,58296942,2673,0.721866330905412
22552,1943.3375,1943.404067,1,58300125,58302122,1997,0.6535734705902927
22553,1943.4091,1943.74,1,58302273,58312200,9927,0.6959595127507265
22554,1943.7711,1943.787733,1,58313133,58313631,498,0.35680089663578646
22555,1943.8299,1943.848567,1,58314897,58315457,560,0.23366877820490484
22556,1943.884033,1943.925133,1,58316520,58317753,1233,0.6896665232033639
22557,1943.9338,1944.0459,1,58318014,58321377,3363,0.7256963565437168
22558,1944.082533,1944.1043,1,58322475,58323129,654,0.06251086714097892
22559,1944.1532,1944.251067,1,58324596,58327532,2936,0.19075494635260345
22560,1944.2581,1944.270967,1,58327743,58328129,386,0.01431496455747121
22561,1944.319733,1944.334033,1,58329591,58330020,429,0.16102203318378774
22562,1944.335967,1944.3629,1,58330079,58330887,808,0.6793080126759677
22563,1944.413067,1944.432033,1,58332392,58332960,568,0.4393372208299884
22564,1944.4433,1944.446533,1,58333299,58333395,96,0.512742915834008
22565,1944.492967,1944.509533,1,58334789,58335285,496,0.5314858073386037
22566,1944.511233,1944.532033,1,58335336,58335960,624,0.6231038250897585
22567,1944.540333,1944.568767,1,58336209,58337063,854,0.6029428331792819
22568,1944.589033,1944.598133,1,58337670,58337943,273,0.3148028361313954
22569,1944.601533,1944.613733,1,58338045,58338411,366,0.6492195561727921
22570,1944.6775,1944.6907,1,58340325,58340721,396,0.3742040130039653
22571,1944.717233,1944.7303,1,58341516,58341909,393,0.08749322589410247
22572,1944.7363,1944.741433,1,58342089,58342242,153,0.8464226517107893
22573,1944.742733,1944.8175,1,58342281,58344525,2244,0.32186388034873
22574,1944.823967,1945.014867,1,58344719,58350446,5727,0.6802959435113827
22575,1945.0181,1945.0456,1,58350543,58351368,825,0.6466189793119304
22576,1945.055467,1945.058767,1,58351664,58351763,99,0.8357725431073098
22577,1945.082433,1945.089367,1,58352472,58352681,209,0.6782914858258712
22578,1945.097933,1945.109833,1,58352937,58353294,357,0.41501538269311017
22579,1945.1604,1945.191033,1,58354812,58355730,918,0.5327222109699763
22580,1945.193167,1945.198467,1,58355795,58355954,159,0.29585798506516053
22581,1945.200133,1945.255733,1,58356003,58357671,1668,0.23282313337341354
22582,1945.2801,1945.285033,1,58358403,58358550,147,0.7607378918032403
22583,1945.2885,1945.448933,1,58358655,58363467,4812,0.7586314941265971
22584,1945.453167,1945.481233,1,58363595,58364436,841,0.6429166530739036
22585,1945.498367,1945.505467,1,58364951,58365164,213,0.38921798367102983
22586,1945.515733,1945.549733,1,58365471,58366491,1020,0.17963939917087873
22587,1945.5542,1945.5612,1,58366626,58366836,210,0.3083947152334658
22588,1945.564833,1945.575967,1,58366944,58367279,335,0.2462198578112223
22589,1945.578533,1945.612667,1,58367355,58368380,1025,0.4999443477692089
22590,1945.614467,1945.660667,1,58368434,58369820,1386,0.2015924827921841
22591,1945.6665,1945.6764,1,58369995,58370292,297,0.12115174270257757
22592,1945.680367,1945.712933,1,58370411,58371387,976,0.27581453634972314
22593,1945.716733,1945.732,1,58371501,58371960,459,0.26850718837329485
22594,1945.744433,1945.809567,1,58372332,58374287,1955,0.6896068873741544
22595,1945.820333,1945.893667,1,58374609,58376810,2201,0.7209091830198974
22596,1945.915833,1945.921067,1,58377474,58377632,158,0.8548406315388517
22597,1945.936733,1945.9509,1,58378101,58378527,426,0.4428366247884799
22598,1945.9564,1945.9743,1,58378692,58379229,537,0.6429776566798376
22599,1945.982933,1946.199667,1,58379487,58385990,6503,0.6718092107485383
22600,1946.212,1946.2265,1,58386360,58386795,435,0.35290348646599357
22601,1946.231,1946.2444,1,58386930,58387332,402,0.7635675332325151
22602,1946.245567,1946.274033,1,58387367,58388220,853,0.6639411220728136
22603,1946.2777,1946.2852,1,58388331,58388556,225,0.6250504979831529
22604,1946.2904,1946.297667,1,58388712,58388930,218,0.4140799495495841
22605,1946.348233,1946.356533,1,58390446,58390695,249,0.7935909785468901
22606,1946.582567,1946.5868,1,58397477,58397604,127,0.6982039209785966
22607,1946.618433,1946.621667,1,58398552,58398650,98,0.7744770940871436
22608,1946.6265,1946.635,1,58398795,58399050,255,0.4352658168961169
22609,1946.642967,1946.670233,1,58399289,58400106,817,0.6748715933710558
22610,1946.686833,1946.777667,1,58400604,58403330,2726,0.6283559932496641
22611,1946.8375,1946.860667,1,58405125,58405820,695,0.16659260346680996
22612,1946.863467,1946.866567,1,58405904,58405997,93,0.7648006976990954
22613,1946.929033,1947.1214,1,58407870,58413642,5772,0.6794910343012621
22614,1947.122667,1947.125867,1,58413680,58413776,96,0.8353855331889338
22615,1947.128133,1947.158567,1,58413843,58414757,914,0.6102558924620188
22616,1947.2286,1947.250133,1,58416858,58417503,645,0.20520947063203132
22617,1947.2512,1947.261,1,58417536,58417830,294,0.6016108226724394
22618,1947.2768,1947.279833,1,58418304,58418394,90,0.6163167170055097
22619,1947.3015,1947.305667,1,58419045,58419170,125,0.7861903804379846
22620,1947.310933,1947.324767,1,58419327,58419743,416,0.8320272462932161
22621,1947.335633,1947.371467,1,58420068,58421144,1076,0.5074176133160834
22622,1947.447433,1947.451133,1,58423422,58423533,111,0.6927827725024788
22623,1947.472767,1947.4909,1,58424183,58424727,544,0.3750900583660974
22624,1947.495867,1947.526833,1,58424876,58425804,928,0.6554124504793619
22625,1947.535333,1947.605833,1,58426059,58428174,2115,0.6782479033133744
22626,1947.6094,1947.624667,1,58428282,58428740,458,0.5832099884562231
22627,1947.6258,1947.6518,1,58428774,58429554,780,0.7022833651997177
22628,1947.712767,1947.716433,1,58431383,58431492,109,0.3418750067469967
22629,1947.719133,1947.7432,1,58431573,58432296,723,0.6496447017951722
22630,1947.7828,1947.800267,1,58433484,58434008,524,0.5161175899738462
22631,1947.808167,1947.999167,1,58434245,58439975,5730,0.6917682965305129
22632,1948.004133,1948.051367,1,58440123,58441541,1418,0.6469970000288353
22633,1948.0635,1948.081733,1,58441905,58442451,546,0.5109417143136414
22634,1948.083633,1948.0877,1,58442508,58442631,123,0.34266723093146517
22635,1948.166533,1948.171533,1,58444995,58445145,150,0.806975333659319
22636,1948.178433,1948.181833,1,58445352,58445454,102,0.8857646589660417
22637,1948.3123,1948.3789,1,58449369,58451367,1998,0.5355008179507237
22638,1948.380933,1948.412,1,58451427,58452360,933,0.576572536660422
22639,1948.474633,1948.4976,1,58454238,58454928,690,0.5202444160817532
22640,1948.531433,1948.554267,1,58455942,58456628,686,0.5990656398085848
22641,1948.5619,1948.568167,1,58456857,58457045,188,0.8148878231494077
22642,1948.635533,1948.654333,1,58459065,58459629,564,0.6643808663978359
22643,1948.734,1948.890733,1,58462020,58466721,4701,0.6245228746994739
22644,1948.8952,1948.927867,1,58466856,58467836,980,0.6731011923104788
22645,1948.962667,1948.9688,1,58468880,58469064,184,0.7555616218416563
22646,1948.989233,1948.999567,1,58469676,58469987,311,0.2874688761852079
22647,1949.0043,1949.0329,1,58470129,58470987,858,0.13046394774969206
22648,1949.0525,1949.087233,1,58471575,58472616,1041,0.7820141380276528
22649,1949.088633,1949.095233,1,58472658,58472856,198,0.7224031523570675
22650,1949.098533,1949.121167,1,58472955,58473635,680,0.06542025080435832
22651,1949.122233,1949.133467,1,58473666,58474004,338,-0.028443226136241628
22652,1949.1483,1949.205267,1,58474449,58476158,1709,0.31824221919215884
22653,1949.213767,1949.236867,1,58476413,58477106,693,0.23528097914464713
22654,1949.268167,1949.277033,1,58478045,58478310,265,0.020111175470934457
22655,1949.285867,1949.2893,1,58478576,58478679,103,0.7898556720272617
22656,1949.3101,1949.3242,1,58479303,58479726,423,0.771503630220139
22657,1949.337833,1949.491667,1,58480134,58484750,4616,0.7236543846428432
22658,1949.497767,1949.549,1,58484933,58486470,1537,0.7087621478294964
22659,1949.556967,1949.5628,1,58486709,58486884,175,0.8110650482638425
22660,1949.577633,1949.595833,1,58487328,58487874,546,0.2598058989577492
22661,1949.639633,1949.692867,1,58489188,58490786,1598,0.6493915878296106
22662,1949.694533,1949.8157,1,58490835,58494471,3636,0.6193918896267998
22663,1949.850367,1949.873533,1,58495511,58496205,694,-0.012914400867243792
22664,1949.884567,1949.8966,1,58496537,58496898,361,0.06388493187147991
22665,1949.926667,1950.140533,1,58497800,58504215,6415,0.7269302390745193
22666,1950.1875,1950.193033,1,58505625,58505790,165,0.5487379185011849
22667,1950.4635,1950.483233,1,58513905,58514496,591,0.5583983454559612
22668,1950.608533,1950.642067,1,58518255,58519262,1007,0.666509567778298
22669,1950.6483,1950.674433,1,58519449,58520232,783,0.6388643018188438
22670,1950.684967,1950.818767,1,58520549,58524563,4014,0.8110913344760552
22671,1950.8744,1950.879367,1,58526232,58526381,149,0.7170107498404923
22672,1950.880533,1950.887067,1,58526415,58526612,197,0.7068619399056476
22673,1951.053433,1951.234767,1,58531602,58537043,5441,0.6689007530806579
22674,1951.3197,1951.330467,1,58539591,58539914,323,0.6613887962255551
22675,1951.360033,1951.3711,1,58540800,58541133,333,0.10808231465504188
22676,1951.384667,1951.3916,1,58541540,58541748,208,0.7723680163294889
22677,1951.3927,1951.403567,1,58541781,58542107,326,0.6127167006336119
22678,1951.4059,1951.433033,1,58542177,58542990,813,0.3606545795276411
22679,1951.438133,1951.4648,1,58543143,58543944,801,0.20698227126733376
22680,1951.466533,1951.475933,1,58543995,58544277,282,0.06497439109164012
22681,1951.4851,1951.4947,1,58544553,58544841,288,0.5855144091722003
22682,1951.496033,1951.499833,1,58544880,58544994,114,0.9058167176611202
22683,1951.508467,1951.551567,1,58545254,58546547,1293,0.7641371519313661
22684,1951.555467,1951.5855,1,58546664,58547565,901,0.7422756129173967
22685,1951.591167,1951.620133,1,58547735,58548603,868,0.8248724776328973
22686,1951.624667,1951.653233,1,58548740,58549596,856,0.6340940899152131
22687,1951.671167,1951.6916,1,58550135,58550748,613,0.2013313098551254
22688,1951.699667,1951.709033,1,58550990,58551270,280,0.4502534936684345
22689,1951.726333,1951.754667,1,58551789,58552640,851,0.5720894488014315
22690,1951.777667,1951.8047,1,58553330,58554141,811,0.2386109922232676
22691,1951.8157,1952.0591,1,58554471,58561773,7302,0.7006632835912165
22692,1952.074867,1952.079567,1,58562246,58562387,141,0.87766179120332
22693,1952.081833,1952.086733,1,58562454,58562601,147,0.904795480976085
22694,1952.0892,1952.140767,1,58562676,58564223,1547,0.237069475314099
22695,1952.149333,1952.155133,1,58564479,58564653,174,0.8622487262757912
22696,1952.1563,1952.1901,1,58564689,58565703,1014,0.5389343349906708
22697,1952.1914,1952.195567,1,58565742,58565867,125,0.8406176918084005
22698,1952.199033,1952.224367,1,58565970,58566731,761,0.3656640384314228
22699,1952.2272,1952.230533,1,58566816,58566915,99,0.6709103417989429
22700,1952.236267,1952.2399,1,58567088,58567197,109,0.527925956900213
22701,1952.241067,1952.244667,1,58567232,58567340,108,0.842689323638282
22702,1952.2554,1952.2657,1,58567662,58567971,309,0.16190755693790615
22703,1952.268767,1952.271967,1,58568063,58568159,96,0.9234935312062815
22704,1952.274833,1952.279367,1,58568244,58568381,137,0.8337209707417998
22705,1952.284167,1952.2986,1,58568525,58568958,433,0.6145327661308079
22706,1952.319233,1952.3235,1,58569576,58569705,129,0.61263628379414
22707,1952.3396,1952.3549,1,58570188,58570647,459,0.500096174516229
22708,1952.356933,1952.556067,1,58570707,58576682,5975,0.7192789394985069
22709,1952.5623,1952.590933,1,58576869,58577727,858,0.663434521259835
22710,1952.594533,1952.6522,1,58577835,58579566,1731,0.27430717450789915
22711,1952.679633,1952.701867,1,58580388,58581056,668,0.3479730796536822
22712,1952.7033,1952.715633,1,58581099,58581468,369,0.4617942788308672
22713,1952.727633,1952.9288,1,58581828,58587864,6036,0.693741425980547
22714,1952.934967,1952.969867,1,58588049,58589096,1047,0.6577637176307046
22715,1953.186833,1953.1902,1,58595604,58595706,102,0.8411610509424641
22716,1953.192933,1953.195933,1,58595787,58595877,90,0.7302390534458725
22717,1953.259,1953.2635,1,58597770,58597905,135,0.8079820706669114
22718,1953.273133,1953.378333,1,58598193,58601349,3156,0.7836266785165327
22719,1953.465233,1953.6392,1,58603956,58609176,5220,0.695505002998852
22720,1953.7029,1953.7437,1,58611087,58612311,1224,0.6496052840736144
22721,1953.777867,1953.791467,1,58613336,58613744,408,0.25338357125034777
22722,1953.8007,1953.956067,1,58614021,58618682,4661,0.7389502915631827
22723,1953.9587,1953.987133,1,58618761,58619613,852,0.6948551608076761
22724,1954.067567,1954.1014,1,58622027,58623042,1015,0.36144960584417346
22725,1954.1086,1954.119567,1,58623258,58623587,329,0.7262959911653836
22726,1954.123467,1954.137267,1,58623704,58624118,414,0.7082315975837481
22727,1954.1387,1954.1698,1,58624161,58625094,933,0.614083177310838
22728,1954.2448,1954.256633,1,58627344,58627698,354,0.43370159064860075
22729,1954.260933,1954.2785,1,58627827,58628355,528,0.7927558425259367
22730,1954.281367,1954.2983,1,58628441,58628949,508,0.844770546208625
22731,1954.337267,1954.3533,1,58630118,58630599,481,0.5527482454943826
22732,1954.357133,1954.379367,1,58630713,58631381,668,0.6317747371446736
22733,1954.39,1954.4706,1,58631700,58634118,2418,0.6209977637119019
22734,1954.474767,1954.491167,1,58634243,58634735,492,0.635111622453324
22735,1954.541833,1954.573267,1,58636254,58637198,944,0.6573893285886471
22736,1954.6466,1954.846833,1,58639398,58645404,6006,0.7316131330663865
22737,1954.851267,1954.880333,1,58645538,58646409,871,0.7625158954999348
22738,1954.8836,1954.911867,1,58646508,58647356,848,0.70926438512741
22739,1954.9476,1954.9508,1,58648428,58648524,96,0.7896446943018826
22740,1955.0308,1955.042467,1,58650924,58651274,350,0.3016689277225473
22741,1955.048133,1955.0521,1,58651443,58651563,120,0.6431805130532673
22742,1955.053667,1955.057167,1,58651610,58651715,105,0.800585444780742
22743,1955.058867,1955.0621,1,58651766,58651863,97,0.9137851257536533
22744,1955.0643,1955.0693,1,58651929,58652079,150,0.6092127796498875
22745,1955.081433,1955.0845,1,58652442,58652535,93,0.5365574211537726
22746,1955.2229,1955.228633,1,58656687,58656858,171,0.7068157400258785
22747,1955.333433,1955.384867,1,58660002,58661546,1544,0.525169965250171
22748,1955.3977,1955.416967,1,58661931,58662509,578,0.6407607085757642
22749,1955.418067,1955.444667,1,58662542,58663340,798,0.5291107591622382
22750,1955.498033,1955.540767,1,58664940,58666223,1283,0.5431505536413328
22751,1955.5661,1955.611,1,58666983,58668330,1347,0.688428955980284
22752,1955.6803,1955.870567,1,58670409,58676117,5708,0.6836450637755985
22753,1955.8746,1955.924133,1,58676238,58677723,1485,0.5935619349171819
22754,1955.9631,1955.987333,1,58678893,58679619,726,0.3322884872665983
22755,1955.990467,1956.001967,1,58679714,58680059,345,0.050690319915693394
22756,1956.039833,1956.073133,1,58681194,58682193,999,0.546254535730739
22757,1956.074367,1956.081133,1,58682231,58682433,202,0.7181987533813228
22758,1956.0894,1956.1071,1,58682682,58683213,531,0.2823590502969937
22759,1956.121033,1956.281,1,58683630,58688430,4800,0.7482480085922718
22760,1956.285633,1956.3428,1,58688568,58690284,1716,0.6803546267401425
22761,1956.3564,1956.3781,1,58690692,58691343,651,0.33157436856803923
22762,1956.384533,1956.396233,1,58691535,58691886,351,0.3738662800256228
22763,1956.403667,1956.416867,1,58692110,58692506,396,0.2919664327329721
22764,1956.4239,1956.431067,1,58692717,58692932,215,0.3532246621554764
22765,1956.5318,1956.5367,1,58695954,58696101,147,0.7355026117015062
22766,1956.537833,1956.540967,1,58696134,58696229,95,0.8467464537665182
22767,1956.550767,1956.5823,1,58696523,58697469,946,0.4268638030209963
22768,1956.583533,1956.597067,1,58697505,58697912,407,0.4854013792090267
22769,1956.609,1956.621033,1,58698270,58698630,360,0.48991507390383227
22770,1956.6366,1956.640067,1,58699098,58699202,104,0.4385171893354249
22771,1956.646133,1956.6502,1,58699383,58699506,123,0.87457640787243
22772,1956.680833,1956.6906,1,58700424,58700718,294,0.24137828565596095
22773,1956.7515,1956.775267,1,58702545,58703258,713,-0.04920456237208281
22774,1956.783167,1956.789367,1,58703495,58703681,186,0.1459487631628536
22775,1956.7905,1956.812,1,58703715,58704360,645,0.5263574391229632
22776,1956.9203,1957.005967,1,58707609,58710179,2570,0.6743657125368717
22777,1957.013433,1957.1864,1,58710402,58715592,5190,0.8000602585534933
22778,1957.414567,1957.5376,1,58722437,58726128,3691,0.5980068301552889
22779,1957.551333,1957.571467,1,58726539,58727144,605,0.6787287414603025
22780,1957.590333,1957.606067,1,58727709,58728182,473,0.7994450249318821
22781,1957.630567,1957.641267,1,58728917,58729238,321,0.46551167022647455
22782,1957.6488,1957.668633,1,58729464,58730058,594,0.599475037888071
22783,1957.673867,1957.795067,1,58730216,58733852,3636,0.5050581659979613
22784,1957.7996,1957.803,1,58733988,58734090,102,0.012954365037265683
22785,1957.8412,1957.866167,1,58735236,58735985,749,0.4177952878997256
22786,1957.871467,1957.878333,1,58736144,58736349,205,0.5684537613603424
22787,1957.8848,1957.913033,1,58736544,58737390,846,0.612391643985975
22788,1957.950133,1957.974467,1,58738503,58739234,731,0.2721971482735174
22789,1957.982633,1958.015133,1,58739478,58740453,975,0.6452236386515464
22790,1958.0163,1958.1801,1,58740489,58745403,4914,0.7239426362065993
22791,1958.1874,1958.2219,1,58745622,58746657,1035,0.6599576536487254
22792,1958.2232,1958.227467,1,58746696,58746824,128,0.7865700619244886
22793,1958.2771,1958.309033,1,58748313,58749270,957,0.5280911427265647
22794,1958.324133,1958.357067,1,58749723,58750712,989,0.6442865383071187
22795,1958.366933,1958.375767,1,58751007,58751273,266,0.5023727754542394
22796,1958.377733,1958.424867,1,58751331,58752746,1415,0.1804502422409536
22797,1958.4324,1958.480167,1,58752972,58754405,1433,0.46037127190797095
22798,1958.4937,1958.509867,1,58754811,58755296,485,0.11231854414008444
22799,1958.531567,1958.542267,1,58755947,58756268,321,0.3937916212642971
22800,1958.576933,1958.589767,1,58757307,58757693,386,0.33421129263337224
22801,1958.595833,1958.7818,1,58757874,58763454,5580,0.7254630550649114
22802,1958.784067,1958.8032,1,58763522,58764096,574,0.6502653091378601
22803,1958.8127,1958.904267,1,58764381,58767128,2747,0.43224260550164356
22804,1958.9057,1958.911233,1,58767171,58767336,165,0.82915799286327
22805,1958.912233,1958.937767,1,58767366,58768133,767,0.45701082406980065
22806,1958.9511,1958.963167,1,58768533,58768895,362,0.47425413698121177
22807,1958.9697,1959.0086,1,58769091,58770258,1167,0.4545871749469468
22808,1959.012467,1959.017033,1,58770374,58770510,136,0.8802606832909102
22809,1959.129833,1959.174433,1,58773894,58775232,1338,0.7720521501276929
22810,1959.178133,1959.1816,1,58775343,58775448,105,0.5044466640433034
22811,1959.184833,1959.191333,1,58775544,58775739,195,0.475602826547307
22812,1959.3018,1959.327867,1,58779054,58779836,782,0.49128278534977937
22813,1959.337,1959.359567,1,58780110,58780787,677,0.7484741383185227
22814,1959.4536,1959.4595,1,58783608,58783785,177,0.5120455921415017
22815,1959.464633,1959.643533,1,58783938,58789305,5367,0.7998169830347817
22816,1959.654133,1959.657167,1,58789623,58789715,92,0.7014498031172792
22817,1959.6583,1959.6648,1,58789749,58789944,195,0.8258739726527891
22818,1959.838767,1959.868367,1,58795163,58796051,888,0.6802604069109323
22819,1959.892833,1959.895867,1,58796784,58796876,92,0.8691038687032557
22820,1959.914367,1959.923667,1,58797431,58797710,279,0.4671627027204745
22821,1960.0191,1960.0404,1,58800573,58801212,639,0.7253965182500782
22822,1960.045067,1960.0494,1,58801352,58801482,130,0.6589885949586309
22823,1960.0588,1960.0651,1,58801764,58801953,189,0.6836784803899911
22824,1960.0842,1960.087367,1,58802526,58802621,95,0.554392936530446
22825,1960.2931,1960.305567,1,58808793,58809167,374,0.5319176167691937
22826,1960.306733,1960.310067,1,58809201,58809302,101,0.7835462434862738
22827,1960.318133,1960.321467,1,58809543,58809644,101,0.7568165986141969
22828,1960.3253,1960.329967,1,58809759,58809899,140,0.6353548716537812
22829,1960.354833,1960.368333,1,58810644,58811049,405,0.43434159315975573
22830,1960.376,1960.407167,1,58811280,58812215,935,0.6844240569140259
22831,1960.408267,1960.415167,1,58812248,58812455,207,0.649833511618013
22832,1960.417667,1960.429767,1,58812530,58812893,363,0.6784262499754627
22833,1960.430833,1960.464367,1,58812924,58813931,1007,0.7068551693695523
22834,1960.466367,1960.471067,1,58813991,58814132,141,0.5789809412930315
22835,1960.477167,1960.489067,1,58814315,58814672,357,0.7562774902902846
22836,1960.492367,1960.527067,1,58814771,58815812,1041,0.7875708100442264
22837,1960.536833,1960.559433,1,58816104,58816782,678,0.23707062905800022
22838,1960.5713,1960.584933,1,58817139,58817547,408,0.30469115733477836
22839,1960.590667,1960.618767,1,58817720,58818563,843,0.6803612483716241
22840,1960.643167,1960.654733,1,58819295,58819641,346,0.3683741790005481
22841,1960.700167,1960.728467,1,58821005,58821854,849,0.6491486287403972
22842,1960.730533,1960.902067,1,58821915,58827062,5147,0.769697794193502
22843,1960.907633,1960.939167,1,58827228,58828175,947,0.6478504706488742
22844,1960.976633,1960.988633,1,58829298,58829658,360,-0.10585467456543693
22845,1961.008833,1961.022967,1,58830264,58830689,425,0.15456549109268103
22846,1961.0282,1961.0312,1,58830846,58830936,90,0.7237594116946717
22847,1961.0559,1961.0679,1,58831677,58832037,360,0.6861720486076454
22848,1961.0788,1961.0846,1,58832364,58832538,174,0.6791804208086732
22849,1961.087267,1961.0908,1,58832618,58832724,106,0.7689435856110112
22850,1961.0952,1961.098933,1,58832856,58832967,111,0.3141352635201185
22851,1961.110833,1961.384833,1,58833324,58841544,8220,0.7677753508339227
22852,1961.549933,1961.554533,1,58846497,58846635,138,0.5034133604984601
22853,1961.7799,1961.811667,1,58853397,58854350,953,0.6386057053698291
22854,1961.928133,1962.0961,1,58857843,58862883,5040,0.6332776337999791
22855,1962.103733,1962.1966,1,58863111,58865898,2787,0.6976787428796873
22856,1962.221333,1962.347333,1,58866639,58870419,3780,0.7108056732307428
22857,1962.349333,1962.355233,1,58870479,58870656,177,0.5602689733966817
22858,1962.3684,1962.373,1,58871052,58871190,138,0.0055310739333550366
22859,1962.385533,1962.390567,1,58871565,58871717,152,0.47456732346176234
22860,1962.393667,1962.4019,1,58871810,58872057,247,0.5223015573394753
22861,1962.4358,1962.634333,1,58873074,58879029,5955,0.7077786185332676
22862,1962.641567,1962.686133,1,58879247,58880583,1336,0.670138053885503
22863,1962.715333,1962.7188,1,58881459,58881564,105,0.8519663634155454
22864,1962.7255,1962.736033,1,58881765,58882080,315,0.16924739848443815
22865,1962.845067,1962.9852,1,58885352,58889556,4204,0.8023223565545379
22866,1963.0352,1963.041967,1,58891056,58891259,203,0.6988491918573672
22867,1963.043667,1963.0518,1,58891310,58891554,244,0.4275666073141422
22868,1963.070333,1963.084433,1,58892109,58892532,423,0.5052187402063003
22869,1963.0856,1963.09,1,58892568,58892700,132,0.867478600627112
22870,1963.236633,1963.239767,1,58897098,58897193,95,0.8731241330613672
22871,1963.267033,1963.278833,1,58898010,58898364,354,0.651325301568704
22872,1963.282633,1963.4533,1,58898478,58903599,5121,0.6146062641718409
22873,1963.457033,1963.550567,1,58903710,58906517,2807,0.43765897726372877
22874,1963.563833,1963.571567,1,58906914,58907147,233,0.833199993154943
22875,1963.577067,1963.5963,1,58907312,58907889,577,0.41357386237951804
22876,1963.598967,1963.642633,1,58907969,58909278,1309,0.6552251249536417
22877,1963.662867,1963.8928,1,58909886,58916784,6898,0.7291185994540379
22878,1963.918233,1963.964733,1,58917546,58918941,1395,0.7166057642089745
22879,1963.9705,1964.002867,1,58919115,58920086,971,0.7423356837726169
22880,1964.030367,1964.057933,1,58920911,58921737,826,0.37604527719330955
22881,1964.059433,1964.063367,1,58921782,58921901,119,0.9149818241482847
22882,1964.066,1964.076633,1,58921980,58922298,318,0.552910817127327
22883,1964.427967,1964.434633,1,58932839,58933038,199,0.4683597772985705
22884,1964.437933,1964.506667,1,58933137,58935200,2063,0.5951457023168358
22885,1964.594167,1964.630933,1,58937825,58938927,1102,0.7316599010541378
22886,1964.6332,1964.926333,1,58938996,58947789,8793,0.7473586894921443
22887,1965.315067,1965.336267,1,58959452,58960088,636,0.6922788086942683
22888,1965.3945,1965.410333,1,58961835,58962309,474,0.4897614341405268
22889,1965.442233,1965.544333,1,58963266,58966329,3063,0.7522566085750408
22890,1965.549867,1965.577567,1,58966496,58967327,831,0.6454994558405202
22891,1965.579933,1965.761967,1,58967397,58972859,5462,0.8262159735352756
22892,1965.7832,1965.788867,1,58973496,58973666,170,0.7673726672338954
22893,1966.014733,1966.0291,1,58980441,58980873,432,0.8663433218987171
22894,1966.030133,1966.043367,1,58980903,58981301,398,0.7482881780225837
22895,1966.044367,1966.0548,1,58981331,58981644,313,0.6932593182385137
22896,1966.0577,1966.228633,1,58981731,58986858,5127,0.5825561994640996
22897,1966.244133,1966.248133,1,58987323,58987443,120,0.6203880386437339
22898,1966.262667,1966.268767,1,58987880,58988063,183,0.8555337210593394
22899,1966.311767,1966.3193,1,58989353,58989579,226,0.5789213546002434
22900,1966.3639,1966.432367,1,58990917,58992971,2054,0.8101111343175963
22901,1966.487967,1966.5034,1,58994639,58995102,463,0.513736886465962
22902,1966.525933,1966.567167,1,58995777,58997015,1238,0.6529301152445856
22903,1966.579233,1966.6149,1,58997376,58998447,1071,0.29226357121908886
22904,1966.6246,1966.627767,1,58998738,58998833,95,0.7872539581091109
22905,1966.6309,1966.667133,1,58998927,59000013,1086,0.4173503320576079
22906,1966.677267,1966.703933,1,59000318,59001117,799,0.37146904723811797
22907,1966.7076,1966.717267,1,59001228,59001518,290,0.24957747558974328
22908,1966.7347,1966.770133,1,59002041,59003103,1062,0.5011979902696063
22909,1966.876233,1966.903633,1,59006286,59007108,822,0.6146252266848874
22910,1966.904867,1966.917933,1,59007146,59007537,391,0.5371970789338517
22911,1966.919133,1966.931,1,59007573,59007930,357,0.8573577431618912
22912,1966.9321,1967.057833,1,59007963,59011734,3771,0.6985813413140769
22913,1967.060833,1967.063933,1,59011824,59011917,93,0.5312225473267028
22914,1967.070967,1967.077933,1,59012129,59012337,208,0.5950416415149411
22915,1967.1113,1967.1202,1,59013339,59013606,267,0.50078004110327
22916,1967.126033,1967.1298,1,59013780,59013894,114,0.5762876581536758
22917,1967.1313,1967.183367,1,59013939,59015501,1562,0.5553124223753417
22918,1967.193033,1967.2111,1,59015790,59016333,543,0.47911979138714184
22919,1967.256633,1967.295367,1,59017698,59018861,1163,0.8206225925075795
22920,1967.2979,1967.306733,1,59018937,59019201,264,0.8628662802697549
22921,1967.308433,1967.322633,1,59019252,59019678,426,0.7439186243330161
22922,1967.339333,1967.3586,1,59020179,59020758,579,0.7131149254130696
22923,1967.363633,1967.382033,1,59020908,59021460,552,0.33172685302954136
22924,1967.418867,1967.457133,1,59022566,59023713,1147,0.6958241066182209
22925,1967.511267,1967.532333,1,59025338,59025969,631,0.559960890619571
22926,1967.596633,1967.638233,1,59027898,59029146,1248,0.6566764899950943
22927,1967.6469,1967.698033,1,59029407,59030940,1533,0.7080149632048999
22928,1967.748833,1967.784967,1,59032464,59033549,1085,0.6357564675411709
22929,1967.865967,1967.902033,1,59035979,59037060,1081,0.7633799933418968
22930,1967.9066,1967.9178,1,59037198,59037534,336,0.6217797000442403
22931,1967.919533,1968.042867,1,59037585,59041286,3701,0.7055041714299761
22932,1968.047333,1968.061633,1,59041419,59041848,429,0.7926892905522059
22933,1968.0658,1968.0937,1,59041974,59042811,837,0.7317289712130091
22934,1968.097467,1968.102233,1,59042924,59043066,142,0.7854556670833899
22935,1968.488733,1968.496167,1,59054661,59054885,224,0.6007450336168952
22936,1968.501067,1968.5333,1,59055032,59055999,967,0.7627689045060777
22937,1968.538433,1968.6863,1,59056152,59060589,4437,0.7468318550682018
22938,1968.689867,1968.747367,1,59060696,59062421,1725,0.7047399934140521
22939,1968.856367,1968.902567,1,59065691,59067077,1386,0.6800230742777011
22940,1968.903967,1968.911,1,59067119,59067330,211,0.8175773825131444
22941,1968.912233,1968.939233,1,59067366,59068176,810,0.5019517820102996
22942,1968.9933,1969.037467,1,59069799,59071124,1325,0.13546459028668964
22943,1969.038533,1969.0889,1,59071155,59072667,1512,0.45519178451110726
22944,1969.095467,1969.099833,1,59072864,59072994,130,0.8194771736163724
22945,1969.102333,1969.130633,1,59073069,59073918,849,0.2509764614031287
22946,1969.132567,1969.292733,1,59073977,59078781,4804,0.6429259482147729
22947,1969.296933,1969.301967,1,59078907,59079059,152,0.5880425441050026
22948,1969.303267,1969.3264,1,59079098,59079792,694,0.700381509245836
22949,1969.378167,1969.397033,1,59081345,59081910,565,0.6325698244406089
22950,1969.3983,1969.4211,1,59081949,59082633,684,0.466002296609502
22951,1969.422233,1969.4339,1,59082666,59083017,351,0.5736211365017255
22952,1969.442733,1969.462033,1,59083281,59083860,579,0.5973758042531733
22953,1969.463333,1969.527067,1,59083899,59085812,1913,0.217519245239951
22954,1969.5372,1969.5451,1,59086116,59086353,237,0.2103706072200239
22955,1969.558867,1969.5666,1,59086766,59086998,232,0.6836715505087202
22956,1969.568,1969.578733,1,59087040,59087361,321,0.5604399295905261
22957,1969.579767,1969.603167,1,59087393,59088095,702,0.37645133654784174
22958,1969.649633,1969.657667,1,59089488,59089730,242,0.5508571654383898
22959,1969.663167,1969.705467,1,59089895,59091164,1269,0.7112637179919131
22960,1969.711833,1969.837733,1,59091354,59095131,3777,0.6983446596425834
22961,1969.840533,1969.978333,1,59095215,59099349,4134,0.709897046469337
22962,1970.007733,1970.0113,1,59100231,59100339,108,-0.0955048992487524
22963,1970.0151,1970.021167,1,59100453,59100635,182,0.2486052861426433
22964,1970.0421,1970.054267,1,59101263,59101628,365,0.033330140452081304
22965,1970.0553,1970.060033,1,59101659,59101800,141,0.0748976511551058
22966,1970.0727,1970.076033,1,59102181,59102280,99,0.7779724713170914
22967,1970.093733,1970.1181,1,59102811,59103543,732,0.6306384055171306
22968,1970.145967,1970.159133,1,59104379,59104773,394,0.18649725823676128
22969,1970.1926,1970.2282,1,59105778,59106846,1068,0.7504659942229771
22970,1970.230733,1970.390467,1,59106921,59111714,4793,0.7447636787494126
22971,1970.3955,1970.426467,1,59111865,59112794,929,0.738392080379091
22972,1970.5713,1970.5858,1,59117139,59117574,435,0.7038377715379547
22973,1970.596533,1970.626833,1,59117895,59118804,909,0.7737775794283834
22974,1970.710467,1970.8389,1,59121314,59125167,3853,0.7282488911218505
22975,1970.841167,1970.879767,1,59125235,59126393,1158,0.6793393734684804
22976,1970.899633,1970.9268,1,59126988,59127804,816,0.7966271267923064
22977,1970.9278,1970.9763,1,59127834,59129289,1455,0.7518269080085679
22978,1970.9921,1971.0012,1,59129763,59130036,273,0.789171782002364
22979,1971.030933,1971.0344,1,59130927,59131032,105,0.7990462187725093
22980,1971.049667,1971.083033,1,59131490,59132490,1000,0.6618120847026684
22981,1971.110833,1971.1267,1,59133324,59133801,477,0.1007888492943429
22982,1971.1452,1971.1885,1,59134356,59135655,1299,0.7518003186521958
22983,1971.191567,1971.598333,1,59135747,59147949,12202,0.6977612972059596
22984,1971.615033,1971.624433,1,59148450,59148732,282,0.7127267219113754
22985,1971.638067,1971.669533,1,59149142,59150085,943,0.2532098971192562
22986,1971.673367,1971.6876,1,59150201,59150628,427,0.30865643512137164
22987,1971.692267,1971.7512,1,59150768,59152536,1768,0.5284642900248369
22988,1971.755167,1971.8046,1,59152655,59154138,1483,0.10000962320935754
22989,1971.808167,1971.818467,1,59154245,59154554,309,0.6335744198204257
22990,1971.8244,1971.8283,1,59154732,59154849,117,0.6342238479977396
22991,1971.836267,1971.847133,1,59155088,59155413,325,0.3780278329728685
22992,1971.851967,1971.859167,1,59155559,59155775,216,0.4811167252358677
22993,1971.8654,1972.137533,1,59155962,59164125,8163,0.7116979455973811
22994,1972.1387,1972.143533,1,59164161,59164305,144,0.7895253450237268
22995,1972.1518,1972.1561,1,59164554,59164683,129,0.8814879419289818
22996,1972.179633,1972.217167,1,59165388,59166515,1127,0.2598037249476623
22997,1972.2347,1972.249367,1,59167041,59167481,440,0.4652003360312647
22998,1972.2607,1972.272367,1,59167821,59168171,350,0.2130982922294245
22999,1972.2823,1972.481567,1,59168469,59174447,5978,0.7290530381772942
23000,1972.484333,1972.539067,1,59174529,59176172,1643,0.7080466147523398
23001,1972.558833,1972.579933,1,59176764,59177397,633,0.4331138724165595
23002,1972.600733,1972.6341,1,59178021,59179023,1002,0.22489785824469813
23003,1972.635367,1972.648767,1,59179061,59179463,402,0.6300337840416297
23004,1972.649767,1972.657933,1,59179493,59179737,244,0.5998369323087637
23005,1972.6658,1972.688333,1,59179974,59180649,675,0.18662328367146763
23006,1972.6909,1972.695233,1,59180727,59180856,129,0.8564594530835337
23007,1972.753733,1972.762733,1,59182611,59182881,270,0.19971988156585874
23008,1972.8162,1972.8736,1,59184486,59186208,1722,0.7201888990436838
23009,1972.878433,1972.8841,1,59186352,59186523,171,0.5611979664221443
23010,1972.892,1972.898367,1,59186760,59186951,191,0.7047547207787445
23011,1972.899667,1972.9099,1,59186990,59187297,307,0.4517053154004748
23012,1972.930367,1972.9474,1,59187911,59188422,511,0.6612158777199926
23013,1972.954333,1972.9676,1,59188629,59189028,399,0.7416086830903165
23014,1973.070233,1973.092867,1,59192106,59192786,680,0.7239449522974916
23015,1973.0974,1973.1904,1,59192922,59195712,2790,0.7287840275948877
23016,1973.191533,1973.3461,1,59195745,59200383,4638,0.7843296832745126
23017,1973.368567,1973.372567,1,59201057,59201177,120,0.8256748781570605
23018,1973.3786,1973.385767,1,59201358,59201573,215,0.7107247222734986
23019,1973.3905,1973.433133,1,59201715,59202993,1278,0.31761685523553707
23020,1973.4377,1973.4463,1,59203131,59203389,258,0.10195668840314755
23021,1973.472867,1973.673567,1,59204186,59210207,6021,0.7532514564095909
23022,1973.678167,1973.702633,1,59210345,59211078,733,0.7127923329491445
23023,1973.703933,1973.7366,1,59211117,59212098,981,0.7083828169829772
23024,1973.7619,1973.768633,1,59212857,59213058,201,0.8744313299993015
23025,1973.8479,1973.8638,1,59215437,59215914,477,0.07531534326538229
23026,1974.043267,1974.0604,1,59221298,59221812,514,0.4253672261354063
23027,1974.066633,1974.1038,1,59221998,59223114,1116,0.7862015357332045
23028,1974.201633,1974.220733,1,59226048,59226621,573,0.67615620106612
23029,1974.225667,1974.242467,1,59226770,59227274,504,0.6317656619885503
23030,1974.2596,1974.3163,1,59227788,59229489,1701,0.6773356150709122
23031,1974.3241,1974.346733,1,59229723,59230401,678,0.7128571736782131
23032,1974.355367,1974.702933,1,59230661,59241087,10426,0.7194672321255325
23033,1974.748267,1974.7606,1,59242448,59242818,370,0.5454833031228121
23034,1974.773167,1974.7823,1,59243195,59243469,274,0.24606055694974627
23035,1974.8068,1974.9651,1,59244204,59248953,4749,0.7644599667315775
23036,1974.966433,1975.027767,1,59248992,59250833,1841,0.697664387439302
23037,1975.075167,1975.098267,1,59252255,59252948,693,-0.07867092083076695
23038,1975.102933,1975.127967,1,59253087,59253839,752,-0.06469009141941791
23039,1975.1295,1975.141733,1,59253885,59254251,366,0.49029612314179283
23040,1975.147133,1975.152367,1,59254413,59254571,158,0.5990933769073391
23041,1975.262333,1975.4356,1,59257869,59263068,5199,0.8264347636206281
23042,1975.437067,1975.445867,1,59263112,59263376,264,0.8934483138596897
23043,1975.4587,1975.462333,1,59263761,59263869,108,0.7995211532922138
23044,1975.470867,1975.473933,1,59264126,59264217,91,0.8763333393350848
23045,1975.4893,1975.503967,1,59264679,59265119,440,0.5653952291882689
23046,1975.515567,1975.5329,1,59265467,59265987,520,0.6050212271976657
23047,1975.5408,1975.5532,1,59266224,59266596,372,0.5932126962473779
23048,1975.5646,1975.571533,1,59266938,59267145,207,0.8439533052171453
23049,1975.601133,1975.606133,1,59268033,59268183,150,0.5947050210255739
23050,1975.608067,1975.6185,1,59268242,59268555,313,0.4587600024822984
23051,1975.6271,1975.636467,1,59268813,59269094,281,0.10958405036720621
23052,1975.651333,1975.655033,1,59269539,59269650,111,0.6482226722371627
23053,1975.678167,1975.722667,1,59270345,59271680,1335,0.7180012827296371
23054,1975.726633,1975.730733,1,59271798,59271921,123,0.4535785442703834
23055,1975.800367,1976.049433,1,59274011,59281482,7471,0.7138200877146254
23056,1976.051733,1976.181533,1,59281551,59285445,3894,0.7614102747253887
23057,1976.222,1976.253967,1,59286660,59287619,959,0.18440524723363858
23058,1976.280133,1976.284167,1,59288403,59288525,122,0.8846840927098226
23059,1976.297,1976.4816,1,59288910,59294448,5538,0.7610489945130036
23060,1976.492533,1976.5012,1,59294775,59295036,261,0.5635282922803158
23061,1976.5237,1976.550433,1,59295711,59296512,801,0.26194073865671647
23062,1976.552233,1976.5617,1,59296566,59296851,285,0.22687136195242286
23063,1976.575033,1976.594833,1,59297250,59297844,594,0.6477832911204193
23064,1976.595967,1976.623533,1,59297879,59298705,826,0.5382408124727605
23065,1976.626933,1976.6651,1,59298807,59299953,1146,0.2662622512444864
23066,1976.670367,1976.676833,1,59300111,59300304,193,0.15324230488817145
23067,1976.6873,1976.696333,1,59300619,59300889,270,-0.008078296227186772
23068,1976.7652,1976.769267,1,59302956,59303078,122,0.768258236460138
23069,1976.7976,1976.839567,1,59303928,59305187,1259,0.7088159629993545
23070,1976.8468,1976.853733,1,59305404,59305611,207,0.5120620916760144
23071,1976.855267,1976.8682,1,59305658,59306046,388,0.6341980041378092
23072,1976.8708,1976.874967,1,59306124,59306249,125,0.48720323752252837
23073,1976.909133,1976.967933,1,59307273,59309037,1764,0.6186375105408503
23074,1976.969833,1977.164733,1,59309094,59314941,5847,0.4169744329302558
23075,1977.169733,1977.177433,1,59315091,59315322,231,0.7022306622648519
23076,1977.201367,1977.248733,1,59316041,59317461,1420,0.7136045812838434
23077,1977.255267,1977.296667,1,59317658,59318900,1242,0.6145454178243257
23078,1977.3168,1977.320233,1,59319504,59319606,102,0.9211359451454911
23079,1977.3233,1977.334433,1,59319699,59320032,333,0.6529198780303377
23080,1977.3493,1977.590433,1,59320479,59327712,7233,0.7445610899863356
23081,1977.6042,1977.6148,1,59328126,59328444,318,0.7830793694822862
23082,1977.6225,1977.625533,1,59328675,59328765,90,0.7997532029364852
23083,1977.6379,1977.6498,1,59329137,59329494,357,0.3800884708123053
23084,1977.654,1977.671033,1,59329620,59330130,510,0.2521512949947546
23085,1977.673733,1977.6798,1,59330211,59330394,183,0.6576148406586907
23086,1977.692267,1977.695633,1,59330768,59330868,100,0.7317304290062053
23087,1977.708833,1977.7123,1,59331264,59331369,105,0.7996389252566342
23088,1977.717933,1977.722533,1,59331537,59331675,138,0.6601775318443054
23089,1977.7625,1977.7831,1,59332875,59333493,618,0.44322330670448906
23090,1977.868133,1977.908667,1,59336043,59337260,1217,0.6420725502643682
23091,1977.909967,1978.085533,1,59337299,59342565,5266,0.7006326022123401
23092,1978.112167,1978.120067,1,59343365,59343602,237,0.8500160771679816
23093,1978.309633,1978.4592,1,59349288,59353776,4488,0.8493500662644712
23094,1978.466633,1978.4699,1,59353998,59354097,99,0.9124853243791455
23095,1978.498633,1978.5179,1,59354958,59355537,579,0.5661579595222768
23096,1978.5231,1978.536433,1,59355693,59356092,399,0.3039543022318183
23097,1978.5399,1978.551567,1,59356197,59356547,350,0.7675434929316345
23098,1978.573033,1978.5761,1,59357190,59357283,93,0.6001878818136581
23099,1978.5778,1978.5867,1,59357334,59357601,267,0.11024917082842535
23100,1978.6074,1978.617433,1,59358222,59358522,300,0.21882659649354622
23101,1978.622133,1978.629067,1,59358663,59358872,209,0.17664279126526294
23102,1978.757367,1978.761367,1,59362721,59362841,120,0.69020695728005
23103,1978.775767,1978.933367,1,59363273,59368001,4728,0.6133806812550091
23104,1978.9351,1979.093467,1,59368053,59372804,4751,0.665629836830385
23105,1979.102967,1979.217633,1,59373089,59376528,3439,0.6515074625703197
23106,1979.2224,1979.233967,1,59376672,59377019,347,0.5930652698177022
23107,1979.2457,1979.248733,1,59377371,59377461,90,0.4711640655488751
23108,1979.259533,1979.279167,1,59377785,59378375,590,0.2852767541140748
23109,1979.2901,1979.479033,1,59378703,59384370,5667,0.7415527209608551
23110,1979.481133,1979.541233,1,59384433,59386236,1803,0.7490931724211747
23111,1979.563733,1979.569933,1,59386911,59387097,186,0.5971617690590953
23112,1979.584267,1979.589833,1,59387528,59387694,166,0.7801922011728848
23113,1979.666767,1979.670033,1,59390003,59390100,97,0.7093300752995902
23114,1979.8638,1979.8876,1,59395914,59396628,714,0.43730275975848365
23115,1979.9051,1979.908567,1,59397153,59397257,104,0.20139201605270157
23116,1979.981367,1980.333967,1,59399441,59410019,10578,0.7143400800102827
23117,1980.349333,1980.353333,1,59410479,59410599,120,0.7869930847555489
23118,1980.369267,1980.377267,1,59411078,59411318,240,0.7976362340530798
23119,1980.399933,1980.638667,1,59411997,59419160,7163,0.7253505966501924
23120,1980.639667,1980.670133,1,59419190,59420103,913,0.6357766103753253
23121,1981.0017,1981.0289,1,59430051,59430867,816,0.5939776368062634
23122,1981.031467,1981.090033,1,59430944,59432700,1756,0.7230666696795119
23123,1981.1003,1981.105067,1,59433009,59433152,143,0.6805625973579997
23124,1981.177733,1981.2165,1,59435331,59436495,1164,0.6780119723815154
23125,1981.2177,1981.272867,1,59436531,59438186,1655,0.7983134762295351
23126,1981.276467,1981.435767,1,59438294,59443073,4779,0.7690668234629346
23127,1981.572767,1981.578267,1,59447183,59447348,165,0.8245901010517949
23128,1981.7806,1981.783967,1,59453418,59453519,101,0.47237786902186385
23129,1981.856333,1981.8623,1,59455689,59455869,180,0.6311455458385071
23130,1981.877567,1982.0061,1,59456327,59460183,3856,0.6519344777247429
23131,1982.013433,1982.149467,1,59460402,59464484,4082,0.6977360463130171
23132,1982.152433,1982.159367,1,59464572,59464781,209,0.33146378864189757
23133,1982.1787,1982.226767,1,59465361,59466803,1442,0.6642330188756844
23134,1982.235133,1982.287333,1,59467053,59468619,1566,0.7002387875728918
23135,1982.302,1982.314933,1,59469060,59469447,387,0.8367177796487082
23136,1982.316733,1982.323633,1,59469501,59469708,207,0.8360338997807888
23137,1982.3451,1982.3991,1,59470353,59471973,1620,0.11491007884800356
23138,1982.409767,1982.619933,1,59472293,59478597,6304,0.7197658452825132
23139,1982.6216,1982.625733,1,59478648,59478771,123,0.8716265394520111
23140,1982.629433,1982.633033,1,59478882,59478990,108,0.8715610670164667
23141,1982.638833,1982.646233,1,59479164,59479386,222,0.9156946849733274
23142,1982.662967,1982.686,1,59479889,59480580,691,0.15897301711407985
23143,1982.687467,1982.690533,1,59480624,59480715,91,0.9342789886430842
23144,1982.695933,1982.7265,1,59480877,59481795,918,0.08004095060957611
23145,1982.7288,1982.731833,1,59481864,59481954,90,0.7845115273337223
23146,1982.740767,1982.7923,1,59482223,59483769,1546,0.6731514916037276
23147,1982.949667,1983.083367,1,59488490,59492501,4011,0.7095909431322709
23148,1983.0846,1983.1261,1,59492538,59493783,1245,0.712557937798109
23149,1983.1528,1983.156633,1,59494584,59494698,114,0.8295646258121294
23150,1983.174533,1983.204667,1,59495235,59496140,905,0.40571997270013277
23151,1983.228833,1983.274867,1,59496864,59498246,1382,0.11075183784886072
23152,1983.276067,1983.283667,1,59498282,59498510,228,0.2517299148537224
23153,1983.288133,1983.324067,1,59498643,59499722,1079,0.7202065977673714
23154,1983.329267,1983.478967,1,59499878,59504369,4491,0.6821631620375882
23155,1983.4815,1983.506733,1,59504445,59505201,756,0.622087970779404
23156,1983.514633,1983.517667,1,59505438,59505530,92,0.9011220515199571
23157,1983.519067,1983.5749,1,59505572,59507247,1675,0.6654850226653762
23158,1983.756567,1983.760333,1,59512697,59512809,112,0.6764806794628688
23159,1983.761633,1983.765,1,59512848,59512950,102,0.5743752510127405
23160,1983.769,1983.831367,1,59513070,59514941,1871,0.6842523336373117
23161,1983.9316,1983.937267,1,59517948,59518118,170,0.7658492544675767
23162,1983.9408,1984.235933,1,59518224,59527077,8853,0.7499679963618595
23163,1984.269567,1984.275467,1,59528087,59528264,177,0.6879447652435692
23164,1984.2941,1984.3046,1,59528823,59529138,315,0.46045619699706464
23165,1984.358067,1984.369067,1,59530742,59531072,330,0.37502893758332445
23166,1984.370067,1984.377867,1,59531102,59531336,234,0.8639998055334418
23167,1984.3833,1984.3932,1,59531499,59531796,297,0.35207463058875316
23168,1984.396067,1984.4049,1,59531882,59532147,265,0.7659677505710006
23169,1984.4115,1984.4596,1,59532345,59533788,1443,-0.07028615332939955
23170,1984.465733,1984.4818,1,59533971,59534454,483,0.22000055866720256
23171,1984.500567,1984.667133,1,59535017,59540013,4996,0.7531983480348441
23172,1984.672733,1984.714667,1,59540181,59541440,1259,0.6903389190314032
23173,1984.7236,1984.7365,1,59541708,59542095,387,0.7925267994959599
23174,1984.748633,1984.8061,1,59542458,59544183,1725,0.12552638236268282
23175,1984.827267,1984.902567,1,59544818,59547077,2259,0.6971014468179297
23176,1984.9276,1984.978633,1,59547828,59549358,1530,0.18373527130277367
23177,1985.003933,1985.2463,1,59550117,59557389,7272,0.7555641569740608
23178,1985.249033,1985.3003,1,59557470,59559009,1539,0.661740279829155
23179,1985.4328,1985.444833,1,59562984,59563344,360,0.4009490204686153
23180,1985.456833,1985.462667,1,59563704,59563880,176,0.6952913939642414
23181,1985.493533,1985.517167,1,59564805,59565515,710,0.26289753586046505
23182,1985.518233,1985.523567,1,59565546,59565707,161,0.5571975150843134
23183,1985.532767,1985.546133,1,59565983,59566383,400,0.0051041843948193945
23184,1985.580133,1985.6074,1,59567403,59568222,819,0.7286246118590833
23185,1985.6158,1985.768633,1,59568474,59573058,4584,0.7470829144144131
23186,1985.772767,1985.830767,1,59573183,59574923,1740,0.7618792996235315
23187,1985.887733,1985.8998,1,59576631,59576994,363,0.7472224521785327
23188,1985.9082,1985.911933,1,59577246,59577357,111,0.567572253985302
23189,1985.916633,1986.251033,1,59577498,59587530,10032,0.7129066205682543
23190,1986.3711,1986.382,1,59591133,59591460,327,0.11698005557309181
23191,1986.485733,1986.495967,1,59594571,59594879,308,0.2178114402828799
23192,1986.580867,1986.629133,1,59597426,59598873,1447,0.7510145807660878
23193,1986.682267,1986.723667,1,59600468,59601710,1242,0.6253755423108138
23194,1986.739633,1986.822567,1,59602188,59604677,2489,0.6732440073003564
23195,1986.828967,1986.908267,1,59604869,59607248,2379,0.7329457279330566
23196,1986.915,1987.056233,1,59607450,59611686,4236,0.6005734741316331
23197,1987.0579,1987.114767,1,59611737,59613443,1706,0.5992429776194186
23198,1987.121533,1987.1282,1,59613645,59613846,201,0.5245251456142348
23199,1987.133367,1987.1366,1,59614001,59614098,97,0.7116186923433618
23200,1987.165333,1987.192133,1,59614959,59615763,804,0.29777389642110863
23201,1987.204133,1987.2073,1,59616123,59616219,96,0.5882520824580185
23202,1987.209933,1987.218333,1,59616297,59616549,252,0.034480710932544
23203,1987.240867,1987.4823,1,59617226,59624469,7243,0.7197296366343953
23204,1987.490733,1987.493867,1,59624721,59624816,95,0.8757325315932645
23205,1987.498,1987.5066,1,59624940,59625198,258,0.13713338537070757
23206,1987.512733,1987.5358,1,59625381,59626074,693,0.2133813185624417
23207,1987.5388,1987.5574,1,59626164,59626722,558,0.4882697733832256
23208,1987.5665,1987.5712,1,59626995,59627136,141,0.6609393284657088
23209,1987.584633,1987.589967,1,59627538,59627699,161,0.7653846831227674
23210,1987.592533,1987.610667,1,59627775,59628320,545,0.6890550058629735
23211,1987.847233,1987.851267,1,59635416,59635538,122,0.7758019577741103
23212,1987.868833,1987.888,1,59636064,59636640,576,0.6671056248773571
23213,1987.891567,1987.9077,1,59636747,59637231,484,0.7120674560877721
23214,1987.926667,1987.932033,1,59637800,59637960,160,0.34211122168664954
23215,1988.012533,1988.038733,1,59640375,59641161,786,0.7271997213634548
23216,1988.040933,1988.058533,1,59641227,59641755,528,0.6681238767331821
23217,1988.0859,1988.254967,1,59642577,59647649,5072,0.7307693636942831
23218,1988.257167,1988.3598,1,59647715,59650794,3079,0.7600411883531877
23219,1988.364,1988.371667,1,59650920,59651150,230,0.7399684680436698
23220,1988.396533,1988.410633,1,59651895,59652318,423,0.34634017941946066
23221,1988.423033,1988.621233,1,59652690,59658636,5946,0.6623292594401263
23222,1988.623133,1988.6339,1,59658693,59659017,324,0.778319281039682
23223,1988.644733,1988.649367,1,59659341,59659481,140,0.4757228157438026
23224,1988.667633,1988.6749,1,59660028,59660247,219,0.5836808114930614
23225,1988.676833,1988.709767,1,59660304,59661293,989,0.10376676140510196
23226,1988.712733,1988.717833,1,59661381,59661534,153,0.5667022226477602
23227,1988.7256,1988.735267,1,59661768,59662058,290,0.24696556182343962
23228,1988.7363,1988.759867,1,59662089,59662796,707,0.23115263406109537
23229,1988.760867,1988.7827,1,59662826,59663481,655,0.5477914170867249
23230,1988.784233,1988.811733,1,59663526,59664351,825,0.18791633822448808
23231,1988.813233,1988.817167,1,59664396,59664515,119,0.8403915968729265
23232,1988.819067,1988.826833,1,59664572,59664804,232,0.2952827159541124
23233,1988.8327,1988.835967,1,59664981,59665079,98,0.578831817468324
23234,1988.8408,1988.854833,1,59665224,59665644,420,0.15577113453027977
23235,1988.9071,1988.9165,1,59667213,59667495,282,0.9046643016848156
23236,1988.917567,1988.920833,1,59667527,59667624,97,0.9059052901764221
23237,1988.925133,1988.9283,1,59667753,59667849,96,0.9053649370626712
23238,1988.951867,1988.964233,1,59668556,59668926,370,0.5683927554366056
23239,1988.9678,1988.997667,1,59669034,59669930,896,0.6714107353505789
23240,1989.013233,1989.048033,1,59670396,59671440,1044,0.7540303921467523
23241,1989.0556,1989.063133,1,59671668,59671893,225,0.7925303524966139
23242,1989.0805,1989.0836,1,59672415,59672508,93,0.7508103312726417
23243,1989.087967,1989.123133,1,59672639,59673693,1054,0.7687069094540512
23244,1989.133233,1989.184167,1,59673996,59675525,1529,0.6774309211341827
23245,1989.203433,1989.321,1,59676102,59679630,3528,0.6112759175985774
23246,1989.3383,1989.342867,1,59680149,59680286,137,0.25780627836020853
23247,1989.360733,1989.380633,1,59680821,59681418,597,0.18483132896426716
23248,1989.387967,1989.637167,1,59681639,59689115,7476,0.7551150335623088
23249,1989.651833,1989.657033,1,59689554,59689710,156,0.7922045341342584
23250,1989.665767,1989.6724,1,59689973,59690172,199,0.6489909461079191
23251,1989.678967,1989.737767,1,59690369,59692133,1764,0.287626721078962
23252,1989.743667,1989.7517,1,59692310,59692551,241,0.5836600267137111
23253,1989.760067,1989.770867,1,59692802,59693126,324,0.7317086485041768
23254,1989.786467,1989.807767,1,59693594,59694233,639,0.24460904128209016
23255,1989.809733,1989.817933,1,59694291,59694537,246,0.6436667048823911
23256,1989.947033,1989.9538,1,59698410,59698614,204,0.7326258131699114
23257,1989.959833,1990.026633,1,59698794,59700798,2004,0.8227052597385022
23258,1990.087333,1990.094,1,59702619,59702820,201,0.7582207522759791
23259,1990.096167,1990.106633,1,59702885,59703198,313,0.6819672090558538
23260,1990.111633,1990.115467,1,59703348,59703464,116,0.8224575986332844
23261,1990.401233,1990.411867,1,59712036,59712356,320,0.5681521001608155
23262,1990.419167,1990.469533,1,59712575,59714085,1510,0.7088231875176217
23263,1990.5642,1990.6218,1,59716926,59718654,1728,0.7674744955985662
23264,1990.623133,1990.631533,1,59718693,59718945,252,0.524025895978676
23265,1990.633167,1990.715567,1,59718995,59721467,2472,0.7093738942667127
23266,1990.7172,1990.752233,1,59721516,59722566,1050,0.7673798552334552
23267,1990.7563,1991.036033,1,59722689,59731080,8391,0.7431990230613851
23268,1991.037133,1991.0465,1,59731113,59731395,282,0.8024431599975432
23269,1991.0772,1991.1003,1,59732316,59733009,693,0.22353003831435772
23270,1991.105367,1991.1124,1,59733161,59733372,211,0.14965331905851087
23271,1991.1217,1991.135367,1,59733651,59734061,410,0.26976030813321206
23272,1991.154667,1991.2563,1,59734640,59737689,3049,0.7832123745398984
23273,1991.265733,1991.293333,1,59737971,59738799,828,0.6765055228579945
23274,1991.351567,1991.609867,1,59740547,59748296,7749,0.7123714438274847
23275,1991.622933,1991.641667,1,59748687,59749250,563,0.6514359547323801
23276,1991.6829,1991.690633,1,59750487,59750718,231,0.4499029209668539
23277,1991.743567,1991.755533,1,59752307,59752665,358,0.27275179058610666
23278,1991.7598,1991.7665,1,59752794,59752995,201,0.7676470796424242
23279,1991.768933,1991.7722,1,59753067,59753166,99,0.5325699310744728
23280,1991.8201,1991.8287,1,59754603,59754861,258,0.7057251657975695
23281,1991.9593,1991.966567,1,59758779,59758997,218,0.05838130396196839
23282,1992.028167,1992.031667,1,59760845,59760950,105,0.9306879618740922
23283,1992.0422,1992.068767,1,59761266,59762063,797,0.8104114213255837
23284,1992.070733,1992.100067,1,59762121,59763002,881,0.7541313031602432
23285,1992.1059,1992.130467,1,59763177,59763914,737,0.6681037976917035
23286,1992.139967,1992.1479,1,59764199,59764437,238,0.6560831714429073
23287,1992.168533,1992.205533,1,59765055,59766165,1110,0.607447834553736
23288,1992.273167,1992.2818,1,59768195,59768454,259,0.602663104560873
23289,1992.2829,1992.325967,1,59768487,59769779,1292,0.8338099554006054
23290,1992.3313,1992.334833,1,59769939,59770044,105,0.7182400023285068
23291,1992.344867,1992.381033,1,59770346,59771430,1084,0.8132727004841448
23292,1992.390333,1992.399167,1,59771709,59771975,266,0.6541656925444855
23293,1992.406467,1992.4162,1,59772194,59772486,292,0.573653081760623
23294,1992.483367,1992.494967,1,59774501,59774849,348,0.6246758775622236
23295,1992.507767,1992.5181,1,59775233,59775543,310,0.663473839895785
23296,1992.5209,1992.544567,1,59775627,59776337,710,0.6568874190355349
23297,1992.614033,1992.803767,1,59778420,59784113,5693,0.6406474997236767
23298,1992.808267,1992.827767,1,59784248,59784833,585,0.6541671689534672
23299,1992.831067,1992.858267,1,59784932,59785748,816,0.6874850854672087
23300,1992.865733,1992.8707,1,59785971,59786121,150,0.6882829827777092
23301,1992.884633,1992.8883,1,59786538,59786649,111,0.7676345109792123
23302,1992.898867,1992.9055,1,59786966,59787165,199,0.48481203947514007
23303,1992.911467,1992.921267,1,59787344,59787638,294,-0.12859898703855058
23304,1992.9225,1992.9264,1,59787675,59787792,117,0.9258032911443813
23305,1992.929033,1992.959,1,59787870,59788770,900,0.15484912696179767
23306,1992.962533,1992.975767,1,59788875,59789273,398,0.7204183907091641
23307,1992.991267,1993.001267,1,59789738,59790038,300,0.4458903000274424
23308,1993.316967,1993.610467,1,59799509,59808314,8805,0.7771428034417487
23309,1993.639767,1993.643733,1,59809193,59809311,118,0.7774556534044967
23310,1993.647867,1993.6759,1,59809436,59810277,841,0.220970466478964
23311,1993.681567,1993.684567,1,59810447,59810537,90,0.7365290832745672
23312,1993.687833,1993.693133,1,59810634,59810793,159,0.5649927543091678
23313,1993.705933,1993.717633,1,59811177,59811528,351,0.17948945474265035
23314,1993.723433,1993.913833,1,59811702,59817414,5712,0.7635807957095673
23315,1993.926,1993.9422,1,59817780,59818266,486,0.7804263169671243
23316,1993.948333,1993.980833,1,59818449,59819424,975,0.7322777428849131
23317,1994.3267,1994.4106,1,59829801,59832318,2517,0.7881559713401839
23318,1994.4116,1994.4234,1,59832348,59832702,354,0.5277481124053066
23319,1994.563433,1994.648867,1,59836902,59839466,2564,0.6963629979282685
23320,1994.663433,1994.972567,1,59839902,59849177,9275,0.7243704691540495
23321,1995.0207,1995.030267,1,59850621,59850908,287,0.6065263337188346
23322,1995.0384,1995.077267,1,59851152,59852318,1166,0.7188421454460489
23323,1995.0789,1995.230533,1,59852367,59856915,4548,0.7515689833541839
23324,1995.234833,1995.2847,1,59857044,59858541,1497,0.7156021046426964
23325,1995.7801,1995.784967,1,59873403,59873549,146,0.8508957943252945
23326,1995.786167,1995.8186,1,59873585,59874558,973,0.805752267354644
23327,1995.8662,1995.8706,1,59875986,59876118,132,0.400874041646142
23328,1995.872933,1995.8825,1,59876187,59876475,288,0.583418924563008
23329,1995.884733,1995.922467,1,59876541,59877674,1133,0.6978382041789702
23330,1995.928433,1996.2026,1,59877852,59886078,8226,0.7083995710857655
23331,1996.259633,1996.527033,1,59887788,59895810,8022,0.7306925078081652
23332,1996.577467,1996.594333,1,59897324,59897829,505,0.0770387339635191
23333,1996.597167,1996.601433,1,59897915,59898042,127,-0.10454770664080852
23334,1996.618733,1996.625067,1,59898561,59898752,191,0.3250786221619226
23335,1996.630433,1996.644933,1,59898912,59899347,435,0.30558220135269415
23336,1996.6466,1996.655933,1,59899398,59899677,279,0.7451021440231167
23337,1996.6752,1996.6783,1,59900256,59900349,93,0.7041819168663757
23338,1996.681867,1996.714,1,59900456,59901420,964,0.32253433498351414
23339,1996.716133,1996.725867,1,59901483,59901776,293,0.8146675837111801
23340,1996.7269,1996.886367,1,59901807,59906591,4784,0.730238951554712
23341,1996.893133,1996.922233,1,59906793,59907666,873,0.6917731963297865
23342,1996.960633,1996.9881,1,59908818,59909643,825,0.24540088335701335
23343,1996.993033,1997.009233,1,59909790,59910276,486,0.6819582093239971
23344,1997.021067,1997.0435,1,59910632,59911305,673,0.49513114739530845
23345,1997.056433,1997.061867,1,59911692,59911856,164,0.4433571996810507
23346,1997.071867,1997.099633,1,59912156,59912988,832,0.31065677746546466
23347,1997.101967,1997.108933,1,59913059,59913267,208,0.25067139146902656
23348,1997.112733,1997.120133,1,59913381,59913603,222,0.20069510365033513
23349,1997.1334,1997.1435,1,59914002,59914305,303,0.2446814204239726
23350,1997.163567,1997.1681,1,59914907,59915043,136,0.8329821136661066
23351,1997.253467,1997.257467,1,59917604,59917724,120,0.8469961025438827
23352,1997.259767,1997.2671,1,59917793,59918013,220,0.6396863577846634
23353,1997.271767,1997.329433,1,59918153,59919882,1729,0.6249034235545831
23354,1997.339133,1997.3555,1,59920173,59920665,492,0.6681138972227249
23355,1997.374967,1997.410067,1,59921249,59922302,1053,0.7390793188400169
23356,1997.466267,1997.534833,1,59923988,59926044,2056,0.7640367491475757
23357,1997.5382,1997.552867,1,59926146,59926586,440,0.7812849059896334
23358,1997.554967,1997.6773,1,59926649,59930319,3670,0.7169427999249173
23359,1997.769067,1997.973067,1,59933072,59939192,6120,0.6956898426763669
23360,1997.976733,1997.998367,1,59939301,59939951,650,0.7264721042182398
23361,1998.0531,1998.06,1,59941593,59941800,207,0.9065669086063225
23362,1998.0634,1998.0727,1,59941902,59942181,279,0.7024048778334964
23363,1998.8558,1998.877267,1,59965674,59966318,644,-0.10636600350100678
23364,1998.886067,1998.8962,1,59966582,59966886,304,-0.04784229818656308
23365,1998.8982,1998.959033,1,59966946,59968770,1824,0.0983283974137995
23366,1998.966767,1999.000867,1,59969003,59970026,1023,0.3534871179735884
23367,1999.015633,1999.025167,1,59970468,59970755,287,0.16285895949943183
23368,1999.073967,1999.124967,1,59972219,59973749,1530,0.6745398281068279
23369,1999.2192,1999.651233,1,59976576,59989536,12960,0.694479243460924
23370,2000.078167,2000.089533,1,60002345,60002685,340,0.46967852368682306
23371,2000.095167,2000.101633,1,60002855,60003048,193,0.6084003292732788
23372,2000.103767,2000.331533,1,60003113,60009945,6832,0.6936831780978254
23373,2000.353033,2000.3685,1,60010590,60011055,465,0.9192827229677721
23374,2000.3779,2000.436867,1,60011337,60013106,1769,0.32983333351071453
23375,2000.442867,2000.450567,1,60013286,60013517,231,0.8100029933620403
23376,2000.4725,2000.4982,1,60014175,60014946,771,0.2042920668988314
23377,2000.4992,2000.5029,1,60014976,60015087,111,0.4383309069369566
23378,2000.5067,2000.515733,1,60015201,60015471,270,0.1508271912325325
23379,2000.522433,2000.535733,1,60015672,60016071,399,0.302238695250337
23380,2000.5426,2000.566067,1,60016278,60016982,704,0.7735383146801327
23381,2000.5711,2000.5798,1,60017133,60017394,261,0.5643323991141524
23382,2000.5842,2000.607367,1,60017526,60018221,695,0.25898425868655184
23383,2000.609633,2000.616733,1,60018288,60018501,213,0.3646946343901027
23384,2000.640767,2000.655,1,60019223,60019650,427,0.10149538119152861
23385,2000.658167,2000.661233,1,60019745,60019836,91,0.6584564411787538
23386,2000.682533,2000.842367,1,60020475,60025271,4796,0.7652536987097096
23387,2000.8478,2000.864733,1,60025434,60025941,507,0.659266468479335
23388,2000.8706,2000.9222,1,60026118,60027666,1548,0.7056286521474409
23389,2000.954367,2000.964,1,60028631,60028920,289,0.446815340751746
23390,2001.0142,2001.047,1,60030426,60031410,984,0.27003361172791257
23391,2001.0483,2001.051767,1,60031449,60031553,104,0.7664009537050834
23392,2001.054333,2001.0775,1,60031629,60032325,696,0.8561807268103248
23393,2001.083033,2001.099,1,60032490,60032970,480,0.22698718767000675
23394,2001.119333,2001.122767,1,60033579,60033683,104,0.27753609589183903
23395,2001.143667,2001.164433,1,60034310,60034932,622,0.1690581185956941
23396,2001.165967,2001.176833,1,60034979,60035304,325,0.5805112248955177
23397,2001.2247,2001.2285,1,60036741,60036855,114,0.3632978649405582
23398,2001.3304,2001.449033,1,60039912,60043470,3558,0.7130330380781896
23399,2001.529633,2001.700233,1,60045888,60051006,5118,0.8056090764807136
23400,2001.748833,2001.755433,1,60052464,60052662,198,0.7161721704673368
23401,2001.764633,2001.820633,1,60052938,60054618,1680,0.7556801968290721
23402,2001.822567,2001.828067,1,60054677,60054842,165,0.6929408685046997
23403,2001.8293,2001.834633,1,60054879,60055038,159,0.7048341963280663
23404,2001.836867,2001.842833,1,60055106,60055284,178,0.6456758673850861
23405,2001.843867,2001.886667,1,60055316,60056600,1284,0.6572746333452756
23406,2001.9548,2002.1509,1,60058644,60064527,5883,0.76114063912166
23407,2002.159067,2002.182033,1,60064772,60065460,688,0.7228200679488092
23408,2002.257333,2002.264467,1,60067719,60067934,215,0.3398066768664005
23409,2002.675867,2002.7406,1,60080276,60082218,1942,0.7359788125437837
23410,2002.8365,2003.2112,1,60085095,60096336,11241,0.7686353372108522
23411,2003.5849,2003.587933,1,60107547,60107637,90,0.6478453828101982
23412,2003.604267,2003.654167,1,60108128,60109625,1497,0.7416171470350852
23413,2003.6585,2003.6664,1,60109755,60109992,237,0.8088848243855711
23414,2003.678033,2003.693733,1,60110340,60110811,471,0.5028887101192459
23415,2003.698933,2003.702433,1,60110967,60111072,105,0.5159698542673692
23416,2003.706033,2003.725,1,60111180,60111750,570,0.5962261602468438
23417,2003.781833,2003.801,1,60113454,60114030,576,0.697782515523976
23418,2003.804533,2003.825733,1,60114135,60114771,636,0.6296074252041887
23419,2003.841367,2003.883633,1,60115241,60116508,1267,0.6461713693972679
23420,2003.933967,2003.9673,1,60118019,60119019,1000,0.6628076941816637
23421,2004.044833,2004.2133,1,60121344,60126399,5055,0.7633546965786516
23422,2004.2197,2004.258567,1,60126591,60127757,1166,0.7396126539438468
23423,2004.383267,2004.4263,1,60131498,60132789,1291,0.21946101560941655
23424,2004.433233,2004.436267,1,60132996,60133088,92,0.8925408038979272
23425,2004.444,2004.459767,1,60133320,60133793,473,0.18399005370177934
23426,2004.461167,2004.4658,1,60133835,60133974,139,0.3846274987553891
23427,2004.4785,2004.484167,1,60134355,60134525,170,0.16872924278841533
23428,2004.488767,2004.493833,1,60134663,60134814,151,-0.1009871261339263
23429,2004.517667,2004.523967,1,60135530,60135719,189,0.7001514353884145
23430,2004.532533,2004.537267,1,60135975,60136118,143,0.5740209172841616
23431,2004.7101,2004.719267,1,60141303,60141578,275,0.14215510522288688
23432,2004.7207,2004.823967,1,60141621,60144719,3098,0.6559848262612756
23433,2004.8307,2004.8344,1,60144921,60145032,111,0.3932769166009111
23434,2004.914367,2004.944233,1,60147431,60148326,895,0.6842194229422806
23435,2004.946233,2005.0282,1,60148386,60150846,2460,0.7576396085507335
23436,2005.037367,2005.057567,1,60151121,60151727,606,0.7470419815084857
23437,2005.058733,2005.0618,1,60151761,60151854,93,0.3716265582944109
23438,2005.248333,2005.251933,1,60157449,60157557,108,0.8421943033212415
23439,2005.297267,2005.3336,1,60158918,60160008,1090,0.6605121032688891
23440,2005.3456,2005.371667,1,60160368,60161150,782,0.7823229269629891
23441,2005.372967,2005.383,1,60161189,60161490,301,0.7836858710025625
23442,2005.3844,2005.4071,1,60161532,60162213,681,0.7699723916543951
23443,2005.408433,2005.413,1,60162252,60162390,138,0.9164015088146414
23444,2005.415067,2005.4211,1,60162452,60162633,181,0.9021987495712263
23445,2005.4245,2005.428067,1,60162735,60162842,107,-0.055848837698995825
23446,2005.4404,2005.447667,1,60163212,60163430,218,0.8571264776363744
23447,2005.5132,2005.5708,1,60165396,60167124,1728,0.6803686566646248
23448,2005.572067,2005.6782,1,60167162,60170346,3184,0.7052133353265686
23449,2005.712267,2005.772867,1,60171368,60173186,1818,0.449640386192733
23450,2005.817433,2005.8284,1,60174522,60174852,330,0.6718600319855279
23451,2005.844333,2005.9992,1,60175329,60179976,4647,0.7506830689549335
23452,2006.005133,2006.031733,1,60180153,60180951,798,0.714171096143581
23453,2006.075933,2006.1455,1,60182277,60184365,2088,0.28860833229048094
23454,2006.148433,2006.157233,1,60184452,60184716,264,0.8358661562633063
23455,2006.1588,2006.196833,1,60184764,60185904,1140,0.51287708735659
23456,2006.1979,2006.222033,1,60185937,60186660,723,0.04072043089072982
23457,2006.223367,2006.2365,1,60186701,60187095,394,0.10692692411025692
23458,2006.244967,2006.256333,1,60187349,60187689,340,0.09212890333793859
23459,2006.2617,2006.2933,1,60187851,60188799,948,0.2989703952845136
23460,2006.296367,2006.308433,1,60188891,60189252,361,0.3891164199949123
23461,2006.319167,2006.4073,1,60189575,60192219,2644,0.12106947904080007
23462,2006.425433,2006.434133,1,60192762,60193023,261,0.5749852730514012
23463,2006.439267,2006.5267,1,60193178,60195801,2623,0.732714992397379
23464,2006.529433,2006.579067,1,60195882,60197372,1490,0.7657802875312562
23465,2006.5853,2006.6486,1,60197559,60199458,1899,-0.04495985955195255
23466,2006.6538,2006.7002,1,60199614,60201006,1392,0.44274262922883845
23467,2006.703867,2006.750967,1,60201116,60202529,1413,0.15912708462692507
23468,2006.7564,2006.7611,1,60202692,60202833,141,0.5445839255292084
23469,2006.766833,2006.7999,1,60203004,60203997,993,0.2432863534696354
23470,2006.833233,2006.912667,1,60204996,60207380,2384,0.7051571084594555
23471,2006.9184,2007.023667,1,60207552,60210710,3158,0.6487432989192401
23472,2007.084833,2007.0952,1,60212544,60212856,312,0.6416557838672621
23473,2007.1047,2007.1304,1,60213141,60213912,771,0.6757333164566153
23474,2007.132033,2007.215967,1,60213960,60216479,2519,0.7258481253101917
23475,2007.2187,2007.242867,1,60216561,60217286,725,0.7171749594598199
23476,2007.3513,2007.359633,1,60220539,60220788,249,0.17698090817803033
23477,2007.400233,2007.561567,1,60222006,60226847,4841,0.7354541107489323
23478,2007.564033,2007.593567,1,60226920,60227807,887,0.7159341162313034
23479,2007.594967,2007.6423,1,60227849,60229269,1420,0.6453115745871689
23480,2007.7596,2007.791,1,60232788,60233730,942,0.7340384599025496
23481,2007.795433,2007.964133,1,60233862,60238923,5061,0.6511012808230882
23482,2007.969033,2007.9983,1,60239070,60239949,879,0.5590153675156129
23483,2008.3335,2008.348433,1,60250005,60250452,447,0.18047977056931566
23484,2008.386167,2008.411267,1,60251585,60252338,753,0.11286914360565789
23485,2008.460267,2008.463467,1,60253808,60253904,96,0.8907586853280639
23486,2008.473767,2008.4768,1,60254213,60254304,91,0.8678431224539964
23487,2008.492733,2008.553233,1,60254781,60256596,1815,0.6834590444062507
23488,2008.559833,2008.622467,1,60256794,60258674,1880,0.38505787314989354
23489,2008.630633,2008.645,1,60258918,60259350,432,0.09498655949815966
23490,2008.730767,2008.7343,1,60261923,60262029,106,0.4542906673901785
23491,2008.7357,2008.809367,1,60262071,60264281,2210,0.646435357089755
23492,2008.810733,2008.8141,1,60264321,60264423,102,0.7193599975033632
23493,2008.817367,2008.8635,1,60264521,60265905,1384,0.6083938213077544
23494,2008.957967,2009.112633,1,60268739,60273378,4639,0.7054263386242026
23495,2010.165867,2010.259733,1,60304976,60307791,2815,0.11886510906703616
23496,2010.274367,2010.3025,1,60308231,60309075,844,0.10425536086099571
23497,2010.306733,2010.310067,1,60309201,60309302,101,0.8556728861144814
23498,2010.311867,2010.337867,1,60309356,60310136,780,0.05306962471778091
23499,2010.3485,2010.4491,1,60310455,60313473,3018,0.16401780959034945
23500,2010.450633,2010.463133,1,60313518,60313893,375,0.22560839168997074
23501,2010.4642,2010.488967,1,60313926,60314669,743,0.14744851996534836
23502,2010.505033,2010.5395,1,60315150,60316185,1035,0.06432711614031512
23503,2010.5489,2010.614567,1,60316467,60318437,1970,0.24311818341470037
23504,2010.631167,2010.637133,1,60318935,60319113,178,0.7791572553747953
23505,2010.685367,2010.696433,1,60320561,60320892,331,0.18082321298793969
23506,2010.853633,2010.857033,1,60325608,60325710,102,0.4911102275956411
23507,2010.872167,2010.948733,1,60326165,60328461,2296,0.6384118774533923
23508,2010.9556,2010.959867,1,60328668,60328796,128,0.5582403999967605
23509,2011.0531,2011.1468,1,60331593,60334404,2811,0.6244858607210603
23510,2011.152933,2011.3429,1,60334587,60340287,5700,0.7159031972860279
23511,2011.3471,2011.434,1,60340413,60343020,2607,0.6810518750112806
23512,2011.724533,2011.8449,1,60351735,60355347,3612,0.6109297456989773
23513,2011.8522,2011.8553,1,60355566,60355659,93,0.9402178621669453
23514,2012.023933,2012.0276,1,60360717,60360828,111,0.6802072603914806
23515,2012.064167,2012.073233,1,60361925,60362196,271,0.14912197256607512
23516,2012.076667,2012.0919,1,60362300,60362757,457,0.11097885675128444
23517,2012.092933,2012.196733,1,60362787,60365901,3114,0.09528635264875306
23518,2012.2011,2012.236767,1,60366033,60367103,1070,0.21779173801059107
23519,2012.243233,2012.268333,1,60367296,60368049,753,0.20297301994278344
23520,2012.275767,2012.357533,1,60368273,60370725,2452,0.12576518052358554
23521,2012.358767,2012.363767,1,60370763,60370913,150,0.5394642598958876
23522,2012.371533,2012.407467,1,60371145,60372224,1079,0.12471180451520521
23523,2012.4135,2012.428467,1,60372405,60372854,449,0.5147456514548244
23524,2012.453733,2012.4718,1,60373611,60374154,543,0.32201058021450996
23525,2012.478167,2012.547467,1,60374345,60376424,2079,0.20485797807423323
23526,2012.562333,2012.567567,1,60376869,60377027,158,0.9087093981785865
23527,2012.653933,2012.6623,1,60379617,60379869,252,0.05782784496870663
23528,2012.697533,2012.705333,1,60380925,60381159,234,0.11253638562579664
23529,2012.706967,2012.7151,1,60381209,60381453,244,0.20258915440597572
23530,2012.716167,2012.732567,1,60381485,60381977,492,0.42265104300972867
23531,2012.947567,2013.107833,1,60388427,60393234,4807,0.7367578331062394
23532,2013.109967,2013.121033,1,60393299,60393630,331,0.3972751807294672
23533,2013.179067,2013.191933,1,60395372,60395757,385,0.7803998131120511
23534,2013.231333,2013.302533,1,60396939,60399075,2136,0.36681740296451576
23535,2013.310033,2013.381333,1,60399300,60401439,2139,0.20778978603030754
23536,2013.386833,2013.3928,1,60401604,60401784,180,0.7111248420054147
23537,2013.394433,2013.4174,1,60401832,60402522,690,0.467344103749674
23538,2013.423333,2013.513533,1,60402699,60405405,2706,0.7155648386053111
23539,2013.516067,2013.625167,1,60405482,60408755,3273,0.7861332798785673
23540,2013.6472,2013.650467,1,60409416,60409514,98,0.6912033900281295
23541,2013.665533,2013.668567,1,60409965,60410057,92,0.8888399827693002
23542,2013.6718,2013.685267,1,60410154,60410558,404,0.3376716205807801
23543,2013.713933,2013.750333,1,60411417,60412509,1092,0.39103205342174785
23544,2013.751333,2013.765633,1,60412539,60412968,429,0.5775657561500068
23545,2013.7719,2013.778833,1,60413157,60413364,207,0.8798100406288364
23546,2013.788267,2013.8041,1,60413648,60414123,475,0.5944310629087021
23547,2013.807,2013.8105,1,60414210,60414315,105,0.8989697131291684
23548,2013.820033,2013.828833,1,60414600,60414864,264,0.21631512057085592
23549,2013.875967,2013.8846,1,60416279,60416538,259,0.7526739889554034
23550,2013.885933,2013.897467,1,60416577,60416924,347,0.6041600584376655
23551,2013.8985,2013.9186,1,60416955,60417558,603,0.7466309789279535
23552,2013.924433,2013.929033,1,60417732,60417870,138,0.7624646816054992
23553,2013.939733,2013.9678,1,60418191,60419034,843,0.31680395659735194
23554,2013.988267,2014.004967,1,60419648,60420149,501,-0.03024670903077354
23555,2014.022767,2014.033533,1,60420683,60421005,322,0.34681192394342064
23556,2014.058867,2014.063667,1,60421766,60421910,144,0.8923272669454884
23557,2014.0768,2014.1065,1,60422304,60423195,891,0.5589650732752555
23558,2014.108967,2014.338667,1,60423269,60430160,6891,0.7162035011099742
23559,2014.473733,2014.4818,1,60434211,60434454,243,0.5495493562535738
23560,2014.4828,2014.620067,1,60434484,60438602,4118,0.7729931263081308
23561,2019.3982,2019.4015,1,60581946,60582045,99,-0.28231889420892786
23562,2024.327267,2024.4305,1,60729818,60732915,3097,0.12583337124656477
23563,2024.432533,2024.4774,1,60732975,60734322,1347,0.29312856681901645
23564,2024.492467,2024.513767,1,60734774,60735413,639,0.14146506256599417
23565,2024.5159,2024.5441,1,60735477,60736323,846,0.44948938979249403
23566,2024.5733,2024.6295,1,60737199,60738885,1686,0.35022281880262257
23567,2024.654233,2024.6598,1,60739626,60739794,168,0.6771463872265778
23568,2024.980933,2024.9869,1,60749427,60749607,180,0.13982673284179004
23569,2024.991967,2025.007067,1,60749759,60750212,453,0.12256111192081169
23570,2025.044767,2025.0614,1,60751343,60751842,499,0.23765328220010873
23571,2027.621133,2027.7136,1,60828633,60831408,2775,0.24543885351304093
23572,2027.781267,2027.807867,1,60833438,60834236,798,0.2756643164915468
23573,2027.809033,2027.928467,1,60834270,60837854,3584,0.28798566866571257
23574,2028.3314,2028.403467,1,60849942,60852104,2162,0.09476565781903784
23575,2028.4052,2028.408833,1,60852156,60852264,108,0.6945130549658861
23576,2028.411233,2028.4158,1,60852336,60852474,138,0.9201424226989703
23577,2028.4208,2028.429433,1,60852624,60852882,258,0.7965619410927068
23578,2028.4314,2028.453967,1,60852942,60853619,677,0.14643439495994645
23579,2028.464667,2028.482733,1,60853940,60854481,541,0.04431566099681149
23580,2028.5002,2028.607067,1,60855006,60858212,3206,0.29263718222316
23581,2029.072967,2029.241333,1,60872189,60877239,5050,0.7167591392044634
23582,2029.436633,2029.602633,1,60883098,60888078,4980,0.7609633501399519
23583,2029.831,2029.836267,1,60894930,60895088,158,0.6750342390705575
23584,2029.8551,2029.862367,1,60895653,60895871,218,0.4637061405961682
23585,2029.868333,2029.871667,1,60896049,60896150,101,0.5532598168774876
23586,2029.875967,2029.885633,1,60896279,60896568,289,0.3342407061008573
23587,2029.9313,2029.9368,1,60897939,60898104,165,0.7954203230969898
23588,2029.941767,2030.079467,1,60898253,60902384,4131,0.14788904734261543
23589,2030.0806,2030.1105,1,60902418,60903315,897,0.07918949201061108
23590,2030.117367,2030.1943,1,60903521,60905829,2308,0.04570479401153723
23591,2030.2138,2030.254567,1,60906414,60907637,1223,0.0826788642540652
23592,2030.2735,2030.330033,1,60908205,60909900,1695,0.1354169786369016
23593,2030.3887,2030.398833,1,60911661,60911964,303,0.9322608301832014
23594,2031.246633,2031.2549,1,60937398,60937647,249,0.15909145833818328
23595,2031.256167,2031.376967,1,60937685,60941309,3624,0.1606607676344394
23596,2031.381,2031.4678,1,60941430,60944034,2604,0.0593041297011129
23597,2031.473,2031.564567,1,60944190,60946937,2747,0.27801691488326097
23598,2031.6432,2031.8351,1,60949296,60955053,5757,0.7212268365585967
23599,2031.837133,2031.858367,1,60955113,60955751,638,0.68154397198266
23600,2031.863233,2031.868033,1,60955896,60956040,144,0.2809798309087072
23601,2031.869767,2031.890367,1,60956093,60956711,618,0.5289962353048319
23602,2032.136767,2032.211467,1,60964103,60966344,2241,0.6408251366611651
23603,2032.4571,2032.533933,1,60973713,60976017,2304,0.6816840805197424
23604,2032.802667,2032.810233,1,60984080,60984306,226,0.4612584121973749
23605,2032.8119,2032.934667,1,60984357,60988040,3683,0.6763199612455751
23606,2033.122733,2033.1264,1,60993681,60993792,111,0.6752064499167678
23607,2033.132033,2033.139533,1,60993960,60994185,225,0.620458309447035
23608,2033.1436,2033.205233,1,60994308,60996156,1848,0.09030390136079403
23609,2033.215433,2033.236033,1,60996462,60997080,618,0.07741079858171336
23610,2033.277033,2033.299933,1,60998310,60998997,687,0.1778124720663079
23611,2033.301067,2033.304367,1,60999032,60999131,99,0.8141562221419371
23612,2033.307467,2033.433233,1,60999224,61002996,3772,0.0979803837501887
23613,2033.434233,2033.4644,1,61003026,61003932,906,0.58118381513916
23614,2033.465433,2033.500267,1,61003962,61005008,1046,0.39804748190064837
23615,2033.5324,2033.543567,1,61005972,61006307,335,0.059229920607747316
23616,2033.556267,2033.7625,1,61006688,61012875,6187,0.6715076735423281
23617,2034.0902,2034.131667,1,61022706,61023950,1244,0.7942440318724218
23618,2034.191867,2034.251767,1,61025756,61027553,1797,0.7829000404046321
23619,2034.310833,2034.3635,1,61029324,61030905,1581,0.7830554904942247
23620,2034.801433,2034.9029,1,61044042,61047087,3045,0.7093147161196695
23621,2034.906267,2034.967833,1,61047188,61049034,1846,0.677148135879706
23622,2035.143733,2035.148533,1,61054311,61054455,144,0.05126476679043551
23623,2035.167567,2035.1981,1,61055027,61055943,916,0.1464979795237044
23624,2035.2106,2035.231933,1,61056318,61056957,639,0.4289236386258516
23625,2035.2995,2035.3027,1,61058985,61059081,96,0.8477027319394407
23626,2035.3062,2035.367333,1,61059186,61061019,1833,0.6990097549763203
23627,2035.387467,2035.4697,1,61061624,61064091,2467,0.5849005018246355
23628,2035.5356,2035.585667,1,61066068,61067570,1502,0.6739616306719445
23629,2036.349733,2036.526233,1,61090491,61095786,5295,0.5584377853415987
23630,2036.529833,2036.582,1,61095894,61097460,1566,0.6860192935918596
23631,2036.778867,2036.878567,1,61103366,61106357,2991,0.6536992903331643
23632,2036.994,2037.1222,1,61109820,61113666,3846,0.7296389274932814
23633,2037.349,2037.428033,1,61120470,61122840,2370,0.16112139289088315
23634,2037.4327,2037.481967,1,61122981,61124459,1478,0.18771025109805708
23635,2037.483767,2037.514867,1,61124513,61125446,933,0.3295557900245169
23636,2037.516467,2037.5197,1,61125494,61125591,97,0.9081733227666358
23637,2037.542467,2037.6369,1,61126274,61129107,2833,0.2943486165544338
23638,2037.705633,2037.716533,1,61131168,61131495,327,0.2504686928622373
23639,2037.9184,2037.921933,1,61137552,61137657,105,0.7689795307431311
23640,2037.9343,2037.95,1,61138029,61138500,471,0.7668511732229616
23641,2037.975467,2037.985167,1,61139264,61139555,291,0.5017587727275368
23642,2038.129533,2038.138033,1,61143885,61144140,255,-0.020458641130951298
23643,2038.143333,2038.158667,1,61144299,61144760,461,0.13724444770207106
23644,2038.162067,2038.2001,1,61144862,61146003,1141,0.08959969160210883
23645,2038.214433,2038.226267,1,61146432,61146788,356,0.7700378482900065
23646,2038.227933,2038.236133,1,61146837,61147083,246,0.7855547722716908
23647,2038.240433,2038.2437,1,61147212,61147311,99,0.7661931862975103
23648,2038.2454,2038.2557,1,61147362,61147671,309,0.5584063682215937
23649,2038.278667,2038.290733,1,61148360,61148721,361,0.46246268292126164
23650,2038.329867,2038.332933,1,61149896,61149987,91,0.5811920382191215
23651,2038.479067,2038.4938,1,61154372,61154814,442,0.2567212985295713
23652,2038.494967,2038.532333,1,61154849,61155969,1120,0.36804074380213303
23653,2038.539567,2038.561,1,61156187,61156830,643,0.2556365488135817
23654,2038.5644,2038.588533,1,61156932,61157655,723,0.1481442501765471
23655,2038.591667,2038.648933,1,61157750,61159467,1717,0.21898886226968559
23656,2038.652767,2038.6646,1,61159583,61159938,355,0.8493847815261
23657,2038.6785,2038.693767,1,61160355,61160813,458,0.18563324283145743
23658,2038.716433,2038.721733,1,61161492,61161651,159,0.8930311545311894
23659,2038.729033,2038.734333,1,61161870,61162029,159,0.6070156870037434
23660,2038.741133,2038.745933,1,61162233,61162377,144,0.7514915034655457
23661,2038.754033,2038.7597,1,61162620,61162791,171,0.7522616306116332
23662,2038.760833,2038.7679,1,61162824,61163037,213,0.8629435006721636
23663,2038.7719,2038.7839,1,61163157,61163517,360,0.8272148446329358
23664,2038.785167,2038.793967,1,61163555,61163819,264,0.5977514243102319
23665,2038.817167,2038.8213,1,61164515,61164639,124,0.7121240708795009
23666,2038.8982,2038.911033,1,61166946,61167330,384,0.10933547483942296
23667,2038.9209,2038.984967,1,61167627,61169549,1922,0.6043176192470471
23668,2039.049867,2039.273233,1,61171496,61178196,6700,0.6500389769070127
23669,2039.4246,2039.4292,1,61182738,61182876,138,0.27791114018517904
23670,2039.430667,2039.482267,1,61182920,61184468,1548,0.6183165438961775
23671,2039.488367,2039.497733,1,61184651,61184931,280,0.5390429238825839
23672,2039.5129,2039.6138,1,61185387,61188414,3027,0.6751011597008769
23673,2039.792667,2039.895667,1,61193780,61196870,3090,0.6678121037457305
23674,2040.005367,2040.1524,1,61200161,61204572,4411,0.7379891593322684
23675,2040.360033,2040.376233,1,61210800,61211286,486,0.2378221067640112
23676,2040.378067,2040.6789,1,61211342,61220367,9025,0.5559197637343857
23677,2040.690067,2040.696167,1,61220702,61220885,183,0.6943584056870172
23678,2040.8676,2040.915167,1,61226028,61227455,1427,0.7336440616804464
23679,2041.178967,2041.240267,1,61235369,61237208,1839,0.7813560939362283
23680,2041.766167,2041.879467,1,61252985,61256384,3399,0.1929214907161766
23681,2041.884,2041.938,1,61256520,61258140,1620,0.15529665534861858
23682,2041.942067,2042.023433,1,61258262,61260702,2440,0.09596464728790997
23683,2042.027333,2042.032433,1,61260819,61260972,153,0.8569941697543033
23684,2042.052167,2042.0654,1,61261565,61261962,397,-0.005777947731589025
23685,2042.0698,2042.122767,1,61262094,61263683,1589,0.13605370612379994
23686,2042.1259,2042.135533,1,61263777,61264065,288,0.3758652758384491
23687,2042.137467,2042.1405,1,61264124,61264215,91,0.6461648544838899
23688,2042.141633,2042.1485,1,61264248,61264455,207,0.6065738073000047
23689,2042.241033,2042.2645,1,61267230,61267935,705,0.36785788972602756
23690,2042.5883,2042.724433,1,61277649,61281732,4083,0.7241618288065703
23691,2042.726167,2042.738967,1,61281785,61282169,384,0.5464550158614904
23692,2042.745467,2042.776433,1,61282364,61283292,928,0.72533559680315
23693,2043.028233,2043.141767,1,61290846,61294253,3407,0.7038858644994345
23694,2043.143333,2043.187033,1,61294299,61295610,1311,0.7254495981327879
23695,2043.194367,2043.295133,1,61295831,61298853,3022,0.7237710881069036
23696,2043.6469,2043.907867,1,61309407,61317236,7829,0.6252021049799016
23697,2044.006633,2044.020433,1,61320198,61320612,414,0.5597162796837848
23698,2044.022033,2044.0273,1,61320660,61320819,159,0.31729363914632386
23699,2044.028433,2044.079267,1,61320852,61322378,1526,0.6847874718551944
23700,2044.1896,2044.194767,1,61325688,61325843,155,0.5804640114810655
23701,2044.1984,2044.4998,1,61325952,61334994,9042,0.7167754486330695
23702,2044.7628,2044.7699,1,61342884,61343097,213,0.5451372337335746
23703,2044.772767,2044.881367,1,61343183,61346441,3258,0.6207985189128878
23704,2044.882433,2044.904,1,61346472,61347120,648,0.6250816370625744
23705,2045.0045,2045.037,1,61350135,61351110,975,0.735886637249403
23706,2045.0383,2045.043567,1,61351149,61351307,158,0.45493937147519425
23707,2045.052367,2045.057133,1,61351571,61351713,142,0.7886078831586951
23708,2045.258367,2045.346967,1,61357751,61360409,2658,0.6351306092111969
23709,2045.687267,2045.794567,1,61370618,61373837,3219,0.08247775209948932
23710,2045.795667,2045.899833,1,61373870,61376994,3124,0.10635085278325933
23711,2045.901067,2046.103033,1,61377032,61383090,6058,0.7303931824334978
23712,2046.108167,2046.1318,1,61383245,61383954,709,0.6487814337620775
23713,2046.134667,2046.164367,1,61384040,61384931,891,0.5741805376992517
23714,2046.291667,2046.2953,1,61388750,61388859,109,0.7231531949564083
23715,2046.2986,2046.447467,1,61388958,61393424,4466,0.7033452179831089
23716,2046.495067,2046.502333,1,61394852,61395069,217,0.550434992559047
23717,2046.5091,2046.5738,1,61395273,61397214,1941,0.6617092089610442
23718,2046.629467,2046.719133,1,61398884,61401573,2689,0.6458385714625925
23719,2046.763167,2046.777633,1,61402895,61403328,433,0.6183145100292975
23720,2047.041033,2047.0567,1,61411230,61411701,471,0.5009226979273348
23721,2047.0641,2047.0891,1,61411923,61412673,750,0.6751372645508615
23722,2047.097967,2047.244,1,61412939,61417320,4381,0.6824775073020564
23723,2047.249033,2047.2988,1,61417470,61418964,1494,0.6701509048792237
23724,2047.431233,2047.669333,1,61422936,61430079,7143,0.6840849634551084
23725,2047.777033,2047.798933,1,61433310,61433967,657,0.5419552109787308
23726,2047.8896,2047.916767,1,61436688,61437503,815,0.5881946751381402
23727,2047.990433,2048.024867,1,61439712,61440746,1034,0.6755364070848392
23728,2048.047733,2048.052433,1,61441431,61441572,141,0.675871754465689
23729,2048.072867,2048.100733,1,61442186,61443021,835,0.5534558940710153
23730,2048.123367,2048.1319,1,61443701,61443956,255,0.46700608310906533
23731,2048.1358,2048.147967,1,61444074,61444439,365,0.6141871662484998
23732,2048.1724,2048.1839,1,61445172,61445517,345,0.7072380229448115
23733,2048.1876,2048.205767,1,61445628,61446173,545,0.616581994783981
23734,2048.347,2048.350667,1,61450410,61450520,110,0.42183073778838687
23735,2048.3533,2048.387733,1,61450599,61451631,1032,0.4647238058710683
23736,2048.391567,2048.427833,1,61451747,61452834,1087,0.17581868655297325
23737,2048.436733,2048.440933,1,61453101,61453227,126,0.3824725395886567
23738,2048.444067,2048.4551,1,61453322,61453653,331,0.2092893097386358
23739,2048.4596,2048.473033,1,61453788,61454190,402,0.018301020026704282
23740,2048.476767,2048.486833,1,61454303,61454604,301,0.4677135850599911
23741,2048.488233,2048.4918,1,61454646,61454753,107,0.8376897869480341
23742,2048.4934,2048.497767,1,61454801,61454933,132,0.8796136618333387
23743,2048.4996,2048.533567,1,61454988,61456007,1019,0.20675294744810382
23744,2048.535133,2048.541033,1,61456053,61456230,177,0.6659241210563909
23745,2048.544467,2048.5514,1,61456334,61456541,207,0.30323858704664347
23746,2048.582267,2048.6177,1,61457468,61458530,1062,0.715574855066673
23747,2048.619833,2048.701333,1,61458594,61461039,2445,0.7476781131539478
23748,2048.7856,2048.797133,1,61463568,61463913,345,0.4690631172140706
23749,2048.806433,2048.891867,1,61464192,61466756,2564,0.5996301045931334
23750,2048.971167,2048.987633,1,61469135,61469628,493,0.30024246823013423
23751,2048.996967,2049.002767,1,61469909,61470083,174,0.687732620667139
23752,2049.0058,2049.084767,1,61470174,61472543,2369,0.3486241255478274
23753,2049.135567,2049.141533,1,61474067,61474245,178,0.692191552020355
23754,2049.142833,2049.154667,1,61474284,61474640,356,0.4166703597425192
23755,2049.156133,2049.180433,1,61474683,61475412,729,0.6861100397066587
23756,2049.1879,2049.218267,1,61475637,61476548,911,0.12076386911128757
23757,2049.259133,2049.307433,1,61477773,61479222,1449,0.32130709617709374
23758,2049.312167,2049.361733,1,61479365,61480851,1486,0.14952644763297882
23759,2049.3716,2049.392867,1,61481148,61481786,638,0.10974664678663859
23760,2049.3964,2049.402933,1,61481892,61482087,195,0.8264957486821181
23761,2049.420533,2049.446767,1,61482615,61483403,788,0.42668021083362384
23762,2049.457733,2049.483,1,61483731,61484490,759,0.509016543465209
23763,2049.498933,2049.5297,1,61484967,61485891,924,0.15759446896405516
23764,2049.5358,2049.5589,1,61486074,61486767,693,0.602528420290235
23765,2049.6029,2049.6109,1,61488086,61488327,241,0.06682642137165926
23766,2049.624467,2049.644167,1,61488734,61489325,591,0.24393965405174342
23767,2049.645567,2049.649233,1,61489367,61489476,109,0.8918647045113912
23768,2049.650267,2049.6611,1,61489508,61489832,324,0.7044574121582062
23769,2049.6624,2049.685333,1,61489872,61490559,687,0.570168563519907
23770,2049.6889,2049.710433,1,61490667,61491312,645,0.33934126267547743
23771,2049.777633,2049.789733,1,61493328,61493691,363,0.12800018393030527
23772,2049.804733,2049.871633,1,61494141,61496148,2007,0.647546019236678
23773,2049.8738,2049.897467,1,61496213,61496924,711,0.4260018758458803
23774,2049.9673,2049.9888,1,61499018,61499664,646,0.5922666726459771
23775,2049.995733,2050.007633,1,61499871,61500228,357,0.5252641908244595
23776,2050.035633,2050.072933,1,61501068,61502187,1119,0.4061703160888792
23777,2050.137267,2050.155767,1,61504118,61504673,555,0.5748319149316127
23778,2050.210133,2050.244,1,61506303,61507320,1017,0.5983567076848895
23779,2050.2547,2050.2669,1,61507641,61508007,366,0.5202602182958477
23780,2050.271767,2050.281167,1,61508153,61508435,282,0.6041796522122711
23781,2050.2868,2050.2979,1,61508603,61508937,334,0.6362028149696708
23782,2050.3026,2050.309467,1,61509078,61509284,206,0.5577766184726177
23783,2050.3362,2050.3653,1,61510086,61510959,873,0.6295791254101144
23784,2050.448267,2050.5897,1,61513448,61517691,4243,0.7259613546413513
23785,2050.687667,2050.7146,1,61520630,61521437,807,0.7089240312358749
23786,2050.832433,2050.862433,1,61524972,61525872,900,0.6008217865242718
23787,2050.864467,2050.870367,1,61525934,61526111,177,0.6935987953769771
23788,2050.8808,2050.887367,1,61526424,61526621,197,0.7562219536086903
23789,2050.889,2050.900667,1,61526670,61527020,350,0.7357797387075531
23790,2050.901667,2050.9085,1,61527050,61527255,205,0.7044230261369696
23791,2050.934767,2050.9421,1,61528043,61528263,220,0.416118306540697
23792,2050.951033,2050.9646,1,61528530,61528937,407,0.640970167847595
23793,2051.0302,2051.034167,1,61530906,61531025,119,0.5402867004805612
23794,2051.0356,2051.043667,1,61531068,61531310,242,0.612801719335371
23795,2051.245,2051.325767,1,61537350,61539773,2423,0.6640428633215202
23796,2051.4001,2051.454767,1,61542002,61543643,1641,0.5985421668431935
23797,2051.458867,2051.565633,1,61543766,61546968,3202,0.6899306434805006
23798,2051.647833,2051.662067,1,61549434,61549862,428,0.09582534875058048
23799,2051.665333,2051.7916,1,61549959,61553748,3789,0.7423189938368573
23800,2051.947033,2051.963367,1,61558410,61558901,491,0.6812461703573442
23801,2051.9667,2052.0641,1,61559001,61561923,2922,0.6768163283729471
23802,2052.0685,2052.0945,1,61562054,61562835,781,0.6130460600654596
23803,2052.098533,2052.1464,1,61562955,61564392,1437,0.6227392376255481
23804,2052.150733,2052.190833,1,61564521,61565724,1203,0.6469861641436906
23805,2052.194,2052.271233,1,61565820,61568136,2316,0.7145872841624399
23806,2052.280033,2052.371267,1,61568400,61571138,2738,0.7407603127635124
23807,2052.3766,2052.414167,1,61571298,61572425,1127,0.7439874341224881
23808,2052.511567,2052.5498,1,61575347,61576493,1146,0.22726493722970909
23809,2052.563867,2052.623367,1,61576916,61578701,1785,0.1901674831065067
23810,2052.655767,2052.661667,1,61579673,61579850,177,0.2503964383204951
23811,2052.667767,2052.746333,1,61580033,61582389,2356,0.6717707682154374
23812,2052.753367,2052.757,1,61582601,61582710,109,0.8764145541652999
23813,2052.760467,2052.9367,1,61582814,61588101,5287,0.6797448167219791
23814,2052.994333,2053.026633,1,61589829,61590798,969,0.6326332696696195
23815,2053.084467,2053.144033,1,61592534,61594320,1786,0.7783429243344288
23816,2053.220167,2053.228633,1,61596605,61596858,253,0.5708564132784917
23817,2053.2303,2053.376567,1,61596909,61601297,4388,0.6769257746299457
23818,2053.4004,2053.4055,1,61602012,61602164,152,0.7538309000974964
23819,2053.420433,2053.426433,1,61602612,61602792,180,0.4406568317699118
23820,2053.4535,2053.472933,1,61603605,61604187,582,0.4098336805921744
23821,2053.4765,2053.482267,1,61604295,61604468,173,0.6092979376951794
23822,2053.510767,2053.529867,1,61605323,61605896,573,0.32309542036088756
23823,2053.540333,2053.7362,1,61606209,61612085,5876,0.746149663101841
23824,2053.7499,2053.762267,1,61612496,61612868,372,0.6032028790684578
23825,2053.764367,2053.779167,1,61612931,61613375,444,0.570383074806648
23826,2053.841367,2053.846933,1,61615241,61615407,166,0.6142410777792654
23827,2053.889033,2053.9193,1,61616670,61617579,909,0.2592761817087233
23828,2053.928733,2054.000167,1,61617861,61620005,2144,0.04736544952849571
23829,2054.007533,2054.014633,1,61620225,61620438,213,0.08263208833584113
23830,2054.0252,2054.029033,1,61620756,61620870,114,0.9849433211218889
23831,2054.0301,2054.062967,1,61620903,61621889,986,0.7799054313808187
23832,2054.0646,2054.107367,1,61621938,61623221,1283,0.1438657910621858
23833,2054.111867,2054.2691,1,61623356,61628073,4717,0.7285156070550777
23834,2054.2731,2054.277233,1,61628193,61628316,123,0.7500721798769802
23835,2054.278267,2054.293467,1,61628348,61628804,456,0.6590159114302434
23836,2054.339933,2054.362367,1,61630197,61630871,674,0.3487138145080138
23837,2054.363633,2054.383133,1,61630908,61631493,585,0.1801687564652402
23838,2054.395733,2054.441367,1,61631871,61633241,1370,0.6248348007569551
23839,2054.455633,2054.473233,1,61633668,61634196,528,0.2839288719288871
23840,2054.474433,2054.481433,1,61634232,61634442,210,0.7737067357876467
23841,2054.4858,2054.492533,1,61634574,61634775,201,0.5304034759677281
23842,2054.521633,2054.530467,1,61635648,61635914,266,0.11483727683561044
23843,2054.5319,2054.535533,1,61635957,61636065,108,0.7695698087772235
23844,2054.5408,2054.551933,1,61636224,61636557,333,0.817139057899432
23845,2054.554933,2054.572867,1,61636647,61637186,539,0.8392840566949588
23846,2054.578067,2054.581533,1,61637342,61637445,103,0.8616405479640886
23847,2054.592833,2054.616033,1,61637784,61638480,696,0.3941184011212655
23848,2054.708167,2054.7149,1,61641245,61641447,202,0.8232547315270111
23849,2054.740833,2054.762467,1,61642224,61642874,650,0.7030211388630533
23850,2054.8209,2054.844533,1,61644627,61645335,708,0.3700343168936156
23851,2054.858167,2054.869133,1,61645745,61646073,328,0.364581146885653
23852,2054.8898,2054.8937,1,61646694,61646811,117,0.8781742315462951
23853,2054.9255,2054.938933,1,61647764,61648167,403,0.46130384548144915
23854,2054.9491,2054.9708,1,61648472,61649124,652,0.4972270914806417
23855,2054.982267,2055.022867,1,61649468,61650686,1218,0.6176165247804153
23856,2055.071767,2055.090933,1,61652153,61652727,574,0.5197575014658246
23857,2055.092233,2055.110633,1,61652766,61653318,552,0.6174239730331877
23858,2055.126367,2055.132267,1,61653791,61653968,177,0.5607408613073188
23859,2055.1392,2055.148067,1,61654176,61654442,266,0.6760735132996678
23860,2055.1565,2055.168367,1,61654695,61655051,356,0.5959723561093415
23861,2055.1696,2055.1788,1,61655088,61655364,276,0.5856413497240015
23862,2055.205133,2055.2164,1,61656153,61656491,338,0.5843048239252525
23863,2055.219533,2055.237367,1,61656585,61657121,536,0.7076816942780052
23864,2055.300333,2055.444567,1,61659009,61663337,4328,0.7252970322176896
23865,2055.5951,2055.624333,1,61667853,61668729,876,0.8914750158967465
23866,2055.625767,2055.700067,1,61668773,61671002,2229,0.7845732722151788
23867,2055.703267,2055.718233,1,61671098,61671546,448,0.6023089619825046
23868,2055.795067,2055.834633,1,61673852,61675038,1186,0.6740665601301421
23869,2055.836233,2055.964167,1,61675086,61678925,3839,0.7153199732028014
23870,2055.984367,2056.0592,1,61679531,61681776,2245,0.4591364525553562
23871,2056.060433,2056.216867,1,61681812,61686506,4694,0.7482860867873815
23872,2056.224233,2056.2569,1,61686726,61687706,980,0.6417390640129882
23873,2056.5846,2056.649433,1,61697538,61699482,1944,0.6365619715269961
23874,2056.656,2056.7018,1,61699680,61701053,1373,0.6480617544599455
23875,2056.703133,2056.7062,1,61701093,61701186,93,0.706430304307541
23876,2056.7625,2056.785267,1,61702874,61703558,684,0.6165434405384005
23877,2056.8391,2056.878967,1,61705173,61706369,1196,0.678925438885094
23878,2056.8887,2056.897333,1,61706661,61706919,258,0.516824498006449
23879,2056.905,2056.912667,1,61707150,61707380,230,0.6012236918988769
23880,2056.9372,2056.9454,1,61708115,61708362,247,0.5394786204078594
23881,2056.950367,2056.963867,1,61708511,61708916,405,0.6723243248639321
23882,2057.095167,2057.245167,1,61712855,61717355,4500,0.8554338533505721
23883,2057.247567,2057.274367,1,61717427,61718231,804,0.9337443320633492
23884,2057.276967,2057.2809,1,61718309,61718427,118,0.6455573810421488
23885,2057.284,2057.299967,1,61718520,61718999,479,0.7847555834213639
23886,2057.3757,2057.411533,1,61721271,61722345,1074,0.5494703320165113
23887,2057.422033,2057.4844,1,61722660,61724531,1871,0.6690483428827819
23888,2057.5194,2057.5272,1,61725582,61725816,234,0.5504242916627125
23889,2057.529233,2057.5704,1,61725876,61727112,1236,0.7251189192396799
23890,2057.575267,2057.7351,1,61727258,61732052,4794,0.7126610559502183
23891,2057.736133,2057.755833,1,61732083,61732674,591,0.6844299944852833
23892,2057.803567,2057.815,1,61734107,61734450,343,0.28025682097377713
23893,2057.836267,2057.8615,1,61735088,61735845,757,0.28336510201666193
23894,2057.883767,2057.887733,1,61736513,61736631,118,0.6211761386140329
23895,2057.895967,2057.916567,1,61736879,61737497,618,0.4705773816589109
23896,2058.1834,2058.2328,1,61745502,61746984,1482,0.6364514905051957
23897,2058.240767,2058.2515,1,61747223,61747544,321,0.3558780230574054
23898,2058.2537,2058.300367,1,61747611,61749011,1400,0.6025109639646182
23899,2058.303533,2058.326867,1,61749105,61749806,701,0.5425808491236774
23900,2058.383467,2058.387467,1,61751504,61751624,120,0.5877296142058004
23901,2058.389867,2058.440267,1,61751696,61753208,1512,0.7346942634695354
23902,2058.445467,2058.508567,1,61753364,61755257,1893,0.7536400891309062
23903,2058.562567,2058.573633,1,61756877,61757208,331,0.524240693573743
23904,2058.574667,2058.5785,1,61757240,61757355,115,0.6615989242400916
23905,2058.581667,2058.585367,1,61757450,61757561,111,0.8042890804068438
23906,2058.587033,2058.595567,1,61757610,61757867,257,0.41518030190749167
23907,2058.6016,2058.6091,1,61758048,61758273,225,0.6284688380728999
23908,2058.613267,2058.620533,1,61758398,61758615,217,0.5946767829855674
23909,2058.723167,2058.881667,1,61761695,61766450,4755,0.7021605774347334
23910,2058.9191,2058.930833,1,61767573,61767924,351,0.5321603938686733
23911,2058.937967,2058.963667,1,61768139,61768910,771,0.2839322718284704
23912,2058.985667,2058.9951,1,61769570,61769853,283,0.16998478762758845
23913,2059.017667,2059.020733,1,61770530,61770621,91,0.8001947874352963
23914,2059.038233,2059.043967,1,61771146,61771319,173,0.5587660732832918
23915,2059.045433,2059.192733,1,61771362,61775781,4419,0.7507920337930344
23916,2059.201867,2059.23,1,61776056,61776900,844,0.6926995904775588
23917,2059.278133,2059.286167,1,61778343,61778585,242,0.26874623804746955
23918,2059.295633,2059.317367,1,61778868,61779521,653,0.09727069027529932
23919,2059.3538,2059.357167,1,61780613,61780715,102,0.8250547462251847
23920,2059.3593,2059.403367,1,61780779,61782101,1322,0.2115890413463755
23921,2059.406267,2059.451433,1,61782188,61783542,1354,0.0012141048707585997
23922,2059.465967,2059.474333,1,61783979,61784229,250,0.030298931066481596
23923,2059.4816,2059.504533,1,61784448,61785135,687,0.6997279986200332
23924,2059.5056,2059.5168,1,61785168,61785503,335,0.8199586135183261
23925,2059.517833,2059.523233,1,61785534,61785696,162,0.03446884543363175
23926,2059.536333,2059.567633,1,61786089,61787028,939,0.2964542710713555
23927,2059.661967,2059.69,1,61789859,61790700,841,0.6560828343916348
23928,2059.6987,2059.7163,1,61790961,61791489,528,0.6520002704597957
23929,2059.8102,2059.830267,1,61794306,61794908,602,0.5302670681048863
23930,2059.840733,2059.8538,1,61795221,61795613,392,0.6282456560499449
23931,2059.8779,2059.884067,1,61796337,61796522,185,0.5993979048542027
23932,2059.886667,2059.9291,1,61796600,61797872,1272,0.6439751042326474
23933,2059.946867,2059.9581,1,61798406,61798742,336,0.6025255961237422
23934,2059.962567,2059.973033,1,61798877,61799190,313,0.6489724391646352
23935,2059.979733,2059.9895,1,61799391,61799685,294,0.640066793860791
23936,2059.996633,2060.004667,1,61799898,61800140,242,0.6303790213012317
23937,2060.008967,2060.023167,1,61800269,61800695,426,0.6543378405696225
23938,2060.0251,2060.028467,1,61800752,61800854,102,0.6735261624751842
23939,2060.050967,2060.061833,1,61801529,61801854,325,0.5371692730318729
23940,2060.064867,2060.0795,1,61801946,61802384,438,0.7012101496924998
23941,2060.138833,2060.181333,1,61804164,61805439,1275,0.7615472125918294
23942,2060.183533,2060.266767,1,61805505,61808003,2498,0.7745767981893423
23943,2060.474,2060.6342,1,61814220,61819026,4806,0.703601661757124
23944,2060.767333,2060.772767,1,61823019,61823183,164,0.2764963126704201
23945,2061.183533,2061.188167,1,61835505,61835645,140,0.48590093454713473
23946,2061.1985,2061.2639,1,61835955,61837917,1962,0.6155463040442748
23947,2061.3497,2061.4258,1,61840491,61842774,2283,0.6731514456476757
23948,2061.4279,2061.5193,1,61842837,61845579,2742,0.718484141794168
23949,2061.521667,2061.655433,1,61845650,61849662,4012,0.6962069491208079
23950,2061.6649,2061.680467,1,61849947,61850414,467,0.742814750652599
23951,2061.684933,2061.763833,1,61850547,61852914,2367,0.705439817565695
23952,2061.777767,2061.899633,1,61853333,61856988,3655,0.6857064192975342
23953,2062.188733,2062.200033,1,61865661,61866000,339,0.03532377887300101
23954,2062.210167,2062.3647,1,61866305,61870941,4636,0.7497575967124903
23955,2062.393333,2062.397967,1,61871799,61871939,140,0.9248284873495778
23956,2062.4032,2062.408333,1,61872096,61872249,153,0.9210317600298713
23957,2062.446867,2062.586933,1,61873406,61877607,4201,0.7814554375402416
23958,2062.611367,2062.614867,1,61878341,61878446,105,0.5928713271146766
23959,2062.640067,2062.643467,1,61879202,61879304,102,0.7343976442497829
23960,2062.926933,2062.9302,1,61887807,61887905,98,-0.08020066816550062
23961,2062.9336,2062.9409,1,61888007,61888227,220,0.34152969995435595
23962,2062.945967,2062.970367,1,61888379,61889111,732,0.13472490244553015
23963,2062.980367,2062.983833,1,61889411,61889514,103,0.37606272436313276
23964,2062.986833,2063.022167,1,61889604,61890665,1061,0.7675312862545138
23965,2063.025467,2063.159,1,61890764,61894770,4006,0.713264798996189
23966,2063.169,2063.172033,1,61895069,61895160,91,0.9214680494231274
23967,2063.473967,2063.5908,1,61904219,61907724,3505,0.6920229402330229
23968,2063.591867,2063.605133,1,61907756,61908153,397,0.611241691587716
23969,2063.607033,2063.6238,1,61908210,61908713,503,0.6227051763718878
23970,2063.8824,2063.985967,1,61916472,61919579,3107,0.07316451609848894
23971,2063.987367,2064.008667,1,61919621,61920260,639,0.11998607444518336
23972,2064.019733,2064.038033,1,61920591,61921140,549,0.11417528812192074
23973,2064.039367,2064.145567,1,61921181,61924367,3186,0.16116120320643895
23974,2064.1599,2064.348633,1,61924797,61930458,5661,0.7118743641203774
23975,2064.3611,2064.379667,1,61930833,61931390,557,0.6387747050232461
23976,2064.3899,2064.393933,1,61931697,61931817,120,0.3369772242035264
23977,2064.520367,2064.7438,1,61935611,61942314,6703,0.5153706939648772
23978,2064.797867,2065.0468,1,61943936,61951404,7468,0.6575873166256162
23979,2065.282167,2065.2878,1,61958465,61958634,169,0.8123970947074357
23980,2065.2918,2065.378833,1,61958754,61961364,2610,0.6848989081523295
23981,2065.392967,2065.397067,1,61961789,61961912,123,0.9255968476380956
23982,2065.444433,2065.632867,1,61963332,61968986,5654,0.6655156103442431
23983,2065.6342,2065.7362,1,61969026,61972085,3059,0.6535197176167634
23984,2065.743467,2065.797,1,61972304,61973910,1606,0.7335779210557191
23985,2065.882433,2065.886167,1,61976472,61976585,113,0.7689166018239576
23986,2065.902767,2065.917833,1,61977083,61977534,451,0.658302905238165
23987,2065.9257,2066.076633,1,61977770,61982298,4528,0.6394847983408058
23988,2066.0962,2066.1019,1,61982886,61983057,171,0.4583694577160189
23989,2066.333033,2066.436267,1,61989990,61993088,3098,0.050184878109136855
23990,2066.437433,2066.553133,1,61993122,61996593,3471,0.14023998389099923
23991,2066.580767,2066.6085,1,61997423,61998254,831,0.1691752420376807
23992,2066.6119,2066.6154,1,61998357,61998462,105,0.32453619912520404
23993,2066.637333,2066.660033,1,61999119,61999800,681,0.25599749605138766
23994,2066.662033,2066.6964,1,61999860,62000891,1031,0.5611634991354665
23995,2066.7337,2066.739433,1,62002011,62002182,171,0.5132242264626616
23996,2066.7513,2066.784333,1,62002539,62003529,990,0.7056870607304253
23997,2066.7909,2066.953067,1,62003727,62008592,4865,0.7379164727551212
23998,2066.961567,2066.979467,1,62008847,62009384,537,0.7243499745122446
23999,2066.9809,2067.0052,1,62009427,62010156,729,0.5892525973165136
24000,2067.011533,2067.0176,1,62010345,62010528,183,0.532576016118761
24001,2067.311533,2067.352967,1,62019345,62020589,1244,0.7641725935543711
24002,2067.534867,2067.691467,1,62026046,62030744,4698,0.771073664701507
24003,2067.737233,2067.752767,1,62032116,62032583,467,0.5857328934303367
24004,2067.7538,2067.757067,1,62032614,62032712,98,0.8145432470846633
24005,2067.8247,2067.9165,1,62034741,62037494,2753,0.7159432315556485
24006,2068.0566,2068.126633,1,62041698,62043798,2100,0.7607543021877978
24007,2068.211467,2068.217367,1,62046344,62046521,177,0.48761381256212233
24008,2068.223367,2068.2785,1,62046701,62048355,1654,0.7959779407968003
24009,2068.343933,2068.488433,1,62050317,62054652,4335,0.7686003244089292
24010,2068.5566,2068.5698,1,62056698,62057094,396,0.597356876853642
24011,2068.591667,2068.595467,1,62057750,62057864,114,0.33278849568344704
24012,2068.6862,2068.692133,1,62060586,62060763,177,0.4224628622658011
24013,2068.698,2068.714633,1,62060939,62061438,499,0.17157552373066032
24014,2068.721867,2068.796733,1,62061656,62063901,2245,0.069559082324667
24015,2068.7982,2068.815,1,62063946,62064450,504,0.15552807986407996
24016,2068.8329,2068.8639,1,62064987,62065916,929,0.049471896437861464
24017,2068.877,2068.997733,1,62066310,62069931,3621,0.25362679835359864
24018,2069.094767,2069.123767,1,62072843,62073713,870,0.5166764568630511
24019,2069.127333,2069.2853,1,62073819,62078559,4740,0.727013271922075
24020,2069.296667,2069.315133,1,62078900,62079453,553,0.5222416006752219
24021,2069.321833,2069.3468,1,62079654,62080403,749,0.6763987474247397
24022,2069.5839,2069.589233,1,62087517,62087676,159,0.6417788919212666
24023,2069.598867,2069.702133,1,62087966,62091063,3097,0.7481207902999661
24024,2069.750533,2069.759033,1,62092515,62092770,255,0.10381215820647145
24025,2069.813233,2069.821933,1,62094396,62094657,261,0.12701720032431615
24026,2070.197433,2070.261133,1,62105922,62107833,1911,0.5983109347947193
24027,2070.347467,2070.6216,1,62110424,62118648,8224,0.6754487452185923
24028,2070.851267,2070.919,1,62125538,62127569,2031,0.7258248433321809
24029,2071.198533,2071.2356,1,62135955,62137068,1113,0.18863750009745606
24030,2071.242533,2071.407067,1,62137275,62142212,4937,0.7583125349108262
24031,2071.5905,2071.6426,1,62147714,62149278,1564,0.8024485703550784
24032,2071.6882,2071.760367,1,62150646,62152811,2165,0.7586716236309184
24033,2071.7615,2071.764767,1,62152845,62152943,98,0.7246982440915462
24034,2071.7819,2071.788233,1,62153457,62153646,189,0.6412073749486582
24035,2071.8325,2071.846367,1,62154975,62155391,416,0.42785555863070385
24036,2071.955267,2071.958433,1,62158658,62158752,94,0.5176293636077272
24037,2071.966033,2072.055067,1,62158980,62161652,2672,0.13199263422257132
24038,2072.0566,2072.059733,1,62161698,62161791,93,0.6878986630183134
24039,2072.069767,2072.171067,1,62162093,62165132,3039,0.08387396413307835
24040,2072.177267,2072.346333,1,62165318,62170389,5071,0.7851349085669785
24041,2072.354833,2072.407867,1,62170644,62172236,1592,0.6275029102165066
24042,2072.490433,2072.494933,1,62174712,62174847,135,0.546279863211582
24043,2072.5205,2072.554633,1,62175615,62176638,1023,0.2102894210856176
24044,2072.558767,2072.5694,1,62176763,62177081,318,0.28021797851287317
24045,2072.5894,2072.596233,1,62177681,62177886,205,0.5963319739386882
24046,2072.701167,2072.7359,1,62181035,62182077,1042,0.7602465213509605
24047,2072.7392,2072.7646,1,62182176,62182938,762,0.6652181631799968
24048,2072.767667,2072.7856,1,62183030,62183568,538,0.6547244664653896
24049,2073.992633,2074.148867,1,62219778,62224466,4688,0.04255953425720015
24050,2074.163933,2074.196433,1,62224917,62225892,975,0.36029272485567704
24051,2074.198233,2074.2759,1,62225946,62228277,2331,0.2866336414566096
24052,2074.296967,2074.300633,1,62228909,62229018,109,0.9263922156647079
24053,2074.963333,2074.979633,1,62248899,62249388,489,-0.008782161376217372
24054,2074.986867,2075.018467,1,62249606,62250554,948,0.09661038561752809
24055,2075.0554,2075.0601,1,62251662,62251803,141,0.9448630260385638
24056,2075.074367,2075.164467,1,62252231,62254934,2703,0.6583289327983849
24057,2075.231733,2075.455267,1,62256951,62263658,6707,0.7060235682540024
24058,2075.646533,2075.7567,1,62269395,62272701,3306,0.706757817649621
24059,2075.8723,2075.9541,1,62276169,62278623,2454,0.7543227229222738
24060,2076.0934,2076.139667,1,62282802,62284190,1388,0.6822892175657446
24061,2076.2788,2076.425,1,62288364,62292750,4386,0.7287448951949133
24062,2076.558167,2076.697867,1,62296745,62300936,4191,0.5894526979746475
24063,2077.2288,2077.3486,1,62316863,62320457,3594,0.7524055806423511
24064,2077.353067,2077.368633,1,62320592,62321058,466,0.6745523980500155
24065,2077.3749,2077.404067,1,62321246,62322122,876,0.6724395668884183
24066,2077.5339,2077.7836,1,62326017,62333508,7491,0.6745177335448417
24067,2077.861367,2078.0912,1,62335841,62342735,6894,0.6961023165790433
24068,2078.095133,2078.101767,1,62342853,62343053,200,0.8761446696057233
24069,2078.390367,2078.526133,1,62351711,62355783,4072,0.7417689227214133
24070,2078.546833,2078.561633,1,62356404,62356848,444,0.7852601367686257
24071,2078.562867,2078.5761,1,62356886,62357283,397,0.7913688535191508
24072,2078.585167,2078.7229,1,62357555,62361687,4132,0.7621297516531492
24073,2078.992167,2078.998233,1,62369765,62369946,181,0.5121704510074894
24074,2080.053633,2080.057967,1,62401608,62401739,131,-0.05873849218814855
24075,2080.063233,2080.086067,1,62401896,62402582,686,0.07608924497901574
24076,2080.100467,2080.141867,1,62403014,62404256,1242,0.13042623862253588
24077,2080.153867,2080.1903,1,62404616,62405709,1093,0.2295224132727463
24078,2080.206967,2080.219933,1,62406209,62406597,388,0.6338215451905227
24079,2080.352133,2080.515367,1,62410563,62415461,4898,0.7099660987102148
24080,2080.5207,2080.537767,1,62415621,62416133,512,0.6581127157172362
24081,2080.539367,2080.577633,1,62416181,62417328,1147,0.6194177773336614
24082,2080.7504,2080.973467,1,62422512,62429204,6692,0.7284874292799345
24083,2081.075767,2081.099233,1,62432273,62432976,703,0.5743856421882962
24084,2081.1059,2081.120567,1,62433177,62433617,440,0.5822390207527728
24085,2081.1477,2081.167833,1,62434431,62435034,603,0.5468447990502237
24086,2081.169833,2081.179867,1,62435094,62435396,302,0.6723516844109434
24087,2081.246067,2081.267633,1,62437382,62438028,646,0.6139930036900346
24088,2081.367,2081.3913,1,62441010,62441738,728,0.5434799593062268
24089,2082.048067,2082.212567,1,62461442,62466377,4935,0.7329753358857632
24090,2082.218567,2082.2372,1,62466557,62467116,559,0.7263253542831354
24091,2082.24,2082.268133,1,62467199,62468043,844,0.69568614463981
24092,2082.444567,2082.459933,1,62473337,62473797,460,0.5336857714238282
24093,2082.461267,2082.526033,1,62473838,62475780,1942,0.6507666578626361
24094,2082.541467,2082.544533,1,62476244,62476335,91,0.3961469258070775
24095,2082.587667,2082.5916,1,62477630,62477748,118,0.8850508861835351
24096,2082.637033,2082.680667,1,62479110,62480420,1310,0.3760630782235256
24097,2082.683533,2082.727067,1,62480505,62481812,1307,0.2662747926701281
24098,2082.7344,2082.7402,1,62482031,62482206,175,0.6411414627210081
24099,2082.743633,2082.7508,1,62482308,62482523,215,0.07091527388449947
24100,2082.754467,2082.7793,1,62482634,62483379,745,0.3200354826871191
24101,2082.785633,2082.809267,1,62483568,62484278,710,0.8343513474969051
24102,2082.810867,2082.857967,1,62484326,62485739,1413,0.23437288841529827
24103,2082.875267,2082.886767,1,62486258,62486603,345,0.36335908820823387
24104,2082.894067,2082.922267,1,62486822,62487668,846,0.7169118705748065
24105,2082.924367,2082.9619,1,62487731,62488856,1125,0.7176142131919753
24106,2082.9633,2082.991767,1,62488899,62489753,854,0.6789858181847598
24107,2083.0038,2083.020133,1,62490114,62490603,489,0.6009839989840307
24108,2083.035567,2083.039667,1,62491067,62491190,123,0.779638735000946
24109,2083.0701,2083.0789,1,62492103,62492367,264,0.5209468303488304
24110,2083.100633,2083.1048,1,62493018,62493144,126,0.6725187579880836
24111,2083.1105,2083.118133,1,62493314,62493543,229,0.39510150521362153
24112,2083.119433,2083.165967,1,62493582,62494979,1397,0.303233771248005
24113,2083.1671,2083.172033,1,62495013,62495160,147,0.5089089336732392
24114,2083.176733,2083.209767,1,62495301,62496293,992,0.41041888455992237
24115,2083.230833,2083.394867,1,62496924,62501846,4922,0.7549347603684042
24116,2083.398067,2083.4128,1,62501942,62502384,442,0.7674590829336084
24117,2083.485367,2083.494133,1,62504561,62504823,262,0.4888486126651824
24118,2083.515667,2083.524333,1,62505470,62505729,259,0.2661960302887002
24119,2083.5288,2083.5708,1,62505864,62507124,1260,0.566889222636168
24120,2083.5721,2083.616867,1,62507162,62508506,1344,0.27854741131698585
24121,2083.640567,2083.65,1,62509217,62509500,283,0.1695760390201051
24122,2083.6513,2083.706833,1,62509539,62511204,1665,0.43576931399180746
24123,2083.713933,2083.7498,1,62511417,62512494,1077,0.2910157405054902
24124,2083.765767,2083.7764,1,62512973,62513292,319,-0.03065889619151153
24125,2083.786133,2083.794333,1,62513583,62513829,246,-0.03444976710735714
24126,2083.795733,2083.817,1,62513871,62514510,639,0.6925747343113599
24127,2083.822233,2083.833267,1,62514666,62514998,332,0.7248591250875971
24128,2083.880633,2083.8979,1,62516418,62516937,519,0.4914522690033255
24129,2083.905233,2083.913867,1,62517156,62517416,260,0.7284594679296068
24130,2083.969567,2084.0056,1,62519087,62520168,1081,0.6352687899106276
24131,2084.064167,2084.083467,1,62521925,62522504,579,0.5114387226061113
24132,2084.150533,2084.170067,1,62524515,62525102,587,0.6040947030399337
24133,2084.213233,2084.2214,1,62526396,62526642,246,0.553871441834568
24134,2084.234033,2084.2772,1,62527020,62528316,1296,0.6956021178442494
24135,2084.296,2084.313733,1,62528879,62529411,532,0.4446046372095315
24136,2084.629733,2084.640667,1,62538891,62539220,329,0.5163561234197671
24137,2084.6458,2084.6804,1,62539373,62540412,1039,0.6424021301220495
24138,2084.685933,2084.739033,1,62540577,62542170,1593,0.5903772439618659
24139,2084.744233,2084.749867,1,62542326,62542496,170,0.43786153780698395
24140,2084.9071,2084.957867,1,62547213,62548736,1523,0.7814522800607482
24141,2084.9589,2084.970467,1,62548767,62549114,347,0.430967836718244
24142,2084.990733,2085.002,1,62549721,62550060,339,0.6574937883284349
24143,2085.003267,2085.006333,1,62550098,62550189,91,0.7548033252792784
24144,2085.0077,2085.0139,1,62550231,62550417,186,0.8877583884079411
24145,2085.015033,2085.024667,1,62550450,62550740,290,0.852438713085439
24146,2085.025667,2085.031967,1,62550770,62550959,189,0.7589198461395559
24147,2085.0368,2085.0433,1,62551103,62551298,195,0.8413123961858803
24148,2085.046467,2085.0495,1,62551394,62551485,91,0.9589423603594118
24149,2085.060333,2085.0765,1,62551809,62552295,486,0.709330041324077
24150,2085.1619,2085.1834,1,62554857,62555502,645,0.5910291559690298
24151,2085.191167,2085.3123,1,62555735,62559369,3634,0.746159430120756
24152,2085.5555,2085.765933,1,62566665,62572977,6312,0.5754147457086703
24153,2085.775367,2085.8067,1,62573261,62574201,940,0.690900854773719
24154,2085.808033,2085.847533,1,62574240,62575425,1185,0.6221697210723619
24155,2085.905033,2085.9419,1,62577150,62578256,1106,0.6280655768627736
24156,2085.9661,2085.987133,1,62578983,62579613,630,0.61537354438786
24157,2085.9905,2086.0639,1,62579715,62581917,2202,0.5706090128463096
24158,2086.138067,2086.176833,1,62584142,62585304,1162,0.6213414674737208
24159,2086.179233,2086.212633,1,62585376,62586378,1002,0.6274286521144571
24160,2086.214967,2086.3237,1,62586449,62589711,3262,0.6503237556349635
24161,2086.3256,2086.338033,1,62589768,62590140,372,0.5348687456033709
24162,2086.3415,2086.361533,1,62590245,62590845,600,0.5685023410063628
24163,2086.577333,2086.690133,1,62597319,62600703,3384,0.6923807960898217
24164,2086.7707,2086.9047,1,62603121,62607141,4020,0.7327541699086807
24165,2087.088867,2087.1135,1,62612666,62613405,739,0.05257519306389953
24166,2087.1214,2087.153933,1,62613642,62614617,975,0.047109334800021344
24167,2087.699267,2087.891733,1,62630978,62636751,5773,0.7231137654968984
24168,2087.905333,2087.9288,1,62637159,62637864,705,0.669628008935233
24169,2088.010433,2088.151267,1,62640312,62644538,4226,0.7092013096633316
24170,2088.283533,2088.346433,1,62648505,62650392,1887,0.7051821655492113
24171,2088.703967,2088.708133,1,62661119,62661243,124,0.9025048596759635
24172,2088.7165,2088.868867,1,62661495,62666066,4571,0.7390782048537342
24173,2089.032467,2089.038333,1,62670974,62671149,175,0.6540987746180953
24174,2089.042833,2089.1907,1,62671284,62675721,4437,0.7759173197436576
24175,2089.3035,2089.415633,1,62679105,62682468,3363,0.6911557622593386
24176,2089.8259,2089.835667,1,62694776,62695070,294,0.5695183186508528
24177,2089.8473,2089.893467,1,62695419,62696804,1385,0.5501939225794445
24178,2089.903433,2089.945467,1,62697102,62698364,1262,0.8522149391120828
24179,2089.9465,2089.964467,1,62698395,62698934,539,0.5869702412663269
24180,2089.967067,2089.976567,1,62699012,62699297,285,0.883813877926575
24181,2089.978967,2089.986567,1,62699369,62699597,228,0.8159426721252055
24182,2089.992867,2089.996967,1,62699786,62699909,123,0.41754155494924966
24183,2090.003133,2090.016933,1,62700093,62700507,414,0.6448820711211123
24184,2090.046033,2090.050633,1,62701380,62701518,138,0.8282300645792695
24185,2090.072767,2090.112933,1,62702183,62703387,1204,0.7301846440329877
24186,2090.129933,2090.137367,1,62703897,62704121,224,0.7649626442994144
24187,2090.139367,2090.153333,1,62704181,62704599,418,0.7845374260906351
24188,2090.156333,2090.159467,1,62704689,62704784,95,0.8070198290229814
24189,2090.906267,2091.067467,1,62727188,62732024,4836,0.7304452958593366
24190,2091.068567,2091.096033,1,62732057,62732880,823,0.705356515793074
24191,2091.279667,2091.283967,1,62738390,62738519,129,0.130608797898926
24192,2091.285033,2091.429833,1,62738550,62742894,4344,0.7642844496144985
24193,2091.644867,2091.6518,1,62749346,62749554,208,0.41171099945832346
24194,2091.660233,2091.766733,1,62749806,62753001,3195,0.7004471361111465
24195,2091.900333,2091.903967,1,62757009,62757119,110,0.8950814023984454
24196,2091.9398,2092.030167,1,62758194,62760905,2711,0.6653563386321794
24197,2092.0402,2092.045967,1,62761206,62761379,173,0.23495809793103237
24198,2092.0662,2092.0732,1,62761986,62762195,209,0.6634480191920692
24199,2092.0798,2092.102267,1,62762394,62763068,674,0.2997461442398328
24200,2092.120433,2092.153067,1,62763612,62764592,980,0.31852756997332826
24201,2092.163833,2092.168667,1,62764914,62765060,146,0.3480870091443223
24202,2092.171033,2092.183333,1,62765130,62765499,369,0.1239488716299303
24203,2092.188033,2092.2233,1,62765640,62766699,1059,0.29059483442683465
24204,2092.2307,2092.234467,1,62766921,62767034,113,0.4161911547084147
24205,2092.2946,2092.4836,1,62768838,62774508,5670,0.6729494683270417
24206,2092.4929,2092.496933,1,62774787,62774907,120,0.5355916033122049
24207,2092.5046,2092.5393,1,62775138,62776179,1041,0.7246650655639688
24208,2092.5425,2092.5557,1,62776275,62776671,396,0.4955255203353062
24209,2092.568367,2092.5733,1,62777051,62777199,148,0.09315767997008782
24210,2092.581033,2092.597367,1,62777430,62777921,491,-0.06658890734978724
24211,2092.620967,2092.650667,1,62778629,62779520,891,0.2121055266704345
24212,2092.676967,2092.681767,1,62780309,62780453,144,0.5252522924261004
24213,2092.685167,2092.719733,1,62780555,62781591,1036,0.31432796438978244
24214,2092.7285,2092.7567,1,62781855,62782701,846,0.5034822596586067
24215,2092.758133,2092.767267,1,62782743,62783018,275,0.6623815777682823
24216,2092.983967,2093.062133,1,62789519,62791863,2344,0.6667489989085689
24217,2093.1362,2093.190933,1,62794086,62795727,1641,0.46239395412595374
24218,2093.1924,2093.219533,1,62795772,62796585,813,0.18284915947198307
24219,2093.225067,2093.463333,1,62796752,62803899,7147,0.734910778132093
24220,2093.647267,2093.672133,1,62809418,62810163,745,0.7173856923219476
24221,2093.783033,2093.7891,1,62813490,62813673,183,0.3108486686518298
24222,2093.801533,2093.903933,1,62814045,62817117,3072,0.727046790196372
24223,2094.008467,2094.097667,1,62820254,62822930,2676,0.7598388792095208
24224,2094.274767,2094.278967,1,62828243,62828369,126,0.3263603542591252
24225,2094.294367,2094.298433,1,62828831,62828952,121,0.46080286392494735
24226,2094.2996,2094.302833,1,62828987,62829084,97,0.5268116270698181
24227,2094.469833,2094.566133,1,62834094,62836983,2889,0.707849111713929
24228,2094.569567,2094.607033,1,62837087,62838210,1123,0.6888352565034558
24229,2094.640167,2094.6837,1,62839205,62840511,1306,0.7079856743507844
24230,2094.766433,2094.7876,1,62842992,62843628,636,0.6013877196014872
24231,2094.838667,2094.861433,1,62845160,62845842,682,0.547276480069234
24232,2094.9318,2094.953133,1,62847953,62848593,640,0.5578505083099091
24233,2095.013833,2095.025167,1,62850414,62850755,341,0.34721002654981614
24234,2095.033533,2095.0397,1,62851005,62851190,185,0.5060186961096819
24235,2095.1179,2095.135767,1,62853537,62854073,536,0.4648118097356896
24236,2095.1414,2095.149233,1,62854242,62854476,234,0.5922409916366873
24237,2095.154967,2095.162833,1,62854649,62854884,235,0.5079530490959839
24238,2095.165667,2095.177333,1,62854970,62855319,349,0.699110515251405
24239,2095.290433,2095.4582,1,62858712,62863746,5034,0.6749485362200749
24240,2095.4607,2095.464133,1,62863821,62863923,102,0.4214825226016407
24241,2095.466767,2095.474667,1,62864003,62864240,237,0.7977611253409527
24242,2095.478833,2095.490667,1,62864364,62864720,356,0.6939618059451759
24243,2095.539833,2095.5675,1,62866194,62867025,831,0.21747767016007827
24244,2095.584167,2095.591767,1,62867525,62867753,228,0.4350538176495811
24245,2095.611367,2095.6469,1,62868341,62869407,1066,0.7082945557437561
24246,2095.649,2095.808033,1,62869470,62874240,4770,0.7208500884524494
24247,2095.817367,2095.840467,1,62874521,62875214,693,0.6275892804379916
24248,2095.973567,2095.9776,1,62879207,62879328,121,0.6529548568528072
24249,2095.9787,2095.9894,1,62879361,62879682,321,0.7345681080535751
24250,2095.9912,2096.009867,1,62879736,62880296,560,0.5625240722986503
24251,2096.020033,2096.025433,1,62880600,62880762,162,0.7126950789102064
24252,2096.0318,2096.039833,1,62880954,62881194,240,0.572140099945432
24253,2096.0411,2096.044333,1,62881233,62881329,96,0.6936346768755595
24254,2096.1678,2096.227467,1,62885034,62886824,1790,0.6272246495136585
24255,2096.554133,2096.6378,1,62896623,62899134,2511,0.6124386337961369
24256,2096.743,2097.068433,1,62902290,62912052,9762,0.6739210989908772
24257,2097.070067,2097.097367,1,62912102,62912921,819,0.7440492974758774
24258,2097.116433,2097.241067,1,62913492,62917232,3740,0.7049223093652163
24259,2097.436933,2097.469167,1,62923107,62924075,968,0.463900644509853
24260,2097.4702,2097.506633,1,62924106,62925198,1092,0.5116647815099207
24261,2097.6082,2097.6596,1,62928246,62929788,1542,0.7711469053599427
24262,2097.661233,2097.723167,1,62929836,62931695,1859,0.6710037664243276
24263,2097.946933,2097.951333,1,62938407,62938539,132,0.7560717119029451
24264,2097.965933,2097.9864,1,62938977,62939591,614,0.6149806388772759
24265,2097.9884,2098.101467,1,62939652,62943044,3392,0.7425184311109415
24266,2098.103233,2098.113567,1,62943096,62943407,311,0.894675063472543
24267,2098.2127,2098.265667,1,62946381,62947970,1589,0.6967067901819476
24268,2098.267567,2098.3497,1,62948027,62950491,2464,0.6497531070009217
24269,2098.3522,2098.373533,1,62950565,62951205,640,0.6165348737015294
24270,2098.385067,2098.497567,1,62951552,62954927,3375,0.7018474004463641
24271,2098.588467,2098.623367,1,62957654,62958701,1047,0.6297957436923567
24272,2098.673533,2098.6978,1,62960205,62960934,729,0.5469771564850078
24273,2098.723333,2098.7314,1,62961699,62961942,243,0.6543685018900631
24274,2098.7491,2098.7848,1,62962473,62963544,1071,0.6598172496054177
24275,2098.837967,2098.872167,1,62965139,62966165,1026,0.6841764095044516
24276,2098.875133,2099.0,1,62966253,62970000,3747,0.6974260563996091
24277,2099.148167,2099.151867,1,62974445,62974556,111,0.6937019498385321
24278,2099.1861,2099.390233,1,62975583,62981706,6123,0.7594183327449918
24279,2099.4704,2099.474767,1,62984112,62984243,131,0.8887030178721802
24280,2099.510067,2099.515733,1,62985302,62985471,169,0.7301263339825633
24281,2099.517933,2099.5278,1,62985537,62985833,296,0.7093788142619215
24282,2099.539633,2099.549,1,62986188,62986470,282,0.8890211845879666
24283,2099.577833,2099.5874,1,62987334,62987622,288,0.4831734442924291
24284,2100.093133,2100.1208,1,63002793,63003624,831,0.5439934796915604
24285,2100.133167,2100.137367,1,63003995,63004121,126,0.5391557809627886
24286,2100.252567,2100.297267,1,63007577,63008918,1341,0.688530416755069
24287,2100.302033,2100.333833,1,63009060,63010014,954,0.7130392979905155
24288,2100.350467,2100.4399,1,63010514,63013196,2682,0.7188476844584105
24289,2100.4409,2100.482067,1,63013227,63014462,1235,0.6573650982204619
24290,2100.587,2100.622933,1,63017610,63018687,1077,0.763272343260876
24291,2100.6257,2100.7253,1,63018771,63021759,2988,0.7306564568394226
24292,2100.728867,2100.749933,1,63021866,63022497,631,0.4736713025510032
24293,2100.774433,2100.848067,1,63023232,63025442,2210,0.18669678005542653
24294,2100.852467,2100.861933,1,63025574,63025857,283,0.5339578581843634
24295,2100.9109,2101.035333,1,63027326,63031059,3733,0.7674083352079489
24296,2101.0911,2101.094433,1,63032733,63032832,99,0.9088046905753586
24297,2101.103533,2101.107933,1,63033105,63033237,132,0.8644049300653532
24298,2101.1107,2101.120133,1,63033321,63033603,282,0.10748029055015605
24299,2102.0556,2102.091667,1,63061668,63062750,1082,0.6945144611198532
24300,2102.111133,2102.1326,1,63063333,63063978,645,0.6476492536225485
24301,2102.255333,2102.313533,1,63067659,63069405,1746,0.6036459372586029
24302,2102.3157,2102.320633,1,63069471,63069618,147,0.574604374873513
24303,2102.322,2102.609667,1,63069660,63078290,8630,0.7152198036343279
24304,2103.198667,2103.254633,1,63095960,63097638,1678,0.7292863090265597
24305,2103.256667,2103.4233,1,63097700,63102699,4999,0.6459491863801694
24306,2104.118767,2104.281767,1,63123563,63128453,4890,0.7262223088140274
24307,2104.2842,2104.303,1,63128526,63129090,564,0.623161906893922
24308,2107.069033,2107.1622,1,63212070,63214866,2796,0.5499011155936012
24309,2107.275067,2107.304133,1,63218252,63219123,871,0.6130491740324526
24310,2107.305967,2107.318233,1,63219179,63219546,367,0.686044484752704
24311,2107.324167,2107.3311,1,63219725,63219933,208,0.7239010358688468
24312,2107.3368,2107.346567,1,63220104,63220397,293,0.29190220366967534
24313,2107.3548,2107.3616,1,63220644,63220848,204,0.494778721119163
24314,2107.3706,2107.3793,1,63221118,63221379,261,0.4710629370499419
24315,2107.386067,2107.395767,1,63221582,63221873,291,0.5124714365468456
24316,2107.482133,2107.5928,1,63224463,63227784,3321,0.7113931496967296
24317,2107.5979,2107.604,1,63227937,63228119,182,0.31329303958453913
24318,2107.606467,2107.622567,1,63228194,63228677,483,0.7044098322071973
24319,2107.741567,2107.746267,1,63232247,63232388,141,0.1584376858252234
24320,2107.755867,2107.7702,1,63232676,63233106,430,0.030712366354855743
24321,2107.788567,2107.827,1,63233657,63234810,1153,0.128314456693186
24322,2107.835633,2107.874533,1,63235068,63236235,1167,0.17866604585232965
24323,2107.883867,2107.9063,1,63236516,63237189,673,0.44665547965366503
24324,2107.909833,2107.929567,1,63237294,63237887,593,0.6165893061260648
24325,2107.954533,2108.0275,1,63238635,63240825,2190,0.7035635431439227
24326,2108.029467,2108.0553,1,63240884,63241659,775,0.6331080499751568
24327,2109.2432,2109.320667,1,63277296,63279620,2324,0.686767861005811
24328,2109.4406,2109.494367,1,63283218,63284831,1613,0.6345089339009261
24329,2109.506633,2109.654467,1,63285198,63289634,4436,0.7267274872702968
24330,2109.657367,2109.676467,1,63289721,63290294,573,0.7150906025749926
24331,2109.6775,2109.760167,1,63290324,63292805,2481,0.7114264307320513
24332,2109.856833,2109.8841,1,63295704,63296523,819,0.5427061455121143
24333,2109.996933,2110.0314,1,63299907,63300941,1034,0.7131506442818598
24334,2110.0938,2110.249433,1,63302814,63307482,4668,0.7607603356225947
24335,2110.2533,2110.277533,1,63307598,63308325,727,0.7114462266947733
24336,2110.351333,2110.354467,1,63310539,63310634,95,0.12846968569670358
24337,2110.757467,2110.7857,1,63322724,63323571,847,0.6340252110853613
24338,2110.906467,2110.924,1,63327194,63327720,526,0.6497118685358961
24339,2110.928867,2110.941067,1,63327866,63328232,366,0.6903743688190156
24340,2110.966133,2111.0072,1,63328983,63330216,1233,0.6416883176254621
24341,2111.071733,2111.0919,1,63332151,63332757,606,0.7220674546272329
24342,2111.188933,2111.231233,1,63335667,63336936,1269,0.6269909912642403
24343,2111.4152,2111.426233,1,63342456,63342786,330,0.6551292442752038
24344,2111.431733,2111.4601,1,63342951,63343802,851,0.6597609126543839
24345,2111.480833,2111.518867,1,63344424,63345566,1142,0.7001340664501305
24346,2111.520033,2111.524267,1,63345600,63345728,128,-0.21500250733782217
24347,2111.5358,2111.5957,1,63346074,63347870,1796,0.7148090085687868
24348,2111.5982,2111.6513,1,63347946,63349539,1593,0.6741487033228806
24349,2111.800933,2112.0472,1,63354027,63361416,7389,0.7303819565839477
24350,2112.358733,2112.377,1,63370761,63371310,549,0.690713120664399
24351,2112.468567,2112.4764,1,63374057,63374292,235,0.7432602178121164
24352,2112.4776,2112.495267,1,63374328,63374858,530,0.7069080409528689
24353,2112.672067,2112.675467,1,63380162,63380264,102,0.8811820907809242
24354,2112.7529,2112.856767,1,63382587,63385703,3116,0.630967620534429
24355,2112.943067,2112.9715,1,63388292,63389145,853,0.6143197748635176
24356,2112.9729,2113.095867,1,63389187,63392876,3689,0.6726206710276504
24357,2113.097733,2113.168067,1,63392931,63395042,2111,0.6794529086317266
24358,2113.1815,2113.299433,1,63395445,63398982,3537,0.7179342400876406
24359,2113.555633,2113.5895,1,63406668,63407685,1017,0.7744308426345433
24360,2113.590667,2113.745233,1,63407720,63412356,4636,0.7342306375988992
24361,2113.752133,2113.781967,1,63412563,63413459,896,0.5765530620691596
24362,2113.930567,2114.0021,1,63417917,63420063,2146,0.759528397607205
24363,2114.0073,2114.015067,1,63420219,63420452,233,0.6920401074790626
24364,2114.041633,2114.053167,1,63421248,63421595,347,0.5500116876967727
24365,2114.326233,2114.335433,1,63429786,63430062,276,0.678485266383518
24366,2114.344533,2114.530567,1,63430335,63435917,5582,0.563722146817126
24367,2114.532433,2114.536833,1,63435972,63436104,132,0.5894848142566002
24368,2114.5414,2114.553633,1,63436242,63436608,366,0.5252648612740124
24369,2114.614167,2114.6173,1,63438425,63438519,94,0.6673253384392825
24370,2114.941467,2115.0348,1,63448244,63451044,2800,0.7797506402547354
24371,2115.036767,2115.056767,1,63451103,63451703,600,0.6663787025933556
24372,2115.117067,2115.155133,1,63453512,63454653,1141,0.6329177791271267
24373,2115.157867,2115.2007,1,63454736,63456020,1284,0.7458427870285487
24374,2115.201767,2115.207067,1,63456053,63456212,159,0.5913517433194053
24375,2115.2086,2115.234,1,63456258,63457020,762,0.6628882794181679
24376,2115.2535,2115.353767,1,63457604,63460613,3009,0.7389785662313237
24377,2115.4248,2115.443433,1,63462743,63463302,559,0.5919000346980492
24378,2115.503833,2115.513667,1,63465114,63465410,296,0.8122336333253596
24379,2115.5225,2115.530533,1,63465675,63465915,240,0.40473134432717783
24380,2115.535367,2115.7844,1,63466061,63473532,7471,0.7354712411986216
24381,2115.789867,2115.842333,1,63473696,63475269,1573,0.6731791849053379
24382,2115.9168,2115.935267,1,63477504,63478058,554,0.6558120023292201
24383,2116.036867,2116.064533,1,63481106,63481935,829,0.6134329460602195
24384,2116.1194,2116.1409,1,63483582,63484226,644,0.664422410614409
24385,2116.209567,2116.455133,1,63486287,63493653,7366,0.7104570255715503
24386,2116.508867,2116.5213,1,63495266,63495639,373,0.32463202213177356
24387,2116.5571,2116.5601,1,63496713,63496803,90,0.7884356173562683
24388,2116.583467,2116.5876,1,63497504,63497627,123,0.5884229049765343
24389,2116.601067,2116.6101,1,63498032,63498302,270,0.693020918147198
24390,2116.621867,2116.6891,1,63498656,63500673,2017,0.7529798061227911
24391,2116.694167,2116.701633,1,63500825,63501048,223,0.5017817711066401
24392,2116.875833,2116.892,1,63506274,63506759,485,0.5882343089532713
24393,2116.8972,2117.009233,1,63506916,63510276,3360,0.6801079849837236
24394,2117.014967,2117.074333,1,63510449,63512229,1780,0.7477208977766346
24395,2117.157533,2117.1875,1,63514725,63515625,900,0.6283581820287655
24396,2117.268633,2117.457867,1,63518058,63523736,5678,0.7721885647823565
24397,2117.460833,2117.5502,1,63523824,63526506,2682,0.6340218349547824
24398,2117.585933,2117.673833,1,63527577,63530214,2637,0.6868704918217071
24399,2117.9729,2117.981667,1,63539187,63539450,263,0.05678958553438062
24400,2117.9834,2118.0822,1,63539502,63542465,2963,0.7340806169938799
24401,2118.165033,2118.300067,1,63544950,63549002,4052,0.6550706341058049
24402,2118.311433,2118.396867,1,63549342,63551906,2564,0.685374776926722
24403,2118.559133,2118.7427,1,63556773,63562280,5507,0.7588901970977923
24404,2118.7666,2118.831,1,63562998,63564930,1932,0.7609532442012795
24405,2118.835733,2118.883133,1,63565071,63566493,1422,0.7283659577216159
24406,2118.992,2119.0137,1,63569760,63570411,651,0.6882177304433859
24407,2119.0803,2119.1153,1,63572409,63573459,1050,0.7260332830718157
24408,2119.1163,2119.127367,1,63573489,63573821,332,0.656204501771276
24409,2119.1402,2119.1436,1,63574205,63574308,103,0.850828979476487
24410,2119.171767,2119.2045,1,63575153,63576134,981,0.5838993377378444
24411,2119.266,2119.269833,1,63577980,63578094,114,0.373512221813136
24412,2119.2709,2119.4968,1,63578127,63584904,6777,0.7205834681508119
24413,2119.5043,2119.6141,1,63585129,63588422,3293,0.7244844722688966
24414,2119.639733,2119.6842,1,63589191,63590526,1335,0.7085144130454967
24415,2119.687633,2119.719667,1,63590628,63591590,962,0.730054791324493
24416,2119.896267,2119.935067,1,63596888,63598052,1164,0.7785697025117094
24417,2119.9758,2119.9794,1,63599274,63599382,108,0.8695941480630628
24418,2119.9807,2119.9851,1,63599421,63599552,131,0.7423265937412737
24419,2120.002167,2120.005533,1,63600065,63600165,100,0.4959927257836038
24420,2120.010867,2120.094867,1,63600326,63602846,2520,0.7073786235315473
24421,2120.1009,2120.194033,1,63603027,63605820,2793,0.7098879546241492
24422,2120.212233,2120.3171,1,63606366,63609513,3147,0.7261263106157928
24423,2120.362367,2120.4495,1,63610871,63613485,2614,0.7132883241027612
24424,2120.524133,2120.542667,1,63615723,63616280,557,0.6967958414274997
24425,2120.552767,2120.564233,1,63616583,63616926,343,0.7859494762970188
24426,2120.587533,2120.598633,1,63617625,63617958,333,0.7042200736897513
24427,2120.824267,2120.827733,1,63624728,63624831,103,0.7928415990813249
24428,2120.8432,2120.8752,1,63625295,63626256,961,0.7907593941174901
24429,2120.878,2121.031933,1,63626340,63630957,4617,0.6876905526054152
24430,2121.0399,2121.256833,1,63631197,63637704,6507,0.7232992288790869
24431,2121.2882,2121.295233,1,63638646,63638856,210,0.4052248530647832
24432,2121.300967,2121.318933,1,63639029,63639567,538,0.25170542442870353
24433,2121.322133,2121.326267,1,63639663,63639788,125,0.7911338435104288
24434,2121.329467,2121.334933,1,63639884,63640047,163,0.7631990537891252
24435,2121.391533,2121.396667,1,63641745,63641900,155,0.7142110150363407
24436,2121.400833,2121.5117,1,63642024,63645351,3327,0.7538077922162687
24437,2121.514967,2121.7366,1,63645449,63652098,6649,0.7162433951168257
24438,2121.739567,2121.789,1,63652187,63653670,1483,0.7325957394415301
24439,2121.791967,2121.821733,1,63653759,63654651,892,0.7676328835404855
24440,2121.905867,2121.923567,1,63657176,63657707,531,0.5346773353232223
24441,2121.929933,2121.933967,1,63657897,63658019,122,0.9046235279236345
24442,2121.9761,2122.007567,1,63659282,63660227,945,0.6712342536696168
24443,2122.066,2122.073633,1,63661979,63662208,229,0.5078865398421096
24444,2122.1045,2122.2732,1,63663135,63668196,5061,0.5392573998537153
24445,2122.279567,2122.308567,1,63668387,63669257,870,0.775562787402438
24446,2122.311933,2122.4118,1,63669357,63672353,2996,0.7099520295240751
24447,2122.423267,2122.426667,1,63672698,63672800,102,0.8290316137304794
24448,2122.4397,2122.490267,1,63673191,63674708,1517,0.7816385536651649
24449,2122.4966,2122.520467,1,63674898,63675614,716,0.7270494010717086
24450,2122.680067,2122.685133,1,63680402,63680553,151,0.7677428720082409
24451,2122.701033,2122.731,1,63681030,63681930,900,0.7105373478857858
24452,2122.732367,2122.745467,1,63681971,63682364,393,0.5703758065859429
24453,2122.815333,2122.819933,1,63684459,63684597,138,0.07990688147664302
24454,2122.835,2122.8485,1,63685050,63685455,405,0.5674250809945229
24455,2122.8525,2123.010733,1,63685575,63690321,4746,0.7454195741792616
24456,2123.022467,2123.078967,1,63690674,63692369,1695,0.782296877633084
24457,2123.1802,2123.185067,1,63695405,63695552,147,0.8039399484070486
24458,2123.195867,2123.227667,1,63695876,63696830,954,0.8124493178813877
24459,2123.2291,2123.2445,1,63696873,63697334,461,0.6234461049872163
24460,2123.249367,2123.264167,1,63697481,63697925,444,0.1450185467392754
24461,2123.340467,2123.5351,1,63700214,63706053,5839,0.7306758175996024
24462,2123.5403,2123.5722,1,63706209,63707166,957,0.774559410084207
24463,2123.5754,2123.717467,1,63707262,63711524,4262,0.7514902166059401
24464,2123.797733,2123.812967,1,63713931,63714389,458,0.5246040776103025
24465,2123.814067,2123.818167,1,63714422,63714545,123,0.8144409414039676
24466,2123.8232,2123.894867,1,63714695,63716846,2151,0.672301680854505
24467,2123.8964,2123.9047,1,63716892,63717141,249,0.4467638915790655
24468,2123.9127,2123.922633,1,63717380,63717678,298,0.2201906087550877
24469,2123.975633,2124.012733,1,63719268,63720381,1113,0.7437344811554613
24470,2124.014733,2124.174967,1,63720441,63725249,4808,0.7278600496776084
24471,2124.176067,2124.216133,1,63725282,63726483,1201,0.707208244425037
24472,2124.2205,2124.223833,1,63726615,63726714,99,0.821675084908315
24473,2124.2305,2124.2363,1,63726915,63727089,174,0.9119497418156632
24474,2124.241333,2124.245967,1,63727239,63727379,140,-0.21713354436861346
24475,2124.254333,2124.2627,1,63727629,63727881,252,0.2898857124424049
24476,2124.271133,2124.280967,1,63728133,63728429,296,0.16507323438800914
24477,2124.322267,2124.3339,1,63729668,63730017,349,0.1269497727261473
24478,2124.335633,2124.388033,1,63730068,63731640,1572,0.5992372521897111
24479,2124.397967,2124.4206,1,63731939,63732618,679,0.2405824799779787
24480,2124.496633,2124.5362,1,63734898,63736086,1188,0.6145685682284802
24481,2124.5621,2124.5675,1,63736863,63737025,162,0.5089690222044837
24482,2124.587067,2124.590167,1,63737612,63737705,93,0.29374416142042936
24483,2124.619033,2124.643333,1,63738570,63739299,729,0.20057826374799606
24484,2124.648467,2124.764067,1,63739454,63742922,3468,0.7270852715712554
24485,2124.765367,2124.777567,1,63742961,63743327,366,0.3851130476505077
24486,2124.798867,2124.802933,1,63743966,63744087,121,0.17715618574272426
24487,2124.839967,2124.8568,1,63745199,63745704,505,0.1621151086692739
24488,2124.857867,2124.923333,1,63745736,63747699,1963,0.8172132289138904
24489,2124.9767,2124.983233,1,63749301,63749496,195,0.5892577494920129
24490,2124.992767,2125.155,1,63749783,63754650,4867,0.6164854291689065
24491,2125.157167,2125.160833,1,63754715,63754824,109,0.7733983388380484
24492,2125.188767,2125.242367,1,63755663,63757271,1608,0.2854389760083528
24493,2125.2536,2125.299033,1,63757608,63758970,1362,0.6966871313636323
24494,2125.3007,2125.308133,1,63759020,63759243,223,0.6400945807897278
24495,2125.3093,2125.318167,1,63759279,63759545,266,0.522266375795611
24496,2125.323467,2125.341733,1,63759704,63760251,547,0.08759137038558756
24497,2125.357767,2125.517767,1,63760733,63765533,4800,0.7810836742038085
24498,2125.521333,2125.545967,1,63765639,63766379,740,0.7361167308343604
24499,2125.581367,2125.586533,1,63767441,63767595,154,0.8848937205118758
24500,2125.589367,2125.609833,1,63767681,63768294,613,0.2342212013641165
24501,2125.6142,2125.652833,1,63768426,63769584,1158,0.32967482632532236
24502,2125.655033,2125.663267,1,63769650,63769898,248,0.9140096319402423
24503,2125.667433,2125.6998,1,63770022,63770993,971,0.6387014847220841
24504,2125.702467,2125.744267,1,63771074,63772328,1254,0.24176001084155171
24505,2125.745733,2125.765,1,63772371,63772949,578,0.2010415682087413
24506,2125.7722,2125.777567,1,63773166,63773327,161,0.570337282491264
24507,2125.7808,2125.830433,1,63773424,63774912,1488,0.5487229901915252
24508,2125.833067,2125.8583,1,63774992,63775748,756,0.29536934118642655
24509,2125.862567,2125.870633,1,63775877,63776118,241,0.45035681636251645
24510,2125.878633,2125.881767,1,63776358,63776453,95,0.8012757967981617
24511,2125.8843,2125.9002,1,63776529,63777006,477,0.23613757041277977
24512,2125.916167,2125.959233,1,63777485,63778776,1291,0.4795179048443907
24513,2125.971767,2126.0061,1,63779153,63780183,1030,0.17192083778605746
24514,2126.015,2126.030333,1,63780449,63780909,460,0.08365786140006463
24515,2126.047167,2126.0557,1,63781415,63781671,256,0.5754535356140489
24516,2126.078133,2126.100867,1,63782343,63783026,683,0.6050995373025234
24517,2126.1024,2126.109433,1,63783072,63783282,210,0.7403343088532249
24518,2126.1756,2126.1896,1,63785268,63785688,420,0.5529516506909815
24519,2126.213167,2126.220867,1,63786395,63786626,231,0.8474392871324729
24520,2126.2416,2126.309367,1,63787247,63789281,2034,0.15497311980699754
24521,2126.319933,2126.323233,1,63789597,63789696,99,0.24638997125274786
24522,2126.324233,2126.3333,1,63789726,63789998,272,0.7407223979001321
24523,2126.335633,2126.3702,1,63790068,63791105,1037,0.4715342218332011
24524,2126.377933,2126.404,1,63791337,63792120,783,0.017820578213375387
24525,2126.4117,2126.434233,1,63792351,63793026,675,0.1446589591291087
24526,2126.487733,2126.641633,1,63794631,63799248,4617,0.39126617288981796
24527,2126.705133,2126.729,1,63801153,63801869,716,0.6909928840898033
24528,2126.7328,2126.8178,1,63801984,63804533,2549,0.6578326730968885
24529,2126.919933,2126.9258,1,63807597,63807774,177,0.2890167166724725
24530,2126.941433,2127.147467,1,63808242,63814424,6182,0.7721942103731628
24531,2127.1491,2127.1747,1,63814473,63815241,768,0.6931999744651602
24532,2127.4385,2127.442133,1,63823155,63823263,108,0.9056499782319832
24533,2127.458933,2127.663767,1,63823767,63829913,6146,0.6829257867810932
24534,2127.664833,2127.686733,1,63829944,63830601,657,0.5966535331738655
24535,2127.767533,2127.7831,1,63833025,63833493,468,0.18534191307517905
24536,2127.795367,2128.001,1,63833861,63840030,6169,0.7464375366190321
24537,2128.004067,2128.067533,1,63840122,63842025,1903,0.7104604949768063
24538,2128.322667,2128.325867,1,63849680,63849776,96,0.691618024260295
24539,2128.340333,2128.4115,1,63850209,63852345,2136,0.7319715794565474
24540,2128.424267,2128.461933,1,63852728,63853857,1129,0.6430112647086744
24541,2128.4687,2128.6135,1,63854061,63858405,4344,0.7202870685494978
24542,2128.631267,2128.747867,1,63858938,63862436,3498,0.6684618970818831
24543,2128.804667,2128.810733,1,63864140,63864321,181,0.3119214603604683
24544,2128.830467,2128.849133,1,63864914,63865473,559,0.23656351739109108
24545,2128.850433,2128.886133,1,63865512,63866583,1071,0.6893558316410773
24546,2128.887733,2129.0678,1,63866631,63872033,5402,0.7550892953905919
24547,2129.4321,2129.439633,1,63882963,63883188,225,0.8464461973578925
24548,2129.450567,2129.512533,1,63883517,63885375,1858,0.6715590583204076
24549,2129.533933,2129.6492,1,63886017,63889475,3458,0.6353962387480775
24550,2129.658833,2129.750133,1,63889764,63892503,2739,0.727823091191713
24551,2129.7583,2129.925233,1,63892749,63897756,5007,0.7524822497140816
24552,2129.983733,2129.987933,1,63899511,63899637,126,0.8319638288725614
24553,2130.028967,2130.0443,1,63900869,63901329,460,0.33260971777243326
24554,2130.0457,2130.051333,1,63901371,63901539,168,0.7590795331681675
24555,2130.052867,2130.058067,1,63901586,63901742,156,0.8033481219521355
24556,2130.059267,2130.080867,1,63901778,63902426,648,0.6448927723699265
24557,2130.0939,2130.112333,1,63902816,63903369,553,0.3224219424526116
24558,2130.199233,2130.202333,1,63905976,63906069,93,0.8872883501197572
24559,2130.212433,2130.217633,1,63906372,63906528,156,0.7694373028181998
24560,2130.221167,2130.225433,1,63906635,63906762,127,0.8422145132021387
24561,2130.2274,2130.428633,1,63906822,63912858,6036,0.743947958108989
24562,2130.429667,2130.483567,1,63912890,63914507,1617,0.6833663503941606
24563,2130.5095,2130.513467,1,63915285,63915404,119,0.8354449219829113
24564,2130.523733,2130.5319,1,63915711,63915957,246,0.005658828473630238
24565,2130.651633,2130.6548,1,63919548,63919643,95,0.6635860563358689
24566,2130.683433,2130.690767,1,63920502,63920723,221,0.5788869812803408
24567,2130.6963,2130.777633,1,63920889,63923328,2439,0.8403340112685995
24568,2130.781,2130.7851,1,63923430,63923553,123,0.11334668348529088
24569,2130.8421,2130.846667,1,63925262,63925400,138,0.9298939222647551
24570,2130.848733,2130.8522,1,63925461,63925565,104,0.9111957227121693
24571,2130.8903,2130.893467,1,63926709,63926804,95,0.8244519659477788
24572,2130.9177,2130.944667,1,63927531,63928340,809,0.23016398201300833
24573,2130.9518,2130.959867,1,63928553,63928796,243,0.04200592306181205
24574,2130.9609,2130.966067,1,63928827,63928982,155,0.33323237636642844
24575,2130.970633,2130.9758,1,63929118,63929274,156,0.7393487610868396
24576,2130.981933,2131.0165,1,63929457,63930495,1038,0.19497447694275197
24577,2131.067233,2131.071067,1,63932016,63932132,116,0.7282135213147862
24578,2131.076067,2131.082333,1,63932282,63932469,187,0.5213258170861086
24579,2131.149867,2131.349267,1,63934496,63940478,5982,0.5941962644009233
24580,2131.3533,2131.3602,1,63940599,63940806,207,0.8342289307580057
24581,2131.7869,2131.961067,1,63953607,63958832,5225,0.7737293793712863
24582,2131.982433,2131.9914,1,63959472,63959742,270,0.8177248715171785
24583,2131.995033,2132.003567,1,63959850,63960107,257,0.3868467952544584
24584,2132.011367,2132.031767,1,63960341,63960953,612,0.12273446464390894
24585,2132.0705,2132.074767,1,63962114,63962243,129,0.6241035561312419
24586,2132.0758,2132.080533,1,63962274,63962415,141,0.585537630190566
24587,2132.097467,2132.1083,1,63962924,63963248,324,0.6474528016661818
24588,2132.1192,2132.125667,1,63963576,63963770,194,0.8248499312050798
24589,2132.254933,2132.258167,1,63967647,63967745,98,0.7729269387484068
24590,2132.318833,2132.331667,1,63969564,63969950,386,0.5677637238583262
24591,2132.3443,2132.370867,1,63970329,63971126,797,0.6252145092503769
24592,2132.3771,2132.380133,1,63971313,63971403,90,0.6777605593308792
24593,2132.4805,2132.488167,1,63974415,63974645,230,0.5584441091198484
24594,2132.4892,2132.518367,1,63974676,63975551,875,0.6822489853423469
24595,2132.531933,2132.555933,1,63975957,63976677,720,0.6722050667609547
24596,2132.5605,2132.7104,1,63976815,63981312,4497,0.7523640039021181
24597,2132.718833,2132.860233,1,63981564,63985806,4242,0.7566231354447682
24598,2132.893467,2132.897467,1,63986804,63986924,120,0.5147157655152972
24599,2132.915333,2132.952067,1,63987459,63988562,1103,0.5730595143062218
24600,2132.9654,2132.968867,1,63988962,63989066,104,0.400242287961541
24601,2133.002133,2133.260433,1,63990063,63997812,7749,0.7398234043797689
24602,2133.4002,2133.421833,1,64002006,64002654,648,0.06526523415772843
24603,2133.542033,2133.577733,1,64006260,64007331,1071,0.5529305901640322
24604,2133.5923,2133.611833,1,64007768,64008354,586,0.44043878506275347
24605,2133.620867,2133.688,1,64008626,64010640,2014,0.8402057223715623
24606,2133.779033,2133.783367,1,64013370,64013501,131,0.7937605101402425
24607,2133.941733,2134.153767,1,64018251,64024613,6362,0.6279624728926743
24608,2134.193433,2134.201733,1,64025802,64026051,249,0.6705654875104256
24609,2134.345367,2134.3625,1,64030361,64030875,514,0.8195963805298361
24610,2134.3881,2134.391767,1,64031643,64031753,110,0.8689512454389485
24611,2134.4469,2134.451667,1,64033407,64033550,143,0.5250614872168483
24612,2134.4608,2134.5942,1,64033823,64037826,4003,0.7476646849038543
24613,2134.6606,2134.696,1,64039818,64040880,1062,0.6790906589663182
24614,2134.7021,2134.7766,1,64041063,64043298,2235,0.6834593161098043
24615,2134.833033,2134.866967,1,64044990,64046009,1019,0.6655196758654162
24616,2134.868,2134.872433,1,64046040,64046172,132,0.6380764115870208
24617,2134.9354,2134.943067,1,64048061,64048292,231,0.38275296915546775
24618,2134.9446,2135.117033,1,64048337,64053510,5173,0.7323514430228835
24619,2135.4552,2135.4903,1,64063656,64064709,1053,0.7436365262057729
24620,2135.492533,2135.6569,1,64064775,64069707,4932,0.7334843539088133
24621,2135.664433,2135.6851,1,64069932,64070553,621,0.5620802858629262
24622,2135.688667,2135.698333,1,64070660,64070949,289,0.29496016129399394
24623,2136.023467,2136.047667,1,64080704,64081430,726,0.5846140877393202
24624,2136.058933,2136.072067,1,64081767,64082162,395,0.8112401211761284
24625,2136.167333,2136.1767,1,64085019,64085301,282,0.6186976879783398
24626,2136.178533,2136.424767,1,64085355,64092743,7388,0.747596668014586
24627,2136.4316,2136.4449,1,64092948,64093347,399,0.5689466232268917
24628,2136.445933,2136.449033,1,64093377,64093470,93,0.8881806128040788
24629,2136.455967,2136.459733,1,64093679,64093791,112,0.9106031048051865
24630,2136.473433,2136.4921,1,64094202,64094763,561,0.09752529892920572
24631,2136.5088,2136.5492,1,64095264,64096476,1212,0.6211859783666205
24632,2136.550933,2136.560067,1,64096527,64096802,275,0.8088609487612812
24633,2136.573067,2136.5911,1,64097192,64097733,541,0.3033582678460514
24634,2136.608733,2136.6218,1,64098261,64098654,393,0.7112514489442372
24635,2136.652067,2136.681633,1,64099562,64100448,886,0.4236587265982369
24636,2136.6838,2136.6887,1,64100513,64100661,148,0.9652241403306069
24637,2136.7267,2136.732733,1,64101801,64101981,180,0.7738231655472096
24638,2136.735067,2136.743667,1,64102052,64102310,258,0.9144146424917244
24639,2136.8164,2136.8676,1,64104492,64106028,1536,0.6442435015843878
24640,2136.868833,2137.025667,1,64106064,64110770,4706,0.7402106529401137
24641,2137.029467,2137.055667,1,64110884,64111670,786,0.6460826519262082
24642,2137.0611,2137.0677,1,64111833,64112031,198,0.6666811277531969
24643,2137.135567,2137.141067,1,64114067,64114232,165,0.6697047269020887
24644,2137.4145,2137.4181,1,64122434,64122542,108,0.509661270388239
24645,2137.541067,2137.546567,1,64126232,64126397,165,0.4606344488211915
24646,2137.5482,2137.5523,1,64126446,64126568,122,0.7910338840916011
24647,2137.739333,2137.784267,1,64132179,64133528,1349,0.7121542182171281
24648,2137.8717,2137.9414,1,64136151,64138242,2091,0.7070150484261803
24649,2137.951733,2138.196367,1,64138551,64145891,7340,0.720126902397881
24650,2138.197867,2138.208767,1,64145936,64146263,327,0.6727076706747017
24651,2138.213333,2138.314633,1,64146399,64149438,3039,0.7321464559785201
24652,2138.320033,2138.325433,1,64149600,64149762,162,0.8580427154342669
24653,2138.3432,2138.398033,1,64150295,64151940,1645,-0.280223537637055
24654,2138.4025,2138.433233,1,64152075,64152996,921,0.1701302892837022
24655,2138.444467,2138.4714,1,64153334,64154142,808,0.10890062171430952
24656,2138.487333,2138.4971,1,64154619,64154913,294,0.5525508616275482
24657,2138.501233,2138.505433,1,64155036,64155162,126,0.8442273101656911
24658,2138.506567,2138.515567,1,64155197,64155467,270,0.5474171050482896
24659,2138.519967,2138.626433,1,64155599,64158792,3193,0.6610817209547873
24660,2138.631033,2138.658867,1,64158930,64159766,836,0.6851411642017385
24661,2138.696533,2138.729467,1,64160895,64161884,989,0.16308374690857372
24662,2138.732933,2138.7697,1,64161987,64163090,1103,0.5729766629526095
24663,2138.789667,2138.795467,1,64163690,64163864,174,0.7511572986336406
24664,2138.802867,2138.806367,1,64164086,64164191,105,0.7992515902395112
24665,2138.808167,2139.013733,1,64164245,64170411,6166,0.7132867215887488
24666,2139.0172,2139.0683,1,64170515,64172049,1534,0.6539275637378997
24667,2139.166467,2139.178133,1,64174994,64175343,349,0.5531696316055538
24668,2139.3848,2139.410567,1,64181543,64182317,774,0.6531995466439031
24669,2139.4254,2139.4301,1,64182762,64182903,141,0.5340646473649417
24670,2139.4315,2139.436867,1,64182945,64183106,161,0.5206445515184207
24671,2139.4652,2139.5224,1,64183956,64185671,1715,0.47471113140120613
24672,2139.5275,2139.532233,1,64185825,64185966,141,0.8684868727027089
24673,2139.533567,2139.540733,1,64186007,64186221,214,0.6642586637504316
24674,2139.547767,2139.6731,1,64186433,64190193,3760,0.8206658162930298
24675,2139.677767,2139.684,1,64190333,64190520,187,0.6404078207689583
24676,2139.7007,2139.7128,1,64191020,64191383,363,0.5098560963775499
24677,2139.731367,2139.734667,1,64191941,64192040,99,0.9163656785293045
24678,2139.746467,2139.754633,1,64192394,64192638,244,0.609705889642954
24679,2139.761367,2139.770233,1,64192841,64193106,265,0.8353808377971789
24680,2139.932633,2140.131533,1,64197978,64203945,5967,0.5988961905526101
24681,2140.132867,2140.138967,1,64203986,64204169,183,0.6758607932989185
24682,2140.173933,2140.3654,1,64205217,64210962,5745,0.8302302087789563
24683,2140.3784,2140.393533,1,64211352,64211805,453,0.768006267161876
24684,2140.409467,2140.4193,1,64212284,64212579,295,0.8583492836195741
24685,2140.431433,2140.436267,1,64212942,64213088,146,0.743117692266163
24686,2140.4399,2140.476967,1,64213196,64214309,1113,0.622362385993833
24687,2140.478667,2140.492733,1,64214360,64214781,421,0.20557292673289404
24688,2140.504467,2140.531167,1,64215134,64215935,801,0.328177110899858
24689,2140.5342,2140.5874,1,64216026,64217622,1596,0.6689348984315208
24690,2140.6084,2140.620467,1,64218252,64218614,362,0.53088275307233
24691,2140.624533,2140.630733,1,64218735,64218921,186,0.09780901976061196
24692,2140.632533,2140.647533,1,64218975,64219425,450,0.5667677886436169
24693,2140.650767,2140.6562,1,64219523,64219686,163,0.5777132148011693
24694,2140.663333,2140.719733,1,64219899,64221591,1692,0.4613978738843701
24695,2140.7227,2140.765233,1,64221680,64222956,1276,0.6962577183296539
24696,2140.823,2140.843967,1,64224689,64225319,630,0.7076799032797394
24697,2140.845767,2140.849767,1,64225373,64225493,120,0.7125881053516472
24698,2140.881333,2140.933633,1,64226439,64228008,1569,0.761210099209902
24699,2140.957067,2140.9615,1,64228712,64228845,133,0.8611209175135194
24700,2140.9789,2140.9985,1,64229367,64229955,588,0.537339983092567
24701,2141.007567,2141.025633,1,64230227,64230768,541,0.11040308155685663
24702,2141.029467,2141.052,1,64230884,64231560,676,0.11461417777576746
24703,2141.062967,2141.067533,1,64231889,64232025,136,0.20695219103280185
24704,2141.068967,2141.075433,1,64232069,64232262,193,0.7817816433434774
24705,2141.078833,2141.110667,1,64232364,64233320,956,0.43836960388860763
24706,2141.121633,2141.146167,1,64233648,64234385,737,0.23552321155718797
24707,2141.147633,2141.164,1,64234428,64234920,492,0.2646498536030511
24708,2141.167033,2141.1787,1,64235010,64235361,351,0.6284876750256337
24709,2141.269967,2141.275,1,64238099,64238250,151,0.5863974189495691
24710,2141.280867,2141.3571,1,64238426,64240713,2287,0.8043478931777104
24711,2141.3798,2141.406633,1,64241394,64242198,804,0.7492501594983245
24712,2141.456133,2141.712933,1,64243683,64251387,7704,0.7858092965358108
24713,2141.718,2141.736933,1,64251539,64252107,568,0.6652684384735568
24714,2141.7594,2141.833833,1,64252782,64255014,2232,0.6304723873992808
24715,2141.8669,2141.872833,1,64256007,64256184,177,0.8227583352659572
24716,2141.8795,2141.898,1,64256385,64256940,555,0.6299755974461586
24717,2141.909267,2141.912967,1,64257278,64257389,111,0.8517239025793959
24718,2141.916167,2141.936633,1,64257485,64258098,613,0.5977456884572596
24719,2141.938367,2141.956233,1,64258151,64258686,535,0.5213524202283053
24720,2141.967667,2141.9933,1,64259030,64259799,769,0.5927751708604496
24721,2142.0004,2142.015267,1,64260012,64260458,446,0.6135872646119751
24722,2142.038033,2142.0464,1,64261140,64261392,252,0.7646108402880064
24723,2142.050867,2142.054633,1,64261526,64261638,112,0.8292311456309883
24724,2142.121067,2142.1269,1,64263632,64263807,175,0.6419647473795531
24725,2142.139167,2142.163567,1,64264175,64264907,732,0.8014920269218316
24726,2142.169067,2142.1754,1,64265072,64265262,190,0.8230457021508393
24727,2142.188733,2142.205333,1,64265661,64266159,498,0.5627280373669827
24728,2142.214833,2142.3587,1,64266444,64270761,4317,0.8124757081421783
24729,2142.362067,2142.3672,1,64270862,64271016,154,0.9253484377195119
24730,2142.4027,2142.409733,1,64272081,64272291,210,0.9297219456971332
24731,2142.4171,2142.420567,1,64272513,64272617,104,0.7364528866157365
24732,2142.447933,2142.458433,1,64273437,64273752,315,0.7650292613415905
24733,2142.494233,2142.734033,1,64274826,64282020,7194,0.6984107352816912
24734,2142.772633,2142.960733,1,64283178,64288821,5643,0.726320311192686
24735,2143.150133,2143.3051,1,64294503,64299153,4650,0.7707957549018004
24736,2143.3798,2143.692167,1,64301394,64310765,9371,0.767611582021923
24737,2143.701633,2143.730167,1,64311048,64311905,857,0.7520782394284418
24738,2143.739233,2143.7621,1,64312176,64312863,687,0.756367786896307
24739,2143.771633,2143.782,1,64313148,64313460,312,0.8645336448572694
24740,2143.8243,2144.059233,1,64314729,64321776,7047,0.9008937659155795
24741,2144.075833,2144.106267,1,64322274,64323188,914,0.6225394204723074
24742,2144.107433,2144.206733,1,64323222,64326201,2979,0.3949576991327682
24743,2144.2329,2144.299833,1,64326987,64328994,2007,0.5386755387989833
24744,2144.304133,2144.311433,1,64329123,64329342,219,0.5027663875207699
24745,2144.3301,2144.3484,1,64329903,64330451,548,0.5947612553324111
24746,2144.3501,2144.368133,1,64330503,64331043,540,0.7588113869408879
24747,2144.3785,2144.401067,1,64331354,64332032,678,0.1828905426992001
24748,2144.4091,2144.419733,1,64332272,64332591,319,0.3052442564495699
24749,2144.428767,2144.449533,1,64332863,64333485,622,0.37908585083748575
24750,2144.5353,2144.558533,1,64336059,64336755,696,0.585768194554393
24751,2144.5708,2144.574833,1,64337124,64337244,120,0.31601870582198544
24752,2144.646433,2144.650133,1,64339392,64339503,111,0.47365233273387414
24753,2144.652333,2144.660367,1,64339569,64339811,242,0.6349402467955501
24754,2144.688667,2144.696433,1,64340660,64340892,232,0.4955613841090327
24755,2144.6983,2144.858733,1,64340949,64345761,4812,0.8007642453966644
24756,2144.8915,2144.9543,1,64346745,64348628,1883,0.7376501020418968
24757,2144.9629,2145.173067,1,64348887,64355192,6305,0.7638310450340283
24758,2145.1757,2145.2021,1,64355270,64356063,793,0.4591884391673195
24759,2145.206367,2145.2316,1,64356191,64356948,757,0.30599514703402175
24760,2145.233,2145.323433,1,64356990,64359702,2712,0.3495756126389552
24761,2145.324733,2145.3825,1,64359741,64361475,1734,0.11098855797140418
24762,2145.394867,2145.4005,1,64361846,64362015,169,0.09122782961977113
24763,2145.403867,2145.417133,1,64362116,64362513,397,-0.10255848935185188
24764,2145.4281,2145.433,1,64362843,64362990,147,0.521726794578872
24765,2145.434267,2145.438233,1,64363028,64363146,118,0.820686590477311
24766,2145.487333,2145.506433,1,64364619,64365192,573,0.6698274636526641
24767,2145.510567,2145.6374,1,64365317,64369122,3805,0.798091104618098
24768,2145.644233,2145.662333,1,64369326,64369869,543,0.657490026973681
24769,2145.678733,2145.702533,1,64370361,64371075,714,0.2934072597893601
24770,2145.7089,2145.747333,1,64371267,64372419,1152,0.4778421312153851
24771,2145.748533,2145.7543,1,64372455,64372629,174,0.8590825168649083
24772,2145.768933,2145.795167,1,64373067,64373855,788,0.30110142722941546
24773,2145.799233,2145.859167,1,64373976,64375775,1799,0.6060283719083722
24774,2145.872333,2145.915,1,64376169,64377450,1281,0.35045353477193014
24775,2145.9178,2145.961467,1,64377534,64378844,1310,0.5823919562487649
24776,2145.962767,2145.966767,1,64378883,64379003,120,0.635331427722784
24777,2145.995767,2146.008033,1,64379873,64380240,367,0.4696454249773504
24778,2146.023667,2146.0751,1,64380710,64382253,1543,0.6667437149918242
24779,2146.0899,2146.101167,1,64382697,64383035,338,0.7580059747687468
24780,2146.107533,2146.112533,1,64383225,64383375,150,0.7068241382656874
24781,2146.147367,2146.155633,1,64384421,64384668,247,0.5232147621966604
24782,2146.159267,2146.209433,1,64384778,64386282,1504,0.7264233473066731
24783,2146.211467,2146.419733,1,64386344,64392591,6247,0.7507892300510431
24784,2146.466267,2146.475033,1,64393988,64394250,262,0.7146554255151272
24785,2146.482367,2146.615333,1,64394471,64398459,3988,0.799610422210777
24786,2146.640567,2146.649367,1,64399217,64399481,264,0.7856024210218575
24787,2146.691,2146.6976,1,64400729,64400928,199,0.7626986396490255
24788,2146.8872,2146.8903,1,64406616,64406709,93,0.7295624576105567
24789,2146.8918,2147.092767,1,64406753,64412783,6030,0.6607205757029618
24790,2147.0985,2147.1296,1,64412955,64413888,933,0.6203428113669567
24791,2147.133767,2147.167733,1,64414013,64415031,1018,0.5097777689540088
24792,2147.169533,2147.172567,1,64415085,64415177,92,0.8395211712210968
24793,2147.173833,2147.3128,1,64415214,64419384,4170,0.7942392368400591
24794,2147.322767,2147.348867,1,64419683,64420466,783,0.8967663512120464
24795,2147.3723,2147.469367,1,64421169,64424081,2912,0.750923359645997
24796,2147.509333,2147.5204,1,64425279,64425612,333,0.7991734632738291
24797,2147.5498,2147.553267,1,64426493,64426598,105,0.8437843434564587
24798,2147.5584,2147.968533,1,64426752,64439055,12303,0.7054383002270651
24799,2147.970867,2147.9753,1,64439126,64439259,133,0.8298474317803726
24800,2147.981067,2148.0149,1,64439432,64440447,1015,0.8089995888405533
24801,2148.021,2148.081333,1,64440630,64442439,1809,0.7065836669600954
24802,2148.097233,2148.2127,1,64442916,64446381,3465,0.7188582712698254
24803,2148.234633,2148.265133,1,64447038,64447953,915,0.7751253761128108
24804,2148.268967,2148.338367,1,64448069,64450151,2082,0.7399763333962244
24805,2148.354,2148.385033,1,64450619,64451550,931,0.20581302496381101
24806,2148.386067,2148.3923,1,64451582,64451769,187,0.817308048056127
24807,2148.393467,2148.442533,1,64451804,64453275,1471,0.6784758817122958
24808,2148.449567,2148.4903,1,64453487,64454709,1222,0.31829585677251326
24809,2148.499067,2148.585167,1,64454972,64457555,2583,0.2659005424282848
24810,2148.5909,2148.6545,1,64457727,64459635,1908,0.485681972843459
24811,2148.6556,2148.817933,1,64459668,64464537,4869,0.6841350107803489
24812,2148.8204,2148.931867,1,64464612,64467956,3344,0.7222415959597315
24813,2148.941067,2148.977567,1,64468232,64469327,1095,0.050075123299020995
24814,2148.984633,2149.029267,1,64469538,64470878,1340,0.41936414568761515
24815,2149.036467,2149.058167,1,64471094,64471745,651,0.2339589255445585
24816,2149.067,2149.078567,1,64472010,64472357,347,0.5181375202764734
24817,2149.0813,2149.129533,1,64472438,64473885,1447,0.4385218557816046
24818,2149.1308,2149.277167,1,64473924,64478315,4391,0.7327859900320862
24819,2149.278467,2149.302933,1,64478354,64479087,733,0.025367838914299112
24820,2149.3199,2149.351067,1,64479597,64480532,935,-0.014052366937689558
24821,2149.3607,2149.403567,1,64480821,64482107,1286,0.02191099097344952
24822,2149.405567,2149.450867,1,64482167,64483526,1359,0.12835639297968698
24823,2149.452767,2149.518633,1,64483583,64485558,1975,0.5285867172081974
24824,2149.520133,2149.538233,1,64485603,64486146,543,0.13587923745448416
24825,2149.551833,2149.559933,1,64486554,64486797,243,0.7222727898939242
24826,2149.5614,2149.572367,1,64486842,64487171,329,0.7340538948666103
24827,2149.581633,2149.626033,1,64487448,64488780,1332,0.7347715769430497
24828,2149.631467,2149.673533,1,64488944,64490205,1261,0.6823994726142547
24829,2149.683633,2149.7111,1,64490508,64491333,825,0.3221390359574419
24830,2149.7172,2149.8806,1,64491516,64496418,4902,0.6914091969823044
24831,2149.882467,2149.9158,1,64496474,64497474,1000,0.5479419197122471
24832,2149.9242,2150.137133,1,64497726,64504113,6387,0.7867434815625451
24833,2150.142067,2150.165533,1,64504262,64504965,703,0.6303500401976372
24834,2150.169,2150.1977,1,64505069,64505931,862,0.6449816777308321
24835,2150.2264,2150.3021,1,64506792,64509063,2271,0.2887722580868447
24836,2150.310667,2150.408533,1,64509320,64512255,2935,0.05197895805008439
24837,2150.409933,2150.413133,1,64512297,64512393,96,0.7116934159232116
24838,2150.4541,2150.5031,1,64513623,64515093,1470,0.7589074048358798
24839,2150.516667,2150.537333,1,64515500,64516119,619,0.7358381045299885
24840,2150.586967,2150.990067,1,64517609,64529702,12093,0.7456487742589567
24841,2151.020467,2151.036867,1,64530614,64531106,492,0.2004587644133929
24842,2151.0411,2151.0483,1,64531233,64531449,216,0.6757531397107798
24843,2151.056133,2151.215367,1,64531683,64536461,4778,0.7590827352313988
24844,2151.2194,2151.256733,1,64536582,64537701,1119,0.7465488496544882
24845,2151.281867,2151.321267,1,64538456,64539638,1182,0.21668433189028377
24846,2151.328733,2151.3684,1,64539861,64541051,1190,0.4045910430646216
24847,2151.3694,2151.3746,1,64541082,64541238,156,0.6794546029667036
24848,2151.390333,2151.427367,1,64541709,64542821,1112,0.2261383070823706
24849,2151.443333,2151.533233,1,64543299,64545996,2697,0.13678170467034045
24850,2151.5827,2151.5911,1,64547481,64547733,252,0.4364967020942398
24851,2151.5932,2151.598733,1,64547795,64547961,166,0.8333683833177457
24852,2151.609333,2151.638633,1,64548279,64549158,879,0.7413794769145572
24853,2151.642,2151.6573,1,64549259,64549718,459,0.5161752786411893
24854,2151.661933,2151.671367,1,64549857,64550141,284,0.09384375738865955
24855,2151.681233,2151.684533,1,64550436,64550535,99,0.4863028845557404
24856,2151.7348,2151.741467,1,64552044,64552244,200,0.7708754193007727
24857,2151.771533,2152.0368,1,64553145,64561103,7958,0.7668295594387483
24858,2152.0926,2152.096867,1,64562778,64562906,128,0.6216810166474264
24859,2152.118333,2152.1225,1,64563549,64563675,126,0.6919916848029503
24860,2152.368067,2152.371067,1,64571042,64571132,90,-0.33403943204981845
24861,2152.378833,2152.3819,1,64571364,64571456,92,0.3429303698747091
24862,2152.383733,2152.4082,1,64571511,64572245,734,-0.014247932300851146
24863,2152.409267,2152.4137,1,64572278,64572411,133,0.2154103557548967
24864,2152.427533,2152.430833,1,64572825,64572924,99,0.30010831396455095
24865,2152.4898,2152.4983,1,64574693,64574949,256,0.7333405066236759
24866,2152.517333,2152.561233,1,64575519,64576836,1317,0.7055358872177803
24867,2152.5684,2152.6266,1,64577052,64578798,1746,0.662407489214256
24868,2152.677033,2152.680833,1,64580310,64580424,114,0.863300999580464
24869,2152.685433,2152.732933,1,64580562,64581987,1425,0.7120046312160193
24870,2152.7367,2152.743733,1,64582101,64582311,210,0.33486579713657955
24871,2152.751233,2152.770533,1,64582536,64583115,579,0.770881773064489
24872,2152.7782,2152.7924,1,64583346,64583771,425,0.7258497640127242
24873,2152.8091,2152.812633,1,64584273,64584378,105,0.8195037030833136
24874,2152.823333,2153.0319,1,64584699,64590957,6258,0.7297231347196861
24875,2153.039433,2153.063033,1,64591182,64591890,708,0.7134845090318199
24876,2153.067967,2153.092233,1,64592039,64592766,727,0.6883126268689903
24877,2153.147433,2153.1512,1,64594422,64594535,113,0.5966643985543104
24878,2153.156467,2153.163067,1,64594694,64594892,198,0.17698526929766822
24879,2153.167533,2153.170933,1,64595025,64595127,102,0.39831497194730714
24880,2153.201433,2153.2045,1,64596042,64596134,92,0.667420283103856
24881,2153.207067,2153.249167,1,64596212,64597475,1263,0.5004845462696496
24882,2153.251667,2153.288267,1,64597550,64598648,1098,0.023530119871483075
24883,2153.293167,2153.324133,1,64598795,64599723,928,0.13222335051845827
24884,2153.327667,2153.3864,1,64599830,64601591,1761,0.04461403046742561
24885,2153.435267,2153.4388,1,64603058,64603164,106,0.20601712390508212
24886,2153.4569,2153.5097,1,64603707,64605291,1584,0.7415320773631701
24887,2153.613933,2153.670567,1,64608417,64610117,1700,0.7158112488109297
24888,2153.6877,2153.781567,1,64610631,64613447,2816,0.721126760382947
24889,2153.7849,2154.007067,1,64613547,64620212,6665,0.7689881003737875
24890,2154.040367,2154.050067,1,64621211,64621502,291,0.5605437843618748
24891,2154.076033,2154.270567,1,64622280,64628117,5837,0.7720461656068247
24892,2154.292867,2154.303067,1,64628786,64629092,306,0.6895191766055423
24893,2154.308433,2154.350067,1,64629252,64630502,1250,-0.04904544404955904
24894,2154.3687,2154.377667,1,64631061,64631330,269,0.08326892910439308
24895,2154.380933,2154.419767,1,64631427,64632593,1166,0.6845084892097932
24896,2154.428833,2154.467933,1,64632864,64634037,1173,0.27964484512493554
24897,2154.4695,2154.482633,1,64634085,64634478,393,0.4343322463529994
24898,2154.489,2154.492267,1,64634670,64634768,98,0.4656590236285579
24899,2154.513367,2154.6799,1,64635401,64640397,4996,0.7715612334983167
24900,2154.683533,2154.701867,1,64640505,64641056,551,0.7804479224283322
24901,2154.702867,2154.7069,1,64641086,64641207,121,0.8682350792496719
24902,2154.709967,2154.733933,1,64641299,64642017,718,0.625843406811329
24903,2154.745367,2154.775367,1,64642361,64643261,900,0.1398517569409112
24904,2154.7765,2154.7847,1,64643295,64643541,246,-0.2895601894453422
24905,2154.7915,2154.8039,1,64643744,64644117,373,-0.015440247661207685
24906,2154.819767,2154.876,1,64644593,64646280,1687,0.7794475412074913
24907,2154.8784,2154.9032,1,64646352,64647096,744,0.7044977821522672
24908,2154.922467,2154.982633,1,64647674,64649478,1804,0.1592704446467997
24909,2154.987133,2155.011133,1,64649613,64650333,720,0.5589058763525948
24910,2155.0176,2155.027533,1,64650528,64650825,297,0.4948141521439391
24911,2155.030367,2155.3365,1,64650911,64660095,9184,0.6908878087718455
24912,2155.3789,2155.412467,1,64661367,64662374,1007,0.07241439857354723
24913,2155.418867,2155.423433,1,64662566,64662702,136,0.8741173670656999
24914,2155.4371,2155.451367,1,64663113,64663541,428,0.6571695683039892
24915,2155.452633,2155.716833,1,64663578,64671504,7926,0.4106961875783452
24916,2155.745367,2155.7693,1,64672361,64673079,718,0.027993515609407004
24917,2155.788767,2155.8136,1,64673663,64674408,745,0.4593167247371234
24918,2155.816467,2155.8206,1,64674494,64674618,124,0.4028807849089641
24919,2155.827733,2155.832267,1,64674831,64674968,137,0.5883173220236974
24920,2155.838167,2155.844433,1,64675145,64675332,187,0.6958621036730147
24921,2155.850267,2156.051,1,64675508,64681530,6022,0.7470998105311075
24922,2156.054367,2156.0859,1,64681631,64682577,946,0.6140521324898537
24923,2156.1377,2156.1546,1,64684131,64684637,506,0.6213369694198683
24924,2156.292933,2156.2938,1,64688787,64688814,27,
24925,2156.457033,2156.587067,1,64693710,64697612,3902,0.7373565278971114
24926,2156.589733,2156.603333,1,64697691,64698099,408,0.5374082606439422
24927,2156.620667,2156.629967,1,64698620,64698899,279,0.4689488878393296
24928,2156.638767,2156.647767,1,64699163,64699433,270,0.6748458260653581
24929,2156.656667,2156.681833,1,64699700,64700454,754,0.7222620953004124
24930,2156.683133,2156.763067,1,64700493,64702892,2399,0.6948924990637863
24931,2156.770567,2156.799367,1,64703117,64703981,864,0.7284333109051021
24932,2156.8459,2156.869367,1,64705376,64706081,705,0.31325920925568407
24933,2156.875333,2156.879733,1,64706259,64706391,132,0.6897413429690907
24934,2156.900467,2156.908967,1,64707014,64707269,255,0.5349405343999649
24935,2156.944067,2156.953133,1,64708322,64708593,271,0.751394765476008
24936,2156.955367,2156.959167,1,64708661,64708775,114,0.8561468841285315
24937,2156.9701,2156.976033,1,64709103,64709280,177,0.6811239774057198
24938,2156.9771,2156.987833,1,64709313,64709634,321,0.11560457791120302
24939,2156.993867,2157.157067,1,64709816,64714712,4896,0.7624481178830845
24940,2157.162267,2157.182733,1,64714868,64715481,613,0.7384726602329296
24941,2157.1884,2157.193633,1,64715652,64715808,156,0.4370428736910119
24942,2157.247633,2157.265133,1,64717428,64717953,525,0.06147469728434941
24943,2157.275,2157.299167,1,64718250,64718975,725,0.2592950874475065
24944,2157.305867,2157.309033,1,64719176,64719270,94,0.5881748986283103
24945,2157.3118,2157.4318,1,64719354,64722953,3599,0.1394366466803035
24946,2157.439867,2157.465433,1,64723196,64723962,766,0.36604990216637734
24947,2157.466433,2157.548933,1,64723992,64726467,2475,0.22271798193455733
24948,2157.5839,2157.587733,1,64727517,64727631,114,0.43841914559167366
24949,2157.597867,2157.684367,1,64727936,64730531,2595,0.6384389291915833
24950,2157.6873,2157.694167,1,64730619,64730825,206,0.4536926815206773
24951,2157.696833,2157.703,1,64730904,64731090,186,0.6000052670008406
24952,2157.712767,2157.8185,1,64731383,64734554,3171,0.1844813042636113
24953,2157.8259,2157.847733,1,64734776,64735431,655,0.7410101347727934
24954,2157.852567,2158.013867,1,64735577,64740416,4839,0.7652569339744251
24955,2158.021033,2158.0463,1,64740630,64741389,759,0.7004505797694837
24956,2158.0497,2158.054467,1,64741491,64741634,143,0.5632557750159516
24957,2158.0623,2158.090167,1,64741869,64742705,836,0.2115070981058821
24958,2158.101367,2158.1129,1,64743041,64743387,346,0.16882279292374067
24959,2158.113933,2158.151967,1,64743417,64744559,1142,0.5265085692222338
24960,2158.1561,2158.159533,1,64744683,64744785,102,0.7942253248806007
24961,2158.168867,2158.234767,1,64745066,64747043,1977,0.2087462109686107
24962,2158.245033,2158.257333,1,64747350,64747719,369,0.8318211152051955
24963,2158.259,2158.277933,1,64747770,64748337,567,0.5715729022734162
24964,2158.294167,2158.340767,1,64748825,64750223,1398,0.13769612023875505
24965,2158.342767,2158.352067,1,64750283,64750562,279,0.6969472356948757
24966,2158.355533,2158.370467,1,64750665,64751114,449,0.37666040271331436
24967,2158.373867,2158.405033,1,64751216,64752150,934,0.530162122254917
24968,2158.407367,2158.419867,1,64752221,64752596,375,-0.04595085843752074
24969,2158.424067,2158.4282,1,64752722,64752845,123,0.8989426740958908
24970,2158.4292,2158.4557,1,64752876,64753671,795,0.0033094913930850215
24971,2158.4567,2158.498433,1,64753701,64754952,1251,0.2329696347470015
24972,2158.506533,2158.532,1,64755195,64755960,765,0.5867918345188964
24973,2158.552867,2158.557533,1,64756586,64756725,139,0.5368299355248677
24974,2158.565433,2158.631133,1,64756962,64758933,1971,0.6847273993839204
24975,2158.711767,2158.715033,1,64761353,64761450,97,0.9325372728337371
24976,2158.716833,2158.7723,1,64761504,64763169,1665,0.7534515570406798
24977,2158.7753,2158.952733,1,64763258,64768581,5323,0.7703832893997882
24978,2158.961,2158.9648,1,64768829,64768944,115,0.8030187170357999
24979,2159.049233,2159.0548,1,64771476,64771644,168,0.1873082318613431
24980,2159.073733,2159.089733,1,64772211,64772691,480,0.0813808395168607
24981,2159.091733,2159.097233,1,64772751,64772916,165,0.5900510561359514
24982,2159.121167,2159.126567,1,64773635,64773797,162,0.17838191009725643
24983,2159.140567,2159.1655,1,64774217,64774965,748,0.8234517902681129
24984,2159.225267,2159.247333,1,64776758,64777419,661,0.18075097638979282
24985,2159.2535,2159.279333,1,64777604,64778379,775,0.8381802657465037
24986,2159.287333,2159.3095,1,64778619,64779284,665,0.6937514279772733
24987,2159.319033,2159.3302,1,64779570,64779906,336,0.6875246058717347
24988,2159.334533,2159.352333,1,64780035,64780569,534,0.6665505929968096
24989,2159.358633,2159.394267,1,64780758,64781828,1070,0.8017246508917093
24990,2159.4371,2159.4415,1,64783113,64783245,132,0.10274864899162439
24991,2159.4432,2159.4464,1,64783296,64783391,95,0.28616272142287524
24992,2159.447733,2159.464867,1,64783431,64783946,515,0.30872148252283443
24993,2159.4663,2159.473533,1,64783989,64784205,216,0.4370716025656947
24994,2159.477933,2159.488267,1,64784337,64784648,311,0.6380844197222804
24995,2159.501967,2159.520367,1,64785059,64785611,552,0.49616079067781144
24996,2159.6298,2159.7239,1,64788894,64791717,2823,0.9042695833745048
24997,2159.725267,2159.730833,1,64791758,64791924,166,0.7709126830340955
24998,2159.731967,2159.7807,1,64791959,64793420,1461,0.7572617862800666
24999,2159.9704,2159.975467,1,64799112,64799264,152,-0.08405799273141908
25000,2159.978067,2160.013633,1,64799342,64800408,1066,0.09841521115567642
25001,2160.015767,2160.0262,1,64800473,64800785,312,0.21600498011722544
25002,2160.0578,2160.076,1,64801734,64802280,546,0.3915256756940601
25003,2160.078,2160.2164,1,64802340,64806491,4151,0.8095519703049877
25004,2160.261933,2160.311333,1,64807857,64809339,1482,0.754877859447105
25005,2160.3124,2160.318933,1,64809371,64809567,196,0.6582608510144379
25006,2160.319967,2160.429467,1,64809599,64812884,3285,0.7673065944950812
25007,2160.430933,2160.454033,1,64812927,64813620,693,0.09628730291334198
25008,2160.4573,2160.494667,1,64813719,64814840,1121,0.6856512495226403
25009,2160.503467,2160.664767,1,64815104,64819943,4839,0.7662376581794619
25010,2160.6687,2160.7242,1,64820061,64821726,1665,0.7234945768813417
25011,2160.7567,2160.7749,1,64822701,64823247,546,0.26898475144422646
25012,2160.778367,2160.7853,1,64823351,64823559,208,0.4674386357926094
25013,2160.786567,2160.789667,1,64823597,64823690,93,0.8661377072644784
25014,2160.7919,2160.795367,1,64823757,64823861,104,0.32387921705473033
25015,2160.799,2160.9612,1,64823970,64828836,4866,0.7544908470461517
25016,2161.080033,2161.446967,1,64832400,64843409,11009,0.6640345098153948
25017,2161.4482,2161.453733,1,64843445,64843611,166,0.6398684016030495
25018,2161.454933,2161.471267,1,64843647,64844138,491,0.6396537849479035
25019,2161.514067,2161.5258,1,64845422,64845774,352,0.39218106299038274
25020,2161.5333,2161.547033,1,64845999,64846410,411,0.22417683351837403
25021,2161.5597,2161.567333,1,64846790,64847019,229,0.8107792880718232
25022,2161.6038,2161.883167,1,64848113,64856495,8382,0.39221653477832324
25023,2161.8913,2161.895033,1,64856738,64856850,112,0.9187836406468256
25024,2161.914067,2161.9427,1,64857422,64858281,859,0.1635074926412068
25025,2161.969667,2161.974767,1,64859090,64859243,153,0.22719537747404678
25026,2161.9758,2161.982,1,64859274,64859460,186,0.2796094244671595
25027,2162.035633,2162.0422,1,64861068,64861265,197,0.6158279893320356
25028,2162.0507,2162.053933,1,64861520,64861617,97,0.7425396370753086
25029,2162.0978,2162.216933,1,64862934,64866507,3573,0.8506614656947
25030,2162.243067,2162.2485,1,64867292,64867455,163,0.7318721007548075
25031,2162.258067,2162.271633,1,64867742,64868148,406,0.3048356170679203
25032,2162.2732,2162.291467,1,64868196,64868744,548,0.089809869319765
25033,2162.293333,2162.327267,1,64868799,64869818,1019,0.36612171410555033
25034,2162.341133,2162.346533,1,64870233,64870395,162,0.5370757139548903
25035,2162.3521,2162.415767,1,64870563,64872473,1910,0.12446459173216881
25036,2162.422533,2162.426533,1,64872675,64872795,120,0.42468444377200804
25037,2162.447367,2162.4567,1,64873421,64873701,280,0.6922215168811409
25038,2162.4652,2162.487467,1,64873956,64874624,668,0.6260241171253187
25039,2162.495,2162.5076,1,64874850,64875228,378,0.5294414523310835
25040,2162.513133,2162.5595,1,64875393,64876784,1391,0.7197825727621578
25041,2162.5605,2162.634767,1,64876815,64879043,2228,0.0646580069400227
25042,2162.636033,2162.642133,1,64879080,64879263,183,0.5462384200378803
25043,2162.6485,2162.8131,1,64879454,64884392,4938,0.740129165115004
25044,2162.8194,2162.835167,1,64884581,64885055,474,0.6427829423143653
25045,2162.838633,2162.842533,1,64885158,64885275,117,0.5279828318313738
25046,2162.889667,2162.895267,1,64886690,64886858,168,0.4267374817187699
25047,2162.8985,2162.923233,1,64886954,64887696,742,0.36954139655304186
25048,2162.927933,2162.957733,1,64887837,64888731,894,0.20397824559583658
25049,2162.963867,2162.985133,1,64888916,64889553,637,0.34717188728068143
25050,2162.986833,2163.007267,1,64889604,64890218,614,0.7022094455528681
25051,2163.015033,2163.106067,1,64890450,64893182,2732,0.1499829911872467
25052,2163.1072,2163.1108,1,64893216,64893324,108,0.5183970302731002
25053,2163.112533,2163.1234,1,64893375,64893702,327,0.3208892626519602
25054,2163.133033,2163.351733,1,64893990,64900551,6561,0.6908254583720363
25055,2163.353167,2163.3838,1,64900595,64901514,919,0.6949727594914148
25056,2163.409633,2163.4864,1,64902288,64904591,2303,0.4018330593823882
25057,2163.498767,2163.524533,1,64904963,64905735,772,0.09907721786139269
25058,2163.5361,2163.751933,1,64906082,64912557,6475,0.7513122153151758
25059,2163.755167,2163.778333,1,64912655,64913349,694,0.7123662923125762
25060,2163.785333,2163.805867,1,64913559,64914176,617,0.5606793460734297
25061,2163.834533,2163.838367,1,64915035,64915151,116,0.8888419520169891
25062,2163.8578,2164.048167,1,64915734,64921445,5711,0.6675550896553663
25063,2164.052333,2164.106967,1,64921569,64923209,1640,0.3814773068444121
25064,2164.168033,2164.1759,1,64925040,64925277,237,0.48047301348922844
25065,2164.189533,2164.200867,1,64925685,64926026,341,0.27312597660285076
25066,2164.214733,2164.2297,1,64926441,64926890,449,0.6745239446577168
25067,2164.230767,2164.241767,1,64926923,64927253,330,0.6880726690648359
25068,2164.2459,2164.250433,1,64927377,64927512,135,0.6780263842713887
25069,2164.263933,2164.280667,1,64927917,64928420,503,0.2289920368028505
25070,2164.2836,2164.292467,1,64928508,64928774,266,0.2605539509313793
25071,2164.295867,2164.302033,1,64928876,64929060,184,0.3176902282922382
25072,2164.304767,2164.308833,1,64929143,64929264,121,0.5277725425905634
25073,2164.372767,2164.378567,1,64931183,64931357,174,0.03940112833012374
25074,2164.391633,2164.441367,1,64931748,64933241,1493,0.7585787234052974
25075,2164.4587,2164.461933,1,64933761,64933857,96,0.832279587764675
25076,2164.525967,2164.552967,1,64935779,64936589,810,0.6966154800281967
25077,2164.554,2164.570267,1,64936620,64937108,488,0.6022176786265631
25078,2164.5878,2164.904133,1,64937633,64947123,9490,0.7328348911694104
25079,2164.908233,2165.030267,1,64947246,64950908,3662,0.7426474723165979
25080,2165.0503,2165.080733,1,64951509,64952421,912,0.3175748644289434
25081,2165.096467,2165.108,1,64952894,64953240,346,0.6447590813194825
25082,2165.1814,2165.3598,1,64955442,64960794,5352,0.8313321274299481
25083,2165.396533,2165.420067,1,64961895,64962602,707,0.2428843250450416
25084,2165.422633,2165.432967,1,64962678,64962989,311,0.5342202826065304
25085,2165.451933,2165.4562,1,64963557,64963686,129,0.8990995529373238
25086,2165.457433,2165.469033,1,64963722,64964070,348,0.5696747247783922
25087,2165.4702,2165.487967,1,64964106,64964639,533,0.7285514307537624
25088,2165.4924,2165.516467,1,64964772,64965494,722,0.10539673611544058
25089,2165.5188,2165.530567,1,64965563,64965917,354,0.09597916452040585
25090,2165.533133,2165.5439,1,64965993,64966317,324,0.02042274592276501
25091,2165.558067,2165.568467,1,64966742,64967054,312,0.027901569000881577
25092,2165.5751,2165.578167,1,64967253,64967345,92,0.6374891413555155
25093,2165.644933,2165.649067,1,64969347,64969472,125,0.5548769491907862
25094,2165.7148,2165.995333,1,64971444,64979859,8415,0.7184409322108679
25095,2166.0412,2166.0459,1,64981236,64981377,141,-0.018163375034015734
25096,2166.059167,2166.0664,1,64981775,64981992,217,0.09653994677962642
25097,2166.0714,2166.39,1,64982141,64991699,9558,0.7401246902408442
25098,2166.4873,2166.493667,1,64994618,64994810,192,0.34336892534901436
25099,2166.519933,2166.538833,1,64995597,64996164,567,0.3635755632416828
25100,2166.540233,2166.552533,1,64996206,64996575,369,0.7838878409940665
25101,2166.553733,2166.6111,1,64996611,64998333,1722,0.06628508837296548
25102,2166.6185,2166.637933,1,64998555,64999137,582,0.07828117286649702
25103,2166.6411,2166.684867,1,64999232,65000546,1314,0.4485941632695292
25104,2166.703067,2166.720367,1,65001092,65001611,519,0.21611380210462428
25105,2166.721467,2166.732267,1,65001644,65001968,324,0.3970360240416618
25106,2166.7916,2166.8505,1,65003748,65005515,1767,0.754256614097528
25107,2166.8536,2166.8592,1,65005608,65005775,167,0.7214250074388983
25108,2166.8784,2166.8931,1,65006352,65006792,440,0.6577063032106619
25109,2166.902867,2166.912967,1,65007086,65007389,303,0.47458525989775985
25110,2166.998067,2167.0018,1,65009942,65010054,112,0.6623183080101189
25111,2167.004933,2167.050033,1,65010147,65011500,1353,0.8123016911899109
25112,2167.051467,2167.059167,1,65011544,65011775,231,0.36710082566114965
25113,2167.071333,2167.1109,1,65012139,65013327,1188,0.8302334369052806
25114,2167.122267,2167.126767,1,65013668,65013803,135,0.2680093916977969
25115,2167.196733,2167.2075,1,65015901,65016225,324,0.6450132193714938
25116,2167.2233,2167.226733,1,65016699,65016801,102,0.4674142169632267
25117,2167.237933,2167.243767,1,65017137,65017313,176,0.4126501034332429
25118,2167.247767,2167.257067,1,65017433,65017712,279,0.6497407417447366
25119,2167.359633,2167.543067,1,65020788,65026292,5504,0.8752073456824501
25120,2167.545933,2167.5541,1,65026377,65026622,245,0.43118629895610044
25121,2167.590467,2167.6625,1,65027714,65029875,2161,0.586774145914844
25122,2167.6915,2167.703733,1,65030745,65031111,366,0.17728443378681122
25123,2167.722267,2167.9106,1,65031668,65037318,5650,0.7785942348242826
25124,2167.915633,2167.965633,1,65037468,65038968,1500,0.6983562694375596
25125,2167.970867,2167.9961,1,65039126,65039882,756,0.3783185838835186
25126,2168.035933,2168.055833,1,65041077,65041674,597,0.3630057738926376
25127,2168.096867,2168.1182,1,65042906,65043546,640,0.08457877407384258
25128,2168.120633,2168.126333,1,65043618,65043789,171,0.8060724861224506
25129,2168.154133,2168.181533,1,65044623,65045445,822,0.46424848391095086
25130,2168.1925,2168.2034,1,65045775,65046101,326,0.660480573332223
25131,2168.2152,2168.219133,1,65046456,65046573,117,-0.1322278988369202
25132,2168.324767,2168.4111,1,65049743,65052332,2589,0.77030555377168
25133,2168.414767,2168.4297,1,65052443,65052891,448,0.8123136258506339
25134,2168.446867,2168.531533,1,65053406,65055945,2539,0.7206396267083885
25135,2168.5523,2168.652667,1,65056568,65059580,3012,0.74407174881825
25136,2168.665367,2168.733367,1,65059961,65062001,2040,0.7530797512999579
25137,2168.7487,2168.7585,1,65062461,65062755,294,0.3249325207383169
25138,2168.7667,2168.854167,1,65063001,65065625,2624,0.4790908306641885
25139,2168.855333,2168.860467,1,65065659,65065814,155,0.8989070709040334
25140,2168.865767,2168.915733,1,65065973,65067471,1498,0.05997144476418306
25141,2168.930967,2168.946567,1,65067929,65068397,468,0.3822973622694078
25142,2168.957867,2169.026133,1,65068736,65070783,2047,0.07261687498715756
25143,2169.029267,2169.032833,1,65070878,65070984,106,0.7671968241664205
25144,2169.036867,2169.0401,1,65071106,65071203,97,0.6831692762582958
25145,2169.041533,2169.068367,1,65071245,65072051,806,0.7504936866792389
25146,2169.215567,2169.349,1,65076467,65080470,4003,0.7855502766103811
25147,2169.406133,2169.4161,1,65082183,65082483,300,0.2411783736438122
25148,2169.4201,2169.426333,1,65082602,65082789,187,0.7957635893716654
25149,2169.449733,2169.486533,1,65083491,65084595,1104,0.5611415240857797
25150,2169.505933,2169.523567,1,65085177,65085707,530,0.19200259484934837
25151,2169.526367,2169.5719,1,65085791,65087157,1366,0.46878812237978335
25152,2169.6045,2169.612067,1,65088135,65088362,227,0.3042926800342297
25153,2169.633867,2169.6868,1,65089016,65090604,1588,0.7337873486360426
25154,2169.7762,2170.241833,1,65093285,65107254,13969,0.6967412170069968
25155,2170.279633,2170.303867,1,65108388,65109116,728,0.5575271249953502
25156,2170.315367,2170.330067,1,65109461,65109902,441,0.6456024519029053
25157,2170.332467,2170.387433,1,65109974,65111622,1648,0.6215041565821194
25158,2170.389067,2170.4181,1,65111672,65112542,870,0.6370906204213619
25159,2170.4199,2170.4251,1,65112596,65112753,157,0.653990695518509
25160,2170.427467,2170.432667,1,65112824,65112980,156,0.7513773624824004
25161,2170.434167,2170.4676,1,65113025,65114028,1003,0.7066194042543005
25162,2170.500067,2170.509933,1,65115002,65115297,295,0.469659584260127
25163,2170.518067,2170.762167,1,65115542,65122865,7323,0.59607198891742
25164,2170.810467,2170.885467,1,65124314,65126564,2250,0.30444421157928164
25165,2170.9204,2170.947367,1,65127612,65128421,809,0.6145301194985465
25166,2170.9846,2170.988067,1,65129537,65129642,105,0.7349914937032935
25167,2171.0177,2171.0213,1,65130531,65130639,108,0.9337233861673506
25168,2171.0518,2171.239633,1,65131554,65137188,5634,0.7598065138275085
25169,2171.282467,2171.3091,1,65138474,65139273,799,0.6079296343082614
25170,2171.310333,2171.335433,1,65139309,65140062,753,0.7090107738138804
25171,2171.348033,2171.361367,1,65140440,65140841,401,0.4037208242428196
25172,2171.3628,2171.379667,1,65140884,65141390,506,0.6545982637716778
25173,2171.380967,2171.386133,1,65141429,65141583,154,0.7623822763279621
25174,2171.3927,2171.4115,1,65141781,65142345,564,0.5839340124694256
25175,2171.519967,2171.7326,1,65145599,65151977,6378,0.6930201536134898
25176,2171.743033,2171.7487,1,65152290,65152461,171,0.8094551219124755
25177,2171.795633,2171.9716,1,65153868,65159147,5279,0.8426268332784322
25178,2171.986533,2171.993067,1,65159595,65159792,197,0.7565036317918036
25179,2171.997,2172.000233,1,65159909,65160006,97,0.8179629046356711
25180,2172.0015,2172.019,1,65160044,65160569,525,0.719474499924854
25181,2172.024033,2172.031233,1,65160720,65160936,216,0.16019258675239204
25182,2172.040533,2172.1319,1,65161215,65163956,2741,0.7724116206596432
25183,2172.191167,2172.198133,1,65165735,65165943,208,0.788956893261547
25184,2172.2433,2172.244167,1,65167299,65167325,26,0.9999633619779154
25185,2172.257933,2172.2674,1,65167737,65168022,285,0.8467112632808688
25186,2172.269467,2172.300333,1,65168084,65169009,925,0.5217825457385877
25187,2172.301467,2172.642433,1,65169044,65179272,10228,0.7267920055106448
25188,2172.741833,2172.7451,1,65182254,65182353,99,0.9366376871380447
25189,2172.7486,2172.7519,1,65182458,65182557,99,0.8690744085774837
25190,2172.752967,2172.756033,1,65182589,65182680,91,0.5879608030405546
25191,2172.826333,2172.9536,1,65184789,65188607,3818,0.7746215732833668
25192,2172.9737,2172.981067,1,65189211,65189432,221,0.7415486640670884
25193,2173.0855,2173.383467,1,65192565,65201504,8939,0.7818394717263635
25194,2173.391533,2173.4016,1,65201745,65202048,303,0.7944167395540151
25195,2173.402933,2173.443,1,65202087,65203290,1203,0.8189539909446764
25196,2173.541767,2173.818967,1,65206253,65214569,8316,0.7864808613073068
25197,2173.8347,2173.839,1,65215041,65215170,129,0.9811960978048135
25198,2173.8578,2173.936,1,65215734,65218080,2346,0.6966464495830678
25199,2173.951067,2173.988633,1,65218532,65219658,1126,0.7688942514567634
25200,2174.0038,2174.2051,1,65220114,65226153,6039,0.7452366815639564
25201,2174.207067,2174.224367,1,65226212,65226731,519,0.5257786215890408
25202,2174.228333,2174.243,1,65226849,65227290,441,0.6430518174392352
25203,2174.313333,2174.325533,1,65229399,65229765,366,0.9006150796921885
25204,2174.557333,2174.560367,1,65236719,65236811,92,0.926308053916308
25205,2174.561967,2174.5667,1,65236859,65237000,141,0.8699623148717838
25206,2174.573567,2174.5946,1,65237207,65237838,631,0.5750541875640557
25207,2174.608933,2174.612233,1,65238267,65238366,99,0.7423483959562343
25208,2174.661167,2174.677233,1,65239835,65240316,481,0.4974855680998305
25209,2174.734333,2174.770533,1,65242029,65243115,1086,0.7413997737454692
25210,2174.776333,2174.814867,1,65243289,65244446,1157,0.7024616710447589
25211,2174.818233,2174.952267,1,65244546,65248568,4022,0.7016247961054903
25212,2174.955433,2174.9767,1,65248662,65249301,639,0.6408202449306856
25213,2175.0315,2175.035667,1,65250945,65251070,125,0.2624028068361398
25214,2175.048533,2175.384067,1,65251455,65261522,10067,0.7251787835557514
25215,2175.386933,2175.395567,1,65261607,65261867,260,0.07138856943339773
25216,2175.421567,2175.446267,1,65262647,65263388,741,0.19264945849424275
25217,2175.448567,2175.460367,1,65263457,65263811,354,0.5065730931397987
25218,2175.4718,2175.495433,1,65264153,65264862,709,0.4017352594180599
25219,2175.496767,2175.512933,1,65264903,65265387,484,0.44355494719780186
25220,2175.532033,2175.5558,1,65265960,65266674,714,0.3312560780013796
25221,2175.658267,2175.699267,1,65269748,65270978,1230,0.8081561056908088
25222,2175.711133,2175.726067,1,65271333,65271782,449,0.3949438330699961
25223,2175.786,2175.7923,1,65273580,65273769,189,0.37077083637449876
25224,2175.798867,2176.053233,1,65273966,65281596,7630,0.7612781420770129
25225,2176.108933,2176.1156,1,65283267,65283468,201,0.5129155073954909
25226,2176.158267,2176.168067,1,65284748,65285042,294,0.45381888473878446
25227,2176.169967,2176.1917,1,65285099,65285750,651,0.39341122753845714
25228,2176.252867,2176.257033,1,65287586,65287710,124,0.11726638641384259
25229,2176.273767,2176.284433,1,65288213,65288532,319,0.11317786648290416
25230,2176.286533,2176.291167,1,65288595,65288735,140,0.5469686609206741
25231,2176.2922,2176.3187,1,65288765,65289560,795,0.2735193561214125
25232,2176.373033,2176.380033,1,65291190,65291400,210,0.09085950604676608
25233,2176.389767,2176.3942,1,65291693,65291826,133,0.6554886691649956
25234,2176.423733,2176.466167,1,65292711,65293985,1274,0.6133301809801884
25235,2176.4709,2176.5205,1,65294126,65295615,1489,0.555327990572626
25236,2176.5668,2176.573667,1,65297004,65297210,206,0.7548014178619681
25237,2176.594933,2176.850733,1,65297847,65305521,7674,0.7458864135785624
25238,2176.8521,2176.859933,1,65305563,65305797,234,0.34025676467935206
25239,2176.874833,2176.890033,1,65306244,65306700,456,0.7774096049057602
25240,2176.905067,2176.929033,1,65307152,65307870,718,0.15141344503547616
25241,2176.932433,2177.037633,1,65307972,65311128,3156,0.27563768315370685
25242,2177.042933,2177.0527,1,65311287,65311581,294,0.162203338349854
25243,2177.0548,2177.087267,1,65311644,65312618,974,0.4052349424491784
25244,2177.0982,2177.111867,1,65312946,65313356,410,0.3338158638274627
25245,2177.115533,2177.1236,1,65313465,65313708,243,0.7346725908180806
25246,2177.1394,2177.142467,1,65314182,65314274,92,0.7099587830703795
25247,2177.144633,2177.148167,1,65314338,65314445,107,0.9046694612167971
25248,2177.153633,2177.331367,1,65314608,65319941,5333,0.6855147842420899
25249,2177.333033,2177.362133,1,65319990,65320863,873,0.6940705662885511
25250,2177.376967,2177.506567,1,65321309,65325197,3888,0.7609805998315703
25251,2177.540633,2177.578367,1,65326218,65327351,1133,0.20192909631775235
25252,2177.584033,2177.593467,1,65327520,65327804,284,0.11132013807771428
25253,2177.5986,2177.613733,1,65327957,65328411,454,0.28671804984451504
25254,2177.615467,2177.625,1,65328464,65328750,286,0.38124182200179474
25255,2177.6351,2177.677333,1,65329053,65330319,1266,0.253837553115389
25256,2177.710133,2177.859967,1,65331303,65335799,4496,0.7988374032153753
25257,2177.880533,2177.890633,1,65336415,65336718,303,0.8200253750249339
25258,2177.907933,2177.963733,1,65337237,65338911,1674,0.05796186545286575
25259,2177.964733,2178.002267,1,65338941,65340068,1127,0.6675172125318202
25260,2178.006733,2178.059733,1,65340201,65341791,1590,0.0988024015403747
25261,2178.0658,2178.069667,1,65341973,65342090,117,0.8389601481500586
25262,2178.0737,2178.081533,1,65342211,65342445,234,0.7590545335091711
25263,2178.144267,2178.209433,1,65344328,65346282,1954,0.687526928515096
25264,2178.211,2178.216367,1,65346329,65346491,162,0.7409173829734002
25265,2178.2388,2178.255867,1,65347164,65347676,512,0.4377496090379441
25266,2178.268867,2178.448233,1,65348066,65353446,5380,0.6870262022073735
25267,2178.449567,2178.465067,1,65353487,65353952,465,0.3036303768808128
25268,2178.491167,2178.509967,1,65354735,65355299,564,0.09312397830697103
25269,2178.5128,2178.703633,1,65355384,65361108,5724,0.7895195764413638
25270,2178.708133,2178.733967,1,65361243,65362019,776,0.7641870742368791
25271,2178.737967,2178.783667,1,65362139,65363510,1371,0.7235304691714936
25272,2178.814833,2178.8515,1,65364444,65365545,1101,-0.08546734443235157
25273,2178.8525,2178.879167,1,65365575,65366375,800,0.11616320791057129
25274,2178.880833,2178.8932,1,65366424,65366796,372,0.3609375718662302
25275,2178.894333,2178.9226,1,65366829,65367677,848,0.07671567683303317
25276,2178.936767,2178.959333,1,65368103,65368779,676,0.02028364324883623
25277,2178.9638,2178.972367,1,65368914,65369171,257,0.3480101450505923
25278,2178.998367,2179.002733,1,65369951,65370081,130,0.8801190110513788
25279,2179.027,2179.038967,1,65370810,65371169,359,0.6969791173231582
25280,2179.042933,2179.0477,1,65371287,65371431,144,0.7751967440703389
25281,2179.057,2179.095433,1,65371709,65372862,1153,0.6809763884097745
25282,2179.0989,2179.123233,1,65372967,65373696,729,0.807774273561433
25283,2179.206633,2179.21,1,65376198,65376300,102,0.5931924918535574
25284,2179.216133,2179.5866,1,65376483,65387598,11115,0.7317942179800495
25285,2180.3068,2180.311467,1,65409203,65409344,141,0.5805022332884172
25286,2180.327067,2180.331433,1,65409812,65409942,130,0.816818098030822
25287,2180.336167,2180.340833,1,65410085,65410224,139,0.49634025856148695
25288,2180.3424,2180.399433,1,65410272,65411982,1710,0.6854870443270776
25289,2180.409933,2180.415267,1,65412297,65412458,161,0.7484912105864993
25290,2180.416933,2180.4275,1,65412507,65412824,317,0.8856167114520132
25291,2180.451167,2180.4543,1,65413535,65413628,93,0.9745465681902947
25292,2180.4591,2180.466667,1,65413773,65414000,227,0.725875044134332
25293,2180.5672,2180.613233,1,65417016,65418396,1380,0.7231292848221871
25294,2180.614267,2180.650167,1,65418428,65419505,1077,0.682612040744487
25295,2180.674067,2180.7449,1,65420222,65422347,2125,0.617012300307783
25296,2180.760067,2180.9242,1,65422802,65427726,4924,0.66293153526854
25297,2181.012333,2181.039067,1,65430369,65431172,803,0.6376864729509405
25298,2181.4725,2181.555767,1,65444174,65446673,2499,0.6660182029789758
25299,2181.5568,2181.574467,1,65446703,65447234,531,0.6760392749404655
25300,2181.575567,2181.638233,1,65447267,65449146,1879,0.40268681466294576
25301,2181.6393,2181.6445,1,65449178,65449335,157,0.8181428598120526
25302,2181.6499,2181.679633,1,65449497,65450388,891,0.6271036694903993
25303,2181.781267,2181.785567,1,65453438,65453567,129,0.22903252062015547
25304,2181.7895,2181.799233,1,65453684,65453976,292,0.03605678148717526
25305,2181.807033,2181.823167,1,65454210,65454695,485,0.07281483775781523
25306,2181.8246,2181.830433,1,65454738,65454912,174,0.8782936540366029
25307,2181.834133,2181.8372,1,65455023,65455116,93,0.4838591345393906
25308,2181.848533,2181.875733,1,65455455,65456271,816,0.5950910399479387
25309,2181.8782,2182.050567,1,65456346,65461517,5171,0.575129186405083
25310,2182.053533,2182.107533,1,65461605,65463225,1620,0.718730426713677
25311,2182.122133,2182.2381,1,65463663,65467143,3480,0.6162536337540244
25312,2182.255467,2182.2606,1,65467664,65467818,154,0.6947775210459107
25313,2182.326367,2182.331867,1,65469791,65469956,165,0.8234131420564551
25314,2182.342233,2182.532367,1,65470266,65475971,5705,0.7027193976486817
25315,2182.540533,2182.568167,1,65476215,65477045,830,0.6803631022141705
25316,2182.9268,2182.936967,1,65487804,65488109,305,0.2974889780206762
25317,2182.938,2182.955367,1,65488140,65488661,521,0.6738501428603231
25318,2183.008933,2183.0142,1,65490267,65490426,159,0.6187889214058773
25319,2183.070033,2183.0939,1,65492100,65492816,716,0.6899373045209004
25320,2183.1692,2183.184733,1,65495075,65495541,466,0.31760461744379825
25321,2183.1859,2183.195,1,65495577,65495850,273,0.001683997863023117
25322,2183.199967,2183.213933,1,65495999,65496417,418,0.391227342607486
25323,2183.230167,2183.233433,1,65496905,65497002,97,0.8352444000312162
25324,2183.249133,2183.283233,1,65497473,65498496,1023,0.6896252040894585
25325,2183.289167,2183.399067,1,65498675,65501972,3297,0.712555411540433
25326,2183.435967,2183.6089,1,65503079,65508267,5188,0.8109659684034376
25327,2183.6177,2183.622667,1,65508530,65508680,150,0.8933219168450282
25328,2183.6556,2183.6757,1,65509668,65510270,602,0.10929452458109642
25329,2183.6804,2183.6878,1,65510412,65510634,222,0.3285544427332611
25330,2183.693267,2183.701167,1,65510798,65511035,237,0.5108187265319849
25331,2183.706833,2183.714967,1,65511204,65511449,245,0.5517923089403551
25332,2183.718033,2183.725433,1,65511540,65511762,222,0.8551794410519422
25333,2183.732,2183.742,1,65511960,65512260,300,0.8593682319041849
25334,2183.785,2183.790667,1,65513549,65513720,171,0.3048273591390608
25335,2183.8203,2183.8275,1,65514608,65514824,216,0.34393659435942614
25336,2183.831033,2183.886633,1,65514930,65516598,1668,0.7091646380353511
25337,2183.9727,2184.072233,1,65519180,65522166,2986,0.7239749257640605
25338,2184.0897,2184.094733,1,65522691,65522841,150,0.32411095895329206
25339,2184.0968,2184.181533,1,65522903,65525445,2542,0.6592780505530769
25340,2184.190533,2184.198,1,65525715,65525939,224,0.6018005516264013
25341,2184.212267,2184.235367,1,65526368,65527061,693,0.6750162308298103
25342,2184.245233,2184.3099,1,65527356,65529297,1941,0.7339611995685125
25343,2184.327667,2184.338,1,65529830,65530140,310,0.6903883425743054
25344,2184.345067,2184.368767,1,65530352,65531063,711,0.6542227542051722
25345,2184.371,2184.3772,1,65531130,65531316,186,0.09009521108515023
25346,2184.3797,2184.446767,1,65531391,65533403,2012,0.7432450367512985
25347,2184.4641,2184.467867,1,65533923,65534036,113,0.34907338058406623
25348,2184.4844,2184.5059,1,65534531,65535177,646,0.6319673698300964
25349,2184.511467,2184.5215,1,65535344,65535644,300,0.646816365641374
25350,2184.522733,2184.5845,1,65535681,65537535,1854,0.585428372461169
25351,2184.723667,2184.7283,1,65541710,65541849,139,0.6672337451332924
25352,2184.829733,2184.971333,1,65544891,65549139,4248,0.716440441469853
25353,2185.090433,2185.099833,1,65552712,65552994,282,0.222066298215963
25354,2185.117233,2185.1306,1,65553516,65553918,402,0.4644565033193929
25355,2185.132,2185.203967,1,65553960,65556119,2159,0.21994119667591103
25356,2185.2112,2185.371933,1,65556336,65561157,4821,0.7301255768346604
25357,2185.377033,2185.403033,1,65561310,65562090,780,0.7114412617435527
25358,2185.4381,2185.443467,1,65563142,65563304,162,0.4639681949675999
25359,2185.4469,2185.496667,1,65563407,65564900,1493,0.120893716972467
25360,2185.498,2185.510933,1,65564940,65565327,387,0.609810994428415
25361,2185.513933,2185.521467,1,65565417,65565644,227,0.5876639118408756
25362,2185.522867,2185.583933,1,65565686,65567517,1831,0.11622315311611159
25363,2185.588333,2185.608867,1,65567649,65568266,617,0.10342949206653702
25364,2185.620933,2185.6434,1,65568627,65569302,675,0.3576394361927037
25365,2185.6447,2185.6562,1,65569340,65569686,346,0.6903506765829085
25366,2185.657433,2185.6669,1,65569722,65570007,285,0.6735601016429079
25367,2185.675167,2185.7134,1,65570255,65571402,1147,0.12667030292769832
25368,2185.7145,2185.7321,1,65571435,65571963,528,0.2156055157652786
25369,2185.747067,2185.768367,1,65572412,65573051,639,0.21739792561126842
25370,2185.770167,2185.786567,1,65573105,65573597,492,0.5975711923372355
25371,2185.8089,2185.812533,1,65574267,65574375,108,0.8903747215376703
25372,2185.8252,2185.925967,1,65574756,65577779,3023,0.7518872854480523
25373,2185.986367,2186.0048,1,65579591,65580144,553,0.19179412304634708
25374,2186.015667,2186.063833,1,65580470,65581914,1444,0.765915511454885
25375,2186.065133,2186.069467,1,65581953,65582084,131,0.372382863612659
25376,2186.0711,2186.0759,1,65582133,65582276,143,0.5867534691355638
25377,2186.078,2186.145867,1,65582340,65584376,2036,0.7223966731964939
25378,2186.175733,2186.179767,1,65585271,65585393,122,0.697973685585377
25379,2186.185967,2186.394167,1,65585579,65591825,6246,0.7371757665466355
25380,2186.398633,2186.472,1,65591958,65594160,2202,0.7855421691710437
25381,2186.474567,2186.478567,1,65594237,65594357,120,0.336446116310503
25382,2186.523133,2186.5265,1,65595693,65595795,102,0.5631587425888421
25383,2186.556067,2186.56,1,65596682,65596800,118,0.3250767528595622
25384,2186.562267,2186.589,1,65596868,65597670,802,0.7237969953081397
25385,2186.594933,2186.751667,1,65597847,65602550,4703,0.7644423985059197
25386,2186.7547,2186.784267,1,65602641,65603528,887,0.674255911952229
25387,2186.905167,2186.928567,1,65607155,65607857,702,0.0742970721189611
25388,2186.930733,2186.9481,1,65607921,65608443,522,0.4663252990144054
25389,2186.954867,2186.9629,1,65608646,65608887,241,0.8432132426222457
25390,2186.9673,2186.973333,1,65609018,65609199,181,0.8156826095432881
25391,2186.981833,2187.003633,1,65609454,65610108,654,0.10632893080675618
25392,2187.0918,2187.1196,1,65612754,65613588,834,0.5745296937146708
25393,2187.134967,2187.138533,1,65614049,65614155,106,0.5580622795612361
25394,2187.3039,2187.315933,1,65619117,65619477,360,0.6896000132397945
25395,2187.317133,2187.505767,1,65619513,65625173,5660,0.7676843364583859
25396,2187.826167,2187.830567,1,65634785,65634917,132,0.8687213792459347
25397,2187.841767,2187.879933,1,65635253,65636397,1144,0.7234269269778687
25398,2187.8927,2187.914167,1,65636781,65637425,644,0.5863190573011392
25399,2188.0053,2188.063167,1,65640158,65641895,1737,0.7357555545382272
25400,2188.069233,2188.575733,1,65642076,65657271,15195,0.561937211631658
25401,2188.5778,2188.697267,1,65657334,65660918,3584,0.46259684257659983
25402,2188.7504,2188.7659,1,65662512,65662976,464,0.22257277611904827
25403,2188.8371,2188.841667,1,65665113,65665250,137,0.8618669000792661
25404,2188.842667,2189.012067,1,65665280,65670362,5082,0.8523634365334959
25405,2189.0132,2189.024733,1,65670395,65670741,346,0.8393257203184115
25406,2189.050833,2189.078967,1,65671524,65672369,845,0.28986106330866773
25407,2189.085767,2189.095533,1,65672573,65672865,292,0.23525164809123647
25408,2189.099433,2189.115667,1,65672982,65673470,488,0.38158457822384917
25409,2189.116667,2189.125867,1,65673500,65673776,276,0.817752415812375
25410,2189.1302,2189.1419,1,65673906,65674257,351,0.8067911535456578
25411,2189.145067,2189.150067,1,65674352,65674502,150,0.7111348399584465
25412,2189.159733,2189.187667,1,65674791,65675630,839,0.028121341707884568
25413,2189.192767,2189.2036,1,65675783,65676107,324,0.24476362183892092
25414,2189.240667,2189.305967,1,65677220,65679179,1959,0.6581019917022798
25415,2189.312233,2189.320433,1,65679366,65679612,246,0.37991570174975653
25416,2189.324833,2189.419567,1,65679744,65682587,2843,0.7060104162351012
25417,2189.435467,2189.720267,1,65683064,65691608,8544,0.6956945476190515
25418,2189.733967,2189.862267,1,65692019,65695868,3849,0.714895353418332
25419,2189.9135,2189.921133,1,65697405,65697633,228,0.7190901542245242
25420,2189.958933,2189.9653,1,65698767,65698958,191,0.7395149806291322
25421,2189.966733,2189.971367,1,65699001,65699141,140,0.8900176018817952
25422,2190.015433,2190.024133,1,65700462,65700723,261,0.01254124163852811
25423,2190.056967,2190.0723,1,65701709,65702168,459,0.44746950152151715
25424,2190.1235,2190.2666,1,65703705,65707998,4293,0.7923464063242809
25425,2190.278267,2190.622933,1,65708348,65718687,10339,0.6582466460540217
25426,2190.6283,2190.632067,1,65718848,65718962,114,0.4793802651579102
25427,2190.6348,2190.7513,1,65719043,65722539,3496,0.6859719477932512
25428,2190.8909,2190.9124,1,65726726,65727372,646,0.4138432470070816
25429,2190.919133,2191.022,1,65727573,65730660,3087,0.8175085252308232
25430,2191.059933,2191.065,1,65731797,65731950,153,0.573743213166874
25431,2191.080033,2191.094367,1,65732400,65732831,431,0.06169612801718501
25432,2191.0956,2191.110967,1,65732868,65733329,461,0.1718814628823092
25433,2191.117033,2191.122367,1,65733510,65733671,161,-0.042656196162862196
25434,2191.135967,2191.143033,1,65734079,65734290,211,0.1760037800285231
25435,2191.1461,2191.156433,1,65734383,65734692,309,0.622959894824888
25436,2191.157833,2191.177767,1,65734734,65735333,599,0.06211288250816681
25437,2191.191967,2191.218567,1,65735759,65736557,798,0.13428129519078133
25438,2191.2934,2191.4138,1,65738802,65742413,3611,0.5852366961506517
25439,2191.421,2191.653267,1,65742629,65749598,6969,0.6943124214237189
25440,2191.6824,2191.699267,1,65750472,65750978,506,0.20852228966348188
25441,2191.7123,2191.715467,1,65751369,65751464,95,0.7051970661386523
25442,2191.720367,2191.764067,1,65751611,65752922,1311,0.5597075203082589
25443,2191.819367,2192.006067,1,65754581,65760182,5601,0.7304379361841324
25444,2192.008667,2192.034767,1,65760260,65761043,783,0.7742756650436524
25445,2192.037933,2192.0672,1,65761137,65762016,879,0.6900732420526731
25446,2192.102367,2192.109,1,65763071,65763270,199,0.6071973984417289
25447,2192.1229,2192.170667,1,65763686,65765120,1434,0.7807365401681315
25448,2192.1738,2192.222367,1,65765214,65766671,1457,0.7768758764082697
25449,2192.2308,2192.2569,1,65766923,65767706,783,0.26147755611457485
25450,2192.3151,2192.358833,1,65769452,65770764,1312,0.7395081845145418
25451,2192.360033,2192.365267,1,65770800,65770958,158,0.8379357879729278
25452,2192.3665,2192.372133,1,65770995,65771163,168,0.7798636557143264
25453,2192.373133,2192.4518,1,65771193,65773553,2360,0.5240068582277452
25454,2192.499833,2192.6925,1,65774994,65780775,5781,0.7252704909669737
25455,2192.698033,2192.7214,1,65780940,65781642,702,0.6048699241366329
25456,2192.7247,2192.7521,1,65781741,65782563,822,0.6833014360259315
25457,2192.8043,2192.814333,1,65784128,65784429,301,0.6071347788463878
25458,2192.837433,2192.845867,1,65785122,65785376,254,0.06749290637909959
25459,2192.850433,2192.8559,1,65785512,65785677,165,0.8217883216255756
25460,2192.8625,2192.884867,1,65785875,65786546,671,0.694507495691789
25461,2192.8863,2192.897067,1,65786589,65786912,323,0.5971092224220081
25462,2192.906667,2192.936467,1,65787200,65788094,894,0.28125268695882505
25463,2192.940033,2192.9532,1,65788200,65788596,396,0.06479437901240105
25464,2192.993033,2192.9979,1,65789790,65789936,146,0.6473263646580112
25465,2193.083333,2193.1109,1,65792499,65793327,828,0.719599191121919
25466,2193.115967,2193.147933,1,65793479,65794437,958,0.7383927527579066
25467,2193.1674,2193.172433,1,65795021,65795172,151,0.41742676844485893
25468,2193.212567,2193.4416,1,65796377,65803248,6871,0.7516639588295855
25469,2193.452433,2193.459233,1,65803572,65803776,204,0.8282962371360862
25470,2193.487933,2193.492767,1,65804637,65804783,146,0.48650484799667815
25471,2193.7084,2193.7147,1,65811252,65811441,189,0.7029748115268
25472,2193.715767,2193.719067,1,65811473,65811572,99,0.10429429897142015
25473,2193.726933,2193.817533,1,65811807,65814525,2718,0.4335014301098821
25474,2193.876767,2193.998833,1,65816303,65819964,3661,0.758246595872866
25475,2194.045767,2194.088867,1,65821373,65822666,1293,0.23190505517216042
25476,2194.090267,2194.4144,1,65822708,65832432,9724,0.7625174000749554
25477,2194.611067,2194.6157,1,65838332,65838470,138,0.8514795993479188
25478,2194.722633,2194.732667,1,65841678,65841980,302,0.0596662835170357
25479,2194.734167,2194.737333,1,65842025,65842119,94,0.6682401013383689
25480,2194.8185,2194.882667,1,65844554,65846480,1926,0.7489281224163459
25481,2194.884933,2194.902167,1,65846547,65847065,518,0.6849680679059011
25482,2194.910733,2195.055733,1,65847321,65851671,4350,0.7125871709792357
25483,2195.058667,2195.062267,1,65851760,65851868,108,0.6017847199660662
25484,2195.166333,2195.170867,1,65854989,65855126,137,0.16283466830783344
25485,2195.181767,2195.188567,1,65855453,65855657,204,0.3553459808912466
25486,2195.2036,2195.334267,1,65856107,65860028,3921,0.7684536316157528
25487,2195.351467,2195.3551,1,65860544,65860653,109,0.8439083828713803
25488,2195.363433,2195.366567,1,65860902,65860997,95,0.5436021142358923
25489,2195.371933,2195.399033,1,65861157,65861970,813,0.2026622091459898
25490,2195.4405,2195.450833,1,65863215,65863524,309,0.0046976309081018
25491,2195.452067,2195.545867,1,65863562,65866376,2814,0.6943646940078054
25492,2195.563,2195.567767,1,65866890,65867033,143,0.7458500009013003
25493,2195.5693,2195.585133,1,65867079,65867553,474,0.5274261098060197
25494,2195.591433,2195.628967,1,65867742,65868869,1127,0.020606778805869586
25495,2195.642333,2195.667167,1,65869269,65870015,746,0.24824547468429972
25496,2195.668467,2195.6969,1,65870054,65870907,853,0.5345510750500534
25497,2195.697967,2195.756333,1,65870939,65872689,1750,0.07092423718914663
25498,2195.7621,2195.7656,1,65872863,65872968,105,0.8320478968515395
25499,2195.777533,2195.789033,1,65873325,65873670,345,-0.08049731631637018
25500,2195.790033,2195.8189,1,65873700,65874567,867,0.17283345131472252
25501,2195.8271,2195.836333,1,65874813,65875089,276,0.29690845375070507
25502,2195.841367,2195.897367,1,65875241,65876921,1680,0.6865174637453401
25503,2195.905733,2195.921867,1,65877171,65877656,485,0.6711718740548324
25504,2195.9473,2195.970633,1,65878418,65879118,700,0.22038724223275508
25505,2195.975967,2195.995433,1,65879279,65879862,583,0.5869727155312603
25506,2195.996733,2196.005,1,65879901,65880150,249,0.6852705993861705
25507,2196.008367,2196.171267,1,65880251,65885138,4887,0.7746212164687738
25508,2196.177533,2196.2194,1,65885325,65886582,1257,0.6839828708359785
25509,2196.2298,2196.240933,1,65886894,65887227,333,0.6277171589518297
25510,2196.264967,2196.268967,1,65887949,65888069,120,0.8264790397858531
25511,2196.274,2196.282867,1,65888220,65888486,266,0.1123887903407361
25512,2196.293267,2196.301133,1,65888798,65889033,235,0.8864966048136476
25513,2196.331267,2196.3506,1,65889938,65890518,580,0.6873268265279464
25514,2196.351733,2196.375967,1,65890551,65891279,728,0.5392556442441195
25515,2196.3774,2196.411867,1,65891321,65892356,1035,0.03652815391762028
25516,2196.414367,2196.444867,1,65892431,65893346,915,0.0859868128737902
25517,2196.453733,2196.4851,1,65893611,65894552,941,0.4835326640435036
25518,2196.487,2196.570633,1,65894610,65897118,2508,0.4818856812561885
25519,2196.593667,2196.7054,1,65897810,65901161,3351,0.7040947420710753
25520,2196.710967,2196.7414,1,65901329,65902242,913,0.7155573668576571
25521,2196.760767,2196.848467,1,65902823,65905454,2631,0.7728677828176098
25522,2197.446,2197.453733,1,65923380,65923611,231,0.655513366166242
25523,2197.462667,2197.516167,1,65923880,65925485,1605,0.6742466421311404
25524,2197.683533,2197.694133,1,65930505,65930823,318,0.2040457646965558
25525,2197.695167,2197.702867,1,65930855,65931086,231,0.7386007832569343
25526,2197.704133,2197.708333,1,65931123,65931249,126,0.7806785371094922
25527,2197.709567,2197.7172,1,65931287,65931516,229,0.7941112972089598
25528,2197.719267,2197.727967,1,65931578,65931839,261,0.7088257461618709
25529,2197.7396,2197.779433,1,65932188,65933382,1194,0.21621114742332972
25530,2197.7969,2197.994533,1,65933906,65939835,5929,0.6819988521522629
25531,2198.002033,2198.0243,1,65940060,65940729,669,0.6540628801415518
25532,2198.076167,2198.0941,1,65942285,65942822,537,0.2722680039473231
25533,2198.121767,2198.1796,1,65943653,65945388,1735,0.7289163060129621
25534,2198.180633,2198.203267,1,65945418,65946098,680,0.7675242069893169
25535,2198.214467,2198.2222,1,65946434,65946666,232,0.5640880039191136
25536,2198.2272,2198.233467,1,65946815,65947004,189,0.8043584145032445
25537,2198.238833,2198.297533,1,65947164,65948925,1761,0.11501941774631293
25538,2198.299967,2198.314733,1,65948999,65949441,442,0.10631463205911569
25539,2198.325933,2198.332033,1,65949777,65949960,183,0.8962889431646089
25540,2198.334833,2198.343033,1,65950044,65950290,246,0.6987589687082443
25541,2198.346367,2198.618767,1,65950391,65958563,8172,0.7165710232245139
25542,2198.667267,2198.678,1,65960018,65960340,322,0.098301010382909
25543,2198.722567,2198.728567,1,65961677,65961857,180,-0.0474857262604028
25544,2198.731067,2198.7383,1,65961932,65962149,217,0.5539248572822526
25545,2198.771733,2198.940133,1,65963151,65968203,5052,0.7855623608118447
25546,2198.9464,2198.967367,1,65968391,65969021,630,0.7619003770948245
25547,2198.973133,2198.998233,1,65969193,65969946,753,0.5816265096077853
25548,2199.013533,2199.017867,1,65970405,65970536,131,0.46248725157910653
25549,2199.036567,2199.068233,1,65971097,65972046,949,0.044790392268832094
25550,2199.0693,2199.0948,1,65972079,65972843,764,0.1531154048808797
25551,2199.0972,2199.126133,1,65972916,65973783,867,0.42864029677348076
25552,2199.155167,2199.365067,1,65974655,65980952,6297,0.706287029705696
25553,2199.372467,2199.396333,1,65981174,65981889,715,0.6609113432021774
25554,2199.645833,2199.6816,1,65989374,65990448,1074,0.4881044418030355
25555,2199.683967,2199.910333,1,65990519,65997309,6790,0.7627687922820569
25556,2199.935867,2199.943433,1,65998076,65998302,226,0.7582843884960573
25557,2199.951367,2199.954833,1,65998541,65998644,103,0.6335600211262822
25558,2199.9647,2199.984833,1,65998941,65999544,603,0.38946471501377006
25559,2199.991967,2200.001833,1,65999759,66000054,295,0.3809374506963351
25560,2200.019967,2200.042567,1,66000599,66001277,678,0.19964243399319118
25561,2200.0504,2200.063767,1,66001512,66001913,401,0.8135004911642231
25562,2200.075633,2200.1152,1,66002268,66003456,1188,0.17894069918059477
25563,2200.122233,2200.347867,1,66003666,66010436,6770,0.6651029431867752
25564,2200.379367,2200.3845,1,66011381,66011535,154,0.7932526209861396
25565,2200.3916,2200.414133,1,66011748,66012423,675,0.27024768475045646
25566,2200.4435,2200.646467,1,66013304,66019394,6090,0.7278544123420806
25567,2200.651267,2200.720133,1,66019538,66021603,2065,0.6345307132963487
25568,2200.743233,2200.747,1,66022296,66022409,113,0.8362221727813621
25569,2200.769767,2200.784233,1,66023093,66023526,433,0.11944658131558421
25570,2200.785233,2200.7953,1,66023556,66023859,303,0.8302701172965371
25571,2200.799467,2200.807267,1,66023984,66024218,234,0.6770049590804553
25572,2200.810133,2200.8214,1,66024303,66024641,338,0.5627773510132347
25573,2200.8261,2200.829633,1,66024783,66024888,105,0.21605905792066007
25574,2200.8406,2200.846567,1,66025218,66025397,179,0.7194402581744828
25575,2200.849333,2200.858767,1,66025479,66025763,284,0.08881370132601851
25576,2200.869533,2201.135733,1,66026085,66034071,7986,0.7239378251120441
25577,2201.173333,2201.176533,1,66035199,66035295,96,-0.10196298076376697
25578,2201.178633,2201.2208,1,66035358,66036624,1266,0.19758618258706054
25579,2201.228233,2201.406833,1,66036846,66042204,5358,0.7381467049887568
25580,2201.445367,2201.471567,1,66043361,66044147,786,0.4003957232812019
25581,2201.476233,2201.481133,1,66044286,66044433,147,0.9221038862950836
25582,2201.488267,2201.493633,1,66044648,66044808,160,0.7803064817950593
25583,2201.501033,2201.546933,1,66045030,66046407,1377,0.5845611712293639
25584,2201.550833,2201.592,1,66046524,66047760,1236,0.20728241757000668
25585,2201.603967,2201.623467,1,66048119,66048704,585,0.5240286389013586
25586,2201.626033,2201.631533,1,66048780,66048945,165,0.5169172388938021
25587,2201.639367,2201.7818,1,66049181,66053454,4273,0.6019416629202039
25588,2201.796867,2201.800167,1,66053906,66054005,99,0.7090407370349572
25589,2201.8281,2201.838,1,66054843,66055140,297,0.2991803162824119
25590,2201.845467,2201.924867,1,66055364,66057746,2382,0.6770692111122549
25591,2201.926833,2201.982367,1,66057804,66059471,1667,0.7367870649131631
25592,2201.996833,2202.0942,1,66059904,66062826,2922,0.20313291444062637
25593,2202.108833,2202.130533,1,66063264,66063915,651,0.7483821761900504
25594,2202.150133,2202.170667,1,66064503,66065120,617,0.3854469619394307
25595,2202.176633,2202.3488,1,66065298,66070464,5166,0.7656234745346001
25596,2202.35,2202.401433,1,66070500,66072042,1542,0.7176761195378611
25597,2202.441633,2202.4794,1,66073248,66074382,1134,0.18865876379739469
25598,2202.494067,2202.499,1,66074822,66074969,147,0.9278712476755407
25599,2202.507867,2202.7241,1,66075236,66081723,6487,0.7596794122770818
25600,2202.729933,2202.749367,1,66081897,66082481,584,0.753023515870013
25601,2202.753333,2202.7593,1,66082599,66082779,180,0.48129028817663744
25602,2202.8348,2202.838433,1,66085044,66085152,108,0.786200784568769
25603,2202.8725,2202.878933,1,66086175,66086367,192,0.540133915016465
25604,2202.900033,2202.9047,1,66087000,66087141,141,0.7796560046516524
25605,2202.993267,2203.160833,1,66089798,66094824,5026,0.7221277373367185
25606,2203.4732,2203.6347,1,66104196,66109041,4845,0.7968366915998708
25607,2203.638533,2203.672533,1,66109155,66110175,1020,0.722850018890556
25608,2203.735067,2203.738933,1,66112052,66112167,115,0.8941276383338465
25609,2203.7418,2203.778133,1,66112253,66113343,1090,0.7285493290739969
25610,2203.7837,2203.9456,1,66113511,66118368,4857,0.758709007010065
25611,2203.9469,2203.970033,1,66118407,66119100,693,0.6889122944967905
25612,2203.9789,2204.034,1,66119367,66121020,1653,0.5809025931976053
25613,2204.3599,2204.363433,1,66130797,66130902,105,0.9091657312591744
25614,2204.366567,2204.380233,1,66130997,66131406,409,0.34689171672520946
25615,2204.3844,2204.545367,1,66131532,66136361,4829,0.7257093021195288
25616,2204.547267,2204.599033,1,66136418,66137970,1552,0.7806374633094185
25617,2204.731233,2204.736033,1,66141936,66142080,144,0.5908627907790528
25618,2204.7632,2205.092333,1,66142895,66152769,9874,0.7329274084829814
25619,2205.1355,2205.140333,1,66154064,66154209,145,0.3274682072669287
25620,2205.1491,2205.153933,1,66154473,66154617,144,0.38742544313324795
25621,2205.1933,2205.2256,1,66155799,66156768,969,0.7158591404471799
25622,2205.230033,2205.371467,1,66156900,66161144,4244,0.5512182042736352
25623,2205.392233,2205.398067,1,66161766,66161942,176,0.601936898526924
25624,2205.414933,2205.436333,1,66162447,66163089,642,0.23209835481127983
25625,2205.475233,2205.553233,1,66164256,66166596,2340,0.14531225618458546
25626,2205.555167,2205.720933,1,66166655,66171627,4972,0.755917499886598
25627,2205.727933,2205.751267,1,66171837,66172538,701,0.7304522164228595
25628,2205.756867,2205.814033,1,66172706,66174420,1714,0.5568175340703392
25629,2205.815067,2205.835133,1,66174452,66175053,601,0.37510224709082196
25630,2205.838967,2205.872567,1,66175169,66176177,1008,0.16605492199462601
25631,2205.874267,2205.8944,1,66176228,66176832,604,0.2723141967951396
25632,2205.9135,2206.182833,1,66177405,66185484,8079,0.7656681432828025
25633,2206.195267,2206.2004,1,66185858,66186012,154,0.9205441695652654
25634,2206.216067,2206.2304,1,66186482,66186912,430,0.1647511544234534
25635,2206.233933,2206.246667,1,66187017,66187400,383,0.26810184572579504
25636,2206.2477,2206.2541,1,66187431,66187623,192,0.39615731736149756
25637,2206.260267,2206.265833,1,66187808,66187974,166,0.26666873247692946
25638,2206.268767,2206.298667,1,66188063,66188960,897,0.17754987751202894
25639,2206.2998,2206.349333,1,66188993,66190479,1486,0.16846562423819988
25640,2206.355233,2206.3651,1,66190656,66190953,297,0.23295451732635183
25641,2206.374967,2206.654733,1,66191249,66199641,8392,0.7617783773121827
25642,2206.656433,2206.661433,1,66199692,66199842,150,0.88734501639565
25643,2206.671233,2206.6775,1,66200136,66200324,188,0.5990510741138708
25644,2206.682833,2206.703967,1,66200484,66201119,635,0.1700614848277856
25645,2206.7052,2206.7103,1,66201156,66201309,153,0.6357187572411253
25646,2206.711733,2206.716267,1,66201351,66201488,137,0.6070470142344093
25647,2206.723167,2206.7341,1,66201695,66202023,328,0.43645650356508725
25648,2206.737833,2206.753733,1,66202134,66202611,477,0.3008478312586213
25649,2206.786467,2206.793867,1,66203594,66203816,222,0.6305190366779588
25650,2206.7959,2206.8238,1,66203877,66204714,837,0.7172934525932436
25651,2206.825767,2206.988633,1,66204773,66209658,4885,0.7409204329915866
25652,2206.991533,2207.049333,1,66209745,66211479,1734,0.7123379099410432
25653,2207.093133,2207.1045,1,66212793,66213135,342,0.552522671891358
25654,2207.174367,2207.178667,1,66215231,66215360,129,0.40854260742866005
25655,2207.180167,2207.187767,1,66215405,66215633,228,0.24985584957922477
25656,2207.3844,2207.440767,1,66221532,66223223,1691,0.7334100177303355
25657,2207.445467,2207.526067,1,66223364,66225782,2418,0.7189591398942463
25658,2207.555533,2207.603333,1,66226665,66228099,1434,0.6684712406328126
25659,2207.609133,2207.615733,1,66228273,66228471,198,0.8024814865696284
25660,2207.620867,2207.6253,1,66228626,66228759,133,0.9255645528548477
25661,2207.6327,2207.637567,1,66228981,66229127,146,0.8126332989843752
25662,2207.665033,2207.692233,1,66229950,66230766,816,0.6592632489775908
25663,2207.7375,2207.760733,1,66232125,66232821,696,0.254871319434149
25664,2207.7742,2207.779233,1,66233225,66233376,151,0.5151060216696267
25665,2207.780233,2207.9407,1,66233406,66238221,4815,0.745430225640707
25666,2207.944667,2208.029867,1,66238340,66240896,2556,0.6631630663007998
25667,2208.038,2208.052467,1,66241140,66241574,434,0.6359164979854562
25668,2208.0656,2208.1257,1,66241968,66243771,1803,0.10637745603655799
25669,2208.1355,2208.347567,1,66244064,66250427,6363,0.7263817815531212
25670,2208.349033,2208.3867,1,66250470,66251601,1131,0.7186028457944876
25671,2208.4049,2208.4194,1,66252147,66252582,435,0.6247798617546743
25672,2208.4322,2208.465667,1,66252966,66253970,1004,0.06145347247695006
25673,2208.466967,2208.4704,1,66254009,66254112,103,0.9174291853967735
25674,2208.498367,2208.519067,1,66254951,66255572,621,0.35007163202695135
25675,2208.5271,2208.534533,1,66255812,66256035,223,0.9483239787657428
25676,2208.540733,2208.544167,1,66256221,66256325,104,0.7179289383249451
25677,2208.5458,2208.549333,1,66256373,66256479,106,0.7253732869037142
25678,2208.5507,2208.759867,1,66256520,66262796,6276,0.7381788160610088
25679,2208.774933,2208.894267,1,66263247,66266828,3581,0.7088802390306165
25680,2208.9034,2208.910933,1,66267102,66267327,225,0.4771030819310632
25681,2208.934033,2208.955467,1,66268020,66268664,644,0.13379257310286521
25682,2208.9595,2208.997767,1,66268785,66269933,1148,0.09672853512113523
25683,2209.004667,2209.2158,1,66270140,66276474,6334,0.6825379461263701
25684,2209.217233,2209.2454,1,66276516,66277361,845,0.6850296729150643
25685,2209.2816,2209.286767,1,66278447,66278603,156,0.7706648417190751
25686,2209.454867,2209.466233,1,66283646,66283986,340,0.5291630449878435
25687,2209.4678,2209.471233,1,66284034,66284136,102,0.92908094027892
25688,2209.482767,2209.664067,1,66284483,66289922,5439,0.7645131296145337
25689,2209.6669,2209.6931,1,66290007,66290793,786,0.6614399448470544
25690,2209.6993,2209.7159,1,66290979,66291477,498,0.7950328431121899
25691,2209.717667,2209.726033,1,66291530,66291780,250,0.7341003322937634
25692,2209.762467,2210.047133,1,66292874,66301413,8539,0.752883885371987
25693,2210.0482,2210.0518,1,66301446,66301554,108,0.7819841821882544
25694,2210.061367,2210.0674,1,66301841,66302022,181,0.7814431957850954
25695,2210.068533,2210.071733,1,66302055,66302151,96,0.9157491622966896
25696,2210.0728,2210.083367,1,66302184,66302501,317,0.5278076813334439
25697,2210.118767,2210.131167,1,66303563,66303935,372,0.3104495230084772
25698,2210.135933,2210.145967,1,66304077,66304379,302,0.13265736473645304
25699,2210.161567,2210.198033,1,66304847,66305940,1093,0.5866579930123796
25700,2210.206567,2210.252467,1,66306197,66307574,1377,0.2648358813312675
25701,2210.254767,2210.4803,1,66307643,66314409,6766,0.7655510241139898
25702,2210.485067,2210.544833,1,66314552,66316344,1792,0.6270172665433692
25703,2210.567433,2210.601067,1,66317022,66318032,1010,0.14143134238976154
25704,2210.602667,2210.6834,1,66318080,66320502,2422,0.20222171255962293
25705,2210.726633,2210.977367,1,66321798,66329321,7523,0.7205495011389043
25706,2210.9865,2210.9952,1,66329595,66329855,260,0.21643087965592053
25707,2211.001267,2211.026033,1,66330038,66330780,742,0.054820734809561074
25708,2211.027533,2211.038667,1,66330825,66331160,335,0.1573062364066815
25709,2211.052833,2211.0698,1,66331584,66332094,510,0.46392570459543697
25710,2211.085333,2211.120867,1,66332559,66333626,1067,0.6002450870139642
25711,2211.124267,2211.127567,1,66333728,66333827,99,0.9534886512765404
25712,2211.135267,2211.163167,1,66334058,66334895,837,0.3371704875698434
25713,2211.2024,2211.233,1,66336072,66336990,918,0.6731980211888962
25714,2211.234033,2211.463067,1,66337020,66343892,6872,0.7556138266702203
25715,2211.5155,2211.5194,1,66345465,66345582,117,-0.01854502111054122
25716,2211.531433,2211.541267,1,66345942,66346238,296,0.2016344195064606
25717,2211.574933,2211.6112,1,66347247,66348335,1088,0.09314249673375176
25718,2211.638633,2211.6461,1,66349158,66349383,225,0.2863698560315018
25719,2211.7089,2211.7221,1,66351267,66351663,396,0.21569114654852312
25720,2211.818233,2211.911933,1,66354546,66357357,2811,0.580405580097915
25721,2211.9889,2212.1067,1,66359666,66363200,3534,0.7188783732143673
25722,2212.1214,2212.1289,1,66363642,66363867,225,0.5020836824840768
25723,2212.143267,2212.149467,1,66364298,66364484,186,0.5082462889622177
25724,2212.152733,2212.164033,1,66364581,66364920,339,0.3096069674980275
25725,2212.1727,2212.1945,1,66365181,66365835,654,0.7174891842071123
25726,2212.2145,2212.256533,1,66366435,66367695,1260,0.7149389672056052
25727,2212.2584,2212.270667,1,66367752,66368120,368,0.5594243837703621
25728,2212.2773,2212.302767,1,66368319,66369083,764,0.707173111183202
25729,2212.308933,2212.349533,1,66369267,66370485,1218,0.08019440194502697
25730,2212.3576,2212.5233,1,66370727,66375698,4971,0.751949373541414
25731,2212.529933,2212.5658,1,66375897,66376973,1076,0.7639352711836612
25732,2212.568667,2212.5805,1,66377060,66377415,355,0.512183638715068
25733,2212.5815,2212.585867,1,66377444,66377576,132,0.676864272679774
25734,2212.590733,2212.620833,1,66377721,66378624,903,0.21077570870394888
25735,2212.624967,2212.6371,1,66378749,66379113,364,0.13696239093869475
25736,2212.642367,2212.685367,1,66379271,66380561,1290,0.4358616375887035
25737,2212.6901,2212.729233,1,66380702,66381876,1174,0.141623849470556
25738,2212.733467,2212.7476,1,66382004,66382428,424,0.23475858144155834
25739,2212.753233,2212.800067,1,66382596,66384002,1406,0.4796540169576903
25740,2212.807833,2212.827,1,66384234,66384810,576,0.30425255428796866
25741,2212.8442,2212.985933,1,66385326,66389577,4251,0.7717132265918684
25742,2213.031733,2213.037067,1,66390951,66391112,161,0.31717506014004293
25743,2213.0387,2213.047133,1,66391161,66391413,252,0.7509024924215127
25744,2213.053633,2213.074933,1,66391608,66392247,639,0.7749858102764192
25745,2213.076433,2213.2308,1,66392292,66396923,4631,0.7801735486032544
25746,2213.246267,2213.250167,1,66397388,66397505,117,0.9094118155926703
25747,2213.2617,2213.264967,1,66397851,66397949,98,0.8689239026588262
25748,2213.2676,2213.3233,1,66398028,66399699,1671,0.08684254603782054
25749,2213.340733,2213.375567,1,66400221,66401267,1046,0.29604290183490434
25750,2213.3783,2213.387,1,66401348,66401610,262,0.6028724721673926
25751,2213.394733,2213.557067,1,66401841,66406712,4871,0.7231624521616157
25752,2213.568267,2213.5896,1,66407048,66407687,639,0.7370548987176666
25753,2213.595967,2213.6503,1,66407879,66409508,1629,0.6876926318685999
25754,2213.6603,2213.664933,1,66409809,66409947,138,0.8868093395934661
25755,2213.677167,2213.6936,1,66410315,66410808,493,-0.028363814903349025
25756,2213.697567,2213.703567,1,66410927,66411107,180,0.7178028380237952
25757,2213.751633,2213.755433,1,66412548,66412662,114,0.5281209986320592
25758,2213.7571,2213.9483,1,66412712,66418449,5737,0.7486088465730938
25759,2214.076833,2214.0845,1,66422304,66422535,231,-0.03608208352904274
25760,2214.0969,2214.101333,1,66422907,66423039,132,0.7586733641268759
25761,2214.1072,2214.120967,1,66423216,66423629,413,0.40761426422481983
25762,2214.1354,2214.139933,1,66424062,66424197,135,0.19383378899482678
25763,2214.154733,2214.170067,1,66424641,66425102,461,0.4226752291637713
25764,2214.2432,2214.2467,1,66427296,66427401,105,0.7098384817331894
25765,2214.250267,2214.2543,1,66427508,66427629,121,0.7805145903573378
25766,2214.288767,2214.3746,1,66428663,66431238,2575,0.739312723361452
25767,2214.391933,2214.423467,1,66431757,66432704,947,0.5957056912911052
25768,2214.511033,2214.681733,1,66435330,66440451,5121,0.7236531784392103
25769,2214.683267,2214.7867,1,66440498,66443601,3103,0.6971624028486857
25770,2214.8119,2214.816367,1,66444357,66444491,134,0.758617485655488
25771,2214.843267,2214.8528,1,66445298,66445584,286,0.436227859479801
25772,2215.2339,2215.380967,1,66457017,66461429,4412,0.8600370932120303
25773,2215.445933,2215.4694,1,66463377,66464082,705,0.5395504113643603
25774,2215.4728,2215.4778,1,66464184,66464334,150,0.6611395844871707
25775,2215.4842,2215.490067,1,66464525,66464702,177,0.6074884433145519
25776,2215.491133,2215.5066,1,66464733,66465198,465,0.10803916632222578
25777,2215.510367,2215.520833,1,66465311,66465624,313,0.5184343207905923
25778,2215.534967,2215.542033,1,66466049,66466260,211,0.6923688987585341
25779,2215.556867,2215.5886,1,66466706,66467658,952,0.08340633980224696
25780,2215.599133,2215.6151,1,66467973,66468453,480,0.3495857546603951
25781,2215.620367,2215.634633,1,66468611,66469038,427,0.029289307491852937
25782,2215.636433,2215.6435,1,66469092,66469305,213,0.5684002213888657
25783,2215.678933,2215.718733,1,66470367,66471561,1194,0.6242669844710804
25784,2215.720067,2215.738933,1,66471602,66472167,565,0.43996650965974365
25785,2215.7433,2215.7469,1,66472299,66472407,108,0.5012220341644059
25786,2215.7521,2215.781067,1,66472563,66473432,869,0.43243528287298477
25787,2215.7841,2215.9312,1,66473522,66477936,4414,0.6804431651440735
25788,2215.939633,2216.009167,1,66478188,66480275,2087,0.6813430982169629
25789,2216.024533,2216.028333,1,66480735,66480849,114,0.4411318659885614
25790,2216.045667,2216.065733,1,66481370,66481971,601,0.6986097192512994
25791,2216.0818,2216.139133,1,66482454,66484173,1719,0.6531541545832329
25792,2216.1404,2216.160533,1,66484212,66484815,603,0.4269304423343085
25793,2216.175133,2216.194267,1,66485253,66485828,575,0.7182283473357162
25794,2216.201833,2216.2049,1,66486054,66486147,93,0.8252352426619189
25795,2216.207433,2216.271167,1,66486222,66488135,1913,0.7168851107026661
25796,2216.277067,2216.281167,1,66488312,66488435,123,0.1988200233290352
25797,2216.2849,2216.2946,1,66488547,66488838,291,0.6725251454426856
25798,2216.308533,2216.3263,1,66489255,66489789,534,0.6542312195540796
25799,2216.345967,2216.4008,1,66490379,66492024,1645,0.6384591147438101
25800,2216.417967,2216.4332,1,66492539,66492996,457,0.512851319524575
25801,2216.442867,2216.4631,1,66493286,66493893,607,0.6488222655834811
25802,2216.4727,2216.4757,1,66494180,66494271,91,0.5374880146403023
25803,2216.483,2216.5473,1,66494490,66496419,1929,0.740214217356424
25804,2216.553267,2216.5587,1,66496598,66496761,163,0.7945155589036828
25805,2216.717067,2216.736333,1,66501512,66502089,577,0.3410171474739974
25806,2216.7377,2216.917633,1,66502131,66507528,5397,0.7692317169114247
25807,2216.919533,2216.941933,1,66507585,66508257,672,0.7502949535255515
25808,2216.9463,2216.970433,1,66508389,66509112,723,0.7161326262077794
25809,2216.9776,2216.987333,1,66509328,66509619,291,0.5900716346160072
25810,2217.005933,2217.018,1,66510177,66510540,363,-0.05188039936176533
25811,2217.025667,2217.043667,1,66510770,66511310,540,0.10733451878451795
25812,2217.066633,2217.070067,1,66511998,66512102,104,0.930142907131084
25813,2217.071733,2217.105267,1,66512151,66513158,1007,0.632249210542961
25814,2217.116667,2217.147533,1,66513500,66514425,925,0.2394507120131424
25815,2217.174367,2217.1823,1,66515231,66515469,238,0.14420981026294116
25816,2217.184,2217.198333,1,66515520,66515949,429,0.6685690728245188
25817,2217.199767,2217.207667,1,66515993,66516230,237,0.8780735470321233
25818,2217.211633,2217.229967,1,66516348,66516899,551,0.630066471284952
25819,2217.254667,2217.258933,1,66517640,66517767,127,0.6288885491664339
25820,2217.260367,2217.265233,1,66517811,66517956,145,0.3509585187480827
25821,2217.2683,2217.273533,1,66518049,66518205,156,0.5069223634863967
25822,2217.2756,2217.338433,1,66518268,66520152,1884,0.7354171279576565
25823,2217.340167,2217.6482,1,66520205,66529446,9241,0.6999389980774299
25824,2217.667367,2217.708867,1,66530021,66531266,1245,0.06892565668080086
25825,2217.717467,2217.735733,1,66531524,66532071,547,0.4849597585854701
25826,2217.7368,2217.751833,1,66532104,66532554,450,0.6820418106686008
25827,2217.754767,2217.7601,1,66532643,66532803,160,0.8583367485606463
25828,2217.783333,2217.9292,1,66533499,66537876,4377,0.8017709387242766
25829,2217.943133,2217.9481,1,66538293,66538443,150,0.3879047564071633
25830,2217.9582,2217.964233,1,66538746,66538926,180,0.7641745760571731
25831,2217.981933,2218.0234,1,66539457,66540702,1245,0.201682642807077
25832,2218.0327,2218.0565,1,66540981,66541695,714,0.6758439315287866
25833,2218.060667,2218.0675,1,66541820,66542025,205,0.8614127285741284
25834,2218.0791,2218.117933,1,66542373,66543537,1164,0.2125635992065243
25835,2218.125133,2218.181033,1,66543753,66545430,1677,0.6044390539395115
25836,2218.193267,2218.209167,1,66545798,66546275,477,0.2969723542627202
25837,2218.228567,2218.232133,1,66546857,66546963,106,0.8128433665159238
25838,2218.235367,2218.241233,1,66547061,66547236,175,0.0356425880624046
25839,2218.276433,2218.315,1,66548292,66549450,1158,0.7066515139517673
25840,2218.406333,2218.409367,1,66552189,66552281,92,0.3383589041460402
25841,2218.4104,2218.491433,1,66552312,66554742,2430,0.7393094662655715
25842,2218.498933,2218.6237,1,66554967,66558711,3744,0.7637777863723135
25843,2218.6363,2218.647233,1,66559089,66559416,327,0.5525077837131577
25844,2218.6513,2218.7524,1,66559539,66562571,3032,0.6683124746181272
25845,2218.768133,2218.786367,1,66563043,66563591,548,0.18715020624233758
25846,2218.790267,2218.794667,1,66563708,66563840,132,0.5028544259110505
25847,2218.809233,2218.8581,1,66564276,66565743,1467,0.6042560361300074
25848,2218.864733,2218.968767,1,66565941,66569063,3122,0.5814160049695826
25849,2218.981367,2218.988433,1,66569441,66569652,211,0.5470478750446756
25850,2218.991633,2219.0254,1,66569748,66570762,1014,0.5693953016132863
25851,2219.029867,2219.0499,1,66570896,66571497,601,0.14584339540392685
25852,2219.056267,2219.110067,1,66571688,66573302,1614,0.6307716515190245
25853,2219.116367,2219.119967,1,66573491,66573599,108,0.9344225414642421
25854,2219.121867,2219.125367,1,66573656,66573761,105,0.9765751009268182
25855,2219.1309,2219.172833,1,66573927,66575184,1257,0.6260424631440762
25856,2219.1757,2219.222633,1,66575270,66576678,1408,0.3207441973643503
25857,2219.233333,2219.261467,1,66576999,66577844,845,0.6728982936613026
25858,2219.2627,2219.3181,1,66577881,66579543,1662,0.13452391175104172
25859,2219.335267,2219.339833,1,66580058,66580194,136,0.876777314743884
25860,2219.342167,2219.593267,1,66580265,66587798,7533,0.7436064166168962
25861,2219.6589,2219.661933,1,66589767,66589857,90,0.836637553981435
25862,2219.6702,2219.888433,1,66590106,66596652,6546,0.8214860941480904
25863,2219.9079,2219.926567,1,66597237,66597797,560,0.2314611601254629
25864,2219.940733,2219.9606,1,66598221,66598818,597,0.6150463396564175
25865,2219.971167,2219.9962,1,66599135,66599886,751,0.6502011416611735
25866,2219.9975,2220.0116,1,66599925,66600347,422,0.7522870006459513
25867,2220.029767,2220.053033,1,66600893,66601590,697,0.3616483884971323
25868,2220.0625,2220.0737,1,66601875,66602211,336,0.13569930915519277
25869,2220.0757,2220.1033,1,66602270,66603099,829,0.39930836568605865
25870,2220.1053,2220.121633,1,66603159,66603648,489,0.5765925158235273
25871,2220.1473,2220.3659,1,66604419,66610976,6557,0.3797390224990887
25872,2220.3676,2220.396367,1,66611028,66611891,863,0.7892367082345184
25873,2220.398033,2220.420733,1,66611940,66612621,681,0.7478755450726441
25874,2220.442133,2220.445233,1,66613263,66613356,93,0.8751697235031014
25875,2220.452233,2220.509133,1,66613566,66615273,1707,0.7424803154313129
25876,2220.5156,2220.5512,1,66615468,66616536,1068,0.6682404235685742
25877,2220.556767,2220.568333,1,66616703,66617049,346,0.5109180287483742
25878,2220.587533,2220.617,1,66617625,66618510,885,0.47974430995406026
25879,2220.6316,2220.6806,1,66618948,66620418,1470,0.42685455366022534
25880,2220.6823,2220.700933,1,66620469,66621027,558,0.11087048917964304
25881,2220.712467,2220.761867,1,66621374,66622856,1482,0.706197654761598
25882,2220.7833,2220.837667,1,66623499,66625130,1631,0.6691507970582841
25883,2220.885267,2220.9122,1,66626558,66627366,808,0.6418692748865809
25884,2220.9256,2220.938433,1,66627768,66628152,384,0.5386281682068164
25885,2220.967733,2220.9995,1,66629031,66629985,954,0.6518152881292228
25886,2221.000667,2221.0851,1,66630020,66632552,2532,0.6491471650608055
25887,2221.1276,2221.1347,1,66633827,66634041,214,0.1938699413324721
25888,2221.147633,2221.157033,1,66634428,66634710,282,0.7348008531955164
25889,2221.171833,2221.196733,1,66635154,66635901,747,0.4106330806845334
25890,2221.2498,2221.2568,1,66637494,66637704,210,0.608814908138071
25891,2221.2693,2221.3098,1,66638079,66639294,1215,0.7449883675300797
25892,2221.321033,2221.371233,1,66639630,66641136,1506,0.2447837705945919
25893,2221.3952,2221.573767,1,66641856,66647213,5357,0.7421635101091432
25894,2221.5798,2221.805233,1,66647394,66654156,6762,0.7270201261602871
25895,2221.808633,2221.8191,1,66654258,66654573,315,0.7828222851600782
25896,2221.8714,2221.8778,1,66656142,66656334,192,0.8479291750786798
25897,2221.8835,2221.951667,1,66656505,66658550,2045,0.7229675805333147
25898,2221.953,2222.010333,1,66658590,66660309,1719,0.7742027111514759
25899,2222.0218,2222.0294,1,66660654,66660882,228,0.45215453631540137
25900,2222.0574,2222.062233,1,66661722,66661866,144,0.827123701181786
25901,2222.069967,2222.073233,1,66662099,66662196,97,0.3208942662288455
25902,2222.075,2222.091,1,66662249,66662730,481,0.6855455116996619
25903,2222.0924,2222.1597,1,66662772,66664791,2019,0.7098376436982433
25904,2222.161333,2222.166967,1,66664839,66665009,170,0.6291599350105957
25905,2222.168067,2222.209333,1,66665042,66666279,1237,0.7337609519780562
25906,2222.213033,2222.216833,1,66666390,66666504,114,0.8124256696110176
25907,2222.252667,2222.2662,1,66667580,66667986,406,0.23681196394795243
25908,2222.2878,2222.291567,1,66668634,66668747,113,-0.044129070794399934
25909,2222.294733,2222.351633,1,66668841,66670548,1707,0.7498105454508702
25910,2222.353467,2222.387933,1,66670604,66671637,1033,0.6859899966173868
25911,2222.389067,2222.402667,1,66671672,66672080,408,0.6423551608307619
25912,2222.404033,2222.429667,1,66672120,66672890,770,0.567610335058677
25913,2222.450567,2222.4561,1,66673517,66673683,166,0.6851504326043929
25914,2222.463367,2222.486933,1,66673901,66674607,706,0.18504878696106605
25915,2222.4923,2222.548033,1,66674769,66676440,1671,0.5954486808617773
25916,2222.5491,2222.7071,1,66676473,66681213,4740,0.7514721075456037
25917,2222.715633,2222.7677,1,66681468,66683031,1563,0.736893609647407
25918,2222.7992,2222.910867,1,66683976,66687326,3350,0.6892823377441745
25919,2222.912233,2223.054567,1,66687366,66691637,4271,0.6899593418746616
25920,2223.057133,2223.080067,1,66691713,66692402,689,0.6721722513963146
25921,2223.085933,2223.0961,1,66692577,66692883,306,0.6598049987528428
25922,2223.0979,2223.114333,1,66692937,66693429,492,0.3066089830358682
25923,2223.117633,2223.1342,1,66693528,66694026,498,0.7910080722108115
25924,2223.1385,2223.142367,1,66694155,66694271,116,0.6282108175290083
25925,2223.160233,2223.192533,1,66694806,66695775,969,0.5411049117298494
25926,2223.207,2223.2216,1,66696210,66696647,437,0.4503801229593773
25927,2223.223633,2223.228233,1,66696708,66696846,138,0.9390327462303558
25928,2223.237433,2223.279267,1,66697122,66698378,1256,0.7258976351470693
25929,2223.280467,2223.2945,1,66698414,66698835,421,0.6425914096343832
25930,2223.3101,2223.327967,1,66699303,66699839,536,0.1678868254571998
25931,2223.335433,2223.341133,1,66700062,66700233,171,0.8974022990251596
25932,2223.342433,2223.346867,1,66700272,66700406,134,0.8150486487450255
25933,2223.351033,2223.376767,1,66700530,66701303,773,0.4961053695499826
25934,2223.386033,2223.394367,1,66701580,66701831,251,-0.09546918012437934
25935,2223.3986,2223.451,1,66701958,66703530,1572,0.05997797798804334
25936,2223.4538,2223.475067,1,66703613,66704252,639,0.11018238382108304
25937,2223.476267,2223.4838,1,66704288,66704514,226,0.39132130826245937
25938,2223.4901,2223.512167,1,66704703,66705365,662,-0.042024861870525815
25939,2223.5247,2223.5296,1,66705741,66705887,146,0.7004711291055722
25940,2223.539467,2223.559433,1,66706184,66706782,598,0.46115541778316493
25941,2223.561867,2223.592767,1,66706856,66707783,927,0.6742634839821084
25942,2223.594567,2223.6496,1,66707837,66709488,1651,0.5514568729907025
25943,2223.651533,2223.660667,1,66709545,66709820,275,0.5679953893566899
25944,2223.6678,2223.6833,1,66710034,66710499,465,0.5041660158302385
25945,2223.684933,2223.696633,1,66710547,66710898,351,0.7111211072831743
25946,2223.7216,2223.744367,1,66711647,66712331,684,0.14990954428285314
25947,2223.745467,2223.785333,1,66712364,66713559,1195,0.517583047829888
25948,2223.796067,2223.814033,1,66713882,66714420,538,0.35906609819197016
25949,2223.816267,2223.826133,1,66714488,66714783,295,0.47768614920478114
25950,2223.8526,2223.862133,1,66715578,66715863,285,0.7225755671500705
25951,2223.8647,2223.872567,1,66715941,66716177,236,0.4143536799900883
25952,2223.874367,2223.880867,1,66716231,66716426,195,0.786098932809224
25953,2223.887433,2223.917,1,66716622,66717510,888,0.6789137689794964
25954,2223.940233,2223.952767,1,66718206,66718583,377,0.46940340839981987
25955,2223.953967,2223.976667,1,66718619,66719300,681,0.36362000825142066
25956,2223.980533,2224.010633,1,66719415,66720318,903,0.35990309082257327
25957,2224.030867,2224.060333,1,66720926,66721809,883,0.8286932315659027
25958,2224.0697,2224.078867,1,66722091,66722366,275,0.614102063097259
25959,2224.094767,2224.1353,1,66722843,66724059,1216,0.7045948496763128
25960,2224.143967,2224.2081,1,66724319,66726242,1923,0.6774107378074365
25961,2224.2102,2224.2712,1,66726306,66728136,1830,0.22766074432019273
25962,2224.2842,2224.289367,1,66728526,66728681,155,0.7208024711698946
25963,2224.291133,2224.3281,1,66728733,66729843,1110,0.4738531820631278
25964,2224.337533,2224.4212,1,66730125,66732636,2511,0.127666416182205
25965,2224.427267,2224.4303,1,66732818,66732909,91,0.7924915649131182
25966,2224.4556,2224.5092,1,66733667,66735276,1609,0.8132082712996478
25967,2224.523167,2224.558433,1,66735695,66736752,1057,0.17902296854041908
25968,2224.559733,2224.563,1,66736791,66736890,99,0.5010903545004107
25969,2224.574767,2224.578467,1,66737243,66737354,111,0.59392829518825
25970,2224.610367,2224.625233,1,66738311,66738756,445,0.7808388376732821
25971,2224.6319,2224.654733,1,66738956,66739641,685,0.09544716945053937
25972,2224.657367,2224.666533,1,66739721,66739995,274,0.4871392983215947
25973,2224.675,2224.680233,1,66740250,66740406,156,0.7611562220601246
25974,2224.681233,2224.7065,1,66740436,66741194,758,0.31673302534817427
25975,2225.186267,2225.298233,1,66755588,66758946,3358,0.6968509257980899
25976,2225.389567,2225.474633,1,66761687,66764238,2551,0.5952905616117242
25977,2225.479067,2225.5638,1,66764372,66766914,2542,0.7822187447358554
25978,2225.565367,2225.590667,1,66766961,66767720,759,0.7513108578007741
25979,2225.593467,2225.848033,1,66767804,66775440,7636,0.7542546823393006
25980,2225.856533,2225.9599,1,66775695,66778796,3101,0.7120590985618797
25981,2226.5337,2226.552667,1,66796011,66796580,569,0.7945953803814758
25982,2226.573267,2226.6274,1,66797198,66798821,1623,0.4730488041332242
25983,2226.6341,2226.659567,1,66799023,66799787,764,0.17972308050397393
25984,2226.661767,2226.674267,1,66799853,66800228,375,0.6872083546887652
25985,2226.676033,2226.686233,1,66800280,66800586,306,0.7013488097877423
25986,2226.704933,2226.7103,1,66801147,66801309,162,0.8092699828994856
25987,2226.757667,2226.774867,1,66802730,66803246,516,0.7036444598556435
25988,2226.776967,2226.797067,1,66803309,66803912,603,0.6299502466920041
25989,2226.798567,2226.862267,1,66803957,66805868,1911,0.6434713219429048
25990,2226.889467,2226.900767,1,66806684,66807023,339,0.5547664925603066
25991,2226.932,2227.0567,1,66807959,66811701,3742,0.49959944072322154
25992,2227.0889,2227.3258,1,66812667,66819774,7107,0.7512707114109747
25993,2227.330733,2227.335067,1,66819921,66820052,131,0.8336102633233844
25994,2227.336467,2227.363133,1,66820094,66820893,799,0.7443809838395538
25995,2227.378133,2227.407933,1,66821343,66822237,894,0.27674077192346397
25996,2227.416867,2227.463967,1,66822506,66823919,1413,0.6924139273166555
25997,2227.469833,2227.5184,1,66824094,66825552,1458,0.2853280428876421
25998,2227.5248,2227.568733,1,66825744,66827061,1317,0.5517300978967511
25999,2227.570567,2227.5981,1,66827117,66827943,826,0.03608413861401869
26000,2227.5997,2227.6182,1,66827991,66828546,555,0.25072331524470265
26001,2227.6194,2227.6231,1,66828582,66828692,110,0.39854890049257685
26002,2227.689233,2227.7183,1,66830676,66831549,873,0.7832940415961074
26003,2227.720367,2227.750067,1,66831611,66832502,891,0.6856861856422624
26004,2227.7982,2227.849167,1,66833946,66835475,1529,0.582806723882686
26005,2227.8524,2228.109733,1,66835572,66843291,7719,0.5322087019522372
26006,2228.129833,2228.179767,1,66843894,66845393,1499,0.7128775293476267
26007,2228.185433,2228.2039,1,66845562,66846117,555,0.6007454118056591
26008,2228.2049,2228.2207,1,66846147,66846620,473,0.6284845073498336
26009,2228.247667,2228.257867,1,66847430,66847736,306,0.3345437662902909
26010,2228.296867,2228.483633,1,66848906,66854508,5602,0.7278018831530502
26011,2228.489367,2228.511867,1,66854681,66855356,675,0.6720776062837828
26012,2228.5138,2228.5408,1,66855414,66856224,810,0.6876680167380823
26013,2228.545967,2228.551633,1,66856379,66856548,169,0.6131206924591517
26014,2228.555167,2228.561733,1,66856655,66856851,196,0.455229993924251
26015,2228.5786,2228.582,1,66857357,66857460,103,0.7998418364659411
26016,2228.607733,2228.6245,1,66858231,66858735,504,0.3624818308126569
26017,2228.627133,2228.630467,1,66858813,66858914,101,0.15752892779913533
26018,2228.631567,2228.645167,1,66858947,66859355,408,0.287230058652398
26019,2228.6508,2228.677633,1,66859524,66860328,804,0.055519001514318315
26020,2228.716067,2228.7232,1,66861482,66861696,214,0.4053459589755662
26021,2228.724467,2228.728467,1,66861734,66861854,120,0.625715256132206
26022,2228.920367,2228.971933,1,66867611,66869157,1546,0.7724917763649064
26023,2228.978333,2228.993,1,66869349,66869790,441,0.3552989600644382
26024,2229.0822,2229.2176,1,66872465,66876528,4063,0.7689834349069776
26025,2229.2346,2229.242567,1,66877037,66877277,240,0.6583130859728927
26026,2229.2659,2229.281867,1,66877976,66878456,480,0.24912459581040367
26027,2229.630267,2229.6411,1,66888908,66889232,324,0.5553405436354575
26028,2229.646767,2229.760467,1,66889403,66892814,3411,0.6461041688493253
26029,2229.761467,2229.769,1,66892844,66893069,225,0.8137992833219398
26030,2229.771733,2229.798967,1,66893151,66893969,818,0.7153314948441466
26031,2229.836433,2229.840467,1,66895092,66895214,122,0.7312885177210816
26032,2229.948367,2230.0093,1,66898451,66900279,1828,0.6954690165735198
26033,2230.017833,2230.354867,1,66900534,66910646,10112,0.737116873031513
26034,2230.394167,2230.397333,1,66911825,66911919,94,0.698276355121634
26035,2230.398467,2230.409033,1,66911954,66912270,316,0.4276389955745433
26036,2230.921167,2230.9244,1,66927635,66927732,97,0.350142808651826
26037,2230.931133,2230.9423,1,66927933,66928269,336,0.5312388845846004
26038,2230.947667,2231.1443,1,66928430,66934329,5899,0.8398949749440937
26039,2231.164367,2231.1694,1,66934931,66935082,151,0.7737759685207205
26040,2231.1766,2231.180233,1,66935297,66935406,109,0.8061118152934738
26041,2231.202067,2231.228067,1,66936062,66936842,780,0.1796172274951261
26042,2231.2442,2231.258267,1,66937326,66937748,422,0.48739543490290743
26043,2231.264167,2231.269867,1,66937925,66938096,171,0.5750020995528247
26044,2231.314633,2231.337467,1,66939438,66940124,686,0.20238135230014312
26045,2231.339,2231.343267,1,66940170,66940298,128,0.6249986188778587
26046,2231.402367,2231.426433,1,66942071,66942792,721,0.6956093233518551
26047,2231.503433,2231.543467,1,66945102,66946304,1202,0.6680745058289299
26048,2231.5867,2231.604633,1,66947600,66948138,538,0.7397140309413899
26049,2231.654367,2231.699067,1,66949631,66950972,1341,0.7463030999135312
26050,2231.706533,2231.745633,1,66951195,66952368,1173,0.7182726373175096
26051,2231.7962,2231.834567,1,66953886,66955037,1151,0.6886170716427229
26052,2231.839333,2231.885033,1,66955179,66956550,1371,0.7381530237266539
26053,2232.1162,2232.121767,1,66963486,66963653,167,-0.1331002384742287
26054,2232.1359,2232.287467,1,66964077,66968624,4547,0.7266815078890316
26055,2232.585367,2232.693433,1,66977561,66980802,3241,0.5339476044765002
26056,2232.701567,2232.7197,1,66981047,66981591,544,0.6174628285885244
26057,2233.141167,2233.144667,1,66994235,66994340,105,0.48175579362797305
26058,2233.261833,2233.301433,1,66997854,66999042,1188,0.5628631671930474
26059,2233.3028,2233.306833,1,66999084,66999204,120,0.49863370527678125
26060,2233.308833,2233.3372,1,66999264,67000116,852,0.4220649052871125
26061,2233.450967,2233.560233,1,67003529,67006806,3277,0.7119195461856836
26062,2233.623467,2233.739733,1,67008704,67012191,3487,0.7535201185245027
26063,2233.807933,2233.917033,1,67014237,67017510,3273,0.7314712169603068
26064,2233.998267,2234.113733,1,67019948,67023411,3463,0.7207326455784931
26065,2234.116,2234.1209,1,67023480,67023627,147,0.08855293469807604
26066,2234.245633,2234.253833,1,67027368,67027614,246,0.5860916353464041
26067,2234.2583,2234.433867,1,67027749,67033016,5267,0.7374827351648064
26068,2234.481667,2234.492067,1,67034450,67034762,312,0.4501997074105263
26069,2234.6506,2234.6557,1,67039518,67039670,152,-0.05348581622671968
26070,2234.660333,2234.923967,1,67039809,67047719,7910,0.7332797626199951
26071,2235.060167,2235.0696,1,67051805,67052087,282,0.01684784568145662
26072,2235.477367,2235.6396,1,67064321,67069188,4867,0.6102338199289644
